Tempo total receptor,Tempo total emissor,Id do pacote,Id da mensagem,Distancia (m),Tempo zerado receptor,Tempo zerado emissor,Delta tempo,Velocidade (m/s)
1747960947407297,155148,1,2,200,0,0,0,0
1747960947427559,242508,1,3,200,20262,87360,-67098,0
1747960948124024,329868,1,4,200,716727,174720,542007,368.9989243681355
1747960948140765,417228,1,5,200,733468,262080,471388,424.27893794496254
1747960948161182,504588,1,6,200,753885,349440,404445,494.5048152406384
1747960948848817,591948,1,7,200,1441520,436800,1004720,199.0604347479895
1747960948869778,679308,1,8,200,1462481,524160,938321,213.14667368629713
1747960948890943,766668,1,9,200,1483646,611520,872126,229.32466180345503
1747960949577917,854036,1,10,200,2170620,698888,1471732,135.89430684390908
1747960949598735,942428,1,11,200,2191438,787280,1404158,142.43411353992926
1747960949619373,1030828,1,12,200,2212076,875680,1336396,149.65623961759837
1747960950311183,1120276,1,13,200,2903886,965128,1938758,103.15882642392707
1747960950336199,1209708,1,14,200,2928902,1054560,1874342,106.70411269661567
1747960950356033,1299148,1,15,200,2948736,1144000,1804736,110.81953260753929
1747960951044295,1388592,1,16,200,3636998,1233444,2403554,83.21011302429652
1747960951065053,1478028,1,17,200,3657756,1322880,2334876,85.65765376833717
1747960951089593,1567468,1,18,200,3682296,1412320,2269976,88.10665839638833
1747960951110156,1656908,1,19,200,3702859,1501760,2201099,90.86370036059259
1747960951798513,1746348,1,20,200,4391216,1591200,2800016,71.42816326763848
1747960951818794,1835788,1,21,200,4411497,1680640,2730857,73.23708271798927
1747960951843309,1925228,1,22,200,4436012,1770080,2665932,75.02066819408746
1747960952535579,2014668,1,23,200,5128282,1859520,3268762,61.185243832374454
1747960952555163,2104108,1,24,200,5147866,1948960,3198906,62.521374494905444
1747960952576500,2193548,1,25,200,5169203,2038400,3130803,63.88137484217308
1747960953268639,2282988,1,26,200,5861342,2127840,3733502,53.56900840015621
1747960953289310,2372428,1,27,200,5882013,2217280,3664733,54.57423501248249
1747960953308611,2461868,1,28,200,5901314,2306720,3594594,55.63910694782221
1747960954000869,2551308,1,29,200,6593572,2396160,4197412,47.64840811433331
1747960954021558,2640748,1,30,200,6614261,2485600,4128661,48.4418556040324
1747960954042647,2730188,1,31,200,6635350,2575040,4060310,49.25732271673837
1747960954734865,2819628,1,32,200,7327568,2664480,4663088,42.89003338560199
1747960954755267,2909068,1,33,200,7347970,2753920,4594050,43.53457189190365
1747960954775952,2998508,1,34,200,7368655,2843360,4525295,44.19601374054067
1747960955467950,3087948,1,35,200,8060653,2932800,5127853,39.00267811889304
1747960955487895,3177388,1,36,200,8080598,3022240,5058358,39.53852218447172
1747960955508837,3266828,1,37,200,8101540,3111680,4989860,40.081284845667014
1747960956200956,3356268,1,38,200,8793659,3201120,5592539,35.76193210275333
1747960956221605,3445708,1,39,200,8814308,3290560,5523748,36.20729982613254
1747960956242218,3535148,1,40,200,8834921,3380000,5454921,36.664142340466526
1747960956933860,3624588,1,41,200,9526563,3469440,6057123,33.018976170700185
1747960956954158,3714028,1,42,200,9546861,3558880,5987981,33.400239579918505
1747960956975158,3803468,1,43,200,9567861,3648320,5919541,33.78640337147762
1747960957667215,3892908,1,44,200,10259918,3737760,6522158,30.66469717538275
1747960957687384,3982356,1,45,200,10280087,3827208,6452879,30.993917598640852
1747960957708392,4071788,1,46,200,10301095,3916640,6384455,31.326088131250042
1747960958401002,4161228,1,47,200,10993705,4006080,6987625,28.62202822847534
1747960958420092,4250668,1,48,200,11012795,4095520,6917275,28.913119689473096
1747960958440985,4340108,1,49,200,11033688,4184960,6848728,29.202503004937558
1747960959133105,4429548,1,50,200,11725808,4274400,7451408,26.840564897265054
1747960959154140,4518988,1,51,200,11746843,4363840,7383003,27.08924810134846
1747960959178665,4608428,1,52,200,11771368,4453280,7318088,27.329542907928953
1747960959870893,4697868,1,53,200,12463596,4542720,7920876,25.249732479084386
1747960959890545,4787308,1,54,200,12483248,4632160,7851088,25.474176317982934
1747960959911254,4876748,1,55,200,12503957,4721600,7782357,25.699155153123918
1747960960602745,4966188,1,56,200,13195448,4811040,8384408,23.853801007775385
1747960960624450,5055628,1,57,200,13217153,4900480,8316673,24.04807787921925
1747960960644890,5145068,1,58,200,13237593,4989920,8247673,24.24926400452588
1747960961336859,5234508,1,59,200,13929562,5079360,8850202,22.598354252253227
1747960961356938,5323948,1,60,200,13949641,5168800,8780841,22.77686157852078
1747960961378039,5413388,1,61,200,13970742,5258240,8712502,22.955518403324323
1747960962070417,5502828,1,62,200,14663120,5347680,9315440,21.46973197186606
1747960962090904,5592268,1,63,200,14683607,5437120,9246487,21.629836282687684
1747960962111292,5681708,1,64,200,14703995,5526560,9177435,21.79258147837604
1747960962803516,5771148,1,65,200,15396219,5616000,9780219,20.449439833606995
1747960962823740,5860588,1,66,200,15416443,5705440,9711003,20.59519495566009
1747960962844309,5950028,1,67,200,15437012,5794880,9642132,20.742300561742983
1747960963536237,6039468,1,68,200,16128940,5884320,10244620,19.522442023227804
1747960963556941,6128908,1,69,200,16149644,5973760,10175884,19.65431209711117
1747960963577414,6218348,1,70,200,16170117,6063200,10106917,19.788428063671642
1747960964269239,6307788,1,71,200,16861942,6152640,10709302,18.675353445070463
1747960964290460,6397228,1,72,200,16883163,6242080,10641083,18.79507941062014
1747960964310687,6486668,1,73,200,16903390,6331520,10571870,18.918128959209675
1747960965002064,6576108,1,74,200,17594767,6420960,11173807,17.89900255123433
1747960965022984,6665548,1,75,200,17615687,6510400,11105287,18.00944000816908
1747960965043742,6754988,1,76,200,17636445,6599840,11036605,18.121514723051156
1747960965064148,6844436,1,77,200,17656851,6689288,10967563,18.23559162596103
1747960965755637,6933868,1,78,200,18348340,6778720,11569620,17.286652457038347
1747960965776791,7023308,1,79,200,18369494,6868160,11501334,17.389287190511986
1747960965797313,7112752,1,80,200,18390016,6957604,11432412,17.494121100604143
1747960966488866,7202188,1,81,200,19081569,7047040,12034529,16.61884731841188
1747960966509395,7291628,1,82,200,19102098,7136480,11965618,16.71455665724913
1747960966533854,7381068,1,83,200,19126557,7225920,11900637,16.805823083251763
1747960967222627,7470508,1,84,200,19815330,7315360,12499970,16.000038400092162
1747960967242394,7559948,1,85,200,19835097,7404800,12430297,16.08972014103927
1747960967263821,7649388,1,86,200,19856524,7494240,12362284,16.178240202215058
1747960967955556,7738828,1,87,200,20548259,7583680,12964579,15.426648254447752
1747960967975973,7828268,1,88,200,20568676,7673120,12895556,15.509218834767575
1747960968000709,7918364908,1,94,200,20593412,7918209760,-7897616348,0
1747960968692374,8454348,1,95,200,21285077,8299200,12985877,15.401347171238415
1747960968713372,8543788,1,96,200,21306075,8388640,12917435,15.48294998194301
1747960969421853,9128268,1,102,200,22014556,8973120,13041436,15.335734500403177
1747960969445945,9218748,1,103,200,22038648,9063600,12975048,15.414201165190295
1747960969474789,9309229852108,1,110,200,22067492,9309229696960,-9309207629468,0
1747960970169888,9942588,1,111,200,22762591,9787440,12975151,15.414078803398896
1747960970900474,10033068,1,112,200,23493177,9877920,13615257,14.689403218756723
1747960970925091,10673708,1,119,200,23517794,10518560,12999234,15.385521946908565
1747960971633270,10765228,1,120,200,24225973,10610080,13615893,14.688717074965263
1747960971653534,11405868,1,127,200,24246237,11250720,12995517,15.389922540211368
1747960972365789,11497388,1,128,200,24958492,11342240,13616252,14.688329798831573
1747960972391333,12138028,1,135,200,24984036,11982880,13001156,15.383247458918268
1747960973103351,12229548,1,136,200,25696054,12074400,13621654,14.68250478245887
1747960973124465,12870188,1,143,200,25717168,12715040,13002128,15.382097453586058
1747960973836840,12961708,1,144,200,26429543,12806560,13622983,14.681072420041925
1747960973861160,13602348,1,151,200,26453863,13447200,13006663,15.376734216916361
1747960974569805,13693868,1,152,200,27162508,13538720,13623788,14.68020494740523
1747960974594553,14334508,1,159,200,27187256,14179360,13007896,15.375276678103821
1747960975307023,14426028,1,160,200,27899726,14270880,13628846,14.674756762237978
1747960975326912,15066668,1,167,200,27919615,14911520,13008095,15.37504146456495
1747960976039930,15158188,1,168,200,28632633,15003040,13629593,14.67395247972555
1747960976064508,15798828,1,175,200,28657211,15643680,13013531,15.368619016622006
1747960976773251,15890348,1,176,200,29365954,15735200,13630754,14.672702625254626
1747960976797538,16530988,1,183,200,29390241,16375840,13014401,15.36759163944618
1747960977511038,16622508,1,184,200,30103741,16467360,13636381,14.66664799113489
1747960977531342,17263148,1,191,200,30124045,17108000,13016045,15.365650625823744
1747960978243291,17354668,1,192,200,30835994,17199520,13636474,14.666547965405133
1747960978268597,17995308,1,199,200,30861300,17840160,13021140,15.35963824979994
1747960978297181,18086828,1,200,200,30889884,17931680,12958204,15.43423764589599
1747960978973186,18681708,1,206,200,31565889,18526560,13039329,15.338212572134655
1747960978996824,18773228,1,207,200,31589527,18618080,12971447,15.418480297533499
1747960979705639,19413868,1,214,200,32298342,19258720,13039622,15.3378679228585
1747960979730822,19505388,1,215,200,32323525,19350240,12973285,15.416295872633645
1747960980439614,20146028,1,222,200,33032317,19990880,13041437,15.335733324479502
1747960980463875,20237548,1,223,200,33056578,20082400,12974178,15.415234784045664
1747960980488090,20329068,0,20329068,200,33080793,20173920,12906873,15.49562004677663
1747960981171461,20878188,1,230,200,33764164,20723040,13041124,15.336101397394888
1747960981192452,20969708,1,231,200,33785155,20814560,12970595,15.419493091874353
1747960981225194,21061228,1,2,200,33817897,20906080,12911817,15.4896866955286
1747960981900847,21610348,1,238,200,34493550,21455200,13038350,15.339364260048242
1747960981925754,21701868,1,239,200,34518457,21546720,12971737,15.418135597414595
1747960982650177,21793388,1,24022342508,200,35242880,21638240,13604640,14.700866763104353
1747960982671351,22434028,1,247,200,35264054,22278880,12985174,15.402180979631076
1747960983387308,22525548,1,248,200,35980011,22370400,13609611,14.69549717475393
1747960983408638,23166188,1,255,200,36001341,23011040,12990301,15.396102061068484
1747960983936594,23257708,1,256,200,36529297,23102560,13426737,14.89565186239963
1747960983957185,23898348,1,263,200,36549888,23743200,12806688,15.61684020099498
1747960984952755,23989868,1,264,200,37545458,23834720,13710738,14.58710683553285
