Tempo total receptor,Tempo total emissor,Id do pacote,Id da mensagem,Distancia (m),Tempo zerado receptor,Tempo zerado emissor,Delta tempo,Velocidade (m/s)
1747959260704810,109580,1,1,1,0,0,0,0
1747959260795048,197404,1,2,1,90238,87824,2414,414.2502071251036
1747959260880687,285804,1,3,1,175877,176224,-347,0
1747959260971334,374204,1,4,1,266524,264624,1900,526.3157894736842
1747959261061127,462604,1,5,1,356317,353024,3293,303.67446097783176
1747959261151009,551004,1,6,1,446199,441424,4775,209.4240837696335
1747959261237414,639404,1,7,1,532604,529824,2780,359.71223021582733
1747959261327555,727804,1,8,1,622745,618224,4521,221.19000221190004
1747959261417369,816204,1,9,1,712559,706624,5935,168.49199663016006
1747959261507530,904604,1,10,1,802720,795024,7696,129.93762993762994
1747959261597126,994044,1,11,1,892316,884464,7852,127.35608762098829
1747959261687703,1083484,1,12,1,982893,973904,8989,111.24707976415618
1747959261777483,1173964,1,13,1,1072673,1064384,8289,120.64181445288938
1747959261872508,1264444,1,14,1,1167698,1154864,12834,77.91803023219573
1747959261961960,1354924,1,15,1,1257150,1245344,11806,84.70269354565475
1747959262052513,1445404,1,16,1,1347703,1335824,11879,84.18217021634817
1747959262142561,1535884,1,17,1,1437751,1426304,11447,87.35913339739669
1747959262236730,1626364,1,18,1,1531920,1516784,15136,66.0676532769556
1747959262326322,1716844,1,19,1,1621512,1607264,14248,70.18528916339135
1747959262416692,1807324,1,20,1,1711882,1697744,14138,70.73136228603764
1747959262506297,1897804,1,21,1,1801487,1788224,13263,75.39772298876574
1747959262601128,1988284,1,22,1,1896318,1878704,17614,56.77302146020211
1747959262690928,2078764,1,23,1,1986118,1969184,16934,59.05279319711822
1747959262780878,2169244,1,24,1,2076068,2059664,16404,60.960741282614
1747959262871992,2259724,1,25,1,2167182,2150144,17038,58.69233478107759
1747959262965594,2350204,1,26,1,2260784,2240624,20160,49.6031746031746
1747959263055283,2440684,1,27,1,2350473,2331104,19369,51.6288915276989
1747959263145872,2531164,1,28,1,2441062,2421584,19478,51.33997330321389
1747959263235948,2621644,1,29,1,2531138,2512064,19074,52.42738806752647
1747959263330290,2712124,1,30,1,2625480,2602544,22936,43.599581444018135
1747959263419555,2802604,1,31,1,2714745,2693024,21721,46.03839602228258
1747959263510579,2893084,1,32,1,2805769,2783504,22265,44.91354143274197
1747959263600868,2983564,1,33,1,2896058,2873984,22074,45.3021654435082
1747959263695165,3074044,1,34,1,2990355,2964464,25891,38.6234598895369
1747959263785286,3164524,1,35,1,3080476,3054944,25532,39.16653611154629
1747959263874762,3255004,1,36,1,3169952,3145424,24528,40.769732550554465
1747959263965733,3345484,1,37,1,3260923,3235904,25019,39.9696230864543
1747959264058890,3435964,1,38,1,3354080,3326384,27696,36.10629693818602
1747959264149861,3526444,1,39,1,3445051,3416864,28187,35.47734771348494
1747959264239452,3616924,1,40,1,3534642,3507344,27298,36.63272034581288
1747959264329792,3707404,1,41,1,3624982,3597824,27158,36.82156270712129
1747959264424326,3797884,1,42,1,3719516,3688304,31212,32.038959374599514
1747959264513995,3888364,1,43,1,3809185,3778784,30401,32.89365481398638
1747959264604149,3978844,1,44,1,3899339,3869264,30075,33.25020781379884
1747959264694423,4069324,1,45,1,3989613,3959744,29869,33.479527269074964
1747959264788641,4159804,1,46,1,4083831,4050224,33607,29.75570565655965
1747959264878874,4250284,1,47,1,4174064,4140704,33360,29.976019184652277
1747959264968565,4340772,1,48,1,4263755,4231192,32563,30.709701194607376
1747959265059013,4431244,1,49,1,4354203,4321664,32539,30.732351946894497
1747959265153218,4521724,1,50,1,4448408,4412144,36264,27.575557026251932
1747959265242530,4612204,1,51,1,4537720,4502624,35096,28.493275586961474
1747959265332673,4702684,1,52,1,4627863,4593104,34759,28.76952731666619
1747959265427538,4793164,1,53,1,4722728,4683584,39144,25.546699366441857
1747959265517010,4883644,1,54,1,4812200,4774064,38136,26.22194252150199
1747959265606967,4974124,1,55,1,4902157,4864544,37613,26.586552521734507
1747959265697739,5064604,1,56,1,4992929,4955024,37905,26.38174383326738
1747959265791679,5155084,1,57,1,5086869,5045504,41365,24.175027196905596
1747959265882076,5245564,1,58,1,5177266,5135984,41282,24.22363257594109
1747959265972331,5336044,1,59,1,5267521,5226464,41057,24.356382590057724
1747959266062341,5426524,1,60,1,5357531,5316944,40587,24.638431024712347
1747959266156343,5517004,1,61,1,5451533,5407424,44109,22.6711102042667
1747959266246630,5607484,1,62,1,5541820,5497904,43916,22.770744147918755
1747959266336834,5697964,1,63,1,5632024,5588384,43640,22.914757103574704
1747959266426985,5788444,1,64,1,5722175,5678864,43311,23.08882270093048
1747959266521026,5878924,1,65,1,5816216,5769344,46872,21.334698754053594
1747959266610778,5969404,1,66,1,5905968,5859824,46144,21.671289875173372
1747959266701274,6059884,1,67,1,5996464,5950304,46160,21.663778162911612
1747959266790934,6150364,1,68,1,6086124,6040784,45340,22.055580061755624
1747959266885379,6240844,1,69,1,6180569,6131264,49305,20.281918669506133
1747959266975677,6331324,1,70,1,6270867,6221744,49123,20.357062882967245
1747959267065869,6421804,1,71,1,6361059,6312224,48835,20.47711682195147
1747959267155881,6512284,1,72,1,6451071,6402704,48367,20.675253788740257
1747959267249866,6602772,1,73,1,6545056,6493192,51864,19.281196976708316
1747959267340177,6693244,1,74,1,6635367,6583664,51703,19.3412374523722
1747959267429526,6783724,1,75,1,6724716,6674144,50572,19.773787866803765
1747959267520305,6874204,1,76,1,6815495,6764624,50871,19.657565213972596
1747959267615811,6964684,1,77,1,6911001,6855104,55897,17.890047766427536
1747959267704354,7055164,1,78,1,6999544,6945584,53960,18.532246108228318
1747959267794101,7145644,1,79,1,7089291,7036064,53227,18.787457493377424
1747959267885026,7236124,1,80,1,7180216,7126544,53672,18.631688776270682
1747959267979255,7326604,1,81,1,7274445,7217024,57421,17.415231361348635
1747959268069546,7417084,1,82,1,7364736,7307504,57232,17.472742521666202
1747959268159385,7507564,1,83,1,7454575,7397984,56591,17.67065434433037
1747959268249506,7598044,1,84,1,7544696,7488464,56232,17.783468487693842
1747959268343781,7688524,1,85,1,7638971,7578944,60027,16.659170040148602
1747959268433856,7779004,1,86,1,7729046,7669424,59622,16.772332360538055
1747959268523662,7869484,1,87,1,7818852,7759904,58948,16.964103956029042
1747959268614099,7959964,1,88,1,7909289,7850384,58905,16.97648756472286
1747959268708303,8050444,1,89,1,8003493,7940864,62629,15.967044021140365
1747959268798312,8140924,1,90,1,8093502,8031344,62158,16.088033720518677
1747959268888604,8231404,1,91,1,8183794,8121824,61970,16.13684040664838
1747959268978607,8321884,1,92,1,8273797,8212304,61493,16.26201356251931
1747959269072701,8412364,1,93,1,8367891,8302784,65107,15.359331561890427
1747959269162542,8502844,1,94,1,8457732,8393264,64468,15.5115716324378
1747959269252729,8593324,1,95,1,8547919,8483744,64175,15.582391897156214
1747959269342466,8683804,1,96,1,8637656,8574224,63432,15.764913608273426
1747959269437386,8774284,1,97,1,8732576,8664704,67872,14.733616218764734
1747959269527146,8864764,1,98,1,8822336,8755184,67152,14.891589230402667
1747959269616937,8955244,1,99,1,8912127,8845664,66463,15.045965424371456
1747959269711588,9045724,1,100,1,9006778,8936144,70634,14.157487895347849
1747959269801759,9137244,1,101,1,9096949,9027664,69285,14.433138485963774
1747959269895984,9228764,1,102,1,9191174,9119184,71990,13.890818169190165
1747959269986015,9320284,1,103,1,9281205,9210704,70501,14.184195968851506
1747959270080325,9411804,1,104,1,9375515,9302224,73291,13.64424008404852
1747959270170385,9503324,1,105,1,9465575,9393744,71831,13.921565897732176
1747959270264228,9594844,1,106,1,9559418,9485264,74154,13.485449200312862
1747959270354453,9686364,1,107,1,9649643,9576784,72859,13.725140339559973
1747959270448822,9777884,1,108,1,9744012,9668304,75708,13.208643736461141
1747959270539024,9869404,1,109,1,9834214,9759824,74390,13.442667025137787
1747959270632333,9960924,1,110,1,9927523,9851344,76179,13.126977250948425
1747959270726288,10052444,1,111,1,10021478,9942864,78614,12.720380593787366
1747959270816994,10145004,1,112,1,10112184,10035424,76760,13.027618551328818
1747959270911720,10237564,1,113,1,10206910,10127984,78926,12.670096039327978
1747959271005947,10330132,1,114,1,10301137,10220552,80585,12.409257305950238
1747959271100107,10422684,1,115,1,10395297,10313104,82193,12.16648619712141
1747959271190166,10515244,1,116,1,10485356,10405664,79692,12.548310997339758
1747959271284374,10607804,1,117,1,10579564,10498224,81340,12.294074256208509
1747959271378639,10700364,1,118,1,10673829,10590784,83045,12.041664157986634
1747959271472715,10792924,1,119,1,10767905,10683344,84561,11.825782571161646
1747959271563103,10885484,1,120,1,10858293,10775904,82389,12.137542633118498
1747959271656817,10978044,1,121,1,10952007,10868464,83543,11.969883772428568
1747959271750766,11070604,1,122,1,11045956,10961024,84932,11.774125182498942
1747959271845155,11163164,1,123,1,11140345,11053584,86761,11.525916022175862
1747959271935636,11255724,1,124,1,11230826,11146144,84682,11.808885005077821
1747959272029823,11348284,1,125,1,11325013,11238704,86309,11.586277213268605
1747959272123159,11440844,1,126,1,11418349,11331264,87085,11.483033817534594
1747959272217527,11533404,1,127,1,11512717,11423824,88893,11.24947971156334
1747959272311891,11625964,1,128,1,11607081,11516384,90697,11.025723011786498
1747959272402042,11718524,1,129,1,11697232,11608944,88288,11.326567596955417
1747959272496690,11811084,1,130,1,11791880,11701504,90376,11.064884482606002
1747959272591098,11903644,1,131,1,11886288,11794064,92224,10.843164469118667
1747959272684112,11996204,1,132,1,11979302,11886624,92678,10.790047260407
1747959272775011,12088764,1,133,1,12070201,11979184,91017,10.986958480283903
1747959272869212,12181324,1,134,1,12164402,12071744,92658,10.792376265406117
1747959272963204,12273884,1,135,1,12258394,12164304,94090,10.628122010840686
1747959273057143,12366444,1,136,1,12352333,12256864,95469,10.474604321821744
1747959273147212,12459004,1,137,1,12442402,12349424,92978,10.755232420572607
1747959273241059,12551564,1,138,1,12536249,12441984,94265,10.608391237468838
1747959273336075,12644124,1,139,1,12631265,12534544,96721,10.339016345984843
1747959273430041,12736684,1,140,1,12725231,12627104,98127,10.190875090444015
1747959273519760,12829244,1,141,1,12814950,12719664,95286,10.494721155258905
1747959273615096,12921804,1,142,1,12910286,12812224,98062,10.197630070771552
1747959273709180,13014364,1,143,1,13004370,12904784,99586,10.041572108529312
1747959273803166,13106924,1,144,1,13098356,12997344,101012,9.89981388349899
1747959273896612,13199484,1,145,1,13191802,13089904,101898,9.813735303931383
1747959273987437,13292044,1,146,1,13282627,13182464,100163,9.983726525763005
1747959274081549,13384604,1,147,1,13376739,13275024,101715,9.83139163348572
1747959274175719,13477164,1,148,1,13470909,13367584,103325,9.678199854827001
1747959274269791,13569724,1,149,1,13564981,13460144,104837,9.538617091294105
1747959274359777,13662284,1,150,1,13654967,13552704,102263,9.778707841545817
1747959274453731,13754844,1,151,1,13748921,13645264,103657,9.647201829109466
1747959274548390,13847404,1,152,1,13843580,13737824,105756,9.45572828019214
1747959274642678,13939964,1,153,1,13937868,13830384,107484,9.303710319675487
1747959274732998,14032524,1,154,1,14028188,13922944,105244,9.50172931473528
1747959274827030,14125092,1,155,1,14122220,14015512,106708,9.371368594669566
1747959274921179,14217644,1,156,1,14216369,14108064,108305,9.233184063524307
1747959275014888,14310204,1,157,1,14310078,14200624,109454,9.136258154110402
1747959275106030,14402764,1,158,1,14401220,14293184,108036,9.256173867969936
1747959275199197,14495324,1,159,1,14494387,14385744,108643,9.204458639765102
1747959275292857,14587884,1,160,1,14588047,14478304,109743,9.112198500132127
1747959275387897,14680444,1,161,1,14683087,14570864,112223,8.910829330885825
1747959275478324,14773004,1,162,1,14773514,14663424,110090,9.083477155054956
1747959275572606,14865564,1,163,1,14867796,14755984,111812,8.94358387292956
1747959275666541,14958124,1,164,1,14961731,14848544,113187,8.834936874376034
1747959275760422,15050684,1,165,1,15055612,14941104,114508,8.733014287211374
1747959275855045,15143244,1,166,1,15150235,15033664,116571,8.578462911015604
1747959275945264,15235804,1,167,1,15240454,15126224,114230,8.754267705506434
1747959276038653,15328364,1,168,1,15333843,15218784,115059,8.691193213916339
1747959276133448,15420924,1,169,1,15428638,15311344,117294,8.52558528142957
1747959276227243,15513484,1,170,1,15522433,15403904,118529,8.436753874579217
1747959276317213,15606044,1,171,1,15612403,15496464,115939,8.625225334011851
1747959276411801,15698604,1,172,1,15706991,15589024,117967,8.476946942789086
1747959276505612,15791164,1,173,1,15800802,15681584,119218,8.38799510141086
1747959276600249,15883724,1,174,1,15895439,15774144,121295,8.2443629168556
1747959276690345,15976284,1,175,1,15985535,15866704,118831,8.415312502629785
1747959276783888,16068844,1,176,1,16079078,15959264,119814,8.3462700519138
1747959276878060,16161404,1,177,1,16173250,16051824,121426,8.235468515803865
1747959276972950,16253972,1,178,1,16268140,16144392,123748,8.080938681837283
1747959277062741,16346524,1,179,1,16357931,16236944,120987,8.265350822815675
1747959277157116,16439084,1,180,1,16452306,16329504,122802,8.14318985032817
1747959277251217,16531644,1,181,1,16546407,16422064,124343,8.042270172024159
1747959277345304,16624204,1,182,1,16640494,16514624,125870,7.944704854214665
1747959277439098,16716764,1,183,1,16734288,16607184,127104,7.8675730110775435
1747959277529579,16809324,1,184,1,16824769,16699744,125025,7.998400319936013
1747959277623705,16901884,1,185,1,16918895,16792304,126591,7.899455727500374
1747959277717815,16994444,1,186,1,17013005,16884864,128141,7.803903512536971
1747959277811917,17087004,1,187,1,17107107,16977424,129683,7.711110939753091
1747959277902665,17179564,1,188,1,17197855,17069984,127871,7.820381478208506
1747959277996406,17272124,1,189,1,17291596,17162544,129052,7.748814431391997
1747959278091336,17364684,1,190,1,17386526,17255104,131422,7.609076105979211
1747959278184375,17457244,1,191,1,17479565,17347664,131901,7.581443658501453
1747959278275717,17549804,1,192,1,17570907,17440224,130683,7.652104711400871
1747959278369910,17642364,1,193,1,17665100,17532784,132316,7.557664983826598
1747959278463358,17734924,1,194,1,17758548,17625344,133204,7.507282063601695
1747959278557671,17827484,1,195,1,17852861,17717904,134957,7.409767555591781
1747959278648290,17920044,1,196,1,17943480,17810464,133016,7.517892584350755
1747959278742523,18012604,1,197,1,18037713,17903024,134689,7.424511281544892
1747959278836818,18105164,1,198,1,18132008,17995584,136424,7.3300885474696535
1747959278930205,18197724,1,199,1,18225395,18088144,137251,7.285921414051628
1747959279025168,18290284,1,200,1,18320358,18180704,139654,7.160553940452833
1747959279118722,18382844,1,201,1,18413912,18273264,140648,7.109948239576816
1747959279209266,18475404,1,202,1,18504456,18365824,138632,7.2133417969877085
1747959279303461,18567964,1,203,1,18598651,18458384,140267,7.129260624380645
1747959279397866,18660524,1,204,1,18693056,18550944,142112,7.036703445170008
1747959279487964,18753084,1,205,1,18783154,18643504,139650,7.160759040458289
1747959279581999,18845644,1,206,1,18877189,18736064,141125,7.085916740478299
1747959279676560,18938204,1,207,1,18971750,18828624,143126,6.986850746894345
1747959279770094,19030764,1,208,1,19065284,18921184,144100,6.939625260235947
1747959279860831,19123324,1,209,1,19156021,19013744,142277,7.028542912768755
1747959279955006,19215884,1,210,1,19250196,19106304,143892,6.949656686959664
1747959280049261,19308444,1,211,1,19344451,19198864,145587,6.868745148948739
1747959280143288,19401004,1,212,1,19438478,19291424,147054,6.800223047315953
1747959280232922,19493564,1,213,1,19528112,19383984,144128,6.938277087033748
1747959280327514,19586124,1,214,1,19622704,19476544,146160,6.841817186644772
1747959280421880,19678684,1,215,1,19717070,19569104,147966,6.758309341335172
1747959280515874,19771244,1,216,1,19811064,19661664,149400,6.693440428380187
1747959280610016,19863804,1,217,1,19905206,19754224,150982,6.623306089467619
1747959280699833,19956364,1,218,1,19995023,19846784,148239,6.745863099454259
1747959280794494,20048932,1,219,1,20089684,19939352,150332,6.651943697948541
1747959280888733,20141484,1,220,1,20183923,20031904,152019,6.578125102783205
1747959280982322,20234044,1,221,1,20277512,20124464,153048,6.53389786210862
1747959281072797,20326604,1,222,1,20367987,20217024,150963,6.624139689857779
1747959281166988,20419164,1,223,1,20462178,20309584,152594,6.5533376148472415
1747959281261587,20511724,1,224,1,20556777,20402144,154633,6.466924912534841
1747959281355780,20604284,1,225,1,20650970,20494704,156266,6.399344707101993
1747959281445674,20696844,1,226,1,20740864,20587264,153600,6.510416666666667
1747959281539999,20789404,1,227,1,20835189,20679824,155365,6.436456087278344
1747959281633884,20881964,1,228,1,20929074,20772384,156690,6.382028208564682
1747959281728325,20974524,1,229,1,21023515,20864944,158571,6.30632335042347
1747959281818533,21067084,1,230,1,21113723,20957504,156219,6.401270011970375
1747959281912042,21159644,1,231,1,21207232,21050064,157168,6.362618344701211
1747959282006879,21252204,1,232,1,21302069,21142624,159445,6.271755150678917
1747959282101050,21344764,1,233,1,21396240,21235184,161056,6.209020464931452
1747959282194835,21437324,1,234,1,21490025,21327744,162281,6.162150837128191
1747959282285459,21529884,1,235,1,21580649,21420304,160345,6.2365524338145875
1747959282379275,21622444,1,236,1,21674465,21512864,161601,6.188080519303718
1747959282473797,21715004,1,237,1,21768987,21605424,163563,6.1138521548271925
1747959282567532,21807564,1,238,1,21862722,21697984,164738,6.070244873678204
1747959282657169,21900124,1,239,1,21952359,21790544,161815,6.179896795723512
1747959282752455,21992684,1,240,1,22047645,21883104,164541,6.077512595644855
1747959282846612,22085244,1,241,1,22141802,21975664,166138,6.0190925616054125
1747959282940798,22177812,1,242,1,22235988,22068232,167756,5.961038651374616
1747959283030944,22270364,1,243,1,22326134,22160784,165350,6.047777441790142
1747959283124927,22362924,1,244,1,22420117,22253344,166773,5.996174440706829
1747959283219194,22455484,1,245,1,22514384,22345904,168480,5.935422602089269
1747959283312869,22548044,1,246,1,22608059,22438464,169595,5.896400247648811
1747959283403659,22640604,1,247,1,22698849,22531024,167825,5.9585878146879185
1747959283496944,22733164,1,248,1,22792134,22623584,168550,5.932957579353308
1747959283591906,22825724,1,249,1,22887096,22716144,170952,5.849595208011606
1747959283686030,22918284,1,250,1,22981220,22808704,172516,5.796563796981149
1747959283779646,23010844,1,251,1,23074836,22901264,173572,5.761297905192081
1747959283869809,23103404,1,252,1,23164999,22993824,171175,5.841974587410545
1747959283964479,23195964,1,253,1,23259669,23086384,173285,5.770839945754105
1747959284058779,23288524,1,254,1,23353969,23178944,175025,5.713469504356521
1747959284152964,23381084,1,255,1,23448154,23271504,176650,5.660911406736485
1747959284243304,23473644,1,256,1,23538494,23364064,174430,5.7329587800263715
1747959284337010,23566204,1,257,1,23632200,23456624,175576,5.695539253656536
1747959284431053,23658764,1,258,1,23726243,23549184,177059,5.64783490249013
1747959284525843,23751324,1,259,1,23821033,23641744,179289,5.577587024301547
1747959284615922,23843884,1,260,1,23911112,23734304,176808,5.655852676349487
1747959284710229,23936444,1,261,1,24005419,23826864,178555,5.600515247402761
1747959284803705,24029004,1,262,1,24098895,23919424,179471,5.5719308411943995
1747959284898608,24121564,1,263,1,24193798,24011984,181814,5.500126502909567
1747959284988567,24214124,1,264,1,24283757,24104544,179213,5.579952347206954
1747959285082629,24306684,1,265,1,24377819,24197104,180715,5.533574966106854
1747959285177194,24399244,1,266,1,24472384,24289664,182720,5.472854640980736
1747959285270655,24491804,1,267,1,24565845,24382224,183621,5.4460001851640065
1747959285365192,24584364,1,268,1,24660382,24474784,185598,5.387989094710072
1747959285455248,24676924,1,269,1,24750438,24567344,183094,5.461675423552929
1747959285549693,24769484,1,270,1,24844883,24659904,184979,5.406019061623211
1747959285643272,24862044,1,271,1,24938462,24752464,185998,5.376401896794589
1747959285737869,24954604,1,272,1,25033059,24845024,188035,5.318158853404951
1747959285827505,25047164,1,273,1,25122695,24937584,185111,5.402164106941241
1747959285921830,25139724,1,274,1,25217020,25030144,186876,5.351141933688649
1747959286016556,25232284,1,275,1,25311746,25122704,189042,5.289829773277896
1747959286110763,25324844,1,276,1,25405953,25215264,190689,5.2441409834862
1747959286200980,25417404,1,277,1,25496170,25307824,188346,5.309377422403449
1747959286295142,25509964,1,278,1,25590332,25400384,189948,5.264598732284625
1747959286389241,25602524,1,279,1,25684431,25492944,191487,5.222286630423998
1747959286483421,25695084,1,280,1,25778611,25585504,193107,5.1784761815988025
1747959286573724,25787644,1,281,1,25868914,25678064,190850,5.239717055279015
1747959286667695,25880204,1,282,1,25962885,25770624,192261,5.201262866624017
1747959286761988,25972772,1,283,1,26057178,25863192,193986,5.155011186374274
1747959286856442,26065324,1,284,1,26151632,25955744,195888,5.104957935146614
1747959286950510,26157884,1,285,1,26245700,26048304,197396,5.0659587833593385
1747959287040013,26250444,1,286,1,26335203,26140864,194339,5.145647554016435
1747959287134630,26343004,1,287,1,26429820,26233424,196396,5.091753396199516
1747959287228832,26435564,1,288,1,26524022,26325984,198038,5.049535947646412
1747959287323189,26528124,1,289,1,26618379,26418544,199835,5.004128405934896
1747959287412856,26620684,1,290,1,26708046,26511104,196942,5.0776370708127265
1747959287507073,26713244,1,291,1,26802263,26603664,198599,5.035272080926893
1747959287601523,26805804,1,292,1,26896713,26696224,200489,4.9878048172218925
1747959287695922,26898364,1,293,1,26991112,26788784,202328,4.942469653236329
1747959287785714,26990924,1,294,1,27080904,26881344,199560,5.0110242533573865
1747959287880205,27083484,1,295,1,27175395,26973904,201491,4.963000828821138
1747959287974260,27176044,1,296,1,27269450,27066464,202986,4.926448129427645
1747959288068585,27268604,1,297,1,27363775,27159024,204751,4.883981030617678
1747959288158789,27361164,1,298,1,27453979,27251584,202395,4.940833518614591
1747959288252771,27453724,1,299,1,27547961,27344144,203817,4.906362079708758
1747959288346982,27546284,1,300,1,27642172,27436704,205468,4.866937917339926
1747959288441451,27638844,1,301,1,27736641,27529264,207377,4.822135530941233
1747959288534967,27731404,1,302,1,27830157,27621824,208333,4.800007680012288
1747959288625205,27823964,1,303,1,27920395,27714384,206011,4.854109732004602
1747959288719943,27916524,1,304,1,28015133,27806944,208189,4.803327745462056
1747959288814133,28009084,1,305,1,28109323,27899504,209819,4.766012610869368
1747959288907937,28101652,1,306,1,28203127,27992072,211055,4.73810144275189
1747959288998192,28194204,1,307,1,28293382,28084624,208758,4.790235583786011
1747959289092073,28286764,1,308,1,28387263,28177184,210079,4.760114052332694
1747959289186571,28379324,1,309,1,28481761,28269744,212017,4.71660291391728
1747959289280763,28471884,1,310,1,28575953,28362304,213649,4.680574212844432
1747959289370869,28564444,1,311,1,28666059,28454864,211195,4.7349605814531595
1747959289464747,28657004,1,312,1,28759937,28547424,212513,4.705594481278792
1747959289559472,28749564,1,313,1,28854662,28639984,214678,4.65813916656574
1747959289653497,28842124,1,314,1,28948687,28732544,216143,4.626566671139014
1747959289743432,28934684,1,315,1,29038622,28825104,213518,4.683445892149607
1747959289837839,29027244,1,316,1,29133029,28917664,215365,4.643280013001184
1747959289932312,29119804,1,317,1,29227502,29010224,217278,4.6023987702390485
1747959290025610,29212364,1,318,1,29320800,29102784,218016,4.586819316013504
1747959290120433,29304924,1,319,1,29415623,29195344,220279,4.539697383772397
1747959290210241,29397484,1,320,1,29505431,29287904,217527,4.597130471159902
1747959290304052,29490044,1,321,1,29599242,29380464,218778,4.570843503460129
1747959290398999,29582604,1,322,1,29694189,29473024,221165,4.521511089005946
1747959290492715,29675164,1,323,1,29787905,29565584,222321,4.498000638716091
1747959290583370,29767724,1,324,1,29878560,29658144,220416,4.536875725900116
1747959290677366,29860284,1,325,1,29972556,29750704,221852,4.507509510845068
1747959290771525,29952844,1,326,1,30066715,29843264,223451,4.475254082550537
1747959290865816,30045404,1,327,1,30161006,29935824,225182,4.440852288371184
1747959290955508,30137964,1,328,1,30250698,30028384,222314,4.498142267243628
1747959291049572,30230524,1,329,1,30344762,30120944,223818,4.467915895951175
1747959291144359,30323084,1,330,1,30439549,30213504,226045,4.42389789643655
1747959291238661,30415644,1,331,1,30533851,30306064,227787,4.390066158297006
1747959291328081,30508204,1,332,1,30623271,30398624,224647,4.451428240751045
1747959291422527,30600764,1,333,1,30717717,30491184,226533,4.4143678845907655
1747959291517118,30693324,1,334,1,30812308,30583744,228564,4.3751421921212446
1747959291611244,30785884,1,335,1,30906434,30676304,230130,4.345370008256203
1747959291704472,30878444,1,336,1,30999662,30768864,230798,4.3327931784504194
1747959291795139,30971004,1,337,1,31090329,30861424,228905,4.368624538564033
1747959291889082,31063564,1,338,1,31184272,30953984,230288,4.342388661154728
1747959291983919,31156124,1,339,1,31279109,31046544,232565,4.299873153741965
1747959292077359,31248684,1,340,1,31372549,31139104,233445,4.283664246396367
1747959292167946,31341244,1,341,1,31463136,31231664,231472,4.320176954448054
1747959292261660,31433804,1,342,1,31556850,31324224,232626,4.298745626026325
1747959292355954,31526364,1,343,1,31651144,31416784,234360,4.266939750810718
1747959292450240,31618924,1,344,1,31745430,31509344,236086,4.235744601543505
1747959292540362,31711484,1,345,1,31835552,31601904,233648,4.279942477573101
1747959292634673,31804044,1,346,1,31929863,31694464,235399,4.2481064065692715
1747959292729309,31896612,1,347,1,32024499,31787032,237467,4.211111438642001
1747959292822728,31989164,1,348,1,32117918,31879584,238334,4.195792459321792
1747959292913576,32081724,1,349,1,32208766,31972144,236622,4.226149724032423
1747959293007808,32174284,1,350,1,32302998,32064704,238294,4.196496764500995
1747959293102024,32266844,1,351,1,32397214,32157264,239950,4.167534903104814
1747959293195311,32359404,1,352,1,32490501,32249824,240677,4.154946255770182
1747959293289977,32451964,1,353,1,32585167,32342384,242783,4.118904536149565
1747959293380347,32544524,1,354,1,32675537,32434944,240593,4.156396902653028
1747959293473889,32637084,1,355,1,32769079,32527504,241575,4.139501190106592
1747959293568136,32729644,1,356,1,32863326,32620064,243262,4.110794123208722
1747959293663411,32822204,1,357,1,32958601,32712624,245977,4.0654207507205955
1747959293752954,32914764,1,358,1,33048144,32805184,242960,4.115903852486006
1747959293847629,33007324,1,359,1,33142819,32897744,245075,4.08038355605427
1747959293941891,33099884,1,360,1,33237081,32990304,246777,4.052241497384278
1747959294035861,33192444,1,361,1,33331051,33082864,248187,4.029219902734631
1747959294126294,33285004,1,362,1,33421484,33175424,246060,4.064049418840933
1747959294220447,33377564,1,363,1,33515637,33267984,247653,4.037907879169644
1747959294314528,33470124,1,364,1,33609718,33360544,249174,4.013259810413606
1747959294408621,33562684,1,365,1,33703811,33453104,250707,3.9887199001224536
1747959294498177,33655244,1,366,1,33793367,33545664,247703,4.037092808726579
1747959294593016,33747804,1,367,1,33888206,33638224,249982,4.000288020737493
1747959294687205,33840364,1,368,1,33982395,33730784,251611,3.9743890370452806
1747959294780623,33932924,1,369,1,34075813,33823344,252469,3.9608823261469723
1747959294875642,34025492,1,370,1,34170832,33915912,254920,3.922799309587322
1747959294965393,34118044,1,371,1,34260583,34008464,252119,3.9663809550252065
1747959295059766,34210604,1,372,1,34354956,34101024,253932,3.938062158373108
1747959295154451,34303164,1,373,1,34449641,34193584,256057,3.9053804426358196
1747959295248193,34395724,1,374,1,34543383,34286144,257239,3.8874354199790857
1747959295338332,34488284,1,375,1,34633522,34378704,254818,3.9243695500317877
1747959295432692,34580844,1,376,1,34727882,34471264,256618,3.8968427779812793
1747959295526297,34673404,1,377,1,34821487,34563824,257663,3.8810384106371503
1747959295621425,34765964,1,378,1,34916615,34656384,260231,3.842739719710565
1747959295711414,34858524,1,379,1,35006604,34748944,257660,3.8810835985407124
1747959295805462,34951084,1,380,1,35100652,34841504,259148,3.858798833099233
1747959295899511,35043644,1,381,1,35194701,34934064,260637,3.8367537993454497
1747959295993333,35136204,1,382,1,35288523,35026624,261899,3.818265820029859
1747959296083593,35228764,1,383,1,35378783,35119184,259599,3.852094961844999
1747959296178161,35321324,1,384,1,35473351,35211744,261607,3.8225276846567566
1747959296271766,35413884,1,385,1,35566956,35304304,262652,3.8073191904116475
1747959296365628,35506444,1,386,1,35660818,35396864,263954,3.788538912083166
1747959296460034,35599004,1,387,1,35755224,35489424,265800,3.7622272385252074
1747959296550630,35691564,1,388,1,35845820,35581984,263836,3.7902333267635955
1747959296645311,35784124,1,389,1,35940501,35674544,265957,3.760006316810612
1747959296738942,35876684,1,390,1,36034132,35767104,267028,3.744925625777072
1747959296833076,35969244,1,391,1,36128266,35859664,268602,3.722980469244458
1747959296923284,36061804,1,392,1,36218474,35952224,266250,3.755868544600939
1747959297018080,36154364,1,393,1,36313270,36044784,268486,3.7245889916047763
1747959297111774,36246924,1,394,1,36406964,36137344,269620,3.7089236703508637
1747959297205330,36339484,1,395,1,36500520,36229904,270616,3.6952730067697397
1747959297295813,36432044,1,396,1,36591003,36322464,268539,3.7238538908687375
1747959297390131,36524604,1,397,1,36685321,36415024,270297,3.699634106186898
1747959297484565,36617164,1,398,1,36779755,36507584,272171,3.6741607298352874
1747959297578564,36709724,1,399,1,36873754,36600144,273610,3.654837177003764
1747959297668691,36802284,1,400,1,36963881,36692704,271177,3.687628375562824
1747959297763283,36894844,1,401,1,37058473,36785264,273209,3.6602015306962805
1747959297857552,36987404,1,402,1,37152742,36877824,274918,3.63744825729854
1747959297951811,37079964,1,403,1,37247001,36970384,276617,3.615106808330652
1747959298045567,37172524,1,404,1,37340757,37062944,277813,3.599543577874326
1747959298135588,37265084,1,405,1,37430778,37155504,275274,3.6327441022399496
1747959298230109,37357644,1,406,1,37525299,37248064,277235,3.6070481721283385
1747959298323757,37450204,1,407,1,37618947,37340624,278323,3.5929477621324866
1747959298418091,37542764,1,408,1,37713281,37433184,280097,3.5701917549991613
1747959298508743,37635324,1,409,1,37803933,37525744,278189,3.594678438040325
1747959298602760,37727884,1,410,1,37897950,37618304,279646,3.5759495934145313
1747959298697297,37820452,1,411,1,37992487,37710872,281615,3.5509472151696464
1747959298790934,37913004,1,412,1,38086124,37803424,282700,3.5373187124159884
1747959298880595,38005564,1,413,1,38175785,37895984,279801,3.573968641999135
1747959298975206,38098124,1,414,1,38270396,37988544,281852,3.5479613414132243
1747959299070029,38190684,1,415,1,38365219,38081104,284115,3.519701529310314
1747959299162678,38283244,1,416,1,38457868,38173664,284204,3.518599315984293
1747959299253630,38375804,1,417,1,38548820,38266224,282596,3.5386205041826493
1747959299347941,38468364,1,418,1,38643131,38358784,284347,3.516829788955044
1747959299442286,38560924,1,419,1,38737476,38451344,286132,3.494890470132666
1747959299535992,38653484,1,420,1,38831182,38543904,287278,3.4809487673960415
1747959299630070,38746044,1,421,1,38925260,38636464,288796,3.462651837283065
1747959299720934,38838604,1,422,1,39016124,38729024,287100,3.4831069313827934
1747959299814315,38931164,1,423,1,39109505,38821584,287921,3.4731749334018707
1747959299908650,39023724,1,424,1,39203840,38914144,289696,3.451894399646526
1747959300003507,39116284,1,425,1,39298697,39006704,291993,3.4247396341693124
1747959300093353,39208844,1,426,1,39388543,39099264,289279,3.4568703569910015
1747959300187009,39301404,1,427,1,39482199,39191824,290375,3.4438226431338785
1747959300281819,39393964,1,428,1,39577009,39284384,292625,3.417343015805211
1747959300375934,39486524,1,429,1,39671124,39376944,294180,3.3992793527772114
1747959300465744,39579084,1,430,1,39760934,39469504,291430,3.4313557286483887
1747959300559793,39671644,1,431,1,39854983,39562064,292919,3.4139130612899815
1747959300654557,39764204,1,432,1,39949747,39654624,295123,3.3884177105816895
1747959300748359,39856764,1,433,1,40043549,39747184,296365,3.3742176032932365
1747959300839166,39949332,1,434,1,40134356,39839752,294604,3.3943870415880304
1747959300933414,40041884,1,435,1,40228604,39932304,296300,3.374957813027337
1747959301027198,40134444,1,436,1,40322388,40024864,297524,3.3610733923985965
1747959301120704,40227004,1,437,1,40415894,40117424,298470,3.3504204777699598
1747959301215567,40319564,1,438,1,40510757,40209984,300773,3.3247665182712542
1747959301305348,40412124,1,439,1,40600538,40302544,297994,3.355772263871085
1747959301399314,40504684,1,440,1,40694504,40395104,299400,3.3400133600534403
1747959301493433,40597244,1,441,1,40788623,40487664,300959,3.322711731498311
1747959301588147,40689804,1,442,1,40883337,40580224,303113,3.2990996756985016
1747959301677932,40782364,1,443,1,40973122,40672784,300338,3.3295820042751836
1747959301772751,40874924,1,444,1,41067941,40765344,302597,3.304725426887907
1747959301866329,40967484,1,445,1,41161519,40857904,303615,3.293644912142022
1747959301960458,41060044,1,446,1,41255648,40950464,305184,3.2767117542204045
1747959302051024,41152604,1,447,1,41346214,41043024,303190,3.2982618160229555
1747959302144885,41245164,1,448,1,41440075,41135584,304491,3.284169318633391
1747959302239327,41337724,1,449,1,41534517,41228144,306373,3.2639951953990725
1747959302333351,41430284,1,450,1,41628541,41320704,307837,3.2484724058511483
1747959302423504,41522844,1,451,1,41718694,41413264,305430,3.274072618930688
1747959302517698,41615404,1,452,1,41812888,41505824,307064,3.2566500794622617
1747959302612223,41707964,1,453,1,41907413,41598384,309029,3.235942257846351
1747959302706226,41800524,1,454,1,42001416,41690944,310472,3.2209023680074207
1747959302800167,41893084,1,455,1,42095357,41783504,311853,3.2066390254382675
1747959302890305,41985644,1,456,1,42185495,41876064,309431,3.2317382550552463
1747959302985003,42078204,1,457,1,42280193,41968624,311569,3.2095619268925986
1747959303079223,42170764,1,458,1,42374413,42061184,313229,3.1925524137292527
1747959303172547,42263324,1,459,1,42467737,42153744,313993,3.184784374173946
1747959303262918,42355884,1,460,1,42558108,42246304,311804,3.2071429487755125
1747959303357622,42448444,1,461,1,42652812,42338864,313948,3.1852408679144317
1747959303451078,42541004,1,462,1,42746268,42431424,314844,3.17617613802391
1747959303545846,42633564,1,463,1,42841036,42523984,317052,3.154056747789006
1747959303635737,42726124,1,464,1,42930927,42616544,314383,3.180833569245156
1747959303730216,42818684,1,465,1,43025406,42709104,316302,3.161535494558997
1747959303824683,42911244,1,466,1,43119873,42801664,318209,3.142588675995965
1747959303918803,43003804,1,467,1,43213993,42894224,319769,3.1272574889998714
1747959304008324,43096364,1,468,1,43303514,42986784,316730,3.157263284185268
1747959304102723,43188924,1,469,1,43397913,43079344,318569,3.1390373827961917
1747959304197375,43281484,1,470,1,43492565,43171904,320661,3.1185582281599573
1747959304291602,43374044,1,471,1,43586792,43264464,322328,3.102429823037403
1747959304385472,43466604,1,472,1,43680662,43357024,323638,3.0898720175010355
1747959304475548,43559164,1,473,1,43770738,43449584,321154,3.1137709634630117
1747959304569939,43651724,1,474,1,43865129,43542144,322985,3.096119014814929
1747959304663696,43744292,1,475,1,43958886,43634712,324174,3.084763121039935
1747959304758367,43836844,1,476,1,44053557,43727264,326293,3.0647301658325494
1747959304848301,43929404,1,477,1,44143491,43819824,323667,3.08959517034483
1747959304942788,44021964,1,478,1,44237978,43912384,325594,3.0713096678685727
1747959305036489,44114524,1,479,1,44331679,44004944,326735,3.0605842655362907
1747959305130247,44207084,1,480,1,44425437,44097504,327933,3.049403384227876
1747959305220665,44299644,1,481,1,44515855,44190064,325791,3.0694525017572616
1747959305315356,44392204,1,482,1,44610546,44282624,327922,3.0495056751300615
1747959305409862,44484764,1,483,1,44705052,44375184,329868,3.0315156365576534
1747959305503983,44577324,1,484,1,44799173,44467744,331429,3.0172374777101583
1747959305594128,44669884,1,485,1,44889318,44560304,329014,3.0393843423076223
1747959305687344,44762444,1,486,1,44982534,44652864,329670,3.0333363666696997
1747959305781765,44855004,1,487,1,45076955,44745424,331531,3.0163091837565714
1747959305876060,44947564,1,488,1,45171250,44837984,333266,3.000606122436732
1747959305970941,45040124,1,489,1,45266131,44930544,335587,2.9798532124307555
1747959306059690,45132684,1,490,1,45354880,45023104,331776,3.0140817901234565
1747959306154571,45225244,1,491,1,45449761,45115664,334097,2.9931427100512726
1747959306248627,45317804,1,492,1,45543817,45208224,335593,2.979799936232282
1747959306342804,45410364,1,493,1,45637994,45300784,337210,2.9655111058390915
1747959306433398,45502924,1,494,1,45728588,45393344,335244,2.9829020057033087
1747959306527105,45595484,1,495,1,45822295,45485904,336391,2.9727311372777514
1747959306622193,45688044,1,496,1,45917383,45578464,338919,2.9505575078411064
1747959306715655,45780604,1,497,1,46010845,45671024,339821,2.9427257291338678
1747959306805912,45873172,1,498,1,46101102,45763592,337510,2.9628751740689165
1747959306900196,45965724,1,499,1,46195386,45856144,339242,2.9477482151384558
1747959306993841,46058284,1,500,1,46289031,45948704,340327,2.9383504688138173
1747959307088190,46150844,1,501,1,46383380,46041264,342116,2.922985186311076
1747959307178643,46243404,1,502,1,46473833,46133824,340009,2.9410986179777594
1747959307273138,46335964,1,503,1,46568328,46226384,341944,2.9244554663921574
1747959307367296,46428524,1,504,1,46662486,46318944,343542,2.910852239318628
1747959307461345,46521084,1,505,1,46756535,46411504,345031,2.898290298552884
1747959307550903,46613644,1,506,1,46846093,46504064,342029,2.923728689672513
1747959307645416,46706204,1,507,1,46940606,46596624,343982,2.90712886139391
1747959307739553,46798764,1,508,1,47034743,46689184,345559,2.8938618296730803
1747959307834275,46891324,1,509,1,47129465,46781744,347721,2.8758688718829175
1747959307928387,46983884,1,510,1,47223577,46874304,349273,2.8630899038860718
1747959308018352,47076444,1,511,1,47313542,46966864,346678,2.8845210829645955
1747959308111997,47169004,1,512,1,47407187,47059424,347763,2.875521547720718
1747959308206222,47261564,1,513,1,47501412,47151984,349428,2.861819888503497
1747959308300199,47354124,1,514,1,47595389,47244544,350845,2.8502615114936796
1747959308391362,47446684,1,515,1,47686552,47337104,349448,2.861656097616813
1747959308485700,47539244,1,516,1,47780890,47429664,351226,2.847169628672137
1747959308579669,47631804,1,517,1,47874859,47522224,352635,2.835793384094035
1747959308674021,47724364,1,518,1,47969211,47614784,354427,2.821455476021861
1747959308763952,47816924,1,519,1,48059142,47707344,351798,2.8425403214344596
1747959308858283,47909484,1,520,1,48153473,47799904,353569,2.828302255005388
1747959308952335,48002044,1,521,1,48247525,47892464,355061,2.816417460661689
1747959309046845,48094604,1,522,1,48342035,47985024,357011,2.8010341418051543
1747959309140945,48187164,1,523,1,48436135,48077584,358551,2.789003516933435
1747959309231235,48279724,1,524,1,48526425,48170144,356281,2.8067733053404473
1747959309325108,48372284,1,525,1,48620298,48262704,357594,2.796467502251156
1747959309419173,48464844,1,526,1,48714363,48355264,359099,2.7847473816412744
1747959309513944,48557404,1,527,1,48809134,48447824,361310,2.767706401704907
1747959309603663,48649964,1,528,1,48898853,48540384,358469,2.7896415031704276
1747959309697875,48742524,1,529,1,48993065,48632944,360121,2.776844449504472
1747959309791639,48835084,1,530,1,49086829,48725504,361325,2.767591503494084
1747959309886388,48927644,1,531,1,49181578,48818064,363514,2.750925686493505
1747959309975936,49020204,1,532,1,49271126,48910624,360502,2.7739097147866034
1747959310070588,49112764,1,533,1,49365778,49003184,362594,2.7579055362195732
1747959310164611,49205324,1,534,1,49459801,49095744,364057,2.7468226129424784
1747959310258947,49297884,1,535,1,49554137,49188304,365833,2.7334876842712386
1747959310348914,49390444,1,536,1,49644104,49280864,363240,2.7530007708402158
1747959310443017,49483004,1,537,1,49738207,49373424,364783,2.7413558197613375
1747959310537444,49575564,1,538,1,49832634,49465984,366650,2.7273966998499932
1747959310631879,49668132,1,539,1,49927069,49558552,368517,2.7135790207778747
1747959310721779,49760684,1,540,1,50016969,49651104,365865,2.733248602626652
1747959310816188,49853244,1,541,1,50111378,49743664,367714,2.7195048325600877
1747959310909613,49945804,1,542,1,50204803,49836224,368579,2.713122559885398
1747959311004037,50038364,1,543,1,50299227,49928784,370443,2.6994706338087098
1747959311098606,50130924,1,544,1,50393796,50021344,372452,2.684909733334765
1747959311188871,50223484,1,545,1,50484061,50113904,370157,2.7015563666228113
1747959311282791,50316044,1,546,1,50577981,50206464,371517,2.691666868541682
1747959311377122,50408604,1,547,1,50672312,50299024,373288,2.678896723173528
1747959311471289,50501164,1,548,1,50766479,50391584,374895,2.667413542458555
1747959311561374,50593724,1,549,1,50856564,50484144,372420,2.685140432844638
1747959311655789,50686284,1,550,1,50950979,50576704,374275,2.6718322089372784
1747959311749766,50778844,1,551,1,51044956,50669264,375692,2.661754841732057
1747959311843767,50871404,1,552,1,51138957,50761824,377133,2.6515844542906613
1747959311934571,50963964,1,553,1,51229761,50854384,375377,2.6639884702579004
1747959312028459,51056524,1,554,1,51323649,50946944,376705,2.6545970985253713
1747959312122520,51149084,1,555,1,51417710,51039504,378206,2.644061701823874
1747959312216637,51241644,1,556,1,51511827,51132064,379763,2.6332212458823
1747959312306895,51334204,1,557,1,51602085,51224624,377461,2.649280323000257
1747959312401293,51426764,1,558,1,51696483,51317184,379299,2.636442489961745
1747959312494681,51519324,1,559,1,51789871,51409744,380127,2.630699739823796
1747959312589508,51611884,1,560,1,51884698,51502304,382394,2.615103793469563
1747959312684104,51704444,1,561,1,51979294,51594864,384430,2.601253804333689
1747959312774102,51797012,1,562,1,52069292,51687432,381860,2.61876080238831
1747959312867719,51889564,1,563,1,52162909,51779984,382925,2.611477443363583
1747959312962214,51982124,1,564,1,52257404,51872544,384860,2.5983474510211506
1747959313056320,52074684,1,565,1,52351510,51965104,386406,2.5879515328436926
1747959313146696,52167244,1,566,1,52441886,52057664,384222,2.602662002696358
1747959313240621,52259804,1,567,1,52535811,52150224,385587,2.593448430574682
1747959313334298,52352364,1,568,1,52629488,52242784,386704,2.5859572179237866
1747959313428825,52444924,1,569,1,52724015,52335344,388671,2.572870113798045
1747959313519242,52537484,1,570,1,52814432,52427904,386528,2.587134696580843
1747959313612840,52630044,1,571,1,52908030,52520464,387566,2.580205693997925
1747959313707861,52722604,1,572,1,53003051,52613024,390027,2.5639250615982996
1747959313801868,52815164,1,573,1,53097058,52705584,391474,2.5544480604075877
1747959313891548,52907724,1,574,1,53186738,52798144,388594,2.5733799286659083
1747959313985930,53000284,1,575,1,53281120,52890704,390416,2.5613704356378837
1747959314080001,53092844,1,576,1,53375191,52983264,391927,2.551495559121979
1747959314174739,53185404,1,577,1,53469929,53075824,394105,2.5373948567006255
1747959314268236,53277964,1,578,1,53563426,53168384,395042,2.531376410609505
1747959314358640,53370524,1,579,1,53653830,53260944,392886,2.545267583981104
1747959314452920,53463084,1,580,1,53748110,53353504,394606,2.534173327318895
1747959314547187,53555644,1,581,1,53842377,53446064,396313,2.5232581318301444
1747959314641611,53648204,1,582,1,53936801,53538624,398177,2.5114459147565027
1747959314731423,53740764,1,583,1,54026613,53631184,395429,2.5288989932453108
1747959314825403,53833324,1,584,1,54120593,53723744,396849,2.519850119314903
1747959314919856,53925884,1,585,1,54215046,53816304,398742,2.5078873055760367
1747959315014212,54018444,1,586,1,54309402,53908864,400538,2.496642016487824
1747959315104174,54111004,1,587,1,54399364,54001424,397940,2.512941649494899
1747959315197886,54203564,1,588,1,54493076,54093984,399092,2.5056879115592396
1747959315292501,54296124,1,589,1,54587691,54186544,401147,2.492851747613718
1747959315387189,54388684,1,590,1,54682379,54279104,403275,2.4796974769078175
1747959315476983,54481244,1,591,1,54772173,54371664,400509,2.496822792995913
1747959315570713,54573804,1,592,1,54865903,54464224,401679,2.4895501133990074
1747959315665681,54666364,1,593,1,54960871,54556784,404087,2.474714603538347
1747959315759477,54758924,1,594,1,55054667,54649344,405323,2.467168159714598
1747959315853633,54851484,1,595,1,55148823,54741904,406919,2.4574915400853734
1747959315943131,54944044,1,596,1,55238321,54834464,403857,2.476123974575159
1747959316037874,55036604,1,597,1,55333064,54927024,406040,2.462811545660526
1747959316132261,55129164,1,598,1,55427451,55019584,407867,2.4517796242402548
1747959316226137,55221724,1,599,1,55521327,55112144,409183,2.44389429668388
1747959316317004,55314284,1,600,1,55612194,55204704,407490,2.454047952096984
1747959316409460,55406844,1,601,1,55704650,55297264,407386,2.454674436529483
1747959316504657,55499404,1,602,1,55799847,55389824,410023,2.4388875745994736
1747959316599057,55591972,1,603,1,55894247,55482392,411855,2.4280389943062484
1747959316688982,55684524,1,604,1,55984172,55574944,409228,2.4436255583684403
1747959316783088,55777084,1,605,1,56078278,55667504,410774,2.4344286639368606
1747959316877459,55869644,1,606,1,56172649,55760064,412585,2.4237429862937336
1747959316971689,55962204,1,607,1,56266879,55852624,414255,2.413972070343146
1747959317062095,56054764,1,608,1,56357285,55945184,412101,2.4265895981810286
1747959317155721,56147324,1,609,1,56450911,56037744,413167,2.420328825874283
1747959317250286,56239884,1,610,1,56545476,56130304,415172,2.4086402743923
1747959317344154,56332444,1,611,1,56639344,56222864,416480,2.4010756819054935
1747959317438892,56425004,1,612,1,56734082,56315424,418658,2.3885844770672007
1747959317528372,56517564,1,613,1,56823562,56407984,415578,2.406287147057833
1747959317622371,56610124,1,614,1,56917561,56500544,417017,2.3979837752417765
1747959317717725,56702684,1,615,1,57012915,56593104,419811,2.3820242918837287
1747959317810912,56795244,1,616,1,57106102,56685664,420438,2.378471974464725
1747959317900848,56887804,1,617,1,57196038,56778224,417814,2.393409507579928
1747959317995510,56980364,1,618,1,57290700,56870784,419916,2.381428666685718
1747959318090020,57072924,1,619,1,57385210,56963344,421866,2.3704209393504097
1747959318183079,57165484,1,620,1,57478269,57055904,422365,2.36762042309377
1747959318274657,57258044,1,621,1,57569847,57148464,421383,2.3731379766150984
1747959318368608,57350604,1,622,1,57663798,57241024,422774,2.365329939873313
1747959318462160,57443164,1,623,1,57757350,57333584,423766,2.359792904574695
1747959318556509,57535724,1,624,1,57851699,57426144,425555,2.3498725194158214
1747959318647232,57628284,1,625,1,57942422,57518704,423718,2.3600602287370376
1747959318741247,57720852,1,626,1,58036437,57611272,425165,2.352028036174191
1747959318834992,57813404,1,627,1,58130182,57703824,426358,2.345446784157914
1747959318929543,57905964,1,628,1,58224733,57796384,428349,2.334544962168699
1747959319023620,57998524,1,629,1,58318810,57888944,429866,2.326306337323724
1747959319113375,58091084,1,630,1,58408565,57981504,427061,2.341585862441197
1747959319208242,58183644,1,631,1,58503432,58074064,429368,2.3290044903206573
1747959319302282,58276204,1,632,1,58597472,58166624,430848,2.3210041592394535
1747959319396390,58368764,1,633,1,58691580,58259184,432396,2.3126948445406526
1747959319486405,58461324,1,634,1,58781595,58351744,429851,2.326387515674036
1747959319580499,58553884,1,635,1,58875689,58444304,431385,2.3181149089560367
1747959319674952,58646444,1,636,1,58970142,58536864,433278,2.307987019881
1747959319769136,58739004,1,637,1,59064326,58629424,434902,2.2993685933842567
1747959319859346,58831564,1,638,1,59154536,58721984,432552,2.3118607704969576
1747959319953610,58924124,1,639,1,59248800,58814544,434256,2.302789138204193
1747959320047584,59016684,1,640,1,59342774,58907104,435670,2.295315261551174
1747959320141308,59109244,1,641,1,59436498,58999664,436834,2.2891991008025934
1747959320232293,59201804,1,642,1,59527483,59092224,435259,2.297482648262299
1747959320326407,59294364,1,643,1,59621597,59184784,436813,2.2893091551762423
1747959320419962,59386924,1,644,1,59715152,59277344,437808,2.2841062748967587
1747959320514493,59479484,1,645,1,59809683,59369904,439779,2.2738693752998667
1747959320608623,59572044,1,646,1,59903813,59462464,441349,2.265780595401825
1747959320698664,59664604,1,647,1,59993854,59555024,438830,2.2787867739215644
1747959320792424,59757164,1,648,1,60087614,59647584,440030,2.272572324614231
1747959320887266,59849724,1,649,1,60182456,59740144,442312,2.2608475465282427
1747959320980877,59942284,1,650,1,60276067,59832704,443363,2.2554881665813338
1747959321070934,60034844,1,651,1,60366124,59925264,440860,2.268293789411605
1747959321165321,60127404,1,652,1,60460511,60017824,442687,2.2589323833769686
1747959321259408,60219964,1,653,1,60554598,60110384,444214,2.2511672302088632
1747959321353315,60312524,1,654,1,60648505,60202944,445561,2.244361602563959
1747959321443885,60405084,1,655,1,60739075,60295504,443571,2.254430519578602
1747959321538398,60497644,1,656,1,60833588,60388064,445524,2.244547992925185
1747959321632341,60590204,1,657,1,60927531,60480624,446907,2.2376020066814797
1747959321726052,60682764,1,658,1,61021242,60573184,448058,2.2318539117703513
1747959321816379,60775324,1,659,1,61111569,60665744,445825,2.243032580048225
1747959321910430,60867884,1,660,1,61205620,60758304,447316,2.2355560722174035
1747959322005155,60960444,1,661,1,61300345,60850864,449481,2.2247881445489353
1747959322098753,61053004,1,662,1,61393943,60943424,450519,2.2196622118046077
1747959322193451,61145564,1,663,1,61488641,61035984,452657,2.2091782519656165
1747959322282942,61238124,1,664,1,61578132,61128544,449588,2.2242586545904253
1747959322377627,61330684,1,665,1,61672817,61221104,451713,2.2137950424273822
1747959322472149,61423244,1,666,1,61767339,61313664,453675,2.2042210833746627
1747959322565757,61515812,1,667,1,61860947,61406232,454715,2.1991797059696734
1747959322656321,61608364,1,668,1,61951511,61498784,452727,2.208836671989963
1747959322750712,61700924,1,669,1,62045902,61591344,454558,2.199939281675826
1747959322844525,61793484,1,670,1,62139715,61683904,455811,2.1938917665435893
1747959322939071,61886044,1,671,1,62234261,61776464,457797,2.1843742969045232
1747959323029110,61978604,1,672,1,62324300,61869024,455276,2.196469833683304
1747959323123177,62071164,1,673,1,62418367,61961584,456783,2.1892233292394856
1747959323216944,62163724,1,674,1,62512134,62054144,457990,2.1834537872005937
1747959323311517,62256284,1,675,1,62606707,62146704,460003,2.1738988658769616
1747959323401581,62348844,1,676,1,62696771,62239264,457507,2.185758906421104
1747959323495740,62441404,1,677,1,62790930,62331824,459106,2.1781462233122633
1747959323590266,62533964,1,678,1,62885456,62424384,461072,2.168858659818857
1747959323683764,62626524,1,679,1,62978954,62516944,462010,2.164455314820026
1747959323778346,62719084,1,680,1,63073536,62609504,464032,2.1550237914626575
1747959323869292,62811644,1,681,1,63164482,62702064,462418,2.1625455756480068
1747959323963335,62904204,1,682,1,63258525,62794624,463901,2.1556323439699416
1747959324057035,62996764,1,683,1,63352225,62887184,465041,2.1503480338292755
1747959324151877,63089324,1,684,1,63447067,62979744,467323,2.1398476000539244
1747959324241665,63181884,1,685,1,63536855,63072304,464551,2.152616182076887
1747959324336554,63274444,1,686,1,63631744,63164864,466880,2.141877998629198
1747959324429974,63367004,1,687,1,63725164,63257424,467740,2.1379398811305426
1747959324524148,63459564,1,688,1,63819338,63349984,469354,2.1305879996761505
1747959324614402,63552124,1,689,1,63909592,63442544,467048,2.141107552114558
1747959324708044,63644692,1,690,1,64003234,63535112,468122,2.136195265336814
1747959324803272,63737244,1,691,1,64098462,63627664,470798,2.1240532032846358
1747959324896264,63829804,1,692,1,64191454,63720224,471230,2.12210597797254
1747959324986858,63922364,1,693,1,64282048,63812784,469264,2.1309966245013467
1747959325081263,64014924,1,694,1,64376453,63905344,471109,2.1226510213135388
1747959325175786,64107484,1,695,1,64470976,63997904,473072,2.113843135928569
1747959325269238,64200044,1,696,1,64564428,64090464,473964,2.1098648842528123
1747959325364059,64292604,1,697,1,64659249,64183024,476225,2.0998477610373247
1747959325453881,64385164,1,698,1,64749071,64275584,473487,2.1119904031156085
1747959325548168,64477724,1,699,1,64843358,64368144,475214,2.1043151085616163
1747959325642545,64570284,1,700,1,64937735,64460704,477031,2.0962998211856254
1747959325736699,64662844,1,701,1,65031889,64553264,478625,2.0893183598850875
1747959325826314,64755404,1,702,1,65121504,64645824,475680,2.1022536158762195
1747959325920498,64847964,1,703,1,65215688,64738384,477304,2.095100816251278
1747959326015105,64940524,1,704,1,65310295,64830944,479351,2.0861539873704236
1747959326109323,65033084,1,705,1,65404513,64923504,481009,2.0789631794831283
1747959326200136,65125644,1,706,1,65495326,65016064,479262,2.0865413907215675
1747959326293583,65218204,1,707,1,65588773,65108624,480149,2.082686832629038
1747959326387881,65310764,1,708,1,65683071,65201184,481887,2.075175300433504
1747959326482494,65403324,1,709,1,65777684,65293744,483940,2.066371864280696
1747959326572263,65495884,1,710,1,65867453,65386304,481149,2.078358263240701
1747959326666512,65588444,1,711,1,65961702,65478864,482838,2.071088025383255
1747959326759753,65681004,1,712,1,66054943,65571424,483519,2.0681710542915583
1747959326854282,65773564,1,713,1,66149472,65663984,485488,2.059783146030386
1747959326948936,65866124,1,714,1,66244126,65756544,487582,2.0509370731487215
1747959327038426,65958684,1,715,1,66333616,65849104,484512,2.0639323690641307
1747959327133242,66051244,1,716,1,66428432,65941664,486768,2.0543667619892845
1747959327227378,66143804,1,717,1,66522568,66034224,488344,2.0477368412430583
1747959327321221,66236364,1,718,1,66616411,66126784,489627,2.0423710293754227
1747959327412191,66328924,1,719,1,66707381,66219344,488037,2.049024971467327
1747959327505820,66421484,1,720,1,66801010,66311904,489106,2.0445465809047527
1747959327599958,66514044,1,721,1,66895148,66404464,490684,2.037971484702986
1747959327694337,66606604,1,722,1,66989527,66497024,492503,2.0304444846021243
1747959327784791,66699164,1,723,1,67079981,66589584,490397,2.0391641873828754
1747959327878752,66791724,1,724,1,67173942,66682144,491798,2.0333551580120295
1747959327972933,66884284,1,725,1,67268123,66774704,493419,2.026675097635073
1747959328066550,66976844,1,726,1,67361740,66867264,494476,2.022342843737613
1747959328156714,67069404,1,727,1,67451904,66959824,492080,2.032189887823118
1747959328251379,67161964,1,728,1,67546569,67052384,494185,2.0235336968948876
1747959328345172,67254524,1,729,1,67640362,67144944,495418,2.0184975111925687
1747959328439840,67347084,1,730,1,67735030,67237504,497526,2.0099452088936056
1747959328533974,67439652,1,731,1,67829164,67330072,499092,2.003638607711604
1747959328624250,67532204,1,732,1,67919440,67422624,496816,2.0128176226208496
1747959328718476,67624764,1,733,1,68013666,67515184,498482,2.006090490729856
1747959328811876,67717324,1,734,1,68107066,67607744,499322,2.002715682465423
1747959328906093,67809884,1,735,1,68201283,67700304,500979,1.9960916525443184
1747959328996729,67902444,1,736,1,68291919,67792864,499055,2.003787157728106
1747959329091357,67995004,1,737,1,68386547,67885424,501123,1.9955180664228145
1747959329185139,68087564,1,738,1,68480329,67977984,502345,1.9906637868397214
1747959329278914,68180124,1,739,1,68574104,68070544,503560,1.9858606720152514
1747959329369274,68272684,1,740,1,68664464,68163104,501360,1.9945747566618797
1747959329463615,68365244,1,741,1,68758805,68255664,503141,1.9875144343235795
1747959329557986,68457804,1,742,1,68853176,68348224,504952,1.9803862545350848
1747959329651825,68550364,1,743,1,68947015,68440784,506231,1.9753827797981554
1747959329742601,68642924,1,744,1,69037791,68533344,504447,1.982368811787958
1747959329836394,68735484,1,745,1,69131584,68625904,505680,1.9775352001265623
1747959329931076,68828044,1,746,1,69226266,68718464,507802,1.9692714877058382
1747959330024587,68920604,1,747,1,69319777,68811024,508753,1.9655903748970522
1747959330118940,69013164,1,748,1,69414130,68903584,510546,1.958687366074751
1747959330208777,69105724,1,749,1,69503967,68996144,507823,1.969190052439531
1747959330302843,69198284,1,750,1,69598033,69088704,509329,1.9633674893830901
1747959330396952,69290844,1,751,1,69692142,69181264,510878,1.9574144903479889
1747959330491789,69383404,1,752,1,69786979,69273824,513155,1.9487289415478752
1747959330581909,69475964,1,753,1,69877099,69366384,510715,1.958039219525567
1747959330676183,69568532,1,754,1,69971373,69458952,512421,1.951520331914578
1747959330770144,69661084,1,755,1,70065334,69551504,513830,1.946168966389662
1747959330864143,69753644,1,756,1,70159333,69644064,515269,1.9407338691052636
1747959330954080,69846204,1,757,1,70249270,69736624,512646,1.9506638108948473
1747959331048687,69938764,1,758,1,70343877,69829184,514693,1.9429057710130118
1747959331142388,70031324,1,759,1,70437578,69921744,515834,1.938608156887681
1747959331236391,70123884,1,760,1,70531581,70014304,517277,1.9332002002795408
1747959331327225,70216444,1,761,1,70622415,70106864,515551,1.9396723117596515
1747959331421306,70309004,1,762,1,70716496,70199424,517072,1.9339666429433426
1747959331515787,70401564,1,763,1,70810977,70291984,518993,1.9268082613831015
1747959331609427,70494124,1,764,1,70904617,70384544,520073,1.9228069905570948
1747959331703976,70586684,1,765,1,70999166,70477104,522062,1.9154813029870015
1747959331793823,70679244,1,766,1,71089013,70569664,519349,1.9254874852940895
1747959331888374,70771804,1,767,1,71183564,70662224,521340,1.9181340392066597
1747959331981768,70864364,1,768,1,71276958,70754784,522174,1.9150704554420557
1747959332076325,70956924,1,769,1,71371515,70847344,524171,1.90777437134065
1747959332166952,71049484,1,770,1,71462142,70939904,522238,1.9148357645364757
1747959332261253,71142044,1,771,1,71556443,71032464,523979,1.9084734311871279
1747959332355614,71234604,1,772,1,71650804,71125024,525780,1.9019361710221003
1747959332449089,71327164,1,773,1,71744279,71217584,526695,1.8986320356183368
1747959332539323,71419724,1,774,1,71834513,71310144,524369,1.907054002048176
1747959332634253,71512284,1,775,1,71929443,71402704,526739,1.8984734375088992
1747959332728214,71604844,1,776,1,72023404,71495264,528140,1.8934373461582155
1747959332821696,71697404,1,777,1,72116886,71587824,529062,1.8901376398229317
1747959332912771,71789964,1,778,1,72207961,71680384,527577,1.8954579142002022
1747959333006626,71882524,1,779,1,72301816,71772944,528872,1.8908166815410912
1747959333100294,71975084,1,780,1,72395484,71865504,529980,1.8868636552322728
1747959333194624,72067644,1,781,1,72489814,71958064,531750,1.8805829807240246
1747959333289093,72160204,1,782,1,72584283,72050624,533659,1.8738557768162816
1747959333379100,72252764,1,783,1,72674290,72143184,531106,1.882863307889574
1747959333473681,72345324,1,784,1,72768871,72235744,533127,1.8757256713691108
1747959333567386,72437884,1,785,1,72862576,72328304,534272,1.8717057977958793
1747959333662166,72530444,1,786,1,72957356,72420864,536492,1.8639606927969103
1747959333752330,72623004,1,787,1,73047520,72513424,534096,1.8723225787124411
1747959333845628,72715564,1,788,1,73140818,72605984,534834,1.8697390218273333
1747959333939657,72808124,1,789,1,73234847,72698544,536303,1.8646175762581974
1747959334034972,72900684,1,790,1,73330162,72791104,539058,1.8550879497196961
1747959334123458,72993244,1,791,1,73418648,72883664,534984,1.8692147802551105
1747959334218767,73085804,1,792,1,73513957,72976224,537733,1.8596589757370292
1747959334312693,73178364,1,793,1,73607883,73068784,539099,1.8549468650470506
1747959334407667,73270924,1,794,1,73702857,73161344,541513,1.8466777344218883
1747959334496888,73363492,1,795,1,73792078,73253912,538166,1.8581627230259807
1747959334590853,73456044,1,796,1,73886043,73346464,539579,1.8532967369004352
1747959334685697,73548604,1,797,1,73980887,73439024,541863,1.8454849288473287
1747959334779871,73641164,1,798,1,74075061,73531584,543477,1.8400042688099036
1747959334874234,73733724,1,799,1,74169424,73624144,545280,1.8339201877934272
1747959334964294,73826284,1,800,1,74259484,73716704,542780,1.8423670732156674
1747959335058513,73918844,1,801,1,74353703,73809264,544439,1.836753061408165
1747959335152493,74011404,1,802,1,74447683,73901824,545859,1.8319749239272414
1747959335246381,74103964,1,803,1,74541571,73994384,547187,1.8275287972850234
1747959335337220,74196524,1,804,1,74632410,74086944,545466,1.8332948341418163
1747959335431366,74289084,1,805,1,74726556,74179504,547052,1.8279797898554435
1747959335524830,74381644,1,806,1,74820020,74272064,547956,1.8249640482082503
1747959335619827,74474204,1,807,1,74915017,74364624,550393,1.8168835722838044
1747959335709713,74566764,1,808,1,75004903,74457184,547719,1.825753716778129
1747959335804090,74659324,1,809,1,75099280,74549744,549536,1.8197169976125311
1747959335897334,74751884,1,810,1,75192524,74642304,550220,1.817454836247319
1747959335991567,74844444,1,811,1,75286757,74734864,551893,1.8119454314513865
1747959336081900,74937004,1,812,1,75377090,74827424,549666,1.819286621330044
1747959336175956,75029564,1,813,1,75471146,74919984,551162,1.8143485944241438
1747959336270721,75122124,1,814,1,75565911,75012544,553367,1.8071189644485484
1747959336364425,75214684,1,815,1,75659615,75105104,554511,1.8033907352604368
1747959336458587,75307244,1,816,1,75753777,75197664,556113,1.7981956904442085
1747959336549031,75399804,1,817,1,75844221,75290224,553997,1.8050639263389514
1747959336643088,75492372,1,818,1,75938278,75382792,555486,1.8002253882186048
1747959336736843,75584924,1,819,1,76032033,75475344,556689,1.7963351170941046
1747959336831571,75677484,1,820,1,76126761,75567904,558857,1.7893665105742613
1747959336921629,75770044,1,821,1,76216819,75660464,556355,1.7974135219419254
1747959337015567,75862604,1,822,1,76310757,75753024,557733,1.7929726231010177
1747959337110257,75955164,1,823,1,76405447,75845584,559863,1.786151254860564
1747959337204395,76047724,1,824,1,76499585,75938144,561441,1.7811310538418108
1747959337294074,76140284,1,825,1,76589264,76030704,558560,1.7903179604697796
1747959337388364,76232844,1,826,1,76683554,76123264,560290,1.7847900194542115
1747959337482644,76325404,1,827,1,76777834,76215824,562010,1.779327769968506
1747959337577158,76417964,1,828,1,76872348,76308384,563964,1.7731628259959855
1747959337666992,76510524,1,829,1,76962182,76400944,561238,1.7817752896275734
1747959337761396,76603084,1,830,1,77056586,76493504,563082,1.7759402715767865
1747959337855432,76695644,1,831,1,77150622,76586064,564558,1.771297191785432
1747959337949675,76788204,1,832,1,77244865,76678624,566241,1.766032484401518
1747959338043772,76880764,1,833,1,77338962,76771184,567778,1.7612517568486274
1747959338133990,76973324,1,834,1,77429180,76863744,565436,1.768546749764783
1747959338228523,77065884,1,835,1,77523713,76956304,567409,1.7623971420967943
1747959338322218,77158444,1,836,1,77617408,77048864,568544,1.7588788202847976
1747959338416795,77251004,1,837,1,77711985,77141424,570561,1.7526609775291337
1747959338506900,77343564,1,838,1,77802090,77233984,568106,1.7602348857431536
1747959338600844,77436124,1,839,1,77896034,77326544,569490,1.7559570844088568
1747959338695795,77528684,1,840,1,77990985,77419104,571881,1.7486155336512317
1747959338788802,77621244,1,841,1,78083992,77511664,572328,1.7472498287695168
1747959338879487,77713804,1,842,1,78174677,77604224,570453,1.7529927969525974
1747959338974044,77806364,1,843,1,78269234,77696784,572450,1.7468774565464231
1747959339068220,77898924,1,844,1,78363410,77789344,574066,1.7419599836952546
1747959339162496,77991484,1,845,1,78457686,77881904,575782,1.736768429718192
1747959339252790,78084044,1,846,1,78547980,77974464,573516,1.7436305177187732
1747959339346207,78176604,1,847,1,78641397,78067024,574373,1.7410289132671626
1747959339440759,78269164,1,848,1,78735949,78159584,576365,1.7350116679534668
1747959339535264,78361724,1,849,1,78830454,78252144,578310,1.7291763932838788
1747959339629019,78454284,1,850,1,78924209,78344704,579505,1.7256106504689346
1747959339719820,78546844,1,851,1,79015010,78437264,577746,1.730864428312788
1747959339813699,78639404,1,852,1,79108889,78529824,579065,1.7269218481517616
1747959339907729,78731964,1,853,1,79202919,78622384,580535,1.7225490280517108
1747959340001969,78824524,1,854,1,79297159,78714944,582215,1.717578557749285
1747959340092179,78917084,1,855,1,79387369,78807504,579865,1.7245393324308245
1747959340186723,79009644,1,856,1,79481913,78900064,581849,1.7186589647829593
1747959340280414,79102204,1,857,1,79575604,78992624,582980,1.715324710967786
1747959340373928,79194764,1,858,1,79669118,79085184,583934,1.7125223056030305
1747959340464627,79287332,1,859,1,79759817,79177752,582065,1.7180211832011887
1747959340558901,79379884,1,860,1,79854091,79270304,583787,1.71295352585789
1747959340653357,79472444,1,861,1,79948547,79362864,585683,1.707408273759013
1747959340746658,79565004,1,862,1,80041848,79455424,586424,1.7052508082888833
1747959340837475,79657564,1,863,1,80132665,79547984,584681,1.7103343532627193
1747959340932061,79750124,1,864,1,80227251,79640544,586707,1.7044282751015414
1747959341025545,79842684,1,865,1,80320735,79733104,587631,1.7017482059319538
1747959341120095,79935244,1,866,1,80415285,79825664,589621,1.6960047216771452
1747959341214578,80027804,1,867,1,80509768,79918224,591544,1.6904913243985233
1747959341304366,80120364,1,868,1,80599556,80010784,588772,1.6984503339153358
1747959341399035,80212924,1,869,1,80694225,80103344,590881,1.6923881458364713
1747959341492681,80305484,1,870,1,80787871,80195904,591967,1.6892833553221716
1747959341586938,80398044,1,871,1,80882128,80288464,593664,1.6844545062526952
1747959341676705,80490604,1,872,1,80971895,80381024,590871,1.6924167880975711
1747959341771417,80583164,1,873,1,81066607,80473584,593023,1.686275237216769
1747959341865952,80675724,1,874,1,81161142,80566144,594998,1.6806779182451033
1747959341959245,80768284,1,875,1,81254435,80658704,595731,1.6786099766505351
1747959342049767,80860844,1,876,1,81344957,80751264,593693,1.6843722260494902
1747959342143962,80953404,1,877,1,81439152,80843824,595328,1.6797462911201892
1747959342237862,81045964,1,878,1,81533052,80936384,596668,1.6759739084381935
1747959342331431,81138524,1,879,1,81626621,81028944,597677,1.6731445245508862
1747959342422497,81231084,1,880,1,81717687,81121504,596183,1.6773373276326229
1747959342516016,81323644,1,881,1,81811206,81214064,597142,1.6746435521199314
1747959342610501,81416212,1,882,1,81905691,81306632,599059,1.6692846614440313
1747959342704149,81508764,1,883,1,81999339,81399184,600155,1.6662362223092368
1747959342799107,81601324,1,884,1,82094297,81491744,602553,1.6596050471908694
1747959342888598,81693884,1,885,1,82183788,81584304,599484,1.6681012337276724
1747959342983043,81786444,1,886,1,82278233,81676864,601369,1.6628725458079814
1747959343078190,81879004,1,887,1,82373380,81769424,603956,1.6557497566047856
1747959343171227,81971564,1,888,1,82466417,81861984,604433,1.6544430896393811
1747959343261528,82064124,1,889,1,82556718,81954544,602174,1.6606495796895915
1747959343355982,82156684,1,890,1,82651172,82047104,604068,1.6554427647218524
1747959343450408,82249244,1,891,1,82745598,82139664,605934,1.6503447570197416
1747959343543992,82341804,1,892,1,82839182,82232224,606958,1.647560457230978
1747959343634164,82434364,1,893,1,82929354,82324784,604570,1.6540681806904078
1747959343729210,82526924,1,894,1,83024400,82417344,607056,1.6472944835402334
1747959343822549,82619484,1,895,1,83117739,82509904,607835,1.645183314550824
1747959343916664,82712044,1,896,1,83211854,82602464,609390,1.6409852475426245
1747959344007247,82804604,1,897,1,83302437,82695024,607413,1.6463263051663366
1747959344101771,82897164,1,898,1,83396961,82787584,609377,1.641020255113009
1747959344195832,82989724,1,899,1,83491022,82880144,610878,1.6369880729049007
1747959344289883,83082284,1,900,1,83585073,82972704,612369,1.6330023237623066
1747959344383483,83174844,1,901,1,83678673,83065264,613409,1.6302336613906871
1747959344473840,83267404,1,902,1,83769030,83157824,611206,1.6361095931649885
1747959344568552,83359964,1,903,1,83863742,83250384,613358,1.6303692134120693
1747959344662843,83452524,1,904,1,83958033,83342944,615089,1.6257809845404487
1747959344756860,83545084,1,905,1,84052050,83435504,616546,1.6219389956304961
1747959344846820,83637644,1,906,1,84142010,83528064,613946,1.6288077453065906
1747959344941388,83730204,1,907,1,84236578,83620624,615954,1.6234978586063245
1747959345035313,83822764,1,908,1,84330503,83713184,617319,1.6199080216225323
1747959345129655,83915324,1,909,1,84424845,83805744,619101,1.6152453315371804
1747959345218946,84007884,1,910,1,84514136,83898304,615832,1.6238194832356876
1747959345313954,84100444,1,911,1,84609144,83990864,618280,1.6173901792068317
1747959345408234,84193004,1,912,1,84703424,84083424,620000,1.6129032258064517
1747959345502201,84285564,1,913,1,84797391,84175984,621407,1.6092512636645546
1747959345592198,84378124,1,914,1,84887388,84268544,618844,1.615916127489319
1747959345686361,84470684,1,915,1,84981551,84361104,620447,1.611741212383975
1747959345780645,84563244,1,916,1,85075835,84453664,622171,1.607275170330986
1747959345874838,84655804,1,917,1,85170028,84546224,623804,1.6030676302171836
1747959345968968,84748364,1,918,1,85264158,84638784,625374,1.5990431325894585
1747959346059819,84840924,1,919,1,85355009,84731344,623665,1.6034249156197637
1747959346153509,84933484,1,920,1,85448699,84823904,624795,1.6005249721908785
1747959346247531,85026044,1,921,1,85542721,84916464,626257,1.5967885388905834
1747959346341323,85118604,1,922,1,85636513,85009024,627489,1.5936534345621995
1747959346432117,85211172,1,923,1,85727307,85101592,625715,1.598171691584827
1747959346526344,85303724,1,924,1,85821534,85194144,627390,1.5939049076332106
1747959346620695,85396284,1,925,1,85915885,85286704,629181,1.589367765396603
1747959346714451,85488844,1,926,1,86009641,85379264,630377,1.5863522939447348
1747959346805334,85581404,1,927,1,86100524,85471824,628700,1.5905837442341337
1747959346899291,85673964,1,928,1,86194481,85564384,630097,1.5870572308708024
1747959346993223,85766524,1,929,1,86288413,85656944,631469,1.5836090132690601
1747959347087031,85859084,1,930,1,86382221,85749504,632717,1.5804854302950608
1747959347177614,85951644,1,931,1,86472804,85842064,630740,1.5854393252370234
1747959347271754,86044204,1,932,1,86566944,85934624,632320,1.5814777327935223
1747959347365938,86136764,1,933,1,86661128,86027184,633944,1.5774263972843028
1747959347459977,86229324,1,934,1,86755167,86119744,635423,1.5737548058537385
1747959347553642,86321884,1,935,1,86848832,86212304,636528,1.5710227986828544
1747959347644492,86414444,1,936,1,86939682,86304864,634818,1.5752546399125418
1747959347738596,86507004,1,937,1,87033786,86397424,636362,1.5714326122552886
1747959347832405,86599564,1,938,1,87127595,86489984,637611,1.5683543728072444
1747959347927312,86692124,1,939,1,87222502,86582544,639958,1.5626025457920676
1747959348016799,86784684,1,940,1,87311989,86675104,636885,1.5701421763740706
1747959348111322,86877244,1,941,1,87406512,86767664,638848,1.5653175716289323
1747959348205016,86969804,1,942,1,87500206,86860224,639982,1.5625439465484965
1747959348299149,87062364,1,943,1,87594339,86952784,641555,1.558712814957408
1747959348390246,87154924,1,944,1,87685436,87045344,640092,1.562275422907957
1747959348483662,87247484,1,945,1,87778852,87137904,640948,1.5601889700880571
1747959348578580,87340052,1,946,1,87873770,87230472,643298,1.5544895211861376
1747959348675057,87432604,1,947,1,87970247,87323024,647223,1.5450625209549105
1747959348762838,87525164,1,948,1,88058028,87415584,642444,1.5565559021486697
1747959348856949,87617724,1,949,1,88152139,87508144,643995,1.5528070870115451
1747959348950227,87710284,1,950,1,88245417,87600704,644713,1.5510777663859734
1747959349045168,87802844,1,951,1,88340358,87693264,647094,1.5453705334928156
1747959349139390,87895404,1,952,1,88434580,87785824,648756,1.5414115630529814
1747959349230018,87987964,1,953,1,88525208,87878384,646824,1.5460156085735843
1747959349323075,88080524,1,954,1,88618265,87970944,647321,1.5448286089899754
1747959349418378,88173084,1,955,1,88713568,88063504,650064,1.5383100740850133
1747959349511670,88265644,1,956,1,88806860,88156064,650796,1.5365798191752869
1747959349602718,88358204,1,957,1,88897908,88248624,649284,1.5401580818255187
1747959349696838,88450764,1,958,1,88992028,88341184,650844,1.5364664958115923
1747959349790356,88543324,1,959,1,89085546,88433744,651802,1.5342082411529883
1747959349884299,88635884,1,960,1,89179489,88526304,653185,1.5309598352687217
1747959349975151,88728444,1,961,1,89270341,88618864,651477,1.5349736061288426
1747959350069030,88821004,1,962,1,89364220,88711424,652796,1.5318721315694335
1747959350162765,88913564,1,963,1,89457955,88803984,653971,1.5291197927736857
1747959350257470,89006124,1,964,1,89552660,88896544,656116,1.5241207347481238
1747959350347585,89098684,1,965,1,89642775,88989104,653671,1.529821576909485
1747959350441251,89191244,1,966,1,89736441,89081664,654777,1.5272375175059598
1747959350536126,89283804,1,967,1,89831316,89174224,657092,1.521856908925995
1747959350630204,89376364,1,968,1,89925394,89266784,658610,1.5183492506946448
1747959350724354,89468924,1,969,1,90019544,89359344,660200,1.5146925174189638
1747959350813916,89561484,1,970,1,90109106,89451904,657202,1.5216021862380213
1747959350908704,89654044,1,971,1,90203894,89544464,659430,1.5164611861759398
1747959351002895,89746604,1,972,1,90298085,89637024,661061,1.5127197036279556
1747959351096562,89839164,1,973,1,90391752,89729584,662168,1.510190767297725
1747959351186778,89931724,1,974,1,90481968,89822144,659824,1.5155556633284029
1747959351280794,90024284,1,975,1,90575984,89914704,661280,1.5122187273167191
1747959351375077,90116844,1,976,1,90670267,90007264,663003,1.5082888011064806
1747959351469723,90209404,1,977,1,90764913,90099824,665089,1.5035581704102758
1747959351559363,90301964,1,978,1,90854553,90192384,662169,1.5101884866250157
1747959351653316,90394524,1,979,1,90948506,90284944,663562,1.5070181836814043
1747959351748162,90487084,1,980,1,91043352,90377504,665848,1.5018442647571217
1747959351843375,90579644,1,981,1,91138565,90470064,668501,1.4958840749677262
1747959351932607,90672204,1,982,1,91227797,90562624,665173,1.503368296668686
1747959352026737,90764764,1,983,1,91321927,90655184,666743,1.4998282696631235
1747959352120552,90857324,1,984,1,91415742,90747744,667998,1.497010470091228
1747959352214693,90949884,1,985,1,91509883,90840304,669579,1.493475751180966
1747959352308939,91042444,1,986,1,91604129,90932864,671265,1.489724624403179
1747959352399441,91135012,1,987,1,91694631,91025432,669199,1.4943238110039017
1747959352493665,91227564,1,988,1,91788855,91117984,670871,1.4905995340385856
1747959352587200,91320124,1,989,1,91882390,91210544,671846,1.4884363380893835
1747959352681772,91412684,1,990,1,91976962,91303104,673858,1.4839921763932462
1747959352771999,91505244,1,991,1,92067189,91395664,671525,1.4891478351513345
1747959352866055,91597804,1,992,1,92161245,91488224,673021,1.4858377376040273
1747959352959781,91690364,1,993,1,92254971,91580784,674187,1.483267995378137
1747959353054316,91782924,1,994,1,92349506,91673344,676162,1.4789355213691393
1747959353144186,91875484,1,995,1,92439376,91765904,673472,1.4848427254585195
1747959353239193,91968044,1,996,1,92534383,91858464,675919,1.4794672142667982
1747959353332884,92060604,1,997,1,92628074,91951024,677050,1.4769957905619968
1747959353427027,92153164,1,998,1,92722217,92043584,678633,1.4735505052067905
1747959353516741,92245724,1,999,1,92811931,92136144,675787,1.4797561953692508
1747959353611546,92338284,1,1000,1,92906736,92228704,678032,1.4748566439342097
1747959353706423,92431884,1,1001,1,93001613,92322304,679309,1.4720841325523435
1747959353804338,92525484,1,1002,1,93099528,92415904,683624,1.4627924122031994
1747959353898600,92619084,1,1003,1,93193790,92509504,684286,1.4613772603852777
1747959353992870,92712684,1,1004,1,93288060,92603104,684956,1.4599477922669486
1747959354086993,92806284,1,1005,1,93382183,92696704,685479,1.4588338957138003
1747959354181690,92899884,1,1006,1,93476880,92790304,686576,1.4565029945701569
1747959354275323,92993484,1,1007,1,93570513,92883904,686609,1.4564329917027012
1747959354370091,93087084,1,1008,1,93665281,92977504,687777,1.4539596409882856
1747959354463588,93180684,1,1009,1,93758778,93071104,687674,1.454177415461396
1747959354558194,93274284,1,1010,1,93853384,93164704,688680,1.4520532032293665
1747959354651990,93367884,1,1011,1,93947180,93258304,688876,1.451640062943113
1747959354745632,93461484,1,1012,1,94040822,93351904,688918,1.4515515634661889
1747959354840590,93555084,1,1013,1,94135780,93445504,690276,1.4486958839652544
1747959354947594,93648684,1,1014,1,94242784,93539104,703680,1.4211005002273762
1747959355028973,93742284,1,1015,1,94324163,93632704,691459,1.446217346220094
1747959355123726,93835884,1,1016,1,94418916,93726304,692612,1.4438098098213719
1747959355217456,93929492,1,1017,1,94512646,93819912,692734,1.443555535024988
1747959355311558,94023084,1,1018,1,94606748,93913504,693244,1.4424935520538225
1747959355405444,94116684,1,1019,1,94700634,94007104,693530,1.4418986921978862
1747959355500006,94210284,1,1020,1,94795196,94100704,694492,1.4399013955524327
1747959355594540,94303884,1,1021,1,94889730,94194304,695426,1.4379675191896766
1747959355687954,94397484,1,1022,1,94983144,94287904,695240,1.438352223692538
1747959355782598,94491084,1,1023,1,95077788,94381504,696284,1.4361955753686715
1747959355876536,94584684,1,1024,1,95171726,94475104,696622,1.4354987353256143
1747959355971303,94678284,1,1025,1,95266493,94568704,697789,1.433097970876583
1747959356065040,94771884,1,1026,1,95360230,94662304,697926,1.432816659645865
1747959356159226,94865484,1,1027,1,95454416,94755904,698512,1.4316146322468333
1747959356253686,94959084,1,1028,1,95548876,94849504,699372,1.4298542120645379
1747959356348319,95052684,1,1029,1,95643509,94943104,700405,1.4277453758896637
1747959356441645,95146284,1,1030,1,95736835,95036704,700131,1.4283041316553617
1747959356536400,95239884,1,1031,1,95831590,95130304,701286,1.4259517514965365
1747959356630491,95333484,1,1032,1,95925681,95223904,701777,1.4249540808547445
1747959356724848,95427084,1,1033,1,96020038,95317504,702534,1.4234186530473971
1747959356818811,95520684,1,1034,1,96114001,95411104,702897,1.4226835510750508
1747959356912371,95614284,1,1035,1,96207561,95504704,702857,1.4227645168220564
1747959357007227,95707884,1,1036,1,96302417,95598304,704113,1.4202265829490437
1747959357101744,95801484,1,1037,1,96396934,95691904,705030,1.418379359743557
1747959357195823,95895084,1,1038,1,96491013,95785504,705509,1.4174163618040307
1747959357290163,95988684,1,1039,1,96585353,95879104,706249,1.4159312083981712
1747959357384219,96082284,1,1040,1,96679409,95972704,706705,1.4150175815934511
1747959357478267,96175884,1,1041,1,96773457,96066304,707153,1.414121130787821
1747959357572385,96269484,1,1042,1,96867575,96159904,707671,1.4130860244379095
1747959357666516,96363084,1,1043,1,96961706,96253504,708202,1.4120265122097932
1747959357761165,96456684,1,1044,1,97056355,96347104,709251,1.409938089618485
1747959357855546,96550284,1,1045,1,97150736,96440704,710032,1.4083872276179101
1747959357949105,96643884,1,1046,1,97244295,96534304,709991,1.4084685580521443
1747959358043582,96737484,1,1047,1,97338772,96627904,710868,1.4067309261353724
1747959358137705,96831084,1,1048,1,97432895,96721504,711391,1.4056967265540328
1747959358231996,96924692,1,1049,1,97527186,96815112,712074,1.4043484244615025
1747959358326005,97018284,1,1050,1,97621195,96908704,712491,1.4035265006856228
1747959358424312,97111884,1,1051,1,97719502,97002304,717198,1.3943150984804753
1747959358518551,97205484,1,1052,1,97813741,97095904,717837,1.3930739151088618
1747959358612695,97299084,1,1053,1,97907885,97189504,718381,1.3920189982752884
1747959358706976,97392684,1,1054,1,98002166,97283104,719062,1.390700662807936
1747959358801092,97486284,1,1055,1,98096282,97376704,719578,1.3897034094983447
1747959358895266,97579884,1,1056,1,98190456,97470304,720152,1.3885957408991434
1747959358988899,97673484,1,1057,1,98284089,97563904,720185,1.3885321132764499
1747959359083812,97767084,1,1058,1,98379002,97657504,721498,1.38600522801172
1747959359177876,97860684,1,1059,1,98473066,97751104,721962,1.3851144520071694
1747959359272239,97954284,1,1060,1,98567429,97844704,722725,1.383652149849528
1747959359366296,98047884,1,1061,1,98661486,97938304,723182,1.3827777793141975
1747959359461051,98141484,1,1062,1,98756241,98031904,724337,1.3805728549004124
1747959359554742,98235084,1,1063,1,98849932,98125504,724428,1.3803994323797535
1747959359648964,98328684,1,1064,1,98944154,98219104,725050,1.379215226536101
1747959359743134,98422284,1,1065,1,99038324,98312704,725620,1.3781318045257849
1747959359837591,98515884,1,1066,1,99132781,98406304,726477,1.3765060697035143
1747959359930975,98609484,1,1067,1,99226165,98499904,726261,1.376915461521409
1747959360025628,98703084,1,1068,1,99320818,98593504,727314,1.3749219731780222
1747959360119924,98796684,1,1069,1,99415114,98687104,728010,1.3736075053914094
1747959360214058,98890284,1,1070,1,99509248,98780704,728544,1.3726006939869109
1747959360307705,98983884,1,1071,1,99602895,98874304,728591,1.3725121501638093
1747959360402523,99077484,1,1072,1,99697713,98967904,729809,1.3702215237137387
1747959360496710,99171084,1,1073,1,99791900,99061504,730396,1.369120312816609
1747959360590775,99264684,1,1074,1,99885965,99155104,730861,1.3682492293336217
1747959360685160,99358284,1,1075,1,99980350,99248704,731646,1.3667812029314723
1747959360779277,99451884,1,1076,1,100074467,99342304,732163,1.3658160819380383
1747959360873846,99545484,1,1077,1,100169036,99435904,733132,1.3640108466142522
1747959360967048,99639084,1,1078,1,100262238,99529504,732734,1.3647517380113383
1747959361061802,99732684,1,1079,1,100356992,99623104,733888,1.3626057382052847
1747959361155997,99826284,1,1080,1,100451187,99716704,734483,1.3615018999759014
1747959361249950,99919892,1,1081,1,100545140,99810312,734828,1.3608626780688813
1747959361344076,100013484,1,1082,1,100639266,99903904,735362,1.3598744563901861
1747959361442699,100108124,1,1083,1,100737889,99998544,739345,1.3525485395857144
1747959361536650,100202764,1,1084,1,100831840,100093184,738656,1.3538101633236581
1747959361631369,100297404,1,1085,1,100926559,100187824,738735,1.3536653874528755
1747959361729516,100392044,1,1086,1,101024706,100282464,742242,1.3472694889267922
1747959361823661,100486684,1,1087,1,101118851,100377104,741747,1.3481685803919665
1747959361916947,100581324,1,1088,1,101212137,100471744,740393,1.3506340551571936
1747959362012079,100675964,1,1089,1,101307269,100566384,740885,1.3497371386922397
1747959362109593,100770604,1,1090,1,101404783,100661024,743759,1.3445215452855026
1747959362203886,100865244,1,1091,1,101499076,100755664,743412,1.3451491232318016
1747959362298338,100959884,1,1092,1,101593528,100850304,743224,1.345489381397802
1747959362393300,101054524,1,1093,1,101688490,100944944,743546,1.3449067038219558
1747959362491177,101149164,1,1094,1,101786367,101039584,746783,1.3390770812940305
1747959362584667,101243804,1,1095,1,101879857,101134224,745633,1.3411423582378998
1747959362679129,101338444,1,1096,1,101974319,101228864,745455,1.3414625966691485
1747959362777825,101433084,1,1097,1,102073015,101323504,749511,1.3342032338417982
1747959362871465,101527724,1,1098,1,102166655,101418144,748511,1.3359857102968427
1747959362965963,101622364,1,1099,1,102261153,101512784,748369,1.336239208198095
1747959363059803,101717012,1,1100,1,102354993,101607432,747561,1.3376834800103268
1747959363158641,101811644,1,1101,1,102453831,101702064,751767,1.3301993835856056
1747959363253068,101906284,1,1102,1,102548258,101796704,751554,1.330576379075888
1747959363346647,102000924,1,1103,1,102641837,101891344,750493,1.3324574646265854
1747959363441567,102095564,1,1104,1,102736757,101985984,750773,1.3319605260178509
1747959363539000,102190204,1,1105,1,102834190,102080624,753566,1.3270237776120473
1747959363633536,102284844,1,1106,1,102928726,102175264,753462,1.3272069460702731
1747959363728479,102379484,1,1107,1,103023669,102269904,753765,1.3266734327011733
1747959363826482,102474124,1,1108,1,103121672,102364544,757128,1.3207806341860293
1747959363920253,102568764,1,1109,1,103215443,102459184,756259,1.322298313144042
1747959364014866,102663404,1,1110,1,103310056,102553824,756232,1.3223455235959336
1747959364108816,102758044,1,1111,1,103404006,102648464,755542,1.3235531578654793
1747959364206765,102852684,1,1112,1,103501955,102743104,758851,1.3177817516218597
1747959364301432,102947324,1,1113,1,103596622,102837744,758878,1.317734866473926
1747959364396119,103041964,1,1114,1,103691309,102932384,758925,1.3176532595447508
1747959364494131,103136604,1,1115,1,103789321,103027024,762297,1.3118246562691445
1747959364589038,103231244,1,1116,1,103884228,103121664,762564,1.3113653411385797
1747959364682373,103325884,1,1117,1,103977563,103216304,761259,1.3136133694314287
1747959364776583,103420524,1,1118,1,104071773,103310944,760829,1.314355788225738
1747959364875453,103515172,1,1119,1,104170643,103405592,765051,1.3071024023235052
1747959364969385,103609804,1,1120,1,104264575,103500224,764351,1.3082994592798334
1747959365062994,103704444,1,1121,1,104358184,103594864,763320,1.31006655138081
1747959365157667,103799084,1,1122,1,104452857,103689504,763353,1.31000991677507
1747959365255644,103893724,1,1123,1,104550834,103784144,766690,1.3043081297525727
1747959365349906,103988364,1,1124,1,104645096,103878784,766312,1.3049515080019627
1747959365444575,104083004,1,1125,1,104739765,103973424,766341,1.3049021258160531
1747959365542979,104177644,1,1126,1,104838169,104068064,770105,1.2985242272157693
1747959365636228,104272284,1,1127,1,104931418,104162704,768714,1.3008739271042287
1747959365731126,104366924,1,1128,1,105026316,104257344,768972,1.300437467163954
1747959365824835,104461564,1,1129,1,105120025,104351984,768041,1.3020138247827915
1747959365923017,104556204,1,1130,1,105218207,104446624,771583,1.2960368489196885
1747959366017841,104650844,1,1131,1,105313031,104541264,771767,1.2957278556870144
1747959366111419,104745484,1,1132,1,105406609,104635904,770705,1.2975133157304026
1747959366205573,104840124,1,1133,1,105500763,104730544,770219,1.2983320328374137
1747959366304077,104934764,1,1134,1,105599267,104825184,774083,1.291851132242925
1747959366398297,105029404,1,1135,1,105693487,104919824,773663,1.2925524420839565
1747959366492706,105124044,1,1136,1,105787896,105014464,773432,1.292938487158535
1747959366591119,105218684,1,1137,1,105886309,105109104,777205,1.286661820240477
1747959366685121,105313324,1,1138,1,105980311,105203744,776567,1.2877188961158534
1747959366779380,105407964,1,1139,1,106074570,105298384,776186,1.2883509880363726
1747959366873355,105502604,1,1140,1,106168545,105393024,775521,1.2894557336293924
1747959366971623,105597244,1,1141,1,106266813,105487664,779149,1.283451560612925
1747959367065686,105691884,1,1142,1,106360876,105582304,778572,1.28440272704387
1747959367160384,105786524,1,1143,1,106455574,105676944,778630,1.2843070521300233
1747959367258326,105881164,1,1144,1,106553516,105771584,781932,1.2788835857849532
1747959367352632,105975804,1,1145,1,106647822,105866224,781598,1.2794300906604161
1747959367446328,106070444,1,1146,1,106741518,105960864,780654,1.28097723191068
1747959367540371,106165084,1,1147,1,106835561,106055504,780057,1.2819576005343198
1747959367638700,106259724,1,1148,1,106933890,106150144,783746,1.275923577281415
1747959367733981,106354364,1,1149,1,107029171,106244784,784387,1.2748808942524545
1747959367827894,106449004,1,1150,1,107123084,106339424,783660,1.2760635990097746
1747959367921333,106543644,1,1151,1,107216523,106434064,782459,1.278022235030845
1747959368019689,106638284,1,1152,1,107314879,106528704,786175,1.2719814290711355
1747959368114533,106732924,1,1153,1,107409723,106623344,786379,1.2716514555958385
1747959368208594,106827564,1,1154,1,107503784,106717984,785800,1.2725884448969202
1747959368306452,106922204,1,1155,1,107601642,106812624,789018,1.2673982089128513
1747959368400749,107016844,1,1156,1,107695939,106907264,788675,1.267949408818588
1747959368495632,107111484,1,1157,1,107790822,107001904,788918,1.2675588590956222
1747959368589296,107206124,1,1158,1,107884486,107096544,787942,1.2691289460391755
1747959368687281,107300764,1,1159,1,107982471,107191184,791287,1.2637639693309761
1747959368782089,107395404,1,1160,1,108077279,107285824,791455,1.2634957135907916
1747959368876666,107490044,1,1161,1,108171856,107380464,791392,1.2635962961465368
1747959368974712,107584684,1,1162,1,108269902,107475104,794798,1.2581813240596982
1747959369068962,107679324,1,1163,1,108364152,107569744,794408,1.2587990050452664
1747959369163271,107773972,1,1164,1,108458461,107664392,794069,1.2593364052746046
1747959369256831,107868604,1,1165,1,108552021,107759024,792997,1.2610388185579517
1747959369354956,107963244,1,1166,1,108650146,107853664,796482,1.2555211542759284
1747959369449964,108057884,1,1167,1,108745154,107948304,796850,1.2549413314927529
1747959369544039,108152524,1,1168,1,108839229,108042944,796285,1.2558317687762548
1747959369638244,108247164,1,1169,1,108933434,108137584,795850,1.2565181881007728
1747959369737136,108341804,1,1170,1,109032326,108232224,800102,1.249840645317722
1747959369831100,108436444,1,1171,1,109126290,108326864,799426,1.250897518969861
1747959369925309,108531084,1,1172,1,109220499,108421504,798995,1.251572287686406
1747959370023470,108625724,1,1173,1,109318660,108516144,802516,1.246081075019065
1747959370117798,108720364,1,1174,1,109412988,108610784,802204,1.246565711464914
1747959370211964,108815004,1,1175,1,109507154,108705424,801730,1.2473027078941787
1747959370305951,108909644,1,1176,1,109601141,108800064,801077,1.2483194499405175
1747959370404278,109004284,1,1177,1,109699468,108894704,804764,1.24260031512344
1747959370498098,109098924,1,1178,1,109793288,108989344,803944,1.2438677320808416
1747959370592876,109193564,1,1179,1,109888066,109083984,804082,1.2436542541681073
1747959370686332,109288204,1,1180,1,109981522,109178624,802898,1.2454882189269372
1747959370785159,109382844,1,1181,1,110080349,109273264,807085,1.2390268682976389
1747959370879668,109477484,1,1182,1,110174858,109367904,806954,1.2392280105185673
1747959370973074,109572132,1,1183,1,110268264,109462552,805712,1.2411382727326887
1747959371071768,109666764,1,1184,1,110366958,109557184,809774,1.2349124570559193
1747959371165315,109761404,1,1185,1,110460505,109651824,808681,1.2365815445150807
1747959371260144,109856044,1,1186,1,110555334,109746464,808870,1.2362926057339252
1747959371354306,109950684,1,1187,1,110649496,109841104,808392,1.2370236222030897
1747959371452437,110045324,1,1188,1,110747627,109935744,811883,1.2317045682690733
1747959371546675,110139964,1,1189,1,110841865,110030384,811481,1.2323147430438914
1747959371641295,110234604,1,1190,1,110936485,110125024,811461,1.2323451157849854
1747959371739568,110329244,1,1191,1,111034758,110219664,815094,1.2268523630403365
1747959371833788,110423884,1,1192,1,111128978,110314304,814674,1.2274848589742646
1747959371927814,110518524,1,1193,1,111223004,110408944,814060,1.2284106822592928
1747959372022135,110613164,1,1194,1,111317325,110503584,813741,1.2288922396683957
1747959372120417,110707804,1,1195,1,111415607,110598224,817383,1.2234166847120629
1747959372214261,110802444,1,1196,1,111509451,110692864,816587,1.2246092578010672
1747959372308740,110897084,1,1197,1,111603930,110787504,816426,1.2248507519358767
1747959372403059,110991724,1,1198,1,111698249,110882144,816105,1.225332524613867
1747959372501270,111086364,1,1199,1,111796460,110976784,819676,1.2199942416271796
1747959372595122,111181004,1,1200,1,111890312,111071424,818888,1.2211682183644161
1747959372689010,111275644,1,1201,1,111984200,111166064,818136,1.2222906704997702
1747959372787785,111370284,1,1202,1,112082975,111260704,822271,1.2161440692910246
1747959372882004,111464924,1,1203,1,112177194,111355344,821850,1.2167670499482874
1747959372976477,111559564,1,1204,1,112271667,111449984,821683,1.2170143473821413
1747959373070625,111654204,1,1205,1,112365815,111544624,821191,1.2177434969452905
1747959373168281,111748844,1,1206,1,112463471,111639264,824207,1.2132874387138182
1747959373262708,111843484,1,1207,1,112557898,111733904,823994,1.2136010699107032
1747959373356694,111938124,1,1208,1,112651884,111828544,823340,1.214565064250492
1747959373451435,112032764,1,1209,1,112746625,111923184,823441,1.214416090527433
1747959373549251,112127404,1,1210,1,112844441,112017824,826617,1.209750101921446
1747959373644069,112222044,1,1211,1,112939259,112112464,826795,1.2094896558397186
1747959373738422,112316684,1,1212,1,113033612,112207104,826508,1.2099096439477899
1747959373835528,112411324,1,1213,1,113130718,112301744,828974,1.2063104512324874
1747959373930862,112505964,1,1214,1,113226052,112396384,829668,1.2053013976675009
1747959374024927,112600604,1,1215,1,113320117,112491024,829093,1.2061373090835408
1747959374118794,112695244,1,1216,1,113413984,112585664,828320,1.2072628935677034
1747959374216961,112789884,1,1217,1,113512151,112680304,831847,1.2021441442957659
1747959374311576,112884524,1,1218,1,113606766,112774944,831822,1.2021802741451897
1747959374405347,112979164,1,1219,1,113700537,112869584,830953,1.2034374988717773
1747959374503559,113073804,1,1220,1,113798749,112964224,834525,1.1982864503759625
1747959374597721,113168444,1,1221,1,113892911,113058864,834047,1.198973199352075
1747959374692281,113263084,1,1222,1,113987471,113153504,833967,1.1990882133225895
1747959374786421,113357724,1,1223,1,114081611,113248144,833467,1.1998075508688406
1747959374884930,113452364,1,1224,1,114180120,113342784,837336,1.1942637125359474
1747959374979391,113547004,1,1225,1,114274581,113437424,837157,1.1945190687051532
1747959375073190,113641644,1,1226,1,114368380,113532064,836316,1.1957202779810503
1747959375166949,113736284,1,1227,1,114462139,113626704,835435,1.1969812133798559
1747959375265849,113830932,1,1228,1,114561039,113721352,839687,1.1909199499337253
1747959375359651,113925564,1,1229,1,114654841,113815984,838857,1.1920982956570667
1747959375453592,114020204,1,1230,1,114748782,113910624,838158,1.1930924718251212
1747959375551850,114114844,1,1231,1,114847040,114005264,841776,1.1879644941171998
1747959375647617,114209484,1,1232,1,114942807,114099904,842903,1.186376131061344
1747959375740371,114304124,1,1233,1,115035561,114194544,841017,1.1890366068700158
1747959375835441,114398764,1,1234,1,115130631,114289184,841447,1.1884289800783652
1747959375933464,114493404,1,1235,1,115228654,114383824,844830,1.1836700874732196
1747959376027657,114588044,1,1236,1,115322847,114478464,844383,1.1842966994835282
1747959376122018,114682684,1,1237,1,115417208,114573104,844104,1.1846881426933176
1747959376215863,114777324,1,1238,1,115511053,114667744,843309,1.1858049659140364
1747959376314078,114871964,1,1239,1,115609268,114762384,846884,1.1807992594027046
1747959376408609,114966604,1,1240,1,115703799,114857024,846775,1.1809512562368987
1747959376502442,115061244,1,1241,1,115797632,114951664,845968,1.1820778090897055
1747959376601073,115155884,1,1242,1,115896263,115046304,849959,1.1765273383774981
1747959376695325,115250524,1,1243,1,115990515,115140944,849571,1.177064659692951
1747959376792129,115345164,1,1244,1,116087319,115235584,851735,1.1740740958161868
1747959376883063,115439804,1,1245,1,116178253,115330224,848029,1.1792049564342728
1747959376982067,115534444,1,1246,1,116277257,115424864,852393,1.1731677758967989
1747959377076176,115629092,1,1247,1,116371366,115519512,851854,1.1739100831832685
1747959377169882,115723724,1,1248,1,116465072,115614144,850928,1.1751875599345656
1747959377268300,115818364,1,1249,1,116563490,115708784,854706,1.169992956642401
1747959377362890,115913004,1,1250,1,116658080,115803424,854656,1.170061404822525
1747959377456551,116007644,1,1251,1,116751741,115898064,853677,1.1714032356500175
1747959377551350,116102284,1,1252,1,116846540,115992704,853836,1.1711850987777512
1747959377649600,116196924,1,1253,1,116944790,116087344,857446,1.1662542014307606
1747959377743688,116291564,1,1254,1,117038878,116181984,856894,1.167005487259801
1747959377837880,116386204,1,1255,1,117133070,116276624,856446,1.1676159384246059
1747959377931057,116480844,1,1256,1,117226247,116371264,854983,1.1696138987558817
1747959378030374,116575484,1,1257,1,117325564,116465904,859660,1.1632505874415466
1747959378124764,116670124,1,1258,1,117419954,116560544,859410,1.163588973830884
1747959378218736,116764764,1,1259,1,117513926,116655184,858742,1.1644941088243035
1747959378317044,116859404,1,1260,1,117612234,116749824,862410,1.1595412854674692
1747959378411478,116954044,1,1261,1,117706668,116844464,862204,1.1598183260574064
1747959378505151,117048684,1,1262,1,117800341,116939104,861237,1.1611205742437911
1747959378599973,117143324,1,1263,1,117895163,117033744,861419,1.1608752535061335
1747959378697828,117237964,1,1264,1,117993018,117128384,864634,1.1565587288956947
1747959378791465,117332604,1,1265,1,118086655,117223024,863631,1.1579019280225002
1747959378886338,117427244,1,1266,1,118181528,117317664,863864,1.157589620588426
1747959378983887,117521884,1,1267,1,118279077,117412304,866773,1.153704603165996
1747959379078842,117616524,1,1268,1,118374032,117506944,867088,1.1532854796744967
1747959379172797,117711164,1,1269,1,118467987,117601584,866403,1.1541972961774138
1747959379267038,117805804,1,1270,1,118562228,117696224,866004,1.1547290774638455
1747959379365264,117900444,1,1271,1,118660454,117790864,869590,1.149967225934061
1747959379459937,117995084,1,1272,1,118755127,117885504,869623,1.1499235875776055
1747959379553461,118089724,1,1273,1,118848651,117980144,868507,1.1514011976875258
1747959379647480,118184364,1,1274,1,118942670,118074784,867886,1.1522250618168746
1747959379746894,118279004,1,1275,1,119042084,118169424,872660,1.1459216647949946
1747959379840114,118373644,1,1276,1,119135304,118264064,871240,1.1477893576970755
1747959379934457,118468284,1,1277,1,119229647,118358704,870943,1.1481807649869165
1747959380032612,118562924,1,1278,1,119327802,118453344,874458,1.1435655000011435
1747959380126997,118657564,1,1279,1,119422187,118547984,874203,1.1438990714971238
1747959380221039,118752204,1,1280,1,119516229,118642624,873605,1.1446820931656756
1747959380314620,118846844,1,1281,1,119609810,118737264,872546,1.1460713819099508
1747959380413439,118941484,1,1282,1,119708629,118831904,876725,1.1406085146425617
1747959380507981,119036124,1,1283,1,119803171,118926544,876627,1.140736025698501
1747959380602253,119130764,1,1284,1,119897443,119021184,876259,1.141215097362766
1747959380696035,119225404,1,1285,1,119991225,119115824,875401,1.1423336276746314
1747959380794898,119320044,1,1286,1,120090088,119210464,879624,1.136849381099197
1747959380890784,119414684,1,1287,1,120185974,119305104,880870,1.1352412955373665
1747959380982843,119509324,1,1288,1,120278033,119399744,878289,1.1385773930904293
1747959381080408,119603964,1,1289,1,120375598,119494384,881214,1.134798130760519
1747959381175339,119698604,1,1290,1,120470529,119589024,881505,1.1344235143306052
1747959381270059,119793244,1,1291,1,120565249,119683664,881585,1.1343205703363828
1747959381364280,119887892,1,1292,1,120659470,119778312,881158,1.134870250284285
1747959381461784,119982524,1,1293,1,120756974,119872944,884030,1.1311833308824362
1747959381556614,120077164,1,1294,1,120851804,119967584,884220,1.1309402637352695
1747959381650176,120171804,1,1295,1,120945366,120062224,883142,1.1323207366425785
1747959381748273,120266444,1,1296,1,121043463,120156864,886599,1.1279056258804714
1747959381843278,120361084,1,1297,1,121138468,120251504,886964,1.127441474513058
1747959381936736,120455724,1,1298,1,121231926,120346144,885782,1.1289459483258861
1747959382031358,120550364,1,1299,1,121326548,120440784,885764,1.1289688901332635
1747959382129505,120645004,1,1300,1,121424695,120535424,889271,1.124516598427251
1747959382223950,120739644,1,1301,1,121519140,120630064,889076,1.1247632373385403
1747959382318284,120834284,1,1302,1,121613474,120724704,888770,1.1251504888778874
1747959382412399,120928924,1,1303,1,121707589,120819344,888245,1.1258155126119482
1747959382511068,121023564,1,1304,1,121806258,120913984,892274,1.1207319724658569
1747959382605310,121118204,1,1305,1,121900500,121008624,891876,1.121232099529531
1747959382698691,121212844,1,1306,1,121993881,121103264,890617,1.1228171031992429
1747959382797729,121307484,1,1307,1,122092919,121197904,895015,1.1172997100607251
1747959382891361,121402124,1,1308,1,122186551,121292544,894007,1.118559474366532
1747959382985794,121496764,1,1309,1,122280984,121387184,893800,1.1188185276348175
