Tempo total receptor,Tempo total emissor,Id do pacote,Id da mensagem,Distancia (m),Tempo zerado receptor,Tempo zerado emissor,Delta tempo,Velocidade (m/s)
1747959853523422,109580,1,1,100,0,0,0,0
1747959853613466,197404,1,2,100,90044,87824,2220,45045.045045045044
1747959853700505,285804,1,3,100,177083,176224,859,116414.43538998837
1747959853790032,374204,1,4,100,266610,264624,1986,50352.467270896275
1747959853880030,462604,1,5,100,356608,353024,3584,27901.785714285714
1747959853970270,551004,1,6,100,446848,441424,5424,18436.578171091445
1747959854056793,639404,1,7,100,533371,529824,3547,28192.839018889204
1747959854146277,727804,1,8,100,622855,618224,4631,21593.608291945584
1747959854236713,816204,1,9,100,713291,706624,6667,14999.250037498125
1747959854326925,904604,1,10,100,803503,795024,8479,11793.843613633682
1747959854417025,994044,1,11,100,893603,884464,9139,10942.1162052741
1747959854507272,1083484,1,12,100,983850,973904,9946,10054.293183189222
1747959854597347,1173964,1,13,100,1073925,1064384,9541,10481.081647626035
1747959854691338,1264444,1,14,100,1167916,1154864,13052,7661.661048115232
1747959854781419,1354924,1,15,100,1257997,1245344,12653,7903.264048051846
1747959854871168,1445404,1,16,100,1347746,1335824,11922,8387.854386847845
1747959854961209,1535884,1,17,100,1437787,1426304,11483,8708.52564660803
1747959855055667,1626364,1,18,100,1532245,1516784,15461,6467.886941336265
1747959855146116,1716844,1,19,100,1622694,1607264,15430,6480.881399870383
1747959855236319,1807324,1,20,100,1712897,1697744,15153,6599.353263380189
1747959855326554,1897804,1,21,100,1803132,1788224,14908,6707.807888382077
1747959855420198,1988284,1,22,100,1896776,1878704,18072,5533.421868083222
1747959855510627,2078764,1,23,100,1987205,1969184,18021,5549.081626990734
1747959855600885,2169244,1,24,100,2077463,2059664,17799,5618.293162537221
1747959855690874,2259724,1,25,100,2167452,2150144,17308,5777.675063554426
1747959855784993,2350204,1,26,100,2261571,2240624,20947,4773.953310736621
1747959855875214,2440684,1,27,100,2351792,2331104,20688,4833.720030935808
1747959855965267,2531164,1,28,100,2441845,2421584,20261,4935.590543408519
1747959856055900,2621644,1,29,100,2532478,2512064,20414,4898.599000685804
1747959856149692,2712124,1,30,100,2626270,2602544,23726,4214.785467419708
1747959856240168,2802604,1,31,100,2716746,2693024,23722,4215.4961638984905
1747959856330299,2893084,1,32,100,2806877,2783504,23373,4278.440936122876
1747959856419937,2983564,1,33,100,2896515,2873984,22531,4438.329412809019
1747959856513946,3074044,1,34,100,2990524,2964464,26060,3837.2985418265544
1747959856604464,3164524,1,35,100,3081042,3054944,26098,3831.711242240785
1747959856694195,3255004,1,36,100,3170773,3145424,25349,3944.928794035268
1747959856784382,3345484,1,37,100,3260960,3235904,25056,3991.0600255427844
1747959856878071,3435964,1,38,100,3354649,3326384,28265,3537.944454272068
1747959856968040,3526444,1,39,100,3444618,3416864,27754,3603.0842401095338
1747959857059093,3616924,1,40,100,3535671,3507344,28327,3530.2008684294133
1747959857148913,3707404,1,41,100,3625491,3597824,27667,3614.414284165251
1747959857243068,3797884,1,42,100,3719646,3688304,31342,3190.606853423521
1747959857333239,3888364,1,43,100,3809817,3778784,31033,3222.376180195276
1747959857422753,3978844,1,44,100,3899331,3869264,30067,3325.905477766322
1747959857513374,4069324,1,45,100,3989952,3959744,30208,3310.3813559322034
1747959857606925,4159804,1,46,100,4083503,4050224,33279,3004.8979837134525
1747959857697785,4250284,1,47,100,4174363,4140704,33659,2970.973588044802
1747959857791867,4340772,1,48,100,4268445,4231192,37253,2684.347569323276
1747959857878469,4431244,1,49,100,4355047,4321664,33383,2995.536650390917
1747959857971712,4521724,1,50,100,4448290,4412144,36146,2766.557848724617
1747959858061513,4612204,1,51,100,4538091,4502624,35467,2819.522372910029
1747959858156177,4702684,1,52,100,4632755,4593104,39651,2522.004489167991
1747959858242336,4793164,1,53,100,4718914,4683584,35330,2830.455703368242
1747959858336547,4883644,1,54,100,4813125,4774064,39061,2560.098307775019
1747959858426366,4974124,1,55,100,4902944,4864544,38400,2604.166666666667
1747959858516966,5064604,1,56,100,4993544,4955024,38520,2596.053997923157
1747959858611076,5155084,1,57,100,5087654,5045504,42150,2372.479240806643
1747959858701286,5245564,1,58,100,5177864,5135984,41880,2387.774594078319
1747959858790838,5336044,1,59,100,5267416,5226464,40952,2441.883180308654
1747959858880862,5426524,1,60,100,5357440,5316944,40496,2469.379691821415
1747959858971893,5517004,1,61,100,5448471,5407424,41047,2436.231636904037
1747959859065097,5607484,1,62,100,5541675,5497904,43771,2284.617669233054
1747959859160067,5697964,1,63,100,5636645,5588384,48261,2072.0664718924186
1747959859245875,5788444,1,64,100,5722453,5678864,43589,2294.1567826745277
1747959859335958,5878924,1,65,100,5812536,5769344,43192,2315.243563622893
1747959859430587,5969404,1,66,100,5907165,5859824,47341,2112.3339177457174
1747959859519793,6059884,1,67,100,5996371,5950304,46067,2170.7512970239
1747959859610320,6150364,1,68,100,6086898,6040784,46114,2168.538838530598
1747959859704759,6240844,1,69,100,6181337,6131264,50073,1997.0842569848023
1747959859794663,6331324,1,70,100,6271241,6221744,49497,2020.324464108936
1747959859889210,6421804,1,71,100,6365788,6312224,53564,1866.9255470091853
1747959859974903,6512284,1,72,100,6451481,6402704,48777,2050.1465854808616
1747959860068909,6602772,1,73,100,6545487,6493192,52295,1912.2287025528253
1747959860163452,6693244,1,74,100,6640030,6583664,56366,1774.1191498421035
1747959860252735,6783724,1,75,100,6729313,6674144,55169,1812.6121553771138
1747959860342818,6874204,1,76,100,6819396,6764624,54772,1825.7503834075806
1747959860433660,6964684,1,77,100,6910238,6855104,55134,1813.762832372039
1747959860523736,7055164,1,78,100,7000314,6945584,54730,1827.151470856934
1747959860724969,7239244,1,80,100,7201547,7129664,71883,1391.1495068374998
1747959860798347,7329724,1,81,100,7274925,7220144,54781,1825.450429893576
1747959860990653,7513804,1,83,100,7467231,7404224,63007,1587.1252400526928
1747959861101210,7607404,1,84,100,7577788,7497824,79964,1250.5627532389576
1747959861178369,7697884,1,85,100,7654947,7588304,66643,1500.5326891046323
1747959861260831,7788364,1,86,100,7737409,7678784,58625,1705.7569296375268
1747959861350474,7878844,1,87,100,7827052,7769264,57788,1730.4630719180452
1747959861445346,7969324,1,88,100,7921924,7859744,62180,1608.2341588935349
1747959861539552,8059804,1,89,100,8016130,7950224,65906,1517.3125360361726
1747959861625527,8150284,1,90,100,8102105,8040704,61401,1628.6379700656341
1747959861732023,8240764,1,91,100,8208601,8131184,77417,1291.7059560561634
1747959861817143,8331244,1,92,100,8293721,8221664,72057,1387.7902216300984
1747959861898908,8421724,1,93,100,8375486,8312144,63342,1578.731331502005
1747959861990120,8512204,1,94,100,8466698,8402624,64074,1560.6954458906887
1747959862084223,8602684,1,95,100,8560801,8493104,67697,1477.170332511042
1747959862173509,8693164,1,96,100,8650087,8583584,66503,1503.691562786641
1747959862264191,8783644,1,97,100,8740769,8674064,66705,1499.1379956524997
1747959862362579,8874124,1,98,100,8839157,8764544,74613,1340.2490182675942
1747959862448543,8964604,1,99,100,8925121,8855024,70097,1426.5945760874215
1747959862538785,9055084,1,100,100,9015363,8945504,69859,1431.4547875005367
1747959862641304,9146604,1,101,100,9117882,9037024,80858,1236.7360063320884
1747959862722225,9238124,1,102,100,9198803,9128544,70259,1423.3051993338931
1747959862812640,9329644,1,103,100,9289218,9220064,69154,1446.0479509500537
1747959862907455,9421164,1,104,100,9384033,9311584,72449,1380.281301329211
1747959862996994,9512684,1,105,100,9473572,9403104,70468,1419.083839473236
1747959863090985,9604204,1,106,100,9567563,9494624,72939,1371.008651064588
1747959863185510,9695724,1,107,100,9662088,9586144,75944,1316.7597176867166
1747959864254893,10740924,1,118,100,10731471,10631344,100127,998.7316108542152
1747959864357420,10836604,1,119,100,10833998,10727024,106974,934.8065885168359
1747959864431168,10929172,1,120,100,10907746,10819592,88154,1134.3784740340768
1747959864529401,11021724,1,121,100,11005979,10912144,93835,1065.7004316086748
1747959864620000,11114284,1,122,100,11096578,11004704,91874,1088.4472211942443
1747959865606174,12071084,1,132,100,12082752,11961504,121248,824.7558722618105
1747959865672090,12163644,1,133,100,12148668,12054064,94604,1057.037757388694
1747959865762498,12256204,1,134,100,12239076,12146624,92452,1081.6423657681823
1747959865856157,12348764,1,135,100,12332735,12239184,93551,1068.9356607625787
1747959865949813,12441324,1,136,100,12426391,12331744,94647,1056.5575242744092
1747959866057063,12537004,1,137,100,12533641,12427424,106217,941.4688797461799
1747959866155211,12629564,1,138,100,12631789,12519984,111805,894.4143821832655
1747959866232958,12722124,1,139,100,12709536,12612544,96992,1031.0128670405807
1747959866327504,12814684,1,140,100,12804082,12705104,98978,1010.3255268847623
1747959866421015,12907244,1,141,100,12897593,12797664,99929,1000.7105044581652
1747959866810116,13286844,1,145,100,13286694,13177264,109430,913.8261902586128
1747959866900102,13379404,1,146,100,13376680,13269824,106856,935.8388859773901
1747959866990739,13471964,1,147,100,13467317,13362384,104933,952.9890501558137
1747959867084018,13564524,1,148,100,13560596,13454944,105652,946.5036156438118
1747959867175302,13657084,1,149,100,13651880,13547504,104376,958.0746531769756
1747959867269921,13749644,1,150,100,13746499,13640064,106435,939.5405646638793
1747959867363674,13842204,1,151,100,13840252,13732624,107628,929.1262496748058
1747959867457821,13934764,1,152,100,13934399,13825184,109215,915.6251430664286
1747959867552366,14027324,1,153,100,14028944,13917744,111200,899.2805755395684
1747959867642481,14119884,1,154,100,14119059,14010304,108755,919.497954117052
1747959867735978,14212444,1,155,100,14212556,14102864,109692,911.6435109214892
1747959867826310,14305004,1,156,100,14302888,14195424,107464,930.5441822377726
1747959867924556,14397564,1,157,100,14401134,14287984,113150,883.7825894829872
1747959868014539,14490124,1,158,100,14491117,14380544,110573,904.3799119133965
1747959868108389,14582684,1,159,100,14584967,14473104,111863,893.9506360458776
1747959868198336,14675244,1,160,100,14674914,14565664,109250,915.3318077803203
1747959868296534,14767804,1,161,100,14773112,14658224,114888,870.4129238910939
1747959868390968,14860364,1,162,100,14867546,14750784,116762,856.4430208458231
1747959868489773,14952924,1,163,100,14966351,14843344,123007,812.9618639589617
1747959868583795,15045484,1,164,100,15060373,14935904,124469,803.4128979906644
1747959868674193,15138044,1,165,100,15150771,15028464,122307,817.6146909007662
1747959868874288,15326284,1,167,100,15350866,15216704,134162,745.3675407343361
1747959868977317,15418844,1,168,100,15453895,15309264,144631,691.4147036250872
1747959869042861,15511404,1,169,100,15519439,15401824,117615,850.2316881350168
1747959869136696,15603964,1,170,100,15613274,15494384,118890,841.1136344520145
1747959869349848,15792204,1,172,100,15826426,15682624,143802,695.4006202973533
1747959869534000,15983564,1,174,100,16010578,15873984,136594,732.0965781805936
1747959869611439,16076124,1,175,100,16088017,15966544,121473,823.2282070912878
1747959869723059,16171804,1,176,100,16199637,16062224,137413,727.7331839054528
1747959870001216,16458844,1,179,100,16477794,16349264,128530,778.0284758422158
1747959870119873,16551404,1,180,100,16596451,16441824,154627,646.717584897851
1747959870189692,16647084,1,181,100,16666270,16537504,128766,776.6025192985727
1747959870582359,17026684,1,185,100,17058937,16917104,141833,705.0545359683572
1747959870676168,17119252,1,186,100,17152746,17009672,143074,698.9390105819366
1747959870762999,17214924,1,187,100,17239577,17105344,134233,744.9732927074565
1747959870882092,17307484,1,188,100,17358670,17197904,160766,622.0220693430203
1747959871238377,17687084,1,192,100,17714955,17577504,137451,727.5319932194019
1747959871426257,17878444,1,194,100,17902835,17768864,133971,746.4301975800732
1747959871549011,17971004,1,195,100,18025589,17861424,164165,609.1432400328937
1747959871709610,18159244,1,197,100,18186188,18049664,136524,732.4719463244558
1747959871823422,18254924,1,198,100,18300000,18145344,154656,646.5963169873785
1747959871917511,18347484,1,199,100,18394089,18237904,156185,640.2663508019336
1747959871995783,18443164,1,200,100,18472361,18333584,138777,720.5804996505184
1747959872094212,18535724,1,201,100,18570790,18426144,144646,691.3430029174675
1747959872184125,18628284,1,202,100,18660703,18518704,141999,704.2303114810668
1747959872285764,18720844,1,203,100,18762342,18611264,151078,661.9097419875826
1747959872384948,18816524,1,204,100,18861526,18706944,154582,646.9058493226896
1747959872471079,18912204,1,205,100,18947657,18802624,145033,689.4982521219309
1747959872560685,19004764,1,206,100,19037263,18895184,142079,703.8337826138978
1747959872654668,19097324,1,207,100,19131246,18987744,143502,696.8543992418224
1747959872748946,19189884,1,208,100,19225524,19080304,145220,688.6103842445945
1747959872842633,19282444,1,209,100,19319211,19172864,146347,683.3074815336153
1747959872933534,19375004,1,210,100,19410112,19265424,144688,691.1423200265398
1747959873027867,19467564,1,211,100,19504445,19357984,146461,682.7756194481807
1747959873125018,19560124,1,212,100,19601596,19450544,151052,662.0236739665811
1747959873215614,19652684,1,213,100,19692192,19543104,149088,670.7447950203906
1747959873306424,19745244,1,214,100,19783002,19635664,147338,678.7115340238092
1747959873400615,19837804,1,215,100,19877193,19728224,148969,671.280602004444
1747959873494325,19930364,1,216,100,19970903,19820784,150119,666.1381970303559
1747959873588932,20022924,1,217,100,20065510,19913344,152166,657.1770303484353
1747959873678460,20115492,1,218,100,20155038,20005912,149126,670.5738771240427
1747959873773578,20208044,1,219,100,20250156,20098464,151692,659.2305461065844
1747959873867294,20300604,1,220,100,20343872,20191024,152848,654.2447398722913
1747959873961831,20393164,1,221,100,20438409,20283584,154825,645.8905215565962
1747959874055707,20485724,1,222,100,20532285,20376144,156141,640.4467756707079
1747959874145414,20578284,1,223,100,20621992,20468704,153288,652.3667867021554
1747959874240493,20670844,1,224,100,20717071,20561264,155807,641.8196871770845
1747959874334468,20763404,1,225,100,20811046,20653824,157222,636.0433018279884
1747959874428674,20855964,1,226,100,20905252,20746384,158868,629.4533826824785
1747959874519426,20948524,1,227,100,20996004,20838944,157060,636.6993505666624
1747959874612922,21041084,1,228,100,21089500,20931504,157996,632.9274158839464
1747959874706703,21133644,1,229,100,21183281,21024064,159217,628.0736353530089
1747959874800706,21226204,1,230,100,21277284,21116624,160660,622.4324660774306
1747959874895306,21318764,1,231,100,21371884,21209184,162700,614.6281499692685
1747959874985680,21411324,1,232,100,21462258,21301744,160514,622.9986169430704
1747959875080110,21503884,1,233,100,21556688,21394304,162384,615.8242191348901
1747959875173933,21596444,1,234,100,21650511,21486864,163647,611.0713914706656
1747959875264311,21689004,1,235,100,21740889,21579424,161465,619.329266404484
1747959875358166,21781564,1,236,100,21834744,21671984,162760,614.4015728680266
1747959875452527,21874124,1,237,100,21929105,21764544,164561,607.6773962238926
1747959875545909,21966684,1,238,100,22022487,21857104,165383,604.6570687434621
1747959875640377,22059244,1,239,100,22116955,21949664,167291,597.760788087823
1747959875731378,22151804,1,240,100,22207956,22042224,165732,603.3837762170251
1747959875825816,22244372,1,241,100,22302394,22134792,167602,596.6515912697939
1747959875919320,22336924,1,242,100,22395898,22227344,168554,593.2816782752114
1747959876013659,22429484,1,243,100,22490237,22319904,170333,587.0852976228916
1747959876103713,22522044,1,244,100,22580291,22412464,167827,595.8516805996651
1747959876197553,22614604,1,245,100,22674131,22505024,169107,591.3415766349116
1747959876291657,22707164,1,246,100,22768235,22597584,170651,585.9912921693983
1747959876390431,22799724,1,247,100,22867009,22690144,176865,565.4029909818223
1747959876476004,22892284,1,248,100,22952582,22782704,169878,588.6577426152886
1747959876570657,22984844,1,249,100,23047235,22875264,171971,581.4933913276075
1747959876664338,23077404,1,250,100,23140916,22967824,173092,577.7274512975758
1747959876758456,23169964,1,251,100,23235034,23060384,174650,572.573718866304
1747959876848888,23262524,1,252,100,23325466,23152944,172522,579.6362203081346
1747959876950934,23355084,1,253,100,23427512,23245504,182008,549.4263988396115
1747959877037122,23447644,1,254,100,23513700,23338064,175636,569.3593568516706
1747959877131655,23540204,1,255,100,23608233,23430624,177609,563.0345309077807
1747959877225782,23632764,1,256,100,23702360,23523184,179176,558.1104612224851
1747959877315923,23725324,1,257,100,23792501,23615744,176757,565.7484569210837
1747959877414391,23817884,1,258,100,23890969,23708304,182665,547.4502504584896
1747959877504149,23910444,1,259,100,23980727,23800864,179863,555.9787171347081
1747959877598083,24003004,1,260,100,24074661,23893424,181237,551.76371270767
1747959877688805,24095564,1,261,100,24165383,23985984,179399,557.4167080084059
1747959877782875,24188124,1,262,100,24259453,24078544,180909,552.7640968663803
1747959877876694,24280684,1,263,100,24353272,24171104,182168,548.9438320671029
1747959877971343,24373244,1,264,100,24447921,24263664,184257,542.720222298203
1747959878060996,24465804,1,265,100,24537574,24356224,181350,551.4199062586159
1747959878155257,24558364,1,266,100,24631835,24448784,183051,546.2958410497621
1747959878253686,24650924,1,267,100,24730264,24541344,188920,529.3245818335803
1747959878343888,24743484,1,268,100,24820466,24633904,186562,536.0148368906852
1747959878434224,24836044,1,269,100,24910802,24726464,184338,542.4817454892643
1747959878532497,24928604,1,270,100,25009075,24819024,190051,526.1745531462608
1747959878622005,25021164,1,271,100,25098583,24911584,186999,534.7622179797753
1747959878716346,25113724,1,272,100,25192924,25004144,188780,529.7171310520182
1747959878810899,25206284,1,273,100,25287477,25096704,190773,524.18319154178
1747959878901201,25298844,1,274,100,25377779,25189264,188515,530.4617669681458
1747959878995108,25391404,1,275,100,25471686,25281824,189862,526.6983387934395
1747959879089570,25483964,1,276,100,25566148,25374384,191764,521.4743121753822
1747959879183353,25576524,1,277,100,25659931,25466944,192987,518.1696176426392
1747959879273929,25669084,1,278,100,25750507,25559504,191003,523.5519860944593
1747959879372127,25761644,1,279,100,25848705,25652064,196641,508.54094517420066
1747959879461910,25854204,1,280,100,25938488,25744624,193864,515.8255271736888
1747959879556862,25946764,1,281,100,26033440,25837184,196256,509.53856187836294
1747959879646924,26039332,1,282,100,26123502,25929752,193750,516.1290322580645
1747959879740807,26131884,1,283,100,26217385,26022304,195081,512.6075835165906
1747959879834240,26224444,1,284,100,26310818,26114864,195954,510.32385151617217
1747959879929257,26317004,1,285,100,26405835,26207424,198411,504.0043142769302
1747959880020635,26409564,1,286,100,26497213,26299984,197229,507.0248290058764
1747959880112940,26502124,1,287,100,26589518,26392544,196974,507.6812168103404
1747959880207794,26594684,1,288,100,26684372,26485104,199268,501.83672240399864
1747959880302390,26687244,1,289,100,26778968,26577664,201304,496.76111751380995
1747959880395722,26779804,1,290,100,26872300,26670224,202076,494.86331875136085
1747959880486104,26872364,1,291,100,26962682,26762784,199898,500.25513011635934
1747959880588989,26964924,1,292,100,27065567,26855344,210223,475.68534365887655
1747959880675047,27057484,1,293,100,27151625,26947904,203721,490.8674118033978
1747959880769109,27150044,1,294,100,27245687,27040464,205223,487.27481812467414
1747959880859335,27242604,1,295,100,27335913,27133024,202889,492.88034343902325
1747959880953158,27335164,1,296,100,27429736,27225584,204152,489.8311062345703
1747959881047332,27427724,1,297,100,27523910,27318144,205766,485.9889388917508
1747959881141715,27520284,1,298,100,27618293,27410704,207589,481.7210931215045
1747959881236101,27612844,1,299,100,27712679,27503264,209415,477.52071246090304
1747959881329900,27705404,1,300,100,27806478,27595824,210654,474.7120871191622
1747959881419836,27797964,1,301,100,27896414,27688384,208030,480.6998990530212
1747959881514315,27890524,1,302,100,27990893,27780944,209949,476.3061505413219
1747959881608057,27983084,1,303,100,28084635,27873504,211131,473.63958869138116
1747959881698953,28075644,1,304,100,28175531,27966064,209467,477.4021683606487
1747959881796110,28168212,1,305,100,28272688,28058632,214056,467.1674701947154
1747959881887134,28260764,1,306,100,28363712,28151184,212528,470.5262365429496
1747959881981415,28353324,1,307,100,28457993,28243744,214249,466.74663592362157
1747959882071218,28445884,1,308,100,28547796,28336304,211492,472.8311236358822
1747959882169999,28538444,1,309,100,28646577,28428864,217713,459.3202978232811
1747959882259342,28631004,1,310,100,28735920,28521424,214496,466.2091600775772
1747959882353214,28723564,1,311,100,28829792,28613984,215808,463.37485172004745
1747959882443736,28816124,1,312,100,28920314,28706544,213770,467.7924872526547
1747959882537486,28908684,1,313,100,29014064,28799104,214960,465.2028284331968
1747959882632842,29001244,1,314,100,29109420,28891664,217756,459.22959642903066
1747959882726511,29093804,1,315,100,29203089,28984224,218865,456.9026568889498
1747959882816409,29186364,1,316,100,29292987,29076784,216203,462.52827204062845
1747959882910970,29278924,1,317,100,29387548,29169344,218204,458.2867408480138
1747959883004852,29371484,1,318,100,29481430,29261904,219526,455.52690797445405
1747959883098321,29464044,1,319,100,29574899,29354464,220435,453.6484678023
1747959883193148,29556604,1,320,100,29669726,29447024,222702,449.03054305753875
1747959883283153,29649164,1,321,100,29759731,29539584,220147,454.2419383411993
1747959883382075,29741724,1,322,100,29858653,29632144,226509,441.4835613595928
1747959883472251,29834284,1,323,100,29948829,29724704,224125,446.1795872838818
1747959883566164,29926844,1,324,100,30042742,29817264,225478,443.50224855640016
1747959883656157,30019404,1,325,100,30132735,29909824,222911,448.6095347470515
1747959883750481,30111964,1,326,100,30227059,30002384,224675,445.08734839212195
1747959883845159,30204524,1,327,100,30321737,30094944,226793,440.9307165565075
1747959883938595,30297084,1,328,100,30415173,30187504,227669,439.2341513337345
1747959884028637,30389644,1,329,100,30505215,30280064,225151,444.14637287864593
1747959884126873,30482204,1,330,100,30603451,30372624,230827,433.224882704363
1747959884217161,30574764,1,331,100,30693739,30465184,228555,437.53144757279426
1747959884310799,30667324,1,332,100,30787377,30557744,229633,435.4774792821589
1747959884401507,30759884,1,333,100,30878085,30650304,227781,439.0181797428231
1747959884495427,30852444,1,334,100,30972005,30742864,229141,436.41251456526766
1747959884590096,30945004,1,335,100,31066674,30835424,231250,432.4324324324324
1747959884683863,31037564,1,336,100,31160441,30927984,232457,430.18708836472985
1747959884777862,31130124,1,337,100,31254440,31020544,233896,427.54044532612784
1747959884868485,31222684,1,338,100,31345063,31113104,231959,431.1106704202036
1747959884962358,31315244,1,339,100,31438936,31205664,233272,428.68411125210054
1747959885057088,31407804,1,340,100,31533666,31298224,235442,424.7330552747598
1747959885151204,31500364,1,341,100,31627782,31390784,236998,421.94448898302943
1747959885241299,31592924,1,342,100,31717877,31483344,234533,426.37923021493776
1747959885335523,31685484,1,343,100,31812101,31575904,236197,423.3754027358519
1747959885429686,31778044,1,344,100,31906264,31668464,237800,420.52144659377626
1747959885523156,31870604,1,345,100,31999734,31761024,238710,418.91835281303673
1747959885617519,31963172,1,346,100,32094097,31853592,240505,415.7917714808424
1747959885708311,32055724,1,347,100,32184889,31946144,238745,418.8569394123437
1747959885819281,32148284,1,348,100,32295859,32038704,257155,388.8705255585153
1747959885896643,32240844,1,349,100,32373221,32131264,241957,413.2965774910418
1747959885986639,32333404,1,350,100,32463217,32223824,239393,417.72315815416493
1747959886081064,32425964,1,351,100,32557642,32316384,241258,414.4940271410689
1747959886175639,32518524,1,352,100,32652217,32408944,243273,411.06082467022645
1747959886269104,32611084,1,353,100,32745682,32501504,244178,409.5373047530899
1747959886363058,32703644,1,354,100,32839636,32594064,245572,407.2125486618995
1747959886453291,32796204,1,355,100,32929869,32686624,243245,411.10814199675224
1747959886547667,32888764,1,356,100,33024245,32779184,245061,408.0616662790081
1747959886641577,32981324,1,357,100,33118155,32871744,246411,405.82603861028934
1747959886736630,33073884,1,358,100,33213208,32964304,248904,401.76132163404367
1747959886826165,33166444,1,359,100,33302743,33056864,245879,406.70411055844545
1747959886925128,33259004,1,360,100,33401706,33149424,252282,396.3818266860101
1747959887014799,33351564,1,361,100,33491377,33241984,249393,400.9735638129378
1747959887108898,33444124,1,362,100,33585476,33334544,250932,398.5143385459009
1747959887198844,33536684,1,363,100,33675422,33427104,248318,402.7094290385715
1747959887293188,33629244,1,364,100,33769766,33519664,250102,399.83686655844417
1747959887386994,33721804,1,365,100,33863572,33612224,251348,397.85476709581934
1747959887481166,33814364,1,366,100,33957744,33704784,252960,395.31941808981657
1747959887571253,33906924,1,367,100,34047831,33797344,250487,399.2223149305153
1747959887665540,33999484,1,368,100,34142118,33889904,252214,396.488696107274
1747959887760051,34092052,1,369,100,34236629,33982472,254157,393.4575872393835
1747959887854630,34184604,1,370,100,34331208,34075024,256184,390.34443993379756
1747959887948714,34277164,1,371,100,34425292,34167584,257708,388.03607183323766
1747959888038503,34369724,1,372,100,34515081,34260144,254937,392.25377250065696
1747959888132357,34462284,1,373,100,34608935,34352704,256231,390.27283974226384
1747959888227167,34554844,1,374,100,34703745,34445264,258481,386.8756310908732
1747959888321434,34647404,1,375,100,34798012,34537824,260188,384.3374790536074
1747959888410921,34739964,1,376,100,34887499,34630384,257115,388.93102308305623
1747959888505047,34832524,1,377,100,34981625,34722944,258681,386.57651702289695
1747959888600256,34925084,1,378,100,35076834,34815504,261330,382.6579420655876
1747959888693638,35017644,1,379,100,35170216,34908064,262152,381.4580853855778
1747959888783613,35110204,1,380,100,35260191,35000624,259567,385.2569856722927
1747959888882401,35202764,1,381,100,35358979,35093184,265795,376.2298011625501
1747959888972324,35295324,1,382,100,35448902,35185744,263158,379.9998480000608
1747959889066660,35387884,1,383,100,35543238,35278304,264934,377.45249760317665
1747959889156806,35480444,1,384,100,35633384,35370864,262520,380.9233582203261
1747959889251340,35573004,1,385,100,35727918,35463424,264494,378.08041014162893
1747959889345234,35665564,1,386,100,35821812,35555984,265828,376.18309583640547
1747959889439615,35758124,1,387,100,35916193,35648544,267649,373.6236638283722
1747959889533289,35850684,1,388,100,36009867,35741104,268763,372.075025208083
1747959889622964,35943244,1,389,100,36099542,35833664,265878,376.11235228187365
1747959889718149,36035804,1,390,100,36194727,35926224,268503,372.4353172962686
1747959889812509,36128364,1,391,100,36289087,36018784,270303,369.95519842547066
1747959889906124,36220924,1,392,100,36382702,36111344,271358,368.5168670170034
1747959889997053,36313484,1,393,100,36473631,36203904,269727,370.7452349968672
1747959890090422,36406044,1,394,100,36567000,36296464,270536,369.6365733211107
1747959890184532,36498604,1,395,100,36661110,36389024,272086,367.5308542152114
1747959890278542,36591164,1,396,100,36755120,36481584,273536,365.58259241927937
1747959890369140,36683724,1,397,100,36845718,36574144,271574,368.22376221582334
1747959890463738,36776284,1,398,100,36940316,36666704,273612,365.4810461529465
1747959890557714,36868844,1,399,100,37034292,36759264,275028,363.59934261238857
1747959890651351,36961404,1,400,100,37127929,36851824,276105,362.1810543090491
1747959890741351,37053964,1,401,100,37217929,36944384,273545,365.570564258166
1747959890836089,37146524,1,402,100,37312667,37036944,275723,362.68283748544735
1747959890930604,37239084,1,403,100,37407182,37129504,277678,360.12935846556087
1747959891024664,37331644,1,404,100,37501242,37222064,279178,358.1944135999255
1747959891118562,37424204,1,405,100,37595140,37314624,280516,356.4859045473342
1747959891216117,37516764,1,406,100,37692695,37407184,285511,350.24920230744175
1747959891306642,37609324,1,407,100,37783220,37499744,283476,352.76354964794194
1747959891396992,37701884,1,408,100,37873570,37592304,281266,355.5353295456969
1747959891490494,37794444,1,409,100,37967072,37684864,282208,354.3485655970064
1747959891581318,37887012,1,410,100,38057896,37777432,280464,356.5519995436135
1747959891687285,37979564,1,411,100,38163863,37869984,293879,340.27610002756234
1747959891781077,38072124,1,412,100,38257655,37962544,295111,338.8555492679026
1747959891867378,38167804,1,413,100,38343956,38058224,285732,349.9783013453166
1747959891958042,38260364,1,414,100,38434620,38150784,283836,352.3161262137291
1747959892052279,38352932,1,415,100,38528857,38243352,285505,350.25656293234795
1747959892146388,38445484,1,416,100,38622966,38335904,287062,348.3568009698254
1747959892236348,38538044,1,417,100,38712926,38428464,284462,351.5408033410438
1747959892330852,38630604,1,418,100,38807430,38521024,286406,349.15469647982235
1747959892424615,38723164,1,419,100,38901193,38613584,287609,347.69426547847945
1747959892519237,38815724,1,420,100,38995815,38706144,289671,345.2192314729469
1747959892613180,38908284,1,421,100,39089758,38798704,291054,343.5788547829613
1747959892702817,39000844,1,422,100,39179395,38891264,288131,347.0643561435597
1747959892797732,39093404,1,423,100,39274310,38983824,290486,344.2506695675523
1747959892891282,39185964,1,424,100,39367860,39076384,291476,343.081420082614
1747959892985817,39278524,1,425,100,39462395,39168944,293451,340.7723947098493
1747959893076355,39371084,1,426,100,39552933,39261504,291429,343.13675028909273
1747959893169950,39463644,1,427,100,39646528,39354064,292464,341.9224246402976
1747959893264563,39556204,1,428,100,39741141,39446624,294517,339.53897398112844
1747959893358441,39648764,1,429,100,39835019,39539184,295835,338.0262646407626
1747959893448560,39741324,1,430,100,39925138,39631744,293394,340.83859928969235
1747959893542870,39833884,1,431,100,40019448,39724304,295144,338.8176618870788
1747959893636766,39926444,1,432,100,40113344,39816864,296480,337.2908796546141
1747959893731417,40019004,1,433,100,40207995,39909424,298571,334.9287104239863
1747959893821176,40111564,1,434,100,40297754,40001984,295770,338.10055110389834
1747959893916149,40204124,1,435,100,40392727,40094544,298183,335.36452446987255
1747959894009467,40296684,1,436,100,40486045,40187104,298941,334.51416834760033
1747959894104626,40389244,1,437,100,40581204,40279664,301540,331.6309610665252
1747959894198385,40481812,1,438,100,40674963,40372232,302731,330.32626325021226
1747959894289010,40574364,1,439,100,40765588,40464784,300804,332.4423877342056
1747959894382794,40666924,1,440,100,40859372,40557344,302028,331.0951302528242
1747959894477061,40759484,1,441,100,40953639,40649904,303735,329.23436548306915
1747959894571792,40852044,1,442,100,41048370,40742464,305906,326.8978052081358
1747959894661834,40944604,1,443,100,41138412,40835024,303388,329.6109272614606
1747959894754924,41037164,1,444,100,41231502,40927584,303918,329.0361215854276
1747959894850275,41129724,1,445,100,41326853,41020144,306709,326.04194855710136
1747959894943501,41222284,1,446,100,41420079,41112704,307375,325.3355022366816
1747959895038233,41314844,1,447,100,41514811,41205264,309547,323.0527189732092
1747959895128318,41407404,1,448,100,41604896,41297824,307072,325.6565235514798
1747959895222628,41499964,1,449,100,41699206,41390384,308822,323.81112744558357
1747959895316743,41592524,1,450,100,41793321,41482944,310377,322.18882198101016
1747959895406477,41685084,1,451,100,41883055,41575504,307551,325.149324827427
1747959895500600,41777644,1,452,100,41977178,41668064,309114,323.5052440200056
1747959895594804,41870204,1,453,100,42071382,41760624,310758,321.79380739997043
1747959895689830,41962764,1,454,100,42166408,41853184,313224,319.2603376497331
1747959895783199,42055324,1,455,100,42259777,41945744,314033,318.4378711791436
1747959895873280,42147884,1,456,100,42349858,42038304,311554,320.9716453648485
1747959895967162,42240444,1,457,100,42443740,42130864,312876,319.6154387041512
1747959896061190,42333004,1,458,100,42537768,42223424,314344,318.12282085867713
1747959896156308,42425564,1,459,100,42632886,42315984,316902,315.55496651961806
1747959896247099,42518124,1,460,100,42723677,42408544,315133,317.3263352298871
1747959896340658,42610684,1,461,100,42817236,42501104,316132,316.32356104412077
1747959896434839,42703244,1,462,100,42911417,42593664,317753,314.70985325079545
1747959896528841,42795804,1,463,100,43005419,42686224,319195,313.28811541534174
1747959896619432,42888364,1,464,100,43096010,42778784,317226,315.23267323611555
1747959896713331,42980924,1,465,100,43189909,42871344,318565,313.9076797513851
1747959896807250,43073484,1,466,100,43283828,42963904,319924,312.5742363811405
1747959896902231,43166044,1,467,100,43378809,43056464,322345,310.2266205463091
1747959896991336,43258604,1,468,100,43467914,43149024,318890,313.5877575339459
1747959897086562,43351164,1,469,100,43563140,43241584,321556,310.9878217169016
1747959897180843,43443724,1,470,100,43657421,43334144,323277,309.33224448383277
1747959897274483,43536284,1,471,100,43751061,43426704,324357,308.3022718794415
1747959897368410,43628844,1,472,100,43844988,43519264,325724,307.00838746914565
1747959897458402,43721404,1,473,100,43934980,43611824,323156,309.4480684251569
1747959897560994,43813964,1,474,100,44037572,43704384,333188,300.1308570536754
1747959897647028,43906524,1,475,100,44123606,43796944,326662,306.12682221990923
1747959897740761,43999084,1,476,100,44217339,43889504,327835,305.03149450180734
1747959897831585,44091644,1,477,100,44308163,43982064,326099,306.6553408627441
1747959897925709,44184204,1,478,100,44402287,44074624,327663,305.1916145551985
1747959898020363,44276772,1,479,100,44496941,44167192,329749,303.2609651583477
1747959898114730,44369324,1,480,100,44591308,44259744,331564,301.6008975642711
1747959898204293,44461884,1,481,100,44680871,44352304,328567,304.35192822164123
1747959898301589,44554444,1,482,100,44778167,44444864,333303,300.0273024845261
1747959898392359,44647004,1,483,100,44868937,44537424,331513,301.6472958828161
1747959898487263,44739564,1,484,100,44963841,44629984,333857,299.5294392509368
1747959898580074,44832124,1,485,100,45056652,44722544,334108,299.3044165359704
1747959898671355,44924684,1,486,100,45147933,44815104,332829,300.45458779132827
1747959898765615,45017244,1,487,100,45242193,44907664,334529,298.92774617447213
1747959898859268,45109804,1,488,100,45335846,45000224,335622,297.95424614596186
1747959898953355,45202364,1,489,100,45429933,45092784,337149,296.6047652521586
1747959899044306,45294924,1,490,100,45520884,45185344,335540,298.02706085712583
1747959899137827,45387484,1,491,100,45614405,45277904,336501,297.17593707002356
1747959899231726,45480044,1,492,100,45708304,45370464,337840,295.9981056121241
1747959899326488,45572604,1,493,100,45803066,45463024,340042,294.0813193664312
1747959899416169,45665164,1,494,100,45892747,45555584,337163,296.5924493494245
1747959899515215,45757724,1,495,100,45991793,45648144,343649,290.9945904105643
1747959899604377,45850284,1,496,100,46080955,45740704,340251,293.9006792044696
1747959899699223,45942844,1,497,100,46175801,45833264,342537,291.9392649553187
1747959899788783,46035404,1,498,100,46265361,45925824,339537,294.5187122463826
1747959899882781,46127964,1,499,100,46359359,46018384,340975,293.27663318425107
1747959899977362,46220524,1,500,100,46453940,46110944,342996,291.54858948792406
1747959900071068,46313084,1,501,100,46547646,46203504,344142,290.5777266360979
1747959900165072,46405652,1,502,100,46641650,46296072,345578,289.37027241317446
1747959900259366,46498204,1,503,100,46735944,46388624,347320,287.9189220315559
1747959900350423,46590764,1,504,100,46827001,46481184,345817,289.17028370496536
1747959900444232,46683324,1,505,100,46920810,46573744,347066,288.1296352855077
1747959900538202,46775884,1,506,100,47014780,46666304,348476,286.96380812451935
1747959900628432,46868444,1,507,100,47105010,46758864,346146,288.8954371854651
1747959900723100,46961004,1,508,100,47199678,46851424,348254,287.1467377259127
1747959900816547,47053564,1,509,100,47293125,46943984,349141,286.41723544356006
1747959900911433,47146124,1,510,100,47388011,47036544,351467,284.5217331925899
1747959901001330,47238684,1,511,100,47477908,47129104,348804,286.69395993165216
1747959901095520,47331244,1,512,100,47572098,47221664,350434,285.36043877021064
1747959901189234,47423804,1,513,100,47665812,47314224,351588,284.42381423711845
1747959901284058,47516364,1,514,100,47760636,47406784,353852,282.6040265421702
1747959901373992,47608924,1,515,100,47850570,47499344,351226,284.71696286721374
1747959901468253,47701484,1,516,100,47944831,47591904,352927,283.34471434602625
1747959901562717,47794044,1,517,100,48039295,47684464,354831,281.82430509171974
1747959901655846,47886604,1,518,100,48132424,47777024,355400,281.37310073157005
1747959901750916,47979164,1,519,100,48227494,47869584,357910,279.39984912408147
1747959901840262,48071724,1,520,100,48316840,47962144,354696,281.9315695694341
1747959901935425,48164284,1,521,100,48412003,48054704,357299,279.8776374968864
1747959902028897,48256844,1,522,100,48505475,48147264,358211,279.1650730993744
1747959902122893,48349404,1,523,100,48599471,48239824,359647,278.0504216634645
1747959902212655,48441964,1,524,100,48689233,48332384,356849,280.2305737160535
1747959902307958,48534524,1,525,100,48784536,48424944,359592,278.09294978753695
1747959902401687,48627084,1,526,100,48878265,48517504,360761,277.1918250586954
1747959902495991,48719644,1,527,100,48972569,48610064,362505,275.85826402394446
1747959902586503,48812204,1,528,100,49063081,48702624,360457,277.4256013893474
1747959902680451,48904764,1,529,100,49157029,48795184,361845,276.36142547223255
1747959902774393,48997324,1,530,100,49250971,48887744,363227,275.3099301538707
1747959902868295,49089884,1,531,100,49344873,48980304,364569,274.2964980566093
1747959902958821,49182444,1,532,100,49435399,49072864,362535,275.83543657853727
1747959903052722,49275004,1,533,100,49529300,49165424,363876,274.81889434862427
1747959903147534,49367564,1,534,100,49624112,49257984,366128,273.12852335795134
1747959903242582,49460124,1,535,100,49719160,49350544,368616,271.2850228964559
1747959903339637,49552684,1,536,100,49816215,49443104,373111,268.01675640761056
1747959903425845,49645244,1,537,100,49902423,49535664,366759,272.6586123312584
1747959903523745,49737804,1,538,100,50000323,49628224,372099,268.74568327246243
1747959903614126,49830364,1,539,100,50090704,49720784,369920,270.3287197231834
1747959903708422,49922924,1,540,100,50185000,49813344,371656,269.06601803818586
1747959903798916,50015484,1,541,100,50275494,49905904,369590,270.57009118212073
1747959903893017,50108044,1,542,100,50369595,49998464,371131,269.44663744068805
1747959903986533,50200612,1,543,100,50463111,50091032,372079,268.76012889735784
1747959904081602,50293164,1,544,100,50558180,50183584,374596,266.9542653952525
1747959904175551,50385724,1,545,100,50652129,50276144,375985,265.96805723632593
1747959904265949,50478284,1,546,100,50742527,50368704,373823,267.50627970991616
1747959904359379,50570844,1,547,100,50835957,50461264,374693,266.8851566482427
1747959904454701,50663404,1,548,100,50931279,50553824,377455,264.93224357870474
1747959904548362,50755964,1,549,100,51024940,50646384,378556,264.1617092319234
1747959904638005,50848524,1,550,100,51114583,50738944,375639,266.213039647108
1747959904732589,50941084,1,551,100,51209167,50831504,377663,264.7863306704655
1747959904826852,51033644,1,552,100,51303430,50924064,379366,263.5976866667018
1747959904921037,51126204,1,553,100,51397615,51016624,380991,262.4733917599103
1747959905011213,51218764,1,554,100,51487791,51109184,378607,264.1261255074523
1747959905105636,51311324,1,555,100,51582214,51201744,380470,262.83281204825613
1747959905199859,51403884,1,556,100,51676437,51294304,382133,261.68899309926127
1747959905293920,51496444,1,557,100,51770498,51386864,383634,260.6651131025926
1747959905384337,51589004,1,558,100,51860915,51479424,381491,262.1293818202788
1747959905478653,51681564,1,559,100,51955231,51571984,383247,260.9283308153749
1747959905571668,51774124,1,560,100,52048246,51664544,383702,260.6189178060057
1747959905667027,51866684,1,561,100,52143605,51757104,386501,258.7315427385699
1747959905756687,51959244,1,562,100,52233265,51849664,383601,260.68753731090374
1747959905855341,52051804,1,563,100,52331919,51942224,389695,256.6109393243434
1747959905952551,52144364,1,564,100,52429129,52034784,394345,253.58505876833738
1747959906043295,52236924,1,565,100,52519873,52127344,392529,254.75824716135622
1747959906129050,52329492,1,566,100,52605628,52219912,385716,259.2581070010059
1747959906222723,52422044,1,567,100,52699301,52312464,386837,258.5068129470552
1747959906317421,52514604,1,568,100,52793999,52405024,388975,257.08593097242755
1747959906411648,52607164,1,569,100,52888226,52497584,390642,255.98885936484044
1747959906505538,52699724,1,570,100,52982116,52590144,391972,255.12026369230455
1747959906596228,52792284,1,571,100,53072806,52682704,390102,256.34321280075466
1747959906689620,52884844,1,572,100,53166198,52775264,390934,255.79765382391912
1747959906784214,52977404,1,573,100,53260792,52867824,392968,254.4736467091468
1747959906877907,53069964,1,574,100,53354485,52960384,394101,253.74206104526505
1747959906976732,53162524,1,575,100,53453310,53052944,400366,249.77145911490985
1747959907062989,53255084,1,576,100,53539567,53145504,394063,253.76652971732946
1747959907157364,53347644,1,577,100,53633942,53238064,395878,252.60307468462506
1747959907251494,53440204,1,578,100,53728072,53330624,397448,251.60524144038968
1747959907341776,53532764,1,579,100,53818354,53423184,395170,253.05564693676138
1747959907435410,53625324,1,580,100,53911988,53515744,396244,252.36975197100776
1747959907530112,53717884,1,581,100,54006690,53608304,398386,251.01283679647375
1747959907624062,53810444,1,582,100,54100640,53700864,399776,250.1400784439286
1747959907714266,53903004,1,583,100,54190844,53793424,397420,251.62296814453222
1747959907808045,53995564,1,584,100,54284623,53885984,398639,250.8535291328746
1747959907902788,54088124,1,585,100,54379366,53978544,400822,249.48730359112025
1747959907996820,54180684,1,586,100,54473398,54071104,402294,248.5744256687895
1747959908090459,54273244,1,587,100,54567037,54163664,403373,247.90950311498293
1747959908180659,54365804,1,588,100,54657237,54256224,401013,249.36847433873714
1747959908274408,54458364,1,589,100,54750986,54348784,402202,248.63128477730095
1747959908369908,54550924,1,590,100,54846486,54441344,405142,246.8270384210968
1747959908463740,54643484,1,591,100,54940318,54533904,406414,246.0545158385292
1747959908553216,54736044,1,592,100,55029794,54626464,403330,247.9359333548211
1747959908647293,54828604,1,593,100,55123871,54719024,404847,247.0068939624105
1747959908742155,54921164,1,594,100,55218733,54811584,407149,245.61032938801276
1747959908836607,55013724,1,595,100,55313185,54904144,409041,244.47427030542173
1747959908926230,55106284,1,596,100,55402808,54996704,406104,246.24234186316804
1747959909020881,55198844,1,597,100,55497459,55089264,408195,244.9809527309252
1747959909114688,55291404,1,598,100,55591266,55181824,409442,244.23483668016473
1747959909209050,55383964,1,599,100,55685628,55274384,411244,243.16464191574832
1747959909298964,55476524,1,600,100,55775542,55366944,408598,244.7393281415964
1747959909393692,55569084,1,601,100,55870270,55459504,410766,243.4476076403597
1747959909487146,55661644,1,602,100,55963724,55552064,411660,242.91891366661807
1747959909581517,55754204,1,603,100,56058095,55644624,413471,241.8549305755422
1747959909675935,55846764,1,604,100,56152513,55737184,415329,240.77297756718167
1747959909766410,55939324,1,605,100,56242988,55829744,413244,241.98778445664064
1747959909860480,56031884,1,606,100,56337058,55922304,414754,241.10677654706163
1747959909954747,56124452,1,607,100,56431325,56014872,416453,240.1231351437017
1747959910048951,56217004,1,608,100,56525529,56107424,418105,239.1743700745028
1747959910138719,56309564,1,609,100,56615297,56199984,415313,240.78225338479655
1747959910233283,56402124,1,610,100,56709861,56292544,417317,239.62599175207336
1747959910326784,56494684,1,611,100,56803362,56385104,418258,239.0868793902328
1747959910421302,56587244,1,612,100,56897880,56477664,420216,237.97285205703736
1747959910511143,56679804,1,613,100,56987721,56570224,417497,239.52267920488052
1747959910605967,56772364,1,614,100,57082545,56662784,419761,238.2308027663361
1747959910700253,56864924,1,615,100,57176831,56755344,421487,237.25524156142419
1747959910794053,56957484,1,616,100,57270631,56847904,422727,236.55929240384455
1747959910884665,57050044,1,617,100,57361243,56940464,420779,237.65444568288817
1747959910978199,57142604,1,618,100,57454777,57033024,421753,237.10560446517275
1747959911072881,57235164,1,619,100,57549459,57125584,423875,235.91860808021232
1747959911167058,57327724,1,620,100,57643636,57218144,425492,235.02204506782738
1747959911261258,57420284,1,621,100,57737836,57310704,427132,234.11966324227637
1747959911351886,57512844,1,622,100,57828464,57403264,425200,235.18344308560677
1747959911445641,57605404,1,623,100,57922219,57495824,426395,234.52432603571805
1747959911539841,57697964,1,624,100,58016419,57588384,428035,233.62575490322052
1747959911634156,57790524,1,625,100,58110734,57680944,429790,232.6717699341539
1747959911727787,57883084,1,626,100,58204365,57773504,430861,232.09341295684686
1747959911818432,57975644,1,627,100,58295010,57866064,428946,233.12957808208958
1747959911911971,58068204,1,628,100,58388549,57958624,429925,232.5987090771646
1747959912006078,58160764,1,629,100,58482656,58051184,431472,231.76474950865872
1747959912096170,58253332,1,630,100,58572748,58143752,428996,233.10240654924522
1747959912190389,58345884,1,631,100,58666967,58236304,430663,232.20011935086134
1747959912284982,58438444,1,632,100,58761560,58328864,432696,231.1091389797918
1747959912379512,58531004,1,633,100,58856090,58421424,434666,230.06170254862354
1747959912468654,58623564,1,634,100,58945232,58513984,431248,231.8851333803287
1747959912563603,58716124,1,635,100,59040181,58606544,433637,230.60762803912027
1747959912657773,58808684,1,636,100,59134351,58699104,435247,229.75459911268774
1747959912751495,58901244,1,637,100,59228073,58791664,436409,229.14284535836796
1747959912846572,58993804,1,638,100,59323150,58884224,438926,227.82883675152533
1747959912936328,59086364,1,639,100,59412906,58976784,436122,229.29363801871952
1747959913030339,59178924,1,640,100,59506917,59069344,437573,228.53329615858382
1747959913123989,59271484,1,641,100,59600567,59161904,438663,227.96543132199432
1747959913219559,59364044,1,642,100,59696137,59254464,441673,226.41184767916536
1747959913308509,59456604,1,643,100,59785087,59347024,438063,228.27766782403447
1747959913402875,59549164,1,644,100,59879453,59439584,439869,227.34041271378524
1747959913497072,59641724,1,645,100,59973650,59532144,441506,226.4974881428565
1747959913591468,59734284,1,646,100,60068046,59624704,443342,225.55950034059484
1747959913681819,59826844,1,647,100,60158397,59717264,441133,226.68900308977112
1747959913775586,59919404,1,648,100,60252164,59809824,442340,226.07044355021023
1747959913870205,60011964,1,649,100,60346783,59902384,444399,225.02300860262963
1747959913964505,60104524,1,650,100,60441083,59994944,446139,224.14538966555267
1747959914058163,60197084,1,651,100,60534741,60087504,447237,223.59509611235205
1747959914148566,60289644,1,652,100,60625144,60180064,445080,224.67870944549296
1747959914242279,60382204,1,653,100,60718857,60272624,446233,224.09817292759612
1747959914336585,60474764,1,654,100,60813163,60365184,447979,223.22474937441262
1747959914431300,60567324,1,655,100,60907878,60457744,450134,222.15606908165125
1747959914521928,60659884,1,656,100,60998506,60550304,448202,223.11368534723184
1747959914615582,60752444,1,657,100,61092160,60642864,449296,222.57042128129342
1747959914709757,60845004,1,658,100,61186335,60735424,450911,221.77325458904306
1747959914804126,60937564,1,659,100,61280704,60827984,452720,220.88708252341402
1747959914894213,61030124,1,660,100,61370791,60920544,450247,222.10031382774343
1747959914988610,61122684,1,661,100,61465188,61013104,452084,221.19783049167853
1747959915083027,61215244,1,662,100,61559605,61105664,453941,220.29294555900438
1747959915176641,61307804,1,663,100,61653219,61198224,454995,219.7826349740107
1747959915267045,61400364,1,664,100,61743623,61290784,452839,220.82903636833402
1747959915361156,61492924,1,665,100,61837734,61383344,454390,220.07526574088337
1747959915455718,61585484,1,666,100,61932296,61475904,456392,219.10988799102526
1747959915548785,61678044,1,667,100,62025363,61568464,456899,218.8667517328775
1747959915643518,61770604,1,668,100,62120096,61661024,459072,217.8307542172034
1747959915733169,61863164,1,669,100,62209747,61753584,456163,219.21988412036927
1747959915827982,61955724,1,670,100,62304560,61846144,458416,218.1424732121043
1747959915922033,62048292,1,671,100,62398611,61938712,459899,217.4390463993181
1747959916016849,62140844,1,672,100,62493427,62031264,462163,216.37387674911233
1747959916106029,62233404,1,673,100,62582607,62123824,458783,217.96797178622575
1747959916200689,62325964,1,674,100,62677267,62216384,460883,216.97480705515284
1747959916294913,62418524,1,675,100,62771491,62308944,462547,216.19424620633148
1747959916389325,62511084,1,676,100,62865903,62401504,464399,215.3320743584719
1747959916483080,62603644,1,677,100,62959658,62494064,465594,214.7794000781797
1747959916573357,62696204,1,678,100,63049935,62586624,463311,215.83774181921
1747959916667672,62788764,1,679,100,63144250,62679184,465066,215.0232440126778
1747959916761974,62881324,1,680,100,63238552,62771744,466808,214.22083597539032
1747959916851943,62973884,1,681,100,63328521,62864304,464217,215.41649702617525
1747959916946584,63066444,1,682,100,63423162,62956864,466298,214.45513384144903
1747959917040539,63159004,1,683,100,63517117,63049424,467693,213.81547297051696
1747959917134533,63251564,1,684,100,63611111,63141984,469127,213.1618943271225
1747959917227938,63344124,1,685,100,63704516,63234544,469972,212.77863362072634
1747959917318925,63436684,1,686,100,63795503,63327104,468399,213.49319703927634
1747959917413102,63529244,1,687,100,63889680,63419664,470016,212.7587145969499
1747959917507188,63621804,1,688,100,63983766,63512224,471542,212.07018674900644
1747959917601146,63714364,1,689,100,64077724,63604784,472940,211.4433120480399
1747959917691437,63806924,1,690,100,64168015,63697344,470671,212.4626331343975
1747959917785985,63899484,1,691,100,64262563,63789904,472659,211.56901698687636
1747959917879385,63992044,1,692,100,64355963,63882464,473499,211.19368784305775
1747959917974504,64084604,1,693,100,64451082,63975024,476058,210.05843825752325
1747959918064228,64177172,1,694,100,64540806,64067592,473214,211.3208823069478
1747959918162701,64269724,1,695,100,64639279,64160144,479135,208.7094451459401
1747959918252764,64362284,1,696,100,64729342,64252704,476638,209.80282730290074
1747959918346531,64454844,1,697,100,64823109,64345264,477845,209.2728813736672
1747959918436474,64547404,1,698,100,64913052,64437824,475228,210.42531163988656
1747959918534577,64639964,1,699,100,65011155,64530384,480771,207.9992345628168
1747959918624991,64732524,1,700,100,65101569,64622944,478625,208.93183598850874
1747959918719377,64825084,1,701,100,65195955,64715504,480451,208.1377705530845
1747959918813280,64917644,1,702,100,65289858,64808064,481794,207.5575868524722
1747959918903972,65010204,1,703,100,65380550,64900624,479926,208.36545634118593
1747959918998004,65102764,1,704,100,65474582,64993184,481398,207.72832458797086
1747959919092063,65195324,1,705,100,65568641,65085744,482897,207.08349813728393
1747959919186192,65287884,1,706,100,65662770,65178304,484466,206.41283392436208
1747959919276964,65380444,1,707,100,65753542,65270864,482678,207.17745577797206
1747959919370538,65473004,1,708,100,65847116,65363424,483692,206.74313406051783
1747959919465434,65565564,1,709,100,65942012,65455984,486028,205.74946299390157
1747959919559553,65658124,1,710,100,66036131,65548544,487587,205.0916041650003
1747959919649376,65750684,1,711,100,66125954,65641104,484850,206.24935547076416
1747959919742604,65843244,1,712,100,66219182,65733664,485518,205.965587269679
1747959919838132,65935804,1,713,100,66314710,65826224,488486,204.71415762171281
1747959919931481,66028364,1,714,100,66408059,65918784,489275,204.3840376066629
1747959920022017,66120924,1,715,100,66498595,66011344,487251,205.23303184600957
1747959920116035,66213484,1,716,100,66592613,66103904,488709,204.6207456789214
1747959920209926,66306044,1,717,100,66686504,66196464,490040,204.06497428781324
1747959920304098,66398604,1,718,100,66780676,66289024,491652,203.39589791153094
1747959920398266,66491164,1,719,100,66874844,66381584,493260,202.732838665207
1747959920488831,66583724,1,720,100,66965409,66474144,491265,203.55612551270698
1747959920583068,66676284,1,721,100,67059646,66566704,492942,202.86362290086868
1747959920677764,66768844,1,722,100,67154342,66659264,495078,201.9883735492185
1747959920771646,66861404,1,723,100,67248224,66751824,496400,201.45044319097502
1747959920861894,66953964,1,724,100,67338472,66844384,494088,202.39309596671038
1747959920956090,67046524,1,725,100,67432668,66936944,495724,201.7251535128418
1747959921049739,67139084,1,726,100,67526317,67029504,496813,201.2829776998589
1747959921144047,67231644,1,727,100,67620625,67122064,498561,200.57726135818888
1747959921233389,67324204,1,728,100,67709967,67214624,495343,201.88031323749402
1747959921328321,67416764,1,729,100,67804899,67307184,497715,200.9181961564349
1747959921422127,67509324,1,730,100,67898705,67399744,498961,200.41646541513265
1747959921516435,67601884,1,731,100,67993013,67492304,500709,199.71680157536613
1747959921606245,67694444,1,732,100,68082823,67584864,497959,200.81974620400476
1747959921701020,67787004,1,733,100,68177598,67677424,500174,199.93042421237408
1747959921795812,67879564,1,734,100,68272390,67769984,502406,199.0422088908174
1747959921889442,67972132,1,735,100,68366020,67862552,503468,198.6223553433386
1747959921982964,68064684,1,736,100,68459542,67955104,504438,198.24041804939355
1747959922073289,68157244,1,737,100,68549867,68047664,502203,199.12266553564996
1747959922167359,68249804,1,738,100,68643937,68140224,503713,198.52574779686051
1747959922265986,68342364,1,739,100,68742564,68232784,509780,196.16305072776493
1747959922355537,68434924,1,740,100,68832115,68325344,506771,197.32778710699705
1747959922445970,68527484,1,741,100,68922548,68417904,504644,198.15949461402494
1747959922540752,68620044,1,742,100,69017330,68510464,506866,197.29080269735985
1747959922634781,68712604,1,743,100,69111359,68603024,508335,196.72066648961808
1747959922729495,68805164,1,744,100,69206073,68695584,510489,195.89060684951096
1747959922819250,68897724,1,745,100,69295828,68788144,507684,196.972920162936
1747959922913102,68990284,1,746,100,69389680,68880704,508976,196.47291817295906
1747959923007510,69082844,1,747,100,69484088,68973264,510824,195.76214116799525
1747959923101471,69175404,1,748,100,69578049,69065824,512225,195.22670701351944
1747959923190839,69267964,1,749,100,69667417,69158384,509033,196.45091772046214
1747959923286033,69360524,1,750,100,69762611,69250944,511667,195.43961209145792
1747959923379938,69453084,1,751,100,69856516,69343504,513012,194.92721417822585
1747959923474175,69545644,1,752,100,69950753,69436064,514689,194.29208706617007
1747959923568015,69638204,1,753,100,70044593,69528624,515969,193.81009324203586
1747959923657986,69730764,1,754,100,70134564,69621184,513380,194.78748685184465
1747959923752162,69823324,1,755,100,70228740,69713744,514996,194.1762654467219
1747959923846851,69915884,1,756,100,70323429,69806304,517125,193.37684312303602
1747959923943062,70008444,1,757,100,70419640,69898864,520776,192.02113768683657
1747959924031881,70101012,1,758,100,70508459,69991432,517027,193.41349678063233
1747959924125759,70193564,1,759,100,70602337,70083984,518353,192.9187252702309
1747959924219431,70286124,1,760,100,70696009,70176544,519465,192.50575110931442
1747959924314546,70378684,1,761,100,70791124,70269104,522020,191.56354162675757
1747959924403774,70471244,1,762,100,70880352,70361664,518688,192.7941267197236
1747959924498551,70563804,1,763,100,70975129,70454224,520905,191.9735844347818
1747959924592118,70656364,1,764,100,71068696,70546784,521912,191.60318214564907
1747959924687076,70748924,1,765,100,71163654,70639344,524310,190.72686006370276
1747959924777549,70841484,1,766,100,71254127,70731904,522223,191.48907650563075
1747959924871379,70934044,1,767,100,71347957,70824464,523493,191.02452181786578
1747959924965438,71026604,1,768,100,71442016,70917024,524992,190.4790930147507
1747959925059616,71119164,1,769,100,71536194,71009584,526610,189.89384933821992
1747959925154020,71211724,1,770,100,71630598,71102144,528454,189.2312292082187
1747959925243653,71304284,1,771,100,71720231,71194704,525527,190.28518039986528
1747959925338143,71396844,1,772,100,71814721,71287264,527457,189.58891435699974
1747959925432474,71489404,1,773,100,71909052,71379824,529228,188.9544770873801
1747959925526395,71581964,1,774,100,72002973,71472384,530589,188.46979488832224
1747959925616315,71674524,1,775,100,72092893,71564944,527949,189.41223489390075
1747959925710671,71767084,1,776,100,72187249,71657504,529745,188.77006861791995
1747959925805555,71859644,1,777,100,72282133,71750064,532069,187.945548415713
1747959925898903,71952204,1,778,100,72375481,71842624,532857,187.66761063474814
1747959925988877,72044764,1,779,100,72465455,71935184,530271,188.58281897369457
1747959926083558,72137324,1,780,100,72560136,72027744,532392,187.83152263745512
1747959926177992,72229884,1,781,100,72654570,72120304,534266,187.1726817727499
1747959926271731,72322444,1,782,100,72748309,72212864,535445,186.76054496727022
1747959926361749,72415004,1,783,100,72838327,72305424,532903,187.65141123243816
1747959926456268,72507564,1,784,100,72932846,72397984,534862,186.96411410793814
1747959926550320,72600124,1,785,100,73026898,72490544,536354,186.44402763846267
1747959926644330,72692684,1,786,100,73120908,72583104,537804,185.9413466616091
1747959927147992,73167964,1,791,100,73624570,73058384,566186,176.62040389553965
1747959927214032,73260524,1,792,100,73690610,73150944,539666,185.2997965408234
1747959927308130,73353084,1,793,100,73784708,73243504,541204,184.77320936282806
1747959927401793,73445644,1,794,100,73878371,73336064,542307,184.39739852150166
1747959927496706,73538204,1,795,100,73973284,73428624,544660,183.6007784673007
1747959927586693,73630764,1,796,100,74063271,73521184,542087,184.47223416167515
1747959927680933,73723324,1,797,100,74157511,73613744,543767,183.90229638797499
1747959927774577,73815884,1,798,100,74251155,73706304,544851,183.53641637805566
1747959927869438,73908444,1,799,100,74346016,73798864,547152,182.76456999151972
1747959927963556,74001004,1,800,100,74440134,73891424,548710,182.2456306610049
1747959928053299,74093564,1,801,100,74529877,73983984,545893,183.18608225421465
1747959928148023,74186124,1,802,100,74624601,74076544,548057,182.462773032732
1747959928241500,74278684,1,803,100,74718078,74169104,548974,182.15798926725128
1747959928336216,74371244,1,804,100,74812794,74261664,551130,181.44539400867308
1747959928426788,74463804,1,805,100,74903366,74354224,549142,182.10226134588137
1747959928520535,74556364,1,806,100,74997113,74446784,550329,181.7094865071621
1747959928614229,74648924,1,807,100,75090807,74539344,551463,181.33582851433368
1747959928708899,74741484,1,808,100,75185477,74631904,553573,180.64464849261074
1747959928798849,74834044,1,809,100,75275427,74724464,550963,181.5003911333429
1747959928893370,74926604,1,810,100,75369948,74817024,552924,180.85668193097064
1747959928986930,75019164,1,811,100,75463508,74909584,553924,180.53018103566555
1747959929081188,75111724,1,812,100,75557766,75002144,555622,179.97847457444092
1747959929175865,75204284,1,813,100,75652443,75094704,557739,179.2953334803555
1747959929265812,75296844,1,814,100,75742390,75187264,555126,180.1392836941523
1747959929360314,75389404,1,815,100,75836892,75279824,557068,179.51129844112387
1747959929454506,75481964,1,816,100,75931084,75372384,558700,178.9869339538214
1747959929548542,75574524,1,817,100,76025120,75464944,560176,178.51532375539117
1747959929642241,75667084,1,818,100,76118819,75557504,561315,178.15308694761407
1747959929732839,75759652,1,819,100,76209417,75650072,559345,178.7805379506387
1747959929827137,75852204,1,820,100,76303715,75742624,561091,178.22420962018637
1747959929921226,75944764,1,821,100,76397804,75835184,562620,177.73985994099036
1747959930011574,76037324,1,822,100,76488152,75927744,560408,178.44142125023197
1747959930105322,76129884,1,823,100,76581900,76020304,561596,178.06394632440401
1747959930199717,76222444,1,824,100,76676295,76112864,563431,177.48402200091937
1747959930292903,76315004,1,825,100,76769481,76205424,564057,177.28704723104224
1747959930384147,76407564,1,826,100,76860725,76297984,562741,177.70164249628158
1747959930478030,76500124,1,827,100,76954608,76390544,564064,177.28484710954785
1747959930572486,76592684,1,828,100,77049064,76483104,565960,176.6909322213584
1747959930666785,76685244,1,829,100,77143363,76575664,567699,176.14968495628847
1747959930760281,76777804,1,830,100,77236859,76668224,568635,175.85973427594152
1747959930850964,76870364,1,831,100,77327542,76760784,566758,176.44214991230825
1747959930944754,76962924,1,832,100,77421332,76853344,567988,176.06005760685085
1747959931039020,77055484,1,833,100,77515598,76945904,569694,175.53282990517715
1747959931133579,77148044,1,834,100,77610157,77038464,571693,174.91905620674032
1747959931223719,77240604,1,835,100,77700297,77131024,569273,175.6626434065905
1747959931318020,77333164,1,836,100,77794598,77223584,571014,175.127054678169
1747959931412146,77425724,1,837,100,77888724,77316144,572580,174.64808411051732
1747959931505749,77518284,1,838,100,77982327,77408704,573623,174.33052719294727
1747959931596644,77610844,1,839,100,78073222,77501264,571958,174.8380125813434
1747959931690353,77703404,1,840,100,78166931,77593824,573107,174.48748662989632
1747959931784716,77795964,1,841,100,78261294,77686384,574910,173.94026891165572
1747959931879113,77888532,1,842,100,78355691,77778952,576739,173.3886558738008
1747959931968976,77981084,1,843,100,78445554,77871504,574050,174.20085358418257
1747959932063289,78073644,1,844,100,78539867,77964064,575803,173.67050883722385
1747959932157571,78166204,1,845,100,78634149,78056624,577525,173.1526773732739
1747959932251355,78258764,1,846,100,78727933,78149184,578749,172.7864756569774
1747959932346013,78351324,1,847,100,78822591,78241744,580847,172.16237666717743
1747959932436050,78443884,1,848,100,78912628,78334304,578324,172.9134533583251
1747959932528963,78536444,1,849,100,79005541,78426864,578677,172.80797405115462
1747959932623819,78629004,1,850,100,79100397,78519424,580973,172.12503851297737
1747959932718667,78721564,1,851,100,79195245,78611984,583261,171.44983120764115
1747959932808983,78814124,1,852,100,79285561,78704544,581017,172.11200360746759
1747959932902875,78906684,1,853,100,79379453,78797104,582349,171.7183338513503
1747959932997271,78999244,1,854,100,79473849,78889664,584185,171.17865059869735
1747959933091171,79091804,1,855,100,79567749,78982224,585525,170.78690064472056
1747959933180936,79184364,1,856,100,79657514,79074784,582730,171.60606112607897
1747959933275697,79276924,1,857,100,79752275,79167344,584931,170.96033549256236
1747959933369912,79369484,1,858,100,79846490,79259904,586586,170.47798617764488
1747959933464097,79462044,1,859,100,79940675,79352464,588211,170.00702128997926
1747959933553740,79554604,1,860,100,80030318,79445024,585294,170.85430569935792
1747959933652257,79647164,1,861,100,80128835,79537584,591251,169.1329063291225
1747959933742433,79739724,1,862,100,80219011,79630144,588867,169.81763284408873
1747959933841279,79832284,1,863,100,80317857,79722704,595153,168.02402071400127
1747959933930992,79924844,1,864,100,80407570,79815264,592306,168.83165120731513
1747959934021141,80017404,1,865,100,80497719,79907824,589895,169.52169453885864
1747959934114740,80109964,1,866,100,80591318,80000384,590934,169.22363580366
1747959934208753,80202524,1,867,100,80685331,80092944,592387,168.8085660218742
1747959934303827,80295084,1,868,100,80780405,80185504,594901,168.0951956712125
1747959934393764,80387644,1,869,100,80870342,80278064,592278,168.83963274003088
1747959934488028,80480204,1,870,100,80964606,80370624,593982,168.3552700250176
1747959934582369,80572764,1,871,100,81058947,80463184,595763,167.85198140871452
1747959934676390,80665324,1,872,100,81152968,80555744,597224,167.44136203501535
1747959934766719,80757884,1,873,100,81243297,80648304,594993,168.06920417551132
1747959934864703,80850444,1,874,100,81341281,80740864,600417,166.55091378158846
1747959934954813,80943004,1,875,100,81431391,80833424,597967,167.23330886152579
1747959935048962,81035564,1,876,100,81525540,80925984,599556,166.79009133425402
1747959935139172,81128124,1,877,100,81615750,81018544,597206,167.44640877687095
1747959935237324,81220684,1,878,100,81713902,81111104,602798,165.89305206719334
1747959935327589,81313244,1,879,100,81804167,81203664,600503,166.52706148012584
1747959935421836,81405804,1,880,100,81898414,81296224,602190,166.0605456749531
1747959935515948,81498364,1,881,100,81992526,81388784,603742,165.6336647110852
1747959935605966,81590924,1,882,100,82082544,81481344,601200,166.33399866932803
1747959935700237,81683492,1,883,100,82176815,81573912,602903,165.86416056977657
1747959935794534,81776044,1,884,100,82271112,81666464,604648,165.3854804778979
1747959935888714,81868604,1,885,100,82365292,81759024,606268,164.94355631502899
1747959935978781,81961164,1,886,100,82455359,81851584,603775,165.62461181731607
1747959936072513,82053724,1,887,100,82549091,81944144,604947,165.3037373521978
1747959936166895,82146284,1,888,100,82643473,82036704,606769,164.80736491152317
1747959936261219,82238844,1,889,100,82737797,82129264,608533,164.32962550921644
1747959936350806,82331404,1,890,100,82827384,82221824,605560,165.13640266860426
1747959936445665,82423964,1,891,100,82922243,82314384,607859,164.5118358040269
1747959936539174,82516524,1,892,100,83015752,82406944,608808,164.25539743235962
1747959936632990,82609084,1,893,100,83109568,82499504,610064,163.91722835636915
1747959936724329,82701644,1,894,100,83200907,82592064,608843,164.24595503274242
1747959936821745,82794204,1,895,100,83298323,82684624,613699,162.94633036716698
1747959936912480,82886764,1,896,100,83389058,82777184,611874,163.43234064529625
1747959937006330,82979324,1,897,100,83482908,82869744,613164,163.08850486982274
1747959937100409,83071884,1,898,100,83576987,82962304,614683,162.68548178492003
1747959937190281,83164444,1,899,100,83666859,83054864,611995,163.40002777800473
1747959937285736,83257004,1,900,100,83762314,83147424,614890,162.6307144367285
1747959937379389,83349564,1,901,100,83855967,83239984,615983,162.3421425591291
1747959937472834,83442124,1,902,100,83949412,83332544,616868,162.1092356873756
1747959937563565,83534684,1,903,100,84040143,83425104,615039,162.59131534748204
1747959937657740,83627244,1,904,100,84134318,83517664,616654,162.16549312904806
1747959937753083,83719804,1,905,100,84229661,83610224,619437,161.4369177172174
1747959937845835,83812372,1,906,100,84322413,83702792,619621,161.38897810112957
1747959937936198,83904924,1,907,100,84412776,83795344,617432,161.96115523652807
1747959938030035,83997484,1,908,100,84506613,83887904,618709,161.62687143713765
1747959938124215,84090044,1,909,100,84600793,83980464,620329,161.20478004413786
1747959938219058,84182604,1,910,100,84695636,84073024,622612,160.61367272073136
1747959938308910,84275164,1,911,100,84785488,84165584,619904,161.31530043361553
1747959938402979,84367724,1,912,100,84879557,84258144,621413,160.92357256768042
1747959938497466,84460284,1,913,100,84974044,84350704,623340,160.426091699554
1747959938591609,84552844,1,914,100,85068187,84443264,624923,160.01971442881762
1747959938685642,84645404,1,915,100,85162220,84535824,626396,159.64342045606932
1747959938776034,84737964,1,916,100,85252612,84628384,624228,160.1978764169502
1747959938870272,84830524,1,917,100,85346850,84720944,625906,159.76839972775466
1747959938964557,84923084,1,918,100,85441135,84813504,627631,159.32928743162782
1747959939066605,85015644,1,919,100,85543183,84906064,637119,156.95654971834148
1747959939152576,85108204,1,920,100,85629154,84998624,630530,158.59673607917148
1747959939243008,85200764,1,921,100,85719586,85091184,628402,159.13380288414103
1747959939337235,85293324,1,922,100,85813813,85183744,630069,158.71277590232182
1747959939431553,85385884,1,923,100,85908131,85276304,631827,158.27117233040056
1747959939521822,85478444,1,924,100,85998400,85368864,629536,158.84715091750115
1747959939615476,85571004,1,925,100,86092054,85461424,630630,158.5715871430157
1747959939710037,85663564,1,926,100,86186615,85553984,632631,158.07002818388602
1747959939808267,85756124,1,927,100,86284845,85646544,638301,156.66589900376155
1747959939894462,85848684,1,928,100,86371040,85739104,631936,158.24387279724527
1747959939988194,85941244,1,929,100,86464772,85831664,633108,157.9509341218244
1747959940082741,86033804,1,930,100,86559319,85924224,635095,157.45675843771406
1747959940176549,86126364,1,931,100,86653127,86016784,636343,157.1479532264832
1747959940270898,86218924,1,932,100,86747476,86109344,638132,156.70738969366838
1747959940361453,86311484,1,933,100,86838031,86201904,636127,157.20131357417623
1747959940455532,86404044,1,934,100,86932110,86294464,637646,156.8268286792358
1747959940549719,86496604,1,935,100,87026297,86387024,639273,156.4276920814738
1747959940643927,86589164,1,936,100,87120505,86479584,640921,156.02546959765712
1747959940734056,86681724,1,937,100,87210634,86572144,638490,156.6195241898855
1747959940828222,86774284,1,938,100,87304800,86664704,640096,156.22656601509775
1747959940922268,86866844,1,939,100,87398846,86757264,641582,155.86472189057673
1747959941016136,86959404,1,940,100,87492714,86849824,642890,155.54760534461573
1747959941106514,87051964,1,941,100,87583092,86942384,640708,156.0773394432409
1747959941200574,87144524,1,942,100,87677152,87034944,642208,155.71279087149335
1747959941295136,87237084,1,943,100,87771714,87127504,644210,155.2288849909191
1747959941389322,87329644,1,944,100,87865900,87220064,645836,154.83807034603214
1747959941479182,87422204,1,945,100,87955760,87312624,643136,155.48810826947954
1747959941573577,87514764,1,946,100,88050155,87405184,644971,155.04573073828126
1747959941667784,87607332,1,947,100,88144362,87497752,646610,154.65272730084595
1747959941762205,87699884,1,948,100,88238783,87590304,648479,154.2069982219933
1747959941855451,87792444,1,949,100,88332029,87682864,649165,154.0440411913766
1747959941946351,87885004,1,950,100,88422929,87775424,647505,154.43896186129837
1747959942040237,87977564,1,951,100,88516815,87867984,648831,154.1233387430625
1747959942133971,88070124,1,952,100,88610549,87960544,650005,153.84497042330443
1747959942228692,88162684,1,953,100,88705270,88053104,652166,153.33519380035145
1747959942318359,88255244,1,954,100,88794937,88145664,649273,154.01841752236732
1747959942413027,88347804,1,955,100,88889605,88238224,651381,153.5199829285779
1747959942507050,88440364,1,956,100,88983628,88330784,652844,153.1759501504188
1747959942601068,88532924,1,957,100,89077646,88423344,654302,152.83462376700666
1747959942691560,88625484,1,958,100,89168138,88515904,652234,153.31920752368015
1747959942784700,88718044,1,959,100,89261278,88608464,652814,153.1829893354003
1747959942879171,88810604,1,960,100,89355749,88701024,654725,152.73588147695597
1747959942973890,88903164,1,961,100,89450468,88793584,656884,152.23387995445162
1747959943063940,88995724,1,962,100,89540518,88886144,654374,152.8178075534786
1747959943158243,89088284,1,963,100,89634821,88978704,656117,152.41184118076504
1747959943251997,89180844,1,964,100,89728575,89071264,657311,152.1349863306715
1747959943346681,89273404,1,965,100,89823259,89163824,659435,151.64496879904766
1747959943440758,89365964,1,966,100,89917336,89256384,660952,151.29691717401568
1747959943531288,89458524,1,967,100,90007866,89348944,658922,151.7630311326682
1747959943625054,89551084,1,968,100,90101632,89441504,660128,151.48577245625088
1747959943718895,89643644,1,969,100,90195473,89534064,661409,151.19237869457476
1747959943813788,89736212,1,970,100,90290366,89626632,663734,150.6627655054585
1747959943906063,89828764,1,971,100,90382641,89719184,663457,150.72566873211076
1747959943998304,89921324,1,972,100,90474882,89811744,663138,150.79817473889295
1747959944091920,90013884,1,973,100,90568498,89904304,664194,150.55842118417212
1747959944185902,90106444,1,974,100,90662480,89996864,665616,150.2367731544915
1747959944276623,90199004,1,975,100,90753201,90089424,663777,150.65300545213228
1747959944370289,90291564,1,976,100,90846867,90181984,664883,150.40240162554915
1747959944464964,90384124,1,977,100,90941542,90274544,666998,149.92548703294463
1747959944558941,90476684,1,978,100,91035519,90367104,668415,149.60765392757494
1747959944653182,90569244,1,979,100,91129760,90459664,670096,149.2323487977842
1747959944743497,90661804,1,980,100,91220075,90552224,667851,149.73399755334648
1747959944837700,90754364,1,981,100,91314278,90644784,669494,149.3665365186245
1747959944931759,90846924,1,982,100,91408337,90737344,670993,149.0328513114146
1747959945025191,90939484,1,983,100,91501769,90829904,671865,148.83942458678453
1747959945115638,91032044,1,984,100,91592216,90922464,669752,149.3089979574529
1747959945210334,91124604,1,985,100,91686912,91015024,671888,148.83432953111233
1747959945304849,91217164,1,986,100,91781427,91107584,673843,148.4025210620278
1747959945399021,91309724,1,987,100,91875599,91200144,675455,148.04835259195653
1747959945493232,91402284,1,988,100,91969810,91292704,677106,147.6873635737979
1747959945582700,91494844,1,989,100,92059278,91385264,674014,148.36487075936108
1747959945677261,91587404,1,990,100,92153839,91477824,676015,147.92571170758043
1747959945771272,91679964,1,991,100,92247850,91570384,677466,147.60888369305619
1747959945861752,91772524,1,992,100,92338330,91662944,675386,148.06347777419134
1747959945960194,91865084,1,993,100,92436772,91755504,681268,146.78511246675316
1747959946050147,91957644,1,994,100,92526725,91848064,678661,147.3489709884611
1747959946144267,92050204,1,995,100,92620845,91940624,680221,147.01104493980634
1747959946237940,92142764,1,996,100,92714518,92033184,681334,146.77089357055425
1747959946327923,92235324,1,997,100,92804501,92125744,678757,147.32813068594504
1747959946422890,92327884,1,998,100,92899468,92218304,681164,146.80752359196904
1747959946517194,92420444,1,999,100,92993772,92310864,682908,146.4326087847851
1747959946610979,92513004,1,1000,100,93087557,92403424,684133,146.170408385504
1747959946705447,92606604,1,1001,100,93182025,92497024,685001,145.98518834279074
1747959946799648,92700204,1,1002,100,93276226,92590624,685602,145.8572174526912
1747959946893670,92793804,1,1003,100,93370248,92684224,686024,145.7674950147517
1747959946988223,92887404,1,1004,100,93464801,92777824,686977,145.56528093371395
1747959947082103,92981004,1,1005,100,93558681,92871424,687257,145.5059752028717
1747959947176647,93074604,1,1006,100,93653225,92965024,688201,145.30638577973588
1747959947270550,93168204,1,1007,100,93747128,93058624,688504,145.2424386786424
1747959947364843,93261804,1,1008,100,93841421,93152224,689197,145.09639478987867
1747959947459178,93355404,1,1009,100,93935756,93245824,689932,144.9418203533102
1747959947553183,93449004,1,1010,100,94029761,93339424,690337,144.85678733719908
1747959947647338,93542604,1,1011,100,94123916,93433024,690892,144.74042252624145
1747959947741582,93636204,1,1012,100,94218160,93526624,691536,144.60563152171397
1747959947835868,93729812,1,1013,100,94312446,93620232,692214,144.4639952384667
1747959947930189,93823404,1,1014,100,94406767,93713824,692943,144.31201411948746
1747959948024246,93917004,1,1015,100,94500824,93807424,693400,144.21690222094028
1747959948118436,94010604,1,1016,100,94595014,93901024,693990,144.0942953068488
1747959948212595,94104204,1,1017,100,94689173,93994624,694549,143.97832262374578
1747959948305632,94197804,1,1018,100,94782210,94088224,693986,144.0951258382734
1747959948401174,94291404,1,1019,100,94877752,94181824,695928,143.6930257153039
1747959948495223,94385004,1,1020,100,94971801,94275424,696377,143.60037738179176
1747959948588993,94478604,1,1021,100,95065571,94369024,696547,143.56533012129833
1747959948683706,94572204,1,1022,100,95160284,94462624,697660,143.33629561677608
1747959948777453,94665804,1,1023,100,95254031,94556224,697807,143.30610039738784
1747959948875281,94759404,1,1024,100,95351859,94649824,702035,142.44304058914443
1747959948966276,94853004,1,1025,100,95442854,94743424,699430,142.97356418798165
1747959949060490,94946604,1,1026,100,95537068,94837024,700044,142.84816382970214
1747959949154788,95040204,1,1027,100,95631366,94930624,700742,142.70587463003503
1747959949248885,95133804,1,1028,100,95725463,95024224,701239,142.6047324806521
1747959949342566,95227404,1,1029,100,95819144,95117824,701320,142.5882621342611
1747959949437057,95321004,1,1030,100,95913635,95211424,702211,142.40733910462808
1747959949531510,95414604,1,1031,100,96008088,95305024,703064,142.23456186065565
1747959949625729,95508204,1,1032,100,96102307,95398624,703683,142.10944416733105
1747959949723360,95601804,1,1033,100,96199938,95492224,707714,141.30001667340198
1747959949817685,95695404,1,1034,100,96294263,95585824,708439,141.15541352184167
1747959949912412,95789004,1,1035,100,96388990,95679424,709566,140.93121711017722
1747959950005956,95882604,1,1036,100,96482534,95773024,709510,140.94234048850615
1747959950100543,95976204,1,1037,100,96577121,95866624,710497,140.74654783904788
1747959950194798,96069804,1,1038,100,96671376,95960224,711152,140.61691452741468
1747959950289224,96163404,1,1039,100,96765802,96053824,711978,140.4537780661762
1747959950383391,96257004,1,1040,100,96859969,96147424,712545,140.3420134868675
1747959950477001,96350604,1,1041,100,96953579,96241024,712555,140.34004392643374
1747959950571741,96444204,1,1042,100,97048319,96334624,713695,140.11587582931085
1747959950665685,96537804,1,1043,100,97142263,96428224,714039,140.0483727079333
1747959950759828,96631404,1,1044,100,97236406,96521824,714582,139.94195207827792
1747959950854294,96725012,1,1045,100,97330872,96615432,715440,139.77412501397743
1747959950948668,96818604,1,1046,100,97425246,96709024,716222,139.6215139998492
1747959951041439,96912204,1,1047,100,97518017,96802624,715393,139.7833079160685
1747959951136629,97005804,1,1048,100,97613207,96896224,716983,139.473320845822
1747959951231049,97099404,1,1049,100,97707627,96989824,717803,139.31399005019483
1747959951325150,97193004,1,1050,100,97801728,97083424,718304,139.2168218470174
1747959951418938,97286604,1,1051,100,97895516,97177024,718492,139.18039449291015
1747959951513576,97380204,1,1052,100,97990154,97270624,719530,138.97961169096493
1747959951607278,97473804,1,1053,100,98083856,97364224,719632,138.95991284434265
1747959951701817,97567404,1,1054,100,98178395,97457824,720571,138.7788295671072
1747959951795515,97661004,1,1055,100,98272093,97551424,720669,138.75995776146885
1747959951890368,97754604,1,1056,100,98366946,97645024,721922,138.5191197941052
1747959951984654,97848204,1,1057,100,98461232,97738624,722608,138.38761818302592
1747959952082024,97941804,1,1058,100,98558602,97832224,726378,137.66936773966174
1747959952173081,98035404,1,1059,100,98649659,97925824,723835,138.1530321136723
1747959952267143,98129004,1,1060,100,98743721,98019424,724297,138.06490983671063
1747959952360901,98222604,1,1061,100,98837479,98113024,724455,138.03479857272018
1747959952454894,98316204,1,1062,100,98931472,98206624,724848,137.95995850164448
1747959952549637,98409804,1,1063,100,99026215,98300224,725991,137.74275438676236
1747959952643906,98503404,1,1064,100,99120484,98393824,726660,137.61594143065534
1747959952738411,98597004,1,1065,100,99214989,98487424,727565,137.44476438531265
1747959952836428,98690604,1,1066,100,99313006,98581024,731982,136.61538125254447
1747959952925891,98784204,1,1067,100,99402469,98674624,727845,137.39188975674767
1747959953020125,98877804,1,1068,100,99496703,98768224,728479,137.2723167037073
1747959953115142,98971404,1,1069,100,99591720,98861824,729896,137.00582000723392
1747959953209357,99065004,1,1070,100,99685935,98955424,730511,136.89047803523835
1747959953303012,99158604,1,1071,100,99779590,99049024,730566,136.88017235951304
1747959953397351,99252204,1,1072,100,99873929,99142624,731305,136.7418518949002
1747959953491378,99345804,1,1073,100,99967956,99236224,731732,136.66205659995734
1747959953586122,99439404,1,1074,100,100062700,99329824,732876,136.44873075390655
1747959953679910,99533004,1,1075,100,100156488,99423424,733064,136.41373740901201
1747959953774472,99626604,1,1076,100,100251050,99517024,734026,136.23495625495556
1747959953868853,99720212,1,1077,100,100345431,99610632,734799,136.091638665812
1747959953962958,99813804,1,1078,100,100439536,99704224,735312,135.99669256043694
1747959954057250,99907404,1,1079,100,100533828,99797824,736004,135.86882679985436
1747959954155395,100001004,1,1080,100,100631973,99891424,740549,135.03495379779056
1747959954249560,100095644,1,1081,100,100726138,99986064,740074,135.12162297283786
1747959954343841,100190284,1,1082,100,100820419,100080704,739715,135.18720047585893
1747959954441750,100284924,1,1083,100,100918328,100175344,742984,134.59240037470525
1747959954536459,100379564,1,1084,100,101013037,100269984,743053,134.57990210657923
1747959954630408,100474204,1,1085,100,101106986,100364624,742362,134.70517079268606
1747959954724861,100568844,1,1086,100,101201439,100459264,742175,134.73911139556034
1747959954823013,100663484,1,1087,100,101299591,100553904,745687,134.10452374789958
1747959954917345,100758124,1,1088,100,101393923,100648544,745379,134.15993742780518
1747959955011637,100852772,1,1089,100,101488215,100743192,745023,134.224044089914
1747959955109285,100947404,1,1090,100,101585863,100837824,748039,133.68286947605674
1747959955203662,101042044,1,1091,100,101680240,100932464,747776,133.72988702499146
1747959955299510,101136684,1,1092,100,101776088,101027104,748984,133.51420057037268
1747959955392328,101231324,1,1093,100,101868906,101121744,747162,133.8397830724796
1747959955490615,101325964,1,1094,100,101967193,101216384,750809,133.18966608018818
1747959955584854,101420604,1,1095,100,102061432,101311024,750408,133.2608394366798
1747959955679407,101515244,1,1096,100,102155985,101405664,750321,133.27629108075078
1747959955773330,101609884,1,1097,100,102249908,101500304,749604,133.40377052417008
1747959955870930,101704524,1,1098,100,102347508,101594944,752564,132.8790641061757
1747959955965240,101799164,1,1099,100,102441818,101689584,752234,132.93735725851266
1747959956060128,101893804,1,1100,100,102536706,101784224,752482,132.89354429740513
1747959956157570,101988444,1,1101,100,102634148,101878864,755284,132.4005274837015
1747959956252457,102083084,1,1102,100,102729035,101973504,755531,132.35724278686118
1747959956346746,102177724,1,1103,100,102823324,102068144,755180,132.41876109007126
1747959956441092,102272364,1,1104,100,102917670,102162784,754886,132.47033326886444
1747959956539173,102367004,1,1105,100,103015751,102257424,758327,131.8692331935959
1747959956633333,102461644,1,1106,100,103109911,102352064,757847,131.9527556353723
1747959956726940,102556284,1,1107,100,103203518,102446704,756814,132.13286223563517
1747959956821583,102650924,1,1108,100,103298161,102541344,756817,132.13233846491292
1747959956919474,102745564,1,1109,100,103396052,102635984,760068,131.56717556850177
1747959957013985,102840204,1,1110,100,103490563,102730624,759939,131.5895091579719
1747959957107813,102934844,1,1111,100,103584391,102825264,759127,131.73026384254544
1747959957206441,103029484,1,1112,100,103683019,102919904,763115,131.04184821422723
1747959957301032,103124124,1,1113,100,103777610,103014544,763066,131.05026301787788
1747959957395340,103218764,1,1114,100,103871918,103109184,762734,131.10730608573894
1747959957489511,103313404,1,1115,100,103966089,103203824,762265,131.1879726866641
1747959957587683,103408044,1,1116,100,104064261,103298464,765797,130.58290904769802
1747959957681854,103502684,1,1117,100,104158432,103393104,765328,130.66293144899964
1747959957776066,103597324,1,1118,100,104252644,103487744,764900,130.73604392731076
1747959957874279,103691964,1,1119,100,104350857,103582384,768473,130.128189279259
1747959957968128,103786604,1,1120,100,104444706,103677024,767682,130.2622700545278
1747959958062690,103881244,1,1121,100,104539268,103771664,767604,130.27550664144533
1747959958157003,103975884,1,1122,100,104633581,103866304,767277,130.33102777745196
1747959958254881,104070524,1,1123,100,104731459,103960944,770515,129.78332673601423
1747959958348654,104165164,1,1124,100,104825232,104055584,769648,129.92952622497558
1747959958443819,104259804,1,1125,100,104920397,104150224,770173,129.84095781077758
1747959958537839,104354444,1,1126,100,105014417,104244864,769553,129.94556580248533
1747959958635535,104449084,1,1127,100,105112113,104339504,772609,129.43157535053305
1747959958730456,104543724,1,1128,100,105207034,104434144,772890,129.38451784859424
1747959958824007,104638364,1,1129,100,105300585,104528784,771801,129.5670775238695
1747959958922407,104733004,1,1130,100,105398985,104623424,775561,128.9389229216013
1747959959017179,104827644,1,1131,100,105493757,104718064,775693,128.91698133153193
1747959959111065,104922284,1,1132,100,105587643,104812704,774939,129.04241495137035
1747959959205274,105016924,1,1133,100,105681852,104907344,774508,129.1142247723716
1747959959302801,105111572,1,1134,100,105779379,105001992,777387,128.63605900278753
1747959959397924,105206204,1,1135,100,105874502,105096624,777878,128.55486335903575
1747959959492312,105300844,1,1136,100,105968890,105191264,777626,128.596523264397
1747959959589956,105395484,1,1137,100,106066534,105285904,780630,128.10166147854937
1747959959684383,105490124,1,1138,100,106160961,105380544,780417,128.13662439439426
1747959959781429,105584764,1,1139,100,106258007,105475184,782823,127.7427975417176
1747959959872382,105679404,1,1140,100,106348960,105569824,779136,128.34729751930342
1747959959971457,105774044,1,1141,100,106448035,105664464,783571,127.62085375798746
1747959960065500,105868684,1,1142,100,106542078,105759104,782974,127.71816177804116
1747959960159722,105963324,1,1143,100,106636300,105853744,782556,127.78638206083653
1747959960254154,106057964,1,1144,100,106730732,105948384,782348,127.8203561586404
1747959960352182,106152604,1,1145,100,106828760,106043024,785736,127.2692100145596
1747959960446110,106247244,1,1146,100,106922688,106137664,785024,127.38464046959074
1747959960540576,106341884,1,1147,100,107017154,106232304,784850,127.4128814423138
1747959960638697,106436524,1,1148,100,107115275,106326944,788331,126.85026974709862
1747959960733297,106531164,1,1149,100,107209875,106421584,788291,126.85670647007261
1747959960827447,106625804,1,1150,100,107304025,106516224,787801,126.93560937343314
1747959960921554,106720444,1,1151,100,107398132,106610864,787268,127.02154793539177
1747959961018955,106815084,1,1152,100,107495533,106705504,790029,126.57763196034577
1747959961113278,106909732,1,1153,100,107589856,106800152,789704,126.62972455502316
1747959961207963,107004364,1,1154,100,107684541,106894784,789757,126.62122652917289
1747959961306174,107099004,1,1155,100,107782752,106989424,793328,126.05126757154669
1747959961400129,107193644,1,1156,100,107876707,107084064,792643,126.16020074611143
1747959961494262,107288284,1,1157,100,107970840,107178704,792136,126.24094852399084
1747959961592466,107382924,1,1158,100,108069044,107273344,795700,125.67550584391103
1747959961687347,107477564,1,1159,100,108163925,107367984,795941,125.63745302729725
1747959961781576,107572204,1,1160,100,108258154,107462624,795530,125.702361947381
1747959961875290,107666844,1,1161,100,108351868,107557264,794604,125.84885049659957
1747959961969381,107761484,1,1162,100,108445959,107651904,794055,125.93586086606092
1747959962067512,107856124,1,1163,100,108544090,107746544,797546,125.3846173136095
1747959962161625,107950764,1,1164,100,108638203,107841184,797019,125.46752335891615
1747959962256785,108045404,1,1165,100,108733363,107935824,797539,125.38571781442663
1747959962354504,108140044,1,1166,100,108831082,108030464,800618,124.90351203695144
1747959962449332,108234684,1,1167,100,108925910,108125104,800806,124.87418925432627
1747959962543157,108329324,1,1168,100,109019735,108219744,799991,125.00140626582049
1747959962637046,108423964,1,1169,100,109113624,108314384,799240,125.11886291977379
1747959962734834,108518604,1,1170,100,109211412,108409024,802388,124.62798546339178
1747959962829961,108613244,1,1171,100,109306539,108503664,802875,124.55238984898023
1747959962923956,108707884,1,1172,100,109400534,108598304,802230,124.65253106964337
1747959963018358,108802524,1,1173,100,109494936,108692944,801992,124.68952308751209
1747959963116819,108897164,1,1174,100,109593397,108787584,805813,124.098270938791
1747959963214167,108991804,1,1175,100,109690745,108882224,808521,123.68262543582665
1747959963305290,109086444,1,1176,100,109781868,108976864,805004,124.22298522740259
1747959963402701,109181084,1,1177,100,109879279,109071504,807775,123.79684937018352
1747959963497011,109275724,1,1178,100,109973589,109166144,807445,123.84744471759687
1747959963591765,109370364,1,1179,100,110068343,109260784,807559,123.82996164986088
1747959963685926,109465004,1,1180,100,110162504,109355424,807080,123.90345442830946
1747959963784534,109559644,1,1181,100,110261112,109450064,811048,123.29726477347826
1747959963878677,109654284,1,1182,100,110355255,109544704,810551,123.3728661120645
1747959963972831,109748924,1,1183,100,110449409,109639344,810065,123.44688389203336
1747959964071153,109843564,1,1184,100,110547731,109733984,813747,122.88831786783852
1747959964164853,109938204,1,1185,100,110641431,109828624,812807,123.03043649968566
1747959964259421,110032844,1,1186,100,110735999,109923264,812735,123.04133573674076
1747959964353204,110127484,1,1187,100,110829782,110017904,811878,123.17121537965063
1747959964452053,110222124,1,1188,100,110928631,110112544,816087,122.53595511262893
1747959964546356,110316764,1,1189,100,111022934,110207184,815750,122.5865767698437
1747959964640049,110411404,1,1190,100,111116627,110301824,814803,122.72905229853104
1747959964734593,110506044,1,1191,100,111211171,110396464,814707,122.74351392586537
1747959964833141,110600684,1,1192,100,111309719,110491104,818615,122.15754658783433
