Tempo total receptor,Tempo total emissor,Id do pacote,Id da mensagem,Distancia (m),Tempo zerado receptor,Tempo zerado emissor,Delta tempo,Velocidade (m/s)
1747959653989507,109580,1,1,50,0,0,0,0
1747959654076481,197404,1,2,50,86974,87824,-850,0
1747959654165610,285804,1,3,50,176103,176224,-121,0
1747959654255677,374204,1,4,50,266170,264624,1546,32341.526520051746
1747959654342580,462604,1,5,50,353073,353024,49,1020408.1632653062
1747959654432237,551004,1,6,50,442730,441424,1306,38284.83920367534
1747959654522744,639404,1,7,50,533237,529824,3413,14649.86815118664
1747959654612640,727804,1,8,50,623133,618224,4909,10185.373803218577
1747959654698790,816204,1,9,50,709283,706624,2659,18804.0616773223
1747959654788462,904604,1,10,50,798955,795024,3931,12719.409819384382
1747959654879047,994044,1,11,50,889540,884464,5076,9850.275807722617
1747959654972112,1083484,1,12,50,982605,973904,8701,5746.465923457074
1747959655063380,1173964,1,13,50,1073873,1064384,9489,5269.259142164612
1747959655153363,1264444,1,14,50,1163856,1154864,8992,5560.498220640569
1747959655243570,1354924,1,15,50,1254063,1245344,8719,5734.602592040372
1747959655337835,1445404,1,16,50,1348328,1335824,12504,3998.72040946897
1747959655427474,1535884,1,17,50,1437967,1426304,11663,4287.061647946498
1747959655517430,1626364,1,18,50,1527923,1516784,11139,4488.733279468534
1747959655608018,1716844,1,19,50,1618511,1607264,11247,4445.629945763315
1747959655702232,1807324,1,20,50,1712725,1697744,14981,3337.5609104866166
1747959655792431,1897804,1,21,50,1802924,1788224,14700,3401.360544217687
1747959655882147,1988284,1,22,50,1892640,1878704,13936,3587.8300803673937
1747959655972515,2078764,1,23,50,1983008,1969184,13824,3616.8981481481483
1747959656066725,2169244,1,24,50,2077218,2059664,17554,2848.353651589381
1747959656156840,2259724,1,25,50,2167333,2150144,17189,2908.83704694863
1747959656246985,2350204,1,26,50,2257478,2240624,16854,2966.6548000474663
1747959656337057,2440684,1,27,50,2347550,2331104,16446,3040.2529490453608
1747959656430609,2531164,1,28,50,2441102,2421584,19518,2561.7378829798135
1747959656520946,2621644,1,29,50,2531439,2512064,19375,2580.6451612903224
1747959656611301,2712124,1,30,50,2621794,2602544,19250,2597.4025974025976
1747959656700888,2802604,1,31,50,2711381,2693024,18357,2723.756605109768
1747959656795527,2893084,1,32,50,2806020,2783504,22516,2220.6430982412508
1747959656885600,2983564,1,33,50,2896093,2873984,22109,2261.5224569179973
1747959656975641,3074044,1,34,50,2986134,2964464,21670,2307.3373327180434
1747959657065787,3164524,1,35,50,3076280,3054944,21336,2343.457067866517
1747959657159953,3255004,1,36,50,3170446,3145424,25022,1998.2415474382544
1747959657250508,3345484,1,37,50,3261001,3235904,25097,1992.269992429374
1747959657340397,3435964,1,38,50,3350890,3326384,24506,2040.3166571451889
1747959657430352,3526444,1,39,50,3440845,3416864,23981,2084.9839456236186
1747959657524108,3616924,1,40,50,3534601,3507344,27257,1834.3911655721465
1747959657614952,3707404,1,41,50,3625445,3597824,27621,1810.2168639803049
1747959657708610,3797884,1,42,50,3719103,3688304,30799,1623.4293321211728
1747959657794199,3888364,1,43,50,3804692,3778784,25908,1929.905820595955
1747959657889305,3978844,1,44,50,3899798,3869264,30534,1637.518831466562
1747959657979431,4069324,1,45,50,3989924,3959744,30180,1656.726308813784
1747959658068951,4159804,1,46,50,4079444,4050224,29220,1711.1567419575633
1747959658159667,4250284,1,47,50,4170160,4140704,29456,1697.447039652363
1747959658253522,4340772,1,48,50,4264015,4231192,32823,1523.322060750084
1747959658343994,4431244,1,49,50,4354487,4321664,32823,1523.322060750084
1747959658433470,4521724,1,50,50,4443963,4412144,31819,1571.3881643043464
1747959658524192,4612204,1,51,50,4534685,4502624,32061,1559.5271513677053
1747959658617670,4702684,1,52,50,4628163,4593104,35059,1426.1673179497418
1747959658708499,4793164,1,53,50,4718992,4683584,35408,1412.1102575689108
1747959658798116,4883644,1,54,50,4808609,4774064,34545,1447.3874656245478
1747959658892491,4974124,1,55,50,4902984,4864544,38440,1300.7284079084286
1747959658982645,5064604,1,56,50,4993138,4955024,38114,1311.8539119483653
1747959659072281,5155084,1,57,50,5082774,5045504,37270,1341.5615776764155
1747959659163294,5245564,1,58,50,5173787,5135984,37803,1322.646350818718
1747959659257330,5336044,1,59,50,5267823,5226464,41359,1208.926714862545
1747959659347431,5426524,1,60,50,5357924,5316944,40980,1220.1073694485115
1747959659440455,5517004,1,61,50,5450948,5407424,43524,1148.7914713721166
1747959659527702,5607484,1,62,50,5538195,5497904,40291,1240.9719292149612
1747959659621753,5697964,1,63,50,5632246,5588384,43862,1139.938899274999
1747959659711340,5788444,1,64,50,5721833,5678864,42969,1163.62959342782
1747959659801347,5878924,1,65,50,5811840,5769344,42496,1176.5813253012047
1747959659892241,5969404,1,66,50,5902734,5859824,42910,1165.2295502213938
1747959659985719,6059884,1,67,50,5996212,5950304,45908,1089.134791321774
1747959660076155,6150364,1,68,50,6086648,6040784,45864,1090.179661608233
1747959660165791,6240844,1,69,50,6176284,6131264,45020,1110.6175033318525
1747959660256497,6331324,1,70,50,6266990,6221744,45246,1105.0700614418954
1747959660349904,6421804,1,71,50,6360397,6312224,48173,1037.9258090631681
1747959660441012,6512284,1,72,50,6451505,6402704,48801,1024.5691686645766
1747959660531017,6602772,1,73,50,6541510,6493192,48318,1034.8110435034562
1747959660620403,6693244,1,74,50,6630896,6583664,47232,1058.6043360433603
1747959660714694,6783724,1,75,50,6725187,6674144,51043,979.5662480653567
1747959660804856,6874204,1,76,50,6815349,6764624,50725,985.7072449482504
1747959660895810,6964684,1,77,50,6906303,6855104,51199,976.5815738588644
1747959660985526,7055164,1,78,50,6996019,6945584,50435,991.3750371765639
1747959661079822,7145644,1,79,50,7090315,7036064,54251,921.6419973825367
1747959661169752,7236124,1,80,50,7180245,7126544,53701,931.0813578890524
1747959661259949,7326604,1,81,50,7270442,7217024,53418,936.0140776517279
1747959661349743,7417084,1,82,50,7360236,7307504,52732,948.1908518546613
1747959661444288,7507564,1,83,50,7454781,7397984,56797,880.3281863478704
1747959661534525,7598044,1,84,50,7545018,7488464,56554,884.1107613961877
1747959661624404,7688524,1,85,50,7634897,7578944,55953,893.6071345593623
1747959661714276,7779004,1,86,50,7724769,7669424,55345,903.4239768723462
1747959661807972,7869484,1,87,50,7818465,7759904,58561,853.8105565137207
1747959661898940,7959964,1,88,50,7909433,7850384,59049,846.7543904215144
1747959661988627,8050444,1,89,50,7999120,7940864,58256,858.2806921175501
1747959662080459,8140924,1,90,50,8090952,8031344,59608,838.8135820695209
1747959662173221,8231404,1,91,50,8183714,8121824,61890,807.8849571820973
1747959662262757,8321884,1,92,50,8273250,8212304,60946,820.3983854559774
1747959662352924,8412364,1,93,50,8363417,8302784,60633,824.6334504312833
1747959662443694,8502844,1,94,50,8454187,8393264,60923,820.7081069546805
1747959662537745,8593324,1,95,50,8548238,8483744,64494,775.2659162092598
1747959662627134,8683804,1,96,50,8637627,8574224,63403,788.6062173714178
1747959662718155,8774284,1,97,50,8728648,8664704,63944,781.934192418366
1747959662808210,8864764,1,98,50,8818703,8755184,63519,787.1660448054912
1747959662901949,8955244,1,99,50,8912442,8845664,66778,748.7495881877264
1747959662991703,9045724,1,100,50,9002196,8936144,66052,756.9793496033428
1747959663086310,9137244,1,101,50,9096803,9027664,69139,723.1808386005004
1747959663176505,9228764,1,102,50,9186998,9119184,67814,737.3108797593418
1747959663271039,9320284,1,103,50,9281532,9210704,70828,705.9355057321962
1747959663360345,9411804,1,104,50,9370838,9302224,68614,728.7142565657155
1747959663454739,9503324,1,105,50,9465232,9393744,71488,699.418084153984
1747959663544951,9594844,1,106,50,9555444,9485264,70180,712.4536905101168
1747959663639182,9686364,1,107,50,9649675,9576784,72891,685.9557421355174
1747959663729893,9777884,1,108,50,9740386,9668304,72082,693.6544490996366
1747959663823717,9869404,1,109,50,9834210,9759824,74386,672.1694942596725
1747959663914246,9960924,1,110,50,9924739,9851344,73395,681.2453164384494
1747959664007761,10052444,1,111,50,10018254,9942864,75390,663.2179334129195
1747959664102531,10145004,1,112,50,10113024,10035424,77600,644.3298969072165
1747959664196224,10237564,1,113,50,10206717,10127984,78733,635.0577267473614
1747959664286292,10330132,1,114,50,10296785,10220552,76233,655.8839347789016
1747959664380827,10422684,1,115,50,10391320,10313104,78216,639.2553953155365
1747959664474778,10515244,1,116,50,10485271,10405664,79607,628.08546987074
1747959664569481,10607804,1,117,50,10579974,10498224,81750,611.6207951070336
1747959664659392,10700364,1,118,50,10669885,10590784,79101,632.1032603886171
1747959664753105,10792924,1,119,50,10763598,10683344,80254,623.0219054501956
1747959664847998,10885484,1,120,50,10858491,10775904,82587,605.4221608727767
1747959664941557,10978044,1,121,50,10952050,10868464,83586,598.1862991410045
1747959665032065,11070604,1,122,50,11042558,10961024,81534,613.2411018716119
1747959665126661,11163164,1,123,50,11137154,11053584,83570,598.3008256551394
1747959665220571,11255724,1,124,50,11231064,11146144,84920,588.7894488930758
1747959665315046,11348284,1,125,50,11325539,11238704,86835,575.8046870501527
1747959665405074,11440844,1,126,50,11415567,11331264,84303,593.0987034862342
1747959665498711,11533404,1,127,50,11509204,11423824,85380,585.6172405715624
1747959665593377,11625964,1,128,50,11603870,11516384,87486,571.5200146309124
1747959665687471,11718524,1,129,50,11697964,11608944,89020,561.6715344866323
1747959665781683,11811084,1,130,50,11792176,11701504,90672,551.4381506970178
1747959665871605,11903644,1,131,50,11882098,11794064,88034,567.9623781720699
1747959665965625,11996204,1,132,50,11976118,11886624,89494,558.6966724026191
1747959666060041,12088764,1,133,50,12070534,11979184,91350,547.3453749315818
1747959666154392,12181324,1,134,50,12164885,12071744,93141,536.8205194275346
1747959666244062,12273884,1,135,50,12254555,12164304,90251,554.0104818783171
1747959666338676,12366444,1,136,50,12349169,12256864,92305,541.682465738584
1747959666432392,12459004,1,137,50,12442885,12349424,93461,534.9825060720515
1747959666526565,12551564,1,138,50,12537058,12441984,95074,525.906136272798
1747959666616777,12644124,1,139,50,12627270,12534544,92726,539.223087375709
1747959666711011,12736684,1,140,50,12721504,12627104,94400,529.6610169491526
1747959666805655,12829244,1,141,50,12816148,12719664,96484,518.2206376186725
1747959666899261,12921804,1,142,50,12909754,12812224,97530,512.6627704296113
1747959666989798,13014364,1,143,50,13000291,12904784,95507,523.5218360957836
1747959667083474,13106924,1,144,50,13093967,12997344,96623,517.4751353197479
1747959667177976,13199484,1,145,50,13188469,13089904,98565,507.2794602546543
1747959667271948,13292044,1,146,50,13282441,13182464,99977,500.11502645608493
1747959667366479,13384604,1,147,50,13376972,13275024,101948,490.4461097814572
1747959667456812,13477164,1,148,50,13467305,13367584,99721,501.39890293920035
1747959667550671,13569724,1,149,50,13561164,13460144,101020,494.95149475351417
1747959667644583,13662284,1,150,50,13655076,13552704,102372,488.41480092212714
1747959667739457,13754844,1,151,50,13749950,13645264,104686,477.6187837915289
1747959667829393,13847404,1,152,50,13839886,13737824,102062,489.8982971135192
1747959667923711,13939964,1,153,50,13934204,13830384,103820,481.60277403197847
1747959668017665,14032524,1,154,50,14028158,13922944,105214,475.2219286406752
1747959668111271,14125092,1,155,50,14121764,14015512,106252,470.5793773293679
1747959668202040,14217644,1,156,50,14212533,14108064,104469,478.6108797825192
1747959668295542,14310204,1,157,50,14306035,14200624,105411,474.3337981804555
1747959668390670,14402764,1,158,50,14401163,14293184,107979,463.05300104649973
1747959668484063,14495324,1,159,50,14494556,14385744,108812,459.5081424842848
1747959668574885,14587884,1,160,50,14585378,14478304,107074,466.9667706446009
1747959668668532,14680444,1,161,50,14679025,14570864,108161,462.27383252743596
1747959668763353,14773004,1,162,50,14773846,14663424,110422,452.80831718317
1747959668857702,14865564,1,163,50,14868195,14755984,112211,445.5891133667822
1747959668951892,14958124,1,164,50,14962385,14848544,113841,439.2090723025975
1747959669041763,15050684,1,165,50,15052256,14941104,111152,449.83446091838204
1747959669135881,15143244,1,166,50,15146374,15033664,112710,443.61636057137787
1747959669229858,15235804,1,167,50,15240351,15126224,114127,438.108423072542
1747959669324447,15328364,1,168,50,15334940,15218784,116156,430.4555942009022
1747959669414645,15420924,1,169,50,15425138,15311344,113794,439.39047752957094
1747959669517068,15513484,1,170,50,15527561,15403904,123657,404.34427488941185
1747959669889802,15893084,1,174,50,15900295,15783504,116791,428.1151801080562
1747959669983983,15985644,1,175,50,15994476,15876064,118412,422.25450123298316
1747959670078117,16078204,1,176,50,16088610,15968624,119986,416.7152834497358
1747959670171839,16170764,1,177,50,16182332,16061184,121148,412.7183279955096
1747959670360678,16359004,1,179,50,16371171,16249424,121747,410.6877376855282
1747959670454862,16451564,1,180,50,16465355,16341984,123371,405.28163020482936
1747959670548636,16544124,1,181,50,16559129,16434544,124585,401.3324236465064
1747959670638864,16636684,1,182,50,16649357,16527104,122253,408.9879184968876
1747959670733492,16729244,1,183,50,16743985,16619664,124321,402.184667111751
1747959670827580,16821804,1,184,50,16838073,16712224,125849,397.3015280216768
1747959670921904,16914364,1,185,50,16932397,16804784,127613,391.80961187339847
1747959671011850,17006924,1,186,50,17022343,16897344,124999,400.0032000256002
1747959671105362,17099484,1,187,50,17115855,16989904,125951,396.9797778501163
1747959671200351,17192044,1,188,50,17210844,17082464,128380,389.4687646050787
1747959671293664,17284604,1,189,50,17304157,17175024,129133,387.197695399317
1747959671384083,17377164,1,190,50,17394576,17267584,126992,393.72558901348117
1747959671478746,17469724,1,191,50,17489239,17360144,129095,387.3116697006081
1747959671573181,17562284,1,192,50,17583674,17452704,130970,381.76681682828126
1747959671666615,17654844,1,193,50,17677108,17545264,131844,379.23606686690334
1747959671761501,17747404,1,194,50,17771994,17637824,134170,372.66154878139673
1747959671850910,17839964,1,195,50,17861403,17730384,131019,381.6240392614812
1747959671945735,17932524,1,196,50,17956228,17822944,133284,375.13880135650186
1747959672039816,18025084,1,197,50,18050309,17915504,134805,370.9061236601016
1747959672133955,18117652,1,198,50,18144448,18008072,136376,366.6334252361119
1747959672224288,18210204,1,199,50,18234781,18100624,134157,372.69766020408923
1747959672318694,18302764,1,200,50,18329187,18193184,136003,367.6389491408277
1747959672412562,18395324,1,201,50,18423055,18285744,137311,364.1368863383123
1747959672506929,18487884,1,202,50,18517422,18378304,139118,359.4071220115298
1747959672597112,18580444,1,203,50,18607605,18470864,136741,365.6547780109843
1747959672695145,18673004,1,204,50,18705638,18563424,142214,351.5828258821213
1747959672801149,18765564,1,205,50,18811642,18655984,155658,321.21702707217105
1747959672878993,18858124,1,206,50,18889486,18748544,140942,354.75585701919937
1747959672969782,18950684,1,207,50,18980275,18841104,139171,359.27025026765637
1747959673063913,19043244,1,208,50,19074406,18933664,140742,355.2599792528172
1747959673158023,19135804,1,209,50,19168516,19026224,142292,351.390099232564
1747959673252194,19228364,1,210,50,19262687,19118784,143903,347.4562726280897
1747959673345904,19320924,1,211,50,19356397,19211344,145053,344.70159183195113
1747959673436573,19413484,1,212,50,19447066,19303904,143162,349.25469049049326
1747959673530635,19506044,1,213,50,19541128,19396464,144664,345.6284908477576
1747959673625068,19598604,1,214,50,19635561,19489024,146537,341.21075223322435
1747959673719003,19691164,1,215,50,19729496,19581584,147912,338.0388339012386
1747959673808765,19783724,1,216,50,19819258,19674144,145114,344.5566933583252
1747959673903698,19876284,1,217,50,19914191,19766704,147487,339.0129299531484
1747959673997052,19968844,1,218,50,20007545,19859264,148281,337.1976180360262
1747959674091466,20061404,1,219,50,20101959,19951824,150135,333.0336030905519
1747959674181597,20153964,1,220,50,20192090,20044384,147706,338.51028394242616
1747959674283950,20246524,1,221,50,20294443,20136944,157499,317.46233309417835
1747959674369808,20339084,1,222,50,20380301,20229504,150797,331.57158298905154
1747959674464644,20431644,1,223,50,20475137,20322064,153073,326.64153704441674
1747959674554818,20524204,1,224,50,20565311,20414624,150687,331.81362692203044
1747959674648390,20616764,1,225,50,20658883,20507184,151699,329.60006328321214
1747959674743117,20709324,1,226,50,20753610,20599744,153866,324.9580804076274
1747959674836858,20801884,1,227,50,20847351,20692304,155047,322.4828600359891
1747959674931432,20894444,1,228,50,20941925,20784864,157061,318.3476483659215
1747959675021645,20987004,1,229,50,21032138,20877424,154714,323.1769587755472
1747959675115589,21079564,1,230,50,21126082,20969984,156098,320.3115991236275
1747959675209726,21172124,1,231,50,21220219,21062544,157675,317.1079752655779
1747959675304142,21264684,1,232,50,21314635,21155104,159531,313.4187085895531
1747959675394338,21357244,1,233,50,21404831,21247664,157167,318.1329413935495
1747959675488725,21449804,1,234,50,21499218,21340224,158994,314.4772758720455
1747959675582351,21542364,1,235,50,21592844,21432784,160060,312.38285642883915
1747959675676366,21634924,1,236,50,21686859,21525344,161515,309.56877070241154
1747959675766511,21727484,1,237,50,21777004,21617904,159100,314.26775612822127
1747959675861358,21820044,1,238,50,21871851,21710464,161387,309.8142973101923
1747959675954923,21912612,1,239,50,21965416,21803032,162384,307.91210956744504
1747959676048218,22005164,1,240,50,22058711,21895584,163127,306.50965198894113
1747959676139753,22097724,1,241,50,22150246,21988144,162102,308.4477674550592
1747959676233918,22190284,1,242,50,22244411,22080704,163707,305.4237143188746
1747959676328126,22282844,1,243,50,22338619,22173264,165355,302.37972846300386
1747959676422072,22375404,1,244,50,22432565,22265824,166741,299.8662596481969
1747959676516292,22467964,1,245,50,22526785,22358384,168401,296.9103508886527
1747959676606387,22560524,1,246,50,22616880,22450944,165936,301.32099122553274
1747959676700736,22653084,1,247,50,22711229,22543504,167725,298.10702042033085
1747959676795150,22745644,1,248,50,22805643,22636064,169579,294.8478290354348
1747959676888798,22838204,1,249,50,22899291,22728624,170667,292.9681777965277
1747959676979252,22930764,1,250,50,22989745,22821184,168561,296.628520238964
1747959677073376,23023324,1,251,50,23083869,22913744,170125,293.9015429831007
1747959677167067,23115884,1,252,50,23177560,23006304,171256,291.96057364413514
1747959677262023,23208444,1,253,50,23272516,23098864,173652,287.93218621150345
1747959677351386,23301004,1,254,50,23361879,23191424,170455,293.33255111319704
1747959677445990,23393564,1,255,50,23456483,23283984,172499,289.8567527927698
1747959677539536,23486124,1,256,50,23550029,23376544,173485,288.20935527567224
1747959677632974,23578684,1,257,50,23643467,23469104,174363,286.75808514421067
1747959677727897,23671244,1,258,50,23738390,23561664,176726,282.9238482170139
1747959677818358,23763804,1,259,50,23828851,23654224,174627,286.3245660751201
1747959677912706,23856364,1,260,50,23923199,23746784,176415,283.422611455942
1747959678007465,23948924,1,261,50,24017958,23839344,178614,279.9332639098839
1747959678100835,24041492,1,262,50,24111328,23931912,179416,278.68194586881884
1747959678190773,24134044,1,263,50,24201266,24024464,176802,282.8022307439961
1747959678285384,24226604,1,264,50,24295877,24117024,178853,279.5591910675247
1747959678379805,24319164,1,265,50,24390298,24209584,180714,276.68027933641
1747959678473587,24411724,1,266,50,24484080,24302144,181936,274.8219153988216
1747959678564098,24504284,1,267,50,24574591,24394704,179887,277.9522700361894
1747959678658411,24596844,1,268,50,24668904,24487264,181640,275.2697643690817
1747959678743345,24689404,1,269,50,24753838,24579824,174014,287.3332030756146
1747959678846054,24781964,1,270,50,24856547,24672384,184163,271.49861807203405
1747959678936616,24874524,1,271,50,24947109,24764944,182165,274.4764361979524
1747959679031549,24967084,1,272,50,25042042,24857504,184538,270.94690524444826
1747959679125151,25059644,1,273,50,25135644,24950064,185580,269.4255846535187
1747959679219258,25152204,1,274,50,25229751,25042624,187127,267.1982129783516
1747959679308995,25244764,1,275,50,25319488,25135184,184304,271.2909106693289
1747959679403198,25337324,1,276,50,25413691,25227744,185947,268.8938245844246
1747959679498164,25429884,1,277,50,25508657,25320304,188353,265.45900516583225
1747959679592522,25522444,1,278,50,25603015,25412864,190151,262.9489195428896
1747959679685315,25615004,1,279,50,25695808,25505424,190384,262.62711152197664
1747959679776482,25707564,1,280,50,25786975,25597984,188991,264.5628627818256
1747959679870263,25800124,1,281,50,25880756,25690544,190212,262.8645931907556
1747959679964787,25892684,1,282,50,25975280,25783104,192176,260.1781700108234
1747959680059064,25985244,1,283,50,26069557,25875664,193893,257.8741883409922
1747959680149583,26077804,1,284,50,26160076,25968224,191852,260.61755936868
1747959680243395,26170364,1,285,50,26253888,26060784,193104,258.92783163476673
1747959680336834,26262924,1,286,50,26347327,26153344,193983,257.75454550140995
1747959680431212,26355484,1,287,50,26441705,26245904,195801,255.36131071853566
1747959680522113,26448044,1,288,50,26532606,26338464,194142,257.54344757960666
1747959680616197,26540604,1,289,50,26626690,26431024,195666,255.53749757239376
1747959680710302,26633164,1,290,50,26720795,26523584,197211,253.53555329063795
1747959680804834,26725724,1,291,50,26815327,26616144,199183,251.02543891797995
1747959680895170,26818284,1,292,50,26905663,26708704,196959,253.859940393686
1747959680989248,26910844,1,293,50,26999741,26801264,198477,251.91835829844266
1747959681082789,27003404,1,294,50,27093282,26893824,199458,250.67934101414835
1747959681177337,27095964,1,295,50,27187830,26986384,201446,248.2054744199438
1747959681270755,27188524,1,296,50,27281248,27078944,202304,247.15279974691552
1747959681361595,27281084,1,297,50,27372088,27171504,200584,249.27212539384993
1747959681455841,27373644,1,298,50,27466334,27264064,202270,247.19434419340485
1747959681549427,27466204,1,299,50,27559920,27356624,203296,245.94679678891862
1747959681643422,27558764,1,300,50,27653915,27449184,204731,244.22290713179734
1747959681734360,27651324,1,301,50,27744853,27541744,203109,246.173237030363
1747959681831907,27743884,1,302,50,27842400,27634304,208096,240.27371982162077
1747959681922909,27836452,1,303,50,27933402,27726872,206530,242.09557933472135
1747959682016425,27929004,1,304,50,28026918,27819424,207494,240.97082325272055
1747959682106493,28021564,1,305,50,28116986,27911984,205002,243.90005951161453
1747959682200400,28114124,1,306,50,28210893,28004544,206349,242.30793461562692
1747959682295383,28206684,1,307,50,28305876,28097104,208772,239.49571781656542
1747959682389353,28299244,1,308,50,28399846,28189664,210182,237.88906757001075
1747959682479812,28391804,1,309,50,28490305,28282224,208081,240.29104050826362
1747959682573619,28484364,1,310,50,28584112,28374784,209328,238.85958877933197
1747959682667637,28576924,1,311,50,28678130,28467344,210786,237.20740466634408
1747959682761515,28669484,1,312,50,28772008,28559904,212104,235.73341379700526
1747959682856585,28762044,1,313,50,28867078,28652464,214614,232.9764134679005
1747959682946221,28854604,1,314,50,28956714,28745024,211690,236.19443525910532
1747959683040760,28947164,1,315,50,29051253,28837584,213669,234.00680491788702
1747959683135046,29039724,1,316,50,29145539,28930144,215395,232.1316650804336
1747959683228586,29132284,1,317,50,29239079,29022704,216375,231.0803004043905
1747959683319090,29224844,1,318,50,29329583,29115264,214319,233.29709451798487
1747959683413272,29317404,1,319,50,29423765,29207824,215941,231.54472749501022
1747959683507697,29409964,1,320,50,29518190,29300384,217806,229.56208736214796
1747959683601433,29502524,1,321,50,29611926,29392944,218982,228.32926907234383
1747959683692028,29595084,1,322,50,29702521,29485504,217017,230.39669703295135
1747959683785628,29687644,1,323,50,29796121,29578064,218057,229.29784414166937
1747959683880550,29780204,1,324,50,29891043,29670624,220419,226.84069885082502
1747959683974642,29872764,1,325,50,29985135,29763184,221951,225.27494807412447
1747959684064652,29965332,1,326,50,30075145,29855752,219393,227.90152830764882
1747959684158796,30057884,1,327,50,30169289,29948304,220985,226.25970088467545
1747959684253155,30150444,1,328,50,30263648,30040864,222784,224.43263430048836
1747959684348414,30243004,1,329,50,30358907,30133424,225483,221.74620703112873
1747959684441702,30335564,1,330,50,30452195,30225984,226211,221.0325757810186
1747959684535125,30428124,1,331,50,30545618,30318544,227074,220.19253635378774
1747959684625948,30520684,1,332,50,30636441,30411104,225337,221.88988049011036
1747959684720504,30613244,1,333,50,30730997,30503664,227333,219.9416714687265
1747959684814519,30705804,1,334,50,30825012,30596224,228788,218.54293057328184
1747959684904496,30798364,1,335,50,30914989,30688784,226205,221.03843858446984
1747959684998445,30890924,1,336,50,31008938,30781344,227594,219.68944699772402
1747959685092666,30983484,1,337,50,31103159,30873904,229255,218.09775141218296
1747959685186455,31076044,1,338,50,31196948,30966464,230484,216.93479807708997
1747959685277041,31168604,1,339,50,31287534,31059024,228510,218.80880486630784
1747959685371415,31261164,1,340,50,31381908,31151584,230324,217.08549695211963
1747959685465583,31353724,1,341,50,31476076,31244144,231932,215.5804287463567
1747959685559191,31446284,1,342,50,31569684,31336704,232980,214.61069619709846
1747959685649719,31538844,1,343,50,31660212,31429264,230948,216.49895214507163
1747959685744185,31631404,1,344,50,31754678,31521824,232854,214.72682453382805
1747959685838100,31723964,1,345,50,31848593,31614384,234209,213.48453731496227
1747959685932316,31816524,1,346,50,31942809,31706944,235865,211.98566976872365
1747959686026367,31909084,1,347,50,32036860,31799504,237356,210.65403865922917
1747959686117147,32001644,1,348,50,32127640,31892064,235576,212.2457296159201
1747959686210915,32094204,1,349,50,32221408,31984624,236784,211.16291641327118
1747959686304865,32186764,1,350,50,32315358,32077184,238174,209.93055497241514
1747959686399474,32279324,1,351,50,32409967,32169744,240223,208.13993664220328
1747959686489611,32371884,1,352,50,32500104,32262304,237800,210.26072329688813
1747959686583235,32464444,1,353,50,32593728,32354864,238864,209.3241342353808
1747959686677609,32557004,1,354,50,32688102,32447424,240678,207.7464496131761
1747959686772053,32649564,1,355,50,32782546,32539984,242562,206.13286499946406
1747959686861743,32742124,1,356,50,32872236,32632544,239692,208.6010379987651
1747959686956567,32834684,1,357,50,32967060,32725104,241956,206.64914281935557
1747959687054723,32927244,1,358,50,33065216,32817664,247552,201.97776628748707
1747959687144712,33019804,1,359,50,33155205,32910224,244981,204.09746061939498
1747959687234685,33112364,1,360,50,33245178,33002784,242394,206.27573289767898
1747959687328930,33204924,1,361,50,33339423,33095344,244079,204.85170784868833
1747959687423437,33297484,1,362,50,33433930,33187904,246026,203.23055286839602
1747959687517527,33390044,1,363,50,33528020,33280464,247556,201.97450273877425
1747959687611849,33482604,1,364,50,33622342,33373024,249318,200.5470924682534
1747959687701936,33575164,1,365,50,33712429,33465584,246845,202.55626000121532
1747959687796240,33667724,1,366,50,33806733,33558144,248589,201.13520710892277
1747959687890450,33760292,1,367,50,33900943,33650712,250231,199.81537059756786
1747959687983933,33852844,1,368,50,33994426,33743264,251162,199.0747007907247
1747959688074397,33945404,1,369,50,34084890,33835824,249066,200.7500020075
1747959688168684,34037964,1,370,50,34179177,33928384,250793,199.3676059539142
1747959688263008,34130524,1,371,50,34273501,34020944,252557,197.9751105690993
1747959688357229,34223084,1,372,50,34367722,34113504,254218,196.68158824316137
1747959688447301,34315644,1,373,50,34457794,34206064,251730,198.625511460692
1747959688541483,34408204,1,374,50,34551976,34298624,253352,197.3538791878493
1747959688635963,34500764,1,375,50,34646456,34391184,255272,195.86950390172052
1747959688729959,34593324,1,376,50,34740452,34483744,256708,194.77382863019463
1747959688820209,34685884,1,377,50,34830702,34576304,254398,196.54242564800037
1747959688922380,34778444,1,378,50,34932873,34668864,264009,189.3874830024734
1747959689012628,34874124,1,379,50,35023121,34764544,258577,193.36599929614775
1747959689106452,34966684,1,380,50,35116945,34857104,259841,192.4253678210906
1747959689196972,35059244,1,381,50,35207465,34949664,257801,193.94804519765245
1747959689291052,35151804,1,382,50,35301545,35042224,259321,192.81122624083662
1747959689385254,35244364,1,383,50,35395747,35134784,260963,191.59804263439645
1747959689478772,35336924,1,384,50,35489265,35227344,261921,190.8972552792636
1747959689568869,35429484,1,385,50,35579362,35319904,259458,192.70941732380575
1747959689662988,35522044,1,386,50,35673481,35412464,261017,191.5584042418693
1747959689757791,35614604,1,387,50,35768284,35505024,263260,189.9263085922662
1747959689852038,35707164,1,388,50,35862531,35597584,264947,188.71698868075504
1747959689941650,35799724,1,389,50,35952143,35690144,261999,190.84042305504985
1747959690036661,35892284,1,390,50,36047154,35782704,264450,189.07165815844203
1747959690130474,35984844,1,391,50,36140967,35875264,265703,188.18003560366273
1747959690224820,36077404,1,392,50,36235313,35967824,267489,186.92357442735965
1747959690314604,36169964,1,393,50,36325097,36060384,264713,188.88381001310856
1747959690409020,36262524,1,394,50,36419513,36152944,266569,187.56869703528918
1747959690503342,36355092,1,395,50,36513835,36245512,268323,186.3425796521357
1747959690597631,36447644,1,396,50,36608124,36338064,270060,185.14404206472634
1747959690691733,36540204,1,397,50,36702226,36430624,271602,184.09290064137966
1747959690781355,36632764,1,398,50,36791848,36523184,268664,186.10606556888902
1747959690876067,36725324,1,399,50,36886560,36615744,270816,184.627200756233
1747959690970222,36817884,1,400,50,36980715,36708304,272411,183.5461857267144
1747959691064011,36910444,1,401,50,37074504,36800864,273640,182.72182429469376
1747959691154585,37003004,1,402,50,37165078,36893424,271654,184.0576615842211
1747959691248657,37095564,1,403,50,37259150,36985984,273166,183.0388847806828
1747959691343108,37188124,1,404,50,37353601,37078544,275057,181.7805036774196
1747959691436708,37280684,1,405,50,37447201,37171104,276097,181.09577431120223
1747959691527305,37373244,1,406,50,37537798,37263664,274134,182.3925525472944
1747959691621359,37465804,1,407,50,37631852,37356224,275628,181.40392122716125
1747959691715436,37558364,1,408,50,37725929,37448784,277145,180.41097620379225
1747959691809542,37650924,1,409,50,37820035,37541344,278691,179.4101711214212
1747959691899898,37743484,1,410,50,37910391,37633904,276487,180.84032884005399
1747959691994139,37836044,1,411,50,38004632,37726464,278168,179.74749072502945
1747959692088307,37928604,1,412,50,38098800,37819024,279776,178.71440009150174
1747959692182542,38021164,1,413,50,38193035,37911584,281451,177.6508166608042
1747959692276789,38113724,1,414,50,38287282,38004144,283138,176.59233306726756
1747959692366811,38206284,1,415,50,38377304,38096704,280600,178.1895937277263
1747959692461177,38298844,1,416,50,38471670,38189264,282406,177.0500626757222
1747959692554528,38391404,1,417,50,38565021,38281824,283197,176.55554260814912
1747959692648679,38483964,1,418,50,38659172,38374384,284788,175.56919533126396
1747959692739628,38576524,1,419,50,38750121,38466944,283177,176.56801223263187
1747959692833457,38669084,1,420,50,38843950,38559504,284446,175.78028870154617
1747959692927657,38761644,1,421,50,38938150,38652064,286086,174.77262082031277
1747959693022021,38854204,1,422,50,39032514,38744624,287890,173.67744624683039
1747959693111016,38946764,1,423,50,39121509,38837184,284325,175.85509540138926
1747959693206263,39039324,1,424,50,39216756,38929744,287012,174.2087438852731
1747959693300799,39131884,1,425,50,39311292,39022304,288988,173.01756474317273
1747959693394333,39224444,1,426,50,39404826,39114864,289962,172.43638821638697
1747959693485119,39317004,1,427,50,39495612,39207424,288188,173.4978555665052
1747959693579118,39409564,1,428,50,39589611,39299984,289627,172.6358385095312
1747959693673541,39502124,1,429,50,39684034,39392544,291490,171.5324710967786
1747959693767630,39594684,1,430,50,39778123,39485104,293019,170.63739894000048
1747959693861751,39687244,1,431,50,39872244,39577664,294580,169.73317944191731
1747959693952026,39779804,1,432,50,39962519,39670224,292295,171.06005918678045
1747959694045848,39872364,1,433,50,40056341,39762784,293557,170.3246728914657
1747959694140002,39964924,1,434,50,40150495,39855344,295151,169.40481312955063
1747959694234126,40057484,1,435,50,40244619,39947904,296715,168.51187166135853
1747959694324998,40150052,1,436,50,40335491,40040472,295019,169.48060972344155
1747959694418685,40242604,1,437,50,40429178,40133024,296154,168.83108112671113
1747959694512878,40335164,1,438,50,40523371,40225584,297787,167.90524771061195
1747959694606790,40427724,1,439,50,40617283,40318144,299139,167.1463767679908
1747959694697389,40520284,1,440,50,40707882,40410704,297178,168.24933205015176
1747959694791598,40612844,1,441,50,40802091,40503264,298827,167.3208913518524
1747959694884879,40705404,1,442,50,40895372,40595824,299548,166.91815668941206
1747959694979500,40797964,1,443,50,40989993,40688384,301609,165.77754642600186
1747959695069938,40890524,1,444,50,41080431,40780944,299487,166.95215485146267
1747959695164305,40983084,1,445,50,41174798,40873504,301294,165.9508652678115
1747959695258362,41075644,1,446,50,41268855,40966064,302791,165.1304034796279
1747959695352058,41168204,1,447,50,41362551,41058624,303927,164.51318902236392
1747959695446231,41260764,1,448,50,41456724,41151184,305540,163.64469463899982
1747959695537104,41353324,1,449,50,41547597,41243744,303853,164.55325436971168
1747959695630930,41445884,1,450,50,41641423,41336304,305119,163.87048987444246
1747959695725026,41538444,1,451,50,41735519,41428864,306655,163.0496812378732
1747959695818667,41631004,1,452,50,41829160,41521424,307736,162.47692827618476
1747959695909961,41723564,1,453,50,41920454,41613984,306470,163.14810585049108
1747959696003819,41816124,1,454,50,42014312,41706544,307768,162.46003483143147
1747959696097273,41908684,1,455,50,42107766,41799104,308662,161.9894901218809
1747959696191365,42001244,1,456,50,42201858,41891664,310194,161.18944918341424
1747959696281538,42093804,1,457,50,42292031,41984224,307807,162.43945069475353
1747959696376006,42186364,1,458,50,42386499,42076784,309715,161.4387420693218
1747959696470349,42278932,1,459,50,42480842,42169352,311490,160.51879675109956
1747959696564569,42371484,1,460,50,42575062,42261904,313158,159.6638118777103
1747959696654959,42464044,1,461,50,42665452,42354464,310988,160.777907829241
1747959696748819,42556604,1,462,50,42759312,42447024,312288,160.10861768623835
1747959696843321,42649164,1,463,50,42853814,42539584,314230,159.1191165706648
1747959696937057,42741724,1,464,50,42947550,42632144,315406,158.5258365408394
1747959697031572,42834284,1,465,50,43042065,42724704,317361,157.549289295156
1747959697121084,42926844,1,466,50,43131577,42817264,314313,159.07709830646522
1747959697216076,43019404,1,467,50,43226569,42909824,316745,157.85568832972896
1747959697309396,43111964,1,468,50,43319889,43002384,317505,157.4778349947245
1747959697404277,43204524,1,469,50,43414770,43094944,319826,156.33500716014333
1747959697498634,43297084,1,470,50,43509127,43187504,321623,155.46151861029838
1747959697588791,43389644,1,471,50,43599284,43280064,319220,156.631789988096
1747959697682836,43482204,1,472,50,43693329,43372624,320705,155.90651845153644
1747959697776299,43574764,1,473,50,43786792,43465184,321608,155.46876943359618
1747959697867390,43667324,1,474,50,43877883,43557744,320139,156.18215837495586
1747959697960616,43759884,1,475,50,43971109,43650304,320805,155.85791992020074
1747959698055586,43852444,1,476,50,44066079,43742864,323215,154.6957907275343
1747959698149931,43945004,1,477,50,44160424,43835424,325000,153.84615384615384
1747959698239297,44037564,1,478,50,44249790,43927984,321806,155.3731129935427
1747959698334195,44130124,1,479,50,44344688,44020544,324144,154.25243101831285
1747959698428050,44222684,1,480,50,44438543,44113104,325439,153.63862352084416
1747959698522672,44315244,1,481,50,44533165,44205664,327501,152.67128955331435
1747959698616640,44407804,1,482,50,44627133,44298224,328909,152.01773134818444
1747959698706140,44500364,1,483,50,44716633,44390784,325849,153.4453074890517
1747959698800646,44592924,1,484,50,44811139,44483344,327795,152.53435836422153
1747959698894964,44685484,1,485,50,44905457,44575904,329553,151.72066405100242
1747959698988275,44778044,1,486,50,44998768,44668464,330304,151.37570238325907
1747959699079906,44870604,1,487,50,45090399,44761024,329375,151.80265654648957
1747959699173720,44963164,1,488,50,45184213,44853584,330629,151.2269038711063
1747959699267656,45055724,1,489,50,45278149,44946144,332005,150.60014156413308
1747959699361921,45148284,1,490,50,45372414,45038704,333710,149.83069131880976
1747959699452489,45240844,1,491,50,45462982,45131264,331718,150.7304397108387
1747959699546939,45333404,1,492,50,45557432,45223824,333608,149.87650176254766
1747959699640445,45425964,1,493,50,45650938,45316384,334554,149.45270419722974
1747959699734807,45518524,1,494,50,45745300,45408944,336356,148.6520234513432
1747959699825062,45611084,1,495,50,45835555,45501504,334051,149.6777438175608
1747959699919441,45703644,1,496,50,45929934,45594064,335870,148.8671212076101
1747959700013831,45796204,1,497,50,46024324,45686624,337700,148.06040864672786
1747959700107766,45888764,1,498,50,46118259,45779184,339075,147.4600014746
1747959700201877,45981324,1,499,50,46212370,45871744,340626,146.78855988679666
1747959700292114,46073892,1,500,50,46302607,45964312,338295,147.79999704400007
1747959700386361,46166444,1,501,50,46396854,46056864,339990,147.0631489161446
1747959700480318,46259004,1,502,50,46490811,46149424,341387,146.46134738581142
1747959700574039,46351564,1,503,50,46584532,46241984,342548,145.96494505879468
1747959700664168,46444124,1,504,50,46674661,46334544,340117,147.00823540134718
1747959700758690,46536684,1,505,50,46769183,46427104,342079,146.16506713361534
1747959700853124,46629244,1,506,50,46863617,46519664,343953,145.36869863033613
1747959700946448,46721804,1,507,50,46956941,46612224,344717,145.04651641781518
1747959701036888,46814364,1,508,50,47047381,46704784,342597,145.94406839522821
1747959701130785,46906924,1,509,50,47141278,46797344,343934,145.3767292561945
1747959701225587,46999484,1,510,50,47236080,46889904,346176,144.4352005916066
1747959701319433,47092044,1,511,50,47329926,46982464,347462,143.90062798234052
1747959701410001,47184604,1,512,50,47420494,47075024,345470,144.73036732567226
1747959701504112,47277164,1,513,50,47514605,47167584,347021,144.08349926949666
1747959701598004,47369724,1,514,50,47608497,47260144,348353,143.5325661039233
1747959701691799,47462284,1,515,50,47702292,47352704,349588,143.02550430792817
1747959701786796,47554844,1,516,50,47797289,47445264,352025,142.0353668063348
1747959701877184,47647404,1,517,50,47887677,47537824,349853,142.9171680677313
1747959701971392,47739964,1,518,50,47981885,47630384,351501,142.24710598262877
1747959702065412,47832524,1,519,50,48075905,47722944,352961,141.65871016911217
1747959702159597,47925084,1,520,50,48170090,47815504,354586,141.00951532209393
1747959702249600,48017644,1,521,50,48260093,47908064,352029,142.0337529010394
1747959702344033,48110204,1,522,50,48354526,48000624,353902,141.2820498330046
1747959702438299,48202772,1,523,50,48448792,48093192,355600,140.60742407199098
1747959702531912,48295324,1,524,50,48542405,48185744,356661,140.18914319199465
1747959702622607,48387884,1,525,50,48633100,48278304,354796,140.92605328132223
1747959702716397,48480444,1,526,50,48726890,48370864,356026,140.43918140809942
1747959702810467,48573004,1,527,50,48820960,48463424,357536,139.84605745994807
1747959702905390,48665564,1,528,50,48915883,48555984,359899,138.92786587348115
1747959702994918,48758124,1,529,50,49005411,48648544,356867,140.1082195888104
1747959703089362,48850684,1,530,50,49099855,48741104,358751,139.37243380506257
1747959703183277,48943244,1,531,50,49193770,48833664,360106,138.84800586493978
1747959703277367,49035804,1,532,50,49287860,48926224,361636,138.2605714032895
1747959703371156,49128364,1,533,50,49381649,49018784,362865,137.79229189919116
1747959703461844,49220924,1,534,50,49472337,49111344,360993,138.50684085286971
1747959703556088,49313484,1,535,50,49566581,49203904,362677,137.86371895653707
1747959703650057,49406044,1,536,50,49660550,49296464,364086,137.33019121855824
1747959703743950,49498604,1,537,50,49754443,49389024,365419,136.8292289125634
1747959703834518,49591164,1,538,50,49845011,49481584,363427,137.57921123086618
1747959703928611,49683724,1,539,50,49939104,49574144,364960,137.00131521262603
1747959704022457,49776284,1,540,50,50032950,49666704,366246,136.5202623373361
1747959704116576,49868844,1,541,50,50127069,49759264,367805,135.9415994888596
1747959704207187,49961404,1,542,50,50217680,49851824,365856,136.66579200559784
1747959704301572,50053964,1,543,50,50312065,49944384,367681,135.9874456390186
1747959704396193,50146524,1,544,50,50406686,50036944,369742,135.22943025136445
1747959704489548,50239084,1,545,50,50500041,50129504,370537,134.9392908130632
1747959704581253,50331644,1,546,50,50591746,50222064,369682,135.25137821154397
1747959704673840,50424204,1,547,50,50684333,50314624,369709,135.24150074788548
1747959704767980,50516764,1,548,50,50778473,50407184,371289,134.6659879500874
1747959704862609,50609324,1,549,50,50873102,50499744,373358,133.91972316114828
1747959704956955,50701884,1,550,50,50967448,50592304,375144,133.28215298658648
1747959705047268,50794444,1,551,50,51057761,50684864,372897,134.08528360378335
1747959705140892,50887004,1,552,50,51151385,50777424,373961,133.7037819451761
1747959705235656,50979564,1,553,50,51246149,50869984,376165,132.92039397604773
1747959705329437,51072124,1,554,50,51339930,50962544,377386,132.490341454108
1747959705419956,51164684,1,555,50,51430449,51055104,375345,133.21077941627038
1747959705515115,51257244,1,556,50,51525608,51147664,377944,132.29473149461296
1747959705607546,51349804,1,557,50,51618039,51240224,377815,132.33990180379286
1747959705702521,51442364,1,558,50,51713014,51332784,380230,131.4993556531573
1747959705792800,51534924,1,559,50,51803293,51425344,377949,132.29298132816862
1747959705886799,51627484,1,560,50,51897292,51517904,379388,131.79120056512068
1747959705980739,51720044,1,561,50,51991232,51610464,380768,131.31355576098832
1747959706074130,51812604,1,562,50,52084623,51703024,381599,131.02759703248697
1747959706164402,51905164,1,563,50,52174895,51795584,379311,131.81795413262466
1747959706258927,51997732,1,564,50,52269420,51888152,381268,131.1413493920287
1747959706353508,52090284,1,565,50,52364001,51980704,383297,130.4471467295596
1747959706446977,52182844,1,566,50,52457470,52073264,384206,130.13851944009204
1747959706542244,52275404,1,567,50,52552737,52165824,386913,129.22801766805458
1747959706632182,52367964,1,568,50,52642675,52258384,384291,130.10973455011958
1747959706725443,52460524,1,569,50,52735936,52350944,384992,129.87282852630705
1747959706820867,52553084,1,570,50,52831360,52443504,387856,128.91382368714162
1747959706914801,52645644,1,571,50,52925294,52536064,389230,128.45875189476658
1747959707004539,52738204,1,572,50,53015032,52628624,386408,129.39690689633755
1747959707098322,52830764,1,573,50,53108815,52721184,387631,128.98865157843412
1747959707192900,52923324,1,574,50,53203393,52813744,389649,128.3206167602124
1747959707287386,53015884,1,575,50,53297879,52906304,391575,127.68945923514013
1747959707376927,53108444,1,576,50,53387420,52998864,388556,128.6815800039119
1747959707471916,53201004,1,577,50,53482409,53091424,390985,127.88214381625893
1747959707565281,53293564,1,578,50,53575774,53183984,391790,127.61938793741544
1747959707659910,53386124,1,579,50,53670403,53276544,393859,126.94898428117676
1747959707749868,53478684,1,580,50,53760361,53369104,391257,127.79324075990972
1747959707843547,53571244,1,581,50,53854040,53461664,392376,127.42879279058862
1747959707938615,53663804,1,582,50,53949108,53554224,394884,126.61946293088603
1747959708032926,53756364,1,583,50,54043419,53646784,396635,126.0604838201369
1747959708126248,53848924,1,584,50,54136741,53739344,397397,125.81876561725429
1747959708216681,53941484,1,585,50,54227174,53831904,395270,126.49581298859007
1747959708310771,54034044,1,586,50,54321264,53924464,396800,126.00806451612904
1747959708405507,54126612,1,587,50,54416000,54017032,398968,125.32333420224178
1747959708499714,54219164,1,588,50,54510207,54109584,400623,124.80561525424152
1747959708590149,54311724,1,589,50,54600642,54202144,398498,125.47114414626924
1747959708684265,54404284,1,590,50,54694758,54294704,400054,124.98312727781749
1747959708777971,54496844,1,591,50,54788464,54387264,401200,124.62612163509472
1747959708871547,54589404,1,592,50,54882040,54479824,402216,124.31131531316505
1747959708962119,54681964,1,593,50,54972612,54572384,400228,124.92879058936407
1747959709059991,54774524,1,594,50,55070484,54664944,405540,123.29240025644819
1747959709150184,54867084,1,595,50,55160677,54757504,403173,124.01624116694322
1747959709244664,54959644,1,596,50,55255157,54850064,405093,123.42844729481872
1747959709334426,55052204,1,597,50,55344919,54942624,402295,124.28690388893722
1747959709429254,55144764,1,598,50,55439747,55035184,404563,123.5901454161651
1747959709523595,55237324,1,599,50,55534088,55127744,406344,123.04845155828559
1747959709617979,55329884,1,600,50,55628472,55220304,408168,122.49857901648342
1747959709711434,55422444,1,601,50,55721927,55312864,409063,122.23056106272139
1747959709802170,55515004,1,602,50,55812663,55405424,407239,122.77802469802744
1747959709896509,55607564,1,603,50,55907002,55497984,409018,122.24400882112768
1747959709990349,55700124,1,604,50,56000842,55590544,410298,121.86264617424409
1747959710084274,55792684,1,605,50,56094767,55683104,411663,121.4585716957803
1747959710174331,55885244,1,606,50,56184824,55775664,409160,122.20158373252517
1747959710269263,55977804,1,607,50,56279756,55868224,411532,121.4972347229377
1747959710363382,56070364,1,608,50,56373875,55960784,413091,121.03870575732708
1747959710456903,56162924,1,609,50,56467396,56053344,414052,120.75777921613711
1747959710547703,56255484,1,610,50,56558196,56145904,412292,121.27327234096224
1747959710641057,56348044,1,611,50,56651550,56238464,413086,121.04017081188904
1747959710736000,56440604,1,612,50,56746493,56331024,415469,120.34592231911407
1747959710830140,56533164,1,613,50,56840633,56423584,417049,119.88998894614302
1747959710920536,56625724,1,614,50,56931029,56516144,414885,120.515323523386
1747959711014278,56718284,1,615,50,57024771,56608704,416067,120.17295291383358
1747959711107758,56810844,1,616,50,57118251,56701264,416987,119.90781487192646
1747959711202641,56903404,1,617,50,57213134,56793824,419310,119.2435191147361
1747959711296962,56995964,1,618,50,57307455,56886384,421071,118.7448197572381
1747959711386633,57088524,1,619,50,57397126,56978944,418182,119.56516540644982
1747959711481353,57181084,1,620,50,57491846,57071504,420342,118.95075914374486
1747959711575315,57273644,1,621,50,57585808,57164064,421744,118.55533214461853
1747959711669422,57366204,1,622,50,57679915,57256624,423291,118.12204842531499
1747959711759273,57458764,1,623,50,57769766,57349184,420582,118.88288134061847
1747959711853662,57551324,1,624,50,57864155,57441744,422411,118.36812961783666
1747959711948404,57643884,1,625,50,57958897,57534304,424593,117.75983117950602
1747959712041508,57736444,1,626,50,58052001,57626864,425137,117.60914716903022
1747959712132643,57829004,1,627,50,58143136,57719424,423712,118.00468242579866
1747959712226586,57921572,1,628,50,58237079,57811992,425087,117.6229807074787
1747959712320711,58014124,1,629,50,58331204,57904544,426660,117.18933108329819
1747959712414912,58106684,1,630,50,58425405,57997104,428301,116.7403298147798
1747959712504834,58199244,1,631,50,58515327,58089664,425663,117.46381527170554
1747959712603151,58291804,1,632,50,58613644,58182224,431420,115.89634231143664
1747959712693685,58384364,1,633,50,58704178,58274784,429394,116.44317340251611
1747959712787579,58476924,1,634,50,58798072,58367344,430728,116.08253932876433
1747959712881926,58569484,1,635,50,58892419,58459904,432515,115.60292706611332
1747959712971777,58662044,1,636,50,58982270,58552464,429806,116.3315542360972
1747959713065685,58754604,1,637,50,59076178,58645024,431154,115.96784443609477
1747959713160602,58847164,1,638,50,59171095,58737584,433511,115.33732708051238
1747959713254220,58939724,1,639,50,59264713,58830144,434569,115.05652727184867
1747959713344872,59032284,1,640,50,59355365,58922704,432661,115.56391724699013
1747959713442989,59124844,1,641,50,59453482,59015264,438218,114.09846240912057
1747959713536914,59217404,1,642,50,59547407,59107824,439583,113.7441620808812
1747959713635557,59309964,1,643,50,59646050,59200384,445666,112.19164127395852
1747959713721568,59402524,1,644,50,59732061,59292944,439117,113.86486972720255
1747959713811432,59495084,1,645,50,59821925,59385504,436421,114.56827237919349
1747959713905892,59587644,1,646,50,59916385,59478064,438321,114.0716506852284
1747959714012628,59680204,1,647,50,60023121,59570624,452497,110.4979701522883
1747959714106355,59772764,1,648,50,60116848,59663184,453664,110.21372645834802
1747959714184570,59865324,1,649,50,60195063,59755744,439319,113.81251436882994
1747959714278230,59957884,1,650,50,60288723,59848304,440419,113.52825377651736
1747959714761957,60433164,1,655,50,60772450,60323584,448866,111.39181849371528
1747959714851931,60525724,1,656,50,60862424,60416144,446280,112.03728600878372
1747959714941739,60618284,1,657,50,60952232,60508704,443528,112.73245432080951
1747959715036638,60710844,1,658,50,61047131,60601264,445867,112.14106448784054
1747959715130504,60803404,1,659,50,61140997,60693824,447173,111.81354867131961
1747959715224163,60895964,1,660,50,61234656,60786384,448272,111.5394224934861
1747959715314838,60988524,1,661,50,61325331,60878944,446387,112.0104304112799
1747959715408594,61081084,1,662,50,61419087,60971504,447583,111.71112397030271
1747959715503388,61173644,1,663,50,61513881,61064064,449817,111.1563146790806
1747959715597388,61266204,1,664,50,61607881,61156624,451257,110.80160529365749
1747959715691473,61358764,1,665,50,61701966,61249184,452782,110.42841809082516
1747959715781936,61451324,1,666,50,61792429,61341744,450685,110.94223237959994
1747959715876236,61543884,1,667,50,61886729,61434304,452425,110.5155550643753
1747959715970200,61636444,1,668,50,61980693,61526864,453829,110.17365571613978
1747959716064439,61729004,1,669,50,62074932,61619424,455508,109.76755622294229
1747959716154617,61821564,1,670,50,62165110,61711984,453126,110.34458406712483
1747959716248546,61914132,1,671,50,62259039,61804552,454487,110.01414781940959
1747959716342458,62006684,1,672,50,62352951,61897104,455847,109.68592532143461
1747959716437132,62099244,1,673,50,62447625,61989664,457961,109.17960262991826
1747959716527308,62191804,1,674,50,62537801,62082224,455577,109.75093123665154
1747959716621501,62284364,1,675,50,62631994,62174784,457210,109.35893790599505
1747959716724086,62376924,1,676,50,62734579,62267344,467235,107.0125311673997
1747959716818096,62469484,1,677,50,62828589,62359904,468685,106.6814598290963
1747959716911802,62562044,1,678,50,62922295,62452464,469831,106.421245085999
1747959716994521,62654604,1,679,50,63005014,62545024,459990,108.69801517424291
1747959717088497,62747164,1,680,50,63098990,62637584,461406,108.36443392587006
1747959717182841,62839724,1,681,50,63193334,62730144,463190,107.94706276042228
1747959717276545,62932284,1,682,50,63287038,62822704,464334,107.68110885698655
1747959717367101,63024844,1,683,50,63377594,62915264,462330,108.14785975385547
1747959717461417,63117404,1,684,50,63471910,63007824,464086,107.73865188779666
1747959717554992,63209964,1,685,50,63565485,63100384,465101,107.50353149100948
1747959717649410,63302524,1,686,50,63659903,63192944,466959,107.07578181382091
1747959717739658,63395084,1,687,50,63750151,63285504,464647,107.60857166838483
1747959717833568,63487644,1,688,50,63844061,63378064,465997,107.29682809116797
1747959717928387,63580204,1,689,50,63938880,63470624,468256,106.77919770382013
1747959718022360,63672764,1,690,50,64032853,63563184,469669,106.45795230257905
1747959718112205,63765324,1,691,50,64122698,63655744,466954,107.07692834840263
1747959718206696,63857884,1,692,50,64217189,63748304,468885,106.63595551147937
1747959718300962,63950444,1,693,50,64311455,63840864,470591,106.24937578491726
1747959718395069,64043004,1,694,50,64405562,63933424,472138,105.9012407389365
1747959718493410,64135564,1,695,50,64503903,64025984,477919,104.62023899447397
1747959718579378,64228124,1,696,50,64589871,64118544,471327,106.08346222473993
1747959718685194,64320684,1,697,50,64695687,64211104,484583,103.1814983191734
1747959718767558,64413244,1,698,50,64778051,64303664,474387,105.39917830800592
1747959718861847,64505804,1,699,50,64872340,64396224,476116,105.01642456880256
1747959718955830,64598364,1,700,50,64966323,64488784,477539,104.70349018614186
1747959719046220,64690924,1,701,50,65056713,64581344,475369,105.1814485168364
1747959719140368,64783484,1,702,50,65150861,64673904,476957,104.83125313183368
1747959719234437,64876044,1,703,50,65244930,64766464,478466,104.50063327383764
1747959719332961,64968604,1,704,50,65343454,64859024,484430,103.21408665854715
1747959719418554,65061164,1,705,50,65429047,64951584,477463,104.72015632624935
