Tempo total receptor,Tempo total emissor,Id do pacote,Id da mensagem,Distancia (m),Tempo zerado receptor,Tempo zerado emissor,Delta tempo,Velocidade (m/s)
1747961095154273,109580,1,1,200,0,0,0,0
1747961095244290,197404,1,2,200,90017,87824,2193,91199.27040583675
1747961095342649,285804,1,3,200,188376,176224,12152,16458.196181698488
1747961095424189,374204,1,4,200,269916,264624,5292,37792.89493575208
1747961095510863,462604,1,5,200,356590,353024,3566,56085.24957936063
1747961095616933,551004,1,6,200,462660,441424,21236,9417.969485778865
1747961095796779,730924,1,8,200,642506,621344,21162,9450.902561194594
1747961095878721,822444,1,9,200,724448,712864,11584,17265.193370165744
1747961095981817,910844,1,10,200,827544,801264,26280,7610.3500761035
1747961096088086,1003404,1,11,200,933813,893824,39989,5001.375378229013
1747961096153281,1097004,1,12,200,999008,987424,11584,17265.193370165744
1747961096432405,1374684,1,15,200,1278132,1265104,13028,15351.550506601166
1747961096530597,1465164,1,16,200,1376324,1355584,20740,9643.201542912246
1747961096616763,1555644,1,17,200,1462490,1446064,16426,12175.818823815902
1747961096706666,1646124,1,18,200,1552393,1536544,15849,12619.092687235789
1747961096797075,1736604,1,19,200,1642802,1627024,15778,12675.877804537964
1747961096899197,1827084,1,20,200,1744924,1717504,27420,7293.946024799417
1747961096989436,1917564,1,21,200,1835163,1807984,27179,7358.622465874389
1747961097075472,2008044,1,22,200,1921199,1898464,22735,8797.009016934244
1747961097160959,2098524,1,23,200,2006686,1988944,17742,11272.686281140795
1747961097259796,2189004,1,24,200,2105523,2079424,26099,7663.128855511705
1747961097341475,2279484,1,25,200,2187202,2169904,17298,11562.030292519366
1747961097443922,2369964,1,26,200,2289649,2260384,29265,6834.102169827439
1747961097525977,2460444,1,27,200,2371704,2350864,20840,9596.928982725527
1747961097616040,2550924,1,28,200,2461767,2441344,20423,9792.880575821378
1747961097726005,2641404,1,29,200,2571732,2531824,39908,5011.526510975244
1747961098566311,3480684,1,38,200,3412038,3371104,40934,4885.913910196902
1747961099135411,4042284,1,44,200,3981138,3932704,48434,4129.330635503985
1747961099225779,4135884,1,45,200,4071506,4026304,45202,4424.582983053847
1747961099307650,4226364,1,46,200,4153377,4116784,36593,5465.526193534282
1747961099418123,4316844,1,47,200,4263850,4207264,56586,3534.443148481957
1747961099495868,4410444,1,48,200,4341595,4300864,40731,4910.264908791829
1747961099586274,4500924,1,49,200,4432001,4391344,40657,4919.202105418502
1747961099676152,4594524,1,50,200,4521879,4484944,36935,5414.9180993637465
1747961099787133,4685004,1,51,200,4632860,4575424,57436,3482.136639041716
1747961099967113,4869084,1,53,200,4812840,4759504,53336,3749.812509374531
1747961100155331,5053164,1,55,200,5001058,4943584,57474,3479.8343598844694
1747961100524010,5424444,1,59,200,5369737,5314864,54873,3644.779764182749
1747961100806014,5702124,1,62,200,5651741,5592544,59197,3378.5495886615877
1747961100913083,5792604,1,63,200,5758810,5683024,75786,2639.009843506716
1747961100974198,5886204,1,64,200,5819925,5776624,43301,4618.830973880511
1747961101076656,5979804,1,65,200,5922383,5870224,52159,3834.429341053318
1747961101161957,6070292,1,66,200,6007684,5960712,46972,4257.855743847398
1747961101252452,6160764,1,67,200,6098179,6051184,46995,4255.771890626662
1747961101342791,6251244,1,68,200,6188518,6141664,46854,4268.578990054211
1747961101465797,6341724,1,69,200,6311524,6232144,79380,2519.5263290501384
1747961101539564,6435324,1,70,200,6385291,6325744,59547,3358.6914538095957
1747961101629810,6525804,1,71,200,6475537,6416224,59313,3371.942070035237
1747961101711382,6616284,1,72,200,6557109,6506704,50405,3967.8603313163376
1747961101817109,6706764,1,73,200,6662836,6597184,65652,3046.3656857369156
1747961101895046,6797244,1,74,200,6740773,6687664,53109,3765.840064772449
1747961101985912,6887724,1,75,200,6831639,6778144,53495,3738.667165155622
1747961102075159,6978204,1,76,200,6920886,6868624,52262,3826.87229727144
1747961102182635,7068692,1,77,200,7028362,6959112,69250,2888.0866425992776
1747961102259856,7159164,1,78,200,7105583,7049584,55999,3571.4923480776442
1747961102350137,7249644,1,79,200,7195864,7140064,55800,3584.229390681003
1747961102439722,7340124,1,80,200,7285449,7230544,54905,3642.6554958564793
1747961102530508,7430604,1,81,200,7376235,7321024,55211,3622.46653746536
1747961102624516,7521084,1,82,200,7470243,7411504,58739,3404.8928309981443
1747961102714912,7611564,1,83,200,7560639,7501984,58655,3409.768988151053
1747961102804744,7702044,1,84,200,7650471,7592464,58007,3447.8597410657335
1747961102894690,7792524,1,85,200,7740417,7682944,57473,3479.894907173803
1747961102988926,7883004,1,86,200,7834653,7773424,61229,3266.4260399483906
1747961103079140,7973484,1,87,200,7924867,7863904,60963,3280.6784443022816
1747961103169526,8063964,1,88,200,8015253,7954384,60869,3285.744796201679
1747961103267646,8154444,1,89,200,8113373,8044864,68509,2919.324468318031
1747961103357459,8244924,1,90,200,8203186,8135344,67842,2948.026296394564
1747961103451612,8335404,1,91,200,8297339,8225824,71515,2796.6160945256242
1747961103533369,8425884,1,92,200,8379096,8316304,62792,3185.119123455217
1747961103624306,8516364,1,93,200,8470033,8406784,63249,3162.1053297285334
1747961103717934,8606844,1,94,200,8563661,8497264,66397,3012.184285434583
1747961103808562,8697324,1,95,200,8654289,8587744,66545,3005.4850101435118
1747961103902178,8787804,1,96,200,8747905,8678224,69681,2870.222872806073
1747961103991999,8878284,1,97,200,8837726,8768704,69022,2897.6268436150795
1747961104090638,8968764,1,98,200,8936365,8859184,77181,2591.3113331001155
1747961104266644,9152844,1,100,200,9112371,9043264,69107,2894.0628301040415
1747961104360778,9244364,1,101,200,9206505,9134784,71721,2788.5835389913696
1747961104451662,9335884,1,102,200,9297389,9226304,71085,2813.5330941830207
1747961104545820,9427404,1,103,200,9391547,9317824,73723,2712.8575885408895
1747961104635572,9518924,1,104,200,9481299,9409344,71955,2779.5149746369257
1747961104745728,9610444,1,105,200,9591455,9500864,90591,2207.724829177291
1747961104819732,9701964,1,106,200,9665459,9592384,73075,2736.9141293191924
1747961104925916,9793484,1,107,200,9771643,9683904,87739,2279.4880269891382
1747961105012804,9888124,1,108,200,9858531,9778544,79987,2500.406316026354
1747961105110728,9979644,1,109,200,9956455,9870064,86391,2315.05596647799
1747961105212689,10074284,1,110,200,10058416,9964704,93712,2134.1983950828067
1747961105290521,10166844,1,111,200,10136248,10057264,78984,2532.158411830244
1747961105384973,10259404,1,112,200,10230700,10149824,80876,2472.9215094712895
1747961105475637,10351964,1,113,200,10321364,10242384,78980,2532.286654849329
1747961105573619,10444524,1,114,200,10419346,10334944,84402,2369.6120945001303
1747961105663544,10537084,1,115,200,10509271,10427504,81767,2445.9745374050653
1747961105757400,10629644,1,116,200,10603127,10520064,83063,2407.8109386850947
1747961105852067,10722204,1,117,200,10697794,10612624,85170,2348.2446870963954
1747961105945977,10814764,1,118,200,10791704,10705184,86520,2311.604253351826
1747961106035709,10907324,1,119,200,10881436,10797744,83692,2389.7146680686324
1747961106129902,10999884,1,120,200,10975629,10890304,85325,2343.9789041898625
1747961106224366,11092444,1,121,200,11070093,10982864,87229,2292.8154627474805
1747961106315104,11185004,1,122,200,11160831,11075424,85407,2341.7284297540014
1747961106408743,11277564,1,123,200,11254470,11167984,86486,2312.5130078856696
1747961106523692,11370124,1,124,200,11369419,11260544,108875,1836.9690011481057
1747961106593626,11462692,1,125,200,11439353,11353112,86241,2319.0825709349383
1747961106716541,11558364,1,126,200,11562268,11448784,113484,1762.3629762785943
1747961107083858,11937964,1,130,200,11929585,11828384,101201,1976.2650566694006
1747961107191011,12033644,1,131,200,12036738,11924064,112674,1775.0323943411968
1747961107269025,12129324,1,132,200,12114752,12019744,95008,2105.0858875042104
1747961107367211,12221884,1,133,200,12212938,12112304,100634,1987.3998847308067
1747961107453647,12314444,1,134,200,12299374,12204864,94510,2116.1781822029416
1747961107568217,12407004,1,135,200,12413944,12297424,116520,1716.4435290078957
1747961107653956,12499564,1,136,200,12499683,12389984,109699,1823.1706761228452
1747961107945304,12783484,1,139,200,12791031,12673904,117127,1707.5482168927747
1747961108026271,12876044,1,140,200,12871998,12766464,105534,1895.1238463433585
1747961108141810,12971724,1,141,200,12987537,12862144,125393,1594.9853660092667
1747961108616532,13450124,1,146,200,13462259,13340544,121715,1643.1828451710965
1747961108801020,13641484,1,148,200,13646747,13531904,114843,1741.5079717527408
1747961108895274,13737164,1,149,200,13741001,13627584,113417,1763.404075226818
1747961109849762,14693964,1,159,200,14695489,14584384,111105,1800.0990054452996
1747961109942782,14786524,1,160,200,14788509,14676944,111565,1792.6769148030296
1747961110045421,14879084,1,161,200,14891148,14769504,121644,1644.1419223307355
1747961110131981,14971644,1,162,200,14977708,14862064,115644,1729.445539759953
1747961110222097,15064204,1,163,200,15067824,14954624,113200,1766.7844522968198
1747961110316391,15156764,1,164,200,15162118,15047184,114934,1740.1291175805245
1747961110713436,15536364,1,168,200,15559163,15426784,132379,1510.8136486905023
1747961110795688,15628924,1,169,200,15641415,15519344,122071,1638.3907725831689
1747961110885647,15721492,1,170,200,15731374,15611912,119462,1674.1725402219954
1747961110979797,15814044,1,171,200,15825524,15704464,121060,1652.0733520568313
1747961111082610,15906604,1,172,200,15928337,15797024,131313,1523.0784461553692
1747961111164639,15999164,1,173,200,16010366,15889584,120782,1655.8758755443691
1747961111266042,16091724,1,174,200,16111769,15982144,129625,1542.9122468659596
1747961111373144,16184284,1,175,200,16218871,16074704,144167,1387.2800294103367
1747961111451209,16276844,1,176,200,16296936,16167264,129672,1542.3530137577889
1747961111541133,16369404,1,177,200,16386860,16259824,127036,1574.356875216474
1747961111639720,16461964,1,178,200,16485447,16352384,133063,1503.0474286616115
1747961111729501,16554524,1,179,200,16575228,16444944,130284,1535.1079180866413
1747961111925772,16742764,1,181,200,16771499,16633184,138315,1445.974767740303
1747961112028516,16838444,1,182,200,16874243,16728864,145379,1375.7145117245268
1747961112491613,17313724,1,187,200,17337340,17204144,133196,1501.5465929907805
1747961112585685,17406284,1,188,200,17431412,17296704,134708,1484.6928170561512
1747961112675837,17498844,1,189,200,17521564,17389264,132300,1511.715797430083
1747961112774172,17591404,1,190,200,17619899,17481824,138075,1448.4881405033495
1747961112865373,17683964,1,191,200,17711100,17574384,136716,1462.8865677755346
1747961112958131,17776524,1,192,200,17803858,17666944,136914,1460.7709949311245
1747961113051650,17869084,1,193,200,17897377,17759504,137873,1450.6103443023653
1747961113142187,17961644,1,194,200,17987914,17852064,135850,1472.211998527788
1747961113236130,18054204,1,195,200,18081857,17944624,137233,1457.3754126194137
1747961113330680,18146764,1,196,200,18176407,18037184,139223,1436.5442491542344
1747961113429479,18239324,1,197,200,18275206,18129744,145462,1374.9295348613382
1747961113514802,18331884,1,198,200,18360529,18222304,138225,1446.9162597214688
1747961113609357,18424444,1,199,200,18455084,18314864,140220,1426.330052774212
1747961113715769,18517012,1,200,200,18561496,18407432,154064,1298.161802887112
1747961113797381,18609564,1,201,200,18643108,18499984,143124,1397.389676085073
1747961113896006,18702124,1,202,200,18741733,18592544,149189,1340.5814101575854
1747961113986511,18794684,1,203,200,18832238,18685104,147134,1359.3051232210096
1747961114071826,18887244,1,204,200,18917553,18777664,139889,1429.704980377299
1747961114182256,18982932,1,205,200,19027983,18873352,154631,1293.401711170464
1747961116210053,20992204,1,226,200,21055780,20882624,173156,1155.0278361708517
1747961116390257,21180452,1,228,200,21235984,21070872,165112,1211.2989970444303
1747961116484538,21276124,1,229,200,21330265,21166544,163721,1221.590388526823
1747961116578019,21368684,1,230,200,21423746,21259104,164642,1214.7568664131873
1747961116669005,21461244,1,231,200,21514732,21351664,163068,1226.4822037432239
1747961116758711,21553804,1,232,200,21604438,21444224,160214,1248.3303581459797
1747961116856659,21646372,1,233,200,21702386,21536792,165594,1207.773228498617
1747961116947705,21738924,1,234,200,21793432,21629344,164088,1218.8581736629126
1747961117045818,21831484,1,235,200,21891545,21721904,169641,1178.9602749335363
1747961117136026,21924044,1,236,200,21981753,21814464,167289,1195.5358690649116
1747961117230138,22016604,1,237,200,22075865,21907024,168841,1184.5464075668824
1747961117320047,22109164,1,238,200,22165774,21999584,166190,1203.4418436729045
1747961117430822,22201724,1,239,200,22276549,22092144,184405,1084.5692904205416
1747961117614982,22389964,1,241,200,22460709,22280384,180325,1109.1085539997227
1747961117708896,22482524,1,242,200,22554623,22372944,181679,1100.842695083086
1747961117791240,22575084,1,243,200,22636967,22465504,171463,1166.4324081580282
1747961117996129,22763324,1,245,200,22841856,22653744,188112,1063.1963936378327
1747961118082395,22859004,1,246,200,22928122,22749424,178698,1119.206706286584
1747961118561432,23337404,1,251,200,23407159,23227824,179335,1115.2312710848412
1747961118658784,23433084,1,252,200,23504511,23323504,181007,1104.9296436049435
1747961118749993,23525644,1,253,200,23595720,23416064,179656,1113.2386338335484
1747961118839294,23618204,1,254,200,23685021,23508624,176397,1133.8061304897476
1747961118946319,23710764,1,255,200,23792046,23601184,190862,1047.877524074986
1747961119048609,23806444,1,256,200,23894336,23696864,197472,1012.8018149408523
1747961119227093,23994684,1,258,200,24072820,23885104,187716,1065.4392806153978
1747961119318618,24090364,1,259,200,24164345,23980784,183561,1089.5560603831968
1747961119417440,24186044,1,260,200,24263167,24076464,186703,1071.220066094278
1747961119515599,24278604,1,261,200,24361326,24169024,192302,1040.0307849112335
1747961119814035,24562524,1,264,200,24659762,24452944,206818,967.0338171725865
1747961119900001,24658204,1,265,200,24745728,24548624,197104,1014.6927510349866
1747961119990198,24750764,1,266,200,24835925,24641184,194741,1027.005099080317
1747961120093165,24843324,1,267,200,24938892,24733744,205148,974.9059215785677
1747961120580628,25318604,1,272,200,25426355,25209024,217331,920.2552788143431
1747961120772980,25509964,1,274,200,25618707,25400384,218323,916.0738905200094
1747961121444774,26176604,1,281,200,26290501,26067024,223477,894.9466835513274
1747961121534536,26272284,1,282,200,26380263,26162704,217559,919.2908590313432
1747961122582853,27324764,1,293,200,27428580,27215184,213396,937.2246902472399
1747961123274743,27994524,1,300,200,28120470,27884944,235526,849.1631497159549
1747961123827542,28565484,1,306,200,28673269,28455904,217365,920.11133347135
1747961123942618,28661164,1,307,200,28788345,28551584,236761,844.733718813487
1747961124601643,29330924,1,314,200,29447370,29221344,226026,884.8539548547512
1747961124704200,29426604,1,315,200,29549927,29317024,232903,858.7265943332632
1747961124790201,29522284,1,316,200,29635928,29412704,223224,895.9610077769415
1747961125089957,29806204,1,319,200,29935684,29696624,239060,836.6100560528738
1747961125171496,29898772,1,320,200,30017223,29789192,228031,877.0737312032136
1747961125368050,30087004,1,322,200,30213777,29977424,236353,846.1919247904617
1747961125559797,30275244,1,324,200,30405524,30165664,239860,833.8197281747687
1747961125658849,30367804,1,325,200,30504576,30258224,246352,811.8464635968046
1747961125736903,30463484,1,326,200,30582630,30353904,228726,874.4086811293862
1747961125826977,30556044,1,327,200,30672704,30446464,226240,884.0169731258841
1747961125937070,30648604,1,328,200,30782797,30539024,243773,820.4354050694704
1747961126019349,30744284,1,329,200,30865076,30634704,230372,868.1610612400813
1747961126117925,30836844,1,330,200,30963652,30727264,236388,846.0666362082678
1747961126215616,30929404,1,331,200,31061343,30819824,241519,828.092199785524
1747961126302366,31021964,1,332,200,31148093,30912384,235709,848.5038755414515
1747961126404061,31114524,1,333,200,31249788,31004944,244844,816.8466452108281
1747961126486558,31207084,1,334,200,31332285,31097504,234781,851.8576886545334
1747961126593073,31299644,1,335,200,31438800,31190064,248736,804.0653544320082
1747961126793647,31491004,1,337,200,31639374,31381424,257950,775.3440589261485
1747961126862925,31583564,1,338,200,31708652,31473984,234668,852.2678848415635
1747961126957883,31676124,1,339,200,31803610,31566544,237066,843.6469168923422
1747961127067938,31768684,1,340,200,31913665,31659104,254561,785.6663039507231
1747961127162378,31864364,1,341,200,32008105,31754784,253321,789.5121209848373
1747961127243702,31956924,1,342,200,32089429,31847344,242085,826.1561021955099
1747961127342459,32049484,1,343,200,32188186,31939904,248282,805.5356409244326
1747961127427846,32142044,1,344,200,32273573,32032464,241109,829.5003504638981
1747961127526810,32234604,1,345,200,32372537,32125024,247513,808.0383656616016
1747961127612527,32327164,1,346,200,32458254,32217584,240670,831.013420866747
1747961127707337,32419724,1,347,200,32553064,32310144,242920,823.3163181294253
1747961127801242,32512284,1,348,200,32646969,32402704,244265,818.7828792499948
1747961127895488,32604844,1,349,200,32741215,32495264,245951,813.1701029879936
1747961127997508,32700524,1,350,200,32843235,32590944,252291,792.7353730414482
1747961128083899,32793084,1,351,200,32929626,32683504,246122,812.6051307887958
1747961128177652,32885644,1,352,200,33023379,32776064,247315,808.6852799061925
1747961128272267,32978204,1,353,200,33117994,32868624,249370,802.0210931547499
1747961128370588,33070764,1,354,200,33216315,32961184,255131,783.9110104220969
1747961128456128,33163324,1,355,200,33301855,33053744,248111,806.0908222529432
1747961128550774,33255884,1,356,200,33396501,33146304,250197,799.3700963640651
1747961128644792,33348444,1,357,200,33490519,33238864,251655,794.7388289523354
1747961128755508,33441004,1,358,200,33601235,33331424,269811,741.2596224764742
1747961128837556,33536684,1,359,200,33683283,33427104,256179,780.7041170431612
1747961128922947,33629244,1,360,200,33768674,33519664,249010,803.180595156821
1747961129042359,33721804,1,361,200,33888086,33612224,275862,725.0001812500453
1747961129124246,33814364,1,362,200,33969973,33704784,265189,754.1790949096682
1747961129206319,33906924,1,363,200,34052046,33797344,254702,785.2313684227058
1747961129500215,34193964,1,366,200,34345942,34084384,261558,764.6487585927404
1747961129590609,34289644,1,367,200,34436336,34180064,256272,780.420802896922
1747961129803598,34481004,1,369,200,34649325,34371424,277901,719.6807496194688
1747961129893869,34573564,1,370,200,34739596,34463984,275612,725.6578088036805
1747961129971981,34669244,1,371,200,34817708,34559664,258044,775.0616173985832
1747961130065944,34761804,1,372,200,34911671,34652224,259447,770.8703511699886
1747961130168569,34857484,1,373,200,35014296,34747904,266392,750.7732964953902
1747961130258470,34950044,1,374,200,35104197,34840464,263733,758.3427178244664
1747961130360498,35042604,1,375,200,35206225,34933024,273201,732.0617420873276
1747961130459269,35135164,1,376,200,35304996,35025584,279412,715.788870914635
1747961130549560,35230844,1,377,200,35395287,35121264,274023,729.8657411969068
1747961130634770,35323404,1,378,200,35480497,35213824,266673,749.9821879230368
1747961130852605,35514764,1,380,200,35698332,35405184,293148,682.2492392920982
1747961130926392,35607324,1,381,200,35772119,35497744,274375,728.9293849658314
1747961131011802,35699884,1,382,200,35857529,35590304,267225,748.4329684722612
1747961131110716,35792444,1,383,200,35956443,35682864,273579,731.0502633608573
1747961131196302,35885004,1,384,200,36042029,35775424,266605,750.173477616699
1747961131290116,35977564,1,385,200,36135843,35867984,267859,746.6614898136706
1747961131397307,36070124,1,386,200,36243034,35960544,282490,707.9896633509151
1747961131479125,36162684,1,387,200,36324852,36053104,271748,735.9759777440864
1747961131569280,36255244,1,388,200,36415007,36145664,269343,742.5476065834271
1747961131663488,36347804,1,389,200,36509215,36238224,270991,738.0318903579824
1747961131761721,36440364,1,390,200,36607448,36330784,276664,722.8985339617731
1747961131868212,36532924,1,391,200,36713939,36423344,290595,688.2430874584903
1747961131946188,36625484,1,392,200,36791915,36515904,276011,724.6088018231158
1747961132044348,36721164,1,393,200,36890075,36611584,278491,718.1560624939406
1747961132142794,36813724,1,394,200,36988521,36704144,284377,703.2917570689613
1747961132228693,36906284,1,395,200,37074420,36796704,277716,720.1601636203891
1747961132318212,36998844,1,396,200,37163939,36889264,274675,728.1332483844543
1747961132413249,37091404,1,397,200,37258976,36981824,277152,721.6256783281376
1747961132507249,37183964,1,398,200,37352976,37074384,278592,717.8957041121066
1747961132605438,37276524,1,399,200,37451165,37166944,284221,703.6777718747031
1747961132690527,37369084,1,400,200,37536254,37259504,276750,722.6738934056008
1747961132789758,37461644,1,401,200,37635485,37352064,283421,705.6640121938742
1747961132896156,37554212,1,402,200,37741883,37444632,297251,672.8320510275828
1747961132969658,37646764,1,403,200,37815385,37537184,278201,718.9046768343752
1747961133063580,37739324,1,404,200,37909307,37629744,279563,715.4022528016941
1747961133158176,37831884,1,405,200,38003903,37722304,281599,710.2297948501238
1747961133256790,37927564,1,406,200,38102517,37817984,284533,702.906165541431
1747961133363204,38020132,1,407,200,38208931,37910552,298379,670.2884586381749
1747961133440537,38112684,1,408,200,38286264,38003104,283160,706.3144511936714
1747961133543389,38205244,1,409,200,38389116,38095664,293452,681.5424669111133
1747961133637536,38297804,1,410,200,38483263,38188224,295039,677.8764841258275
1747961133731768,38393484,1,411,200,38577495,38283904,293591,681.2197921598414
1747961133825984,38489164,1,412,200,38671711,38379584,292127,684.6337380659782
1747961133912092,38581724,1,413,200,38757819,38472144,285675,700.096263236195
1747961134010099,38674284,1,414,200,38855826,38564704,291122,686.9972039213801
1747961134129183,38766844,1,415,200,38974910,38657264,317646,629.6317284020577
1747961134214697,38859404,1,416,200,39060424,38749824,310600,643.915003219575
1747961134288732,38951972,1,417,200,39134459,38842392,292067,684.7743839598447
1747961134382788,39044524,1,418,200,39228515,38934944,293571,681.2662013618511
1747961134485527,39140204,1,419,200,39331254,39030624,300630,665.2696005056049
1747961134571254,39232764,1,420,200,39416981,39123184,293797,680.7421450865735
1747961134776203,39421004,1,422,200,39621930,39311424,310506,644.1099366839932
1747961134858489,39513564,1,423,200,39704216,39403984,300232,666.1515094993206
1747961134948212,39606124,1,424,200,39793939,39496544,297395,672.5062627145714
1747961135816205,40464124,1,433,200,40661932,40354544,307388,650.6434864080576
1747961135906543,40559804,1,434,200,40752270,40450224,302046,662.1507982227873
1747961136008202,40655484,1,435,200,40853929,40545904,308025,649.297946595244
1747961136103040,40748052,1,436,200,40948767,40638472,310295,644.5479301954592
1747961136189280,40840604,1,437,200,41035007,40731024,303983,657.9315290657701
1747961136282775,40933164,1,438,200,41128502,40823584,304918,655.914049023016
1747961136372985,41025724,1,439,200,41218712,40916144,302568,661.0084344676238
1747961136484173,41118284,1,440,200,41329900,41008704,321196,622.6727605574167
1747961136565374,41210844,1,441,200,41411101,41101264,309837,645.5006987545064
1747961136663525,41306524,1,442,200,41509252,41196944,312308,640.3934577404358
1747961136757150,41402204,1,443,200,41602877,41292624,310253,644.6351848330233
1747961136864432,41494764,1,444,200,41710159,41385184,324975,615.431956304331
1747961136967220,41587324,1,445,200,41812947,41477744,335203,596.653371240711
1747961137056658,41679892,1,446,200,41902385,41570312,332073,602.2772101315072
1747961137131758,41775564,1,447,200,41977485,41665984,311501,642.0525134750771
1747961137228569,41868124,1,448,200,42074296,41758544,315752,633.4084978084067
1747961137425888,42056364,1,450,200,42271615,41946784,324831,615.7047818711884
1747961137527530,42148924,1,451,200,42373257,42039344,333913,598.9584113227098
1747961137614044,42244604,1,452,200,42459771,42135024,324747,615.8640418541203
1747961137699940,42340284,1,453,200,42545667,42230704,314963,634.995221660957
1747961137790129,42432844,1,454,200,42635856,42323264,312592,639.8116394533449
1747961137896787,42525404,1,455,200,42742514,42415824,326690,612.2011693042334
1747961137983019,42617964,1,456,200,42828746,42508384,320362,624.2937676753173
1747961138076334,42710524,1,457,200,42922061,42600944,321117,622.8259481746529
1747961138166768,42803084,1,458,200,43012495,42693504,318991,626.9769366533851
1747961138260905,42895644,1,459,200,43106632,42786064,320568,623.8925906515934
1747961138351466,42988204,1,460,200,43197193,42878624,318569,627.8074765592384
1747961138449888,43080764,1,461,200,43295615,42971184,324431,616.4639014150929
1747961138544138,43173324,1,462,200,43389865,43063744,326121,613.2693080175763
1747961138736165,43361564,1,464,200,43581892,43251984,329908,606.2296155291779
1747961138826333,43454124,1,465,200,43672060,43344544,327516,610.6571892670893
1747961138916689,43546684,1,466,200,43762416,43437104,325312,614.794412748377
1747961139301260,43926284,1,470,200,44146987,43816704,330283,605.5413085142136
1747961139391716,44018844,1,471,200,44237443,43909264,328179,609.4235158252052
1747961139481306,44111404,1,472,200,44327033,44001824,325209,614.989130067126
1747961139596066,44203964,1,473,200,44441793,44094384,347409,575.6903246605585
1747961139677770,44299644,1,474,200,44523497,44190064,333433,599.8206536245663
1747961139771745,44392204,1,475,200,44617472,44282624,334848,597.2859327217126
1747961139859005,44484764,1,476,200,44704732,44375184,329548,606.8918640076711
1747961139956764,44577324,1,477,200,44802491,44467744,334747,597.466146074498
1747961140045742,44669884,1,478,200,44891469,44560304,331165,603.9285552519137
1747961140140703,44762444,1,479,200,44986430,44652864,333566,599.5814921185014
1747961140231054,44855004,1,480,200,45076781,44745424,331357,603.578617623892
1747961140329743,44947564,1,481,200,45175470,44837984,337486,592.6171752309725
1747961140420031,45040124,1,482,200,45265758,44930544,335214,596.6337921447195
1747961140530233,45132684,1,483,200,45375960,45023104,352856,566.8034552338631
1747961140624753,45225244,1,484,200,45470480,45115664,354816,563.6724386724386
1747961140718259,45317804,1,485,200,45563986,45208224,355762,562.1735879604904
1747961140796419,45413484,1,486,200,45642146,45303904,338242,591.2926248070908
1747961140894787,45506044,1,487,200,45740514,45396464,344050,581.3108559802354
1747961140980987,45598604,1,488,200,45826714,45489024,337690,592.2591726139359
1747961141074617,45691164,1,489,200,45920344,45581584,338760,590.3884756169559
1747961141172722,45783724,1,490,200,46018449,45674144,344305,580.8803241312208
1747961141259493,45876284,1,491,200,46105220,45766704,338516,590.8140235616632
1747961141361957,45968844,1,492,200,46207684,45859264,348420,574.0198610871936
1747961141448054,46061404,1,493,200,46293781,45951824,341957,584.8688577803641
1747961141542368,46153964,1,494,200,46388095,46044384,343711,581.8841992255121
1747961141632533,46246524,1,495,200,46478260,46136944,341316,585.9672561497264
1747961141734746,46339092,1,496,200,46580473,46229512,350961,569.8638880103487
1747961141836755,46434764,1,497,200,46682482,46325184,357298,559.7568416279968
1747961141919142,46527324,1,498,200,46764869,46417744,347125,576.1613251710479
1747961142009219,46619884,1,499,200,46854946,46510304,344642,580.3123240928268
1747961142107592,46712444,1,500,200,46953319,46602864,350455,570.6866787462013
1747961142201708,46808124,1,501,200,47047435,46698544,348891,573.2449389637451
1747961142304188,46900684,1,502,200,47149915,46791104,358811,557.3965123700222
1747961142508500,47088924,1,504,200,47354227,46979344,374883,533.4997852663364
1747961142574395,47181484,1,505,200,47420122,47071904,348218,574.3528479285964
1747961142676720,47274044,1,506,200,47522447,47164464,357983,558.6857476472346
1747961142770943,47366604,1,507,200,47616670,47257024,359646,556.1023895719679
1747961142856916,47459164,1,508,200,47702643,47349584,353059,566.4775575753628
1747961142947108,47551724,1,509,200,47792835,47442144,350691,570.3026310911886
1747961143049716,47644284,1,510,200,47895443,47534704,360739,554.4174597146414
1747961143143038,47736852,1,511,200,47988765,47627272,361493,553.261058996993
1747961143237805,47832524,1,512,200,48083532,47722944,360588,554.6496278300997
1747961143327932,47928204,1,513,200,48173659,47818624,355035,563.3247426310082
1747961143426350,48023884,1,514,200,48272077,47914304,357773,559.01367626959
1747961143519742,48116444,1,515,200,48365469,48006864,358605,557.7167077982739
1747961143614765,48209004,1,516,200,48460492,48099424,361068,553.912282450951
1747961143708621,48301564,1,517,200,48554348,48191984,362364,551.9312072943228
1747961143798849,48394124,1,518,200,48644576,48284544,360032,555.5061772286907
1747961143896677,48486684,1,519,200,48742404,48377104,365300,547.4952094169175
1747961143991367,48579244,1,520,200,48837094,48469664,367430,544.3213673352748
1747961144081318,48671804,1,521,200,48927045,48562224,364821,548.214055660173
1747961144175147,48764364,1,522,200,49020874,48654784,366090,546.313747985468
1747961144261551,48856924,1,523,200,49107278,48747344,359934,555.6574260836709
1747961144360208,48949484,1,524,200,49205935,48839904,366031,546.4018074971792
1747961144470919,49042044,1,525,200,49316646,48932464,384182,520.5865969774742
1747961144544397,49134612,1,526,200,49390124,49025032,365092,547.8071280663504
1747961144638641,49227164,1,527,200,49484368,49117584,366784,545.2800558366778
1747961144740973,49319724,1,528,200,49586700,49210144,376556,531.1294999946887
1747961144827313,49412284,1,529,200,49673040,49302704,370336,540.0501166508252
1747961144924998,49504844,1,530,200,49770725,49395264,375461,532.6784939048264
1747961145015537,49597404,1,531,200,49861264,49487824,373440,535.5612682090831
1747961145100942,49689964,1,532,200,49946669,49580384,366285,546.0229056608924
1747961145207892,49782524,1,533,200,50053619,49672944,380675,525.3825441649701
1747961145297336,49875084,1,534,200,50143063,49765504,377559,529.7185340569289
1747961145408717,49970764,1,535,200,50254444,49861184,393260,508.5693942938514
1747961145498589,50066452,1,536,200,50344316,49956872,387444,516.2036320087548
1747961145686565,50254684,1,538,200,50532292,50145104,387188,516.5449342438299
1747961145777082,50347244,1,539,200,50622809,50237664,385145,519.2849446312428
1747961146170108,50726844,1,543,200,51015835,50617264,398571,501.79265425733433
1747961146267649,50822524,1,544,200,51113376,50712944,400432,499.4605825708235
1747961146440752,51013884,1,546,200,51286479,50904304,382175,523.3204683718192
1747961146539144,51109564,1,547,200,51384871,50999984,384887,519.6330351505767
1747961146624980,51202124,1,548,200,51470707,51092544,378163,528.8724703368653
1747961146719138,51294684,1,549,200,51564865,51185104,379761,526.6470227327187
1747961146825628,51390364,1,550,200,51671355,51280784,390571,512.0707886658251
1747961147030491,51578604,1,552,200,51876218,51469024,407194,491.16637278545363
1747961147104330,51674284,1,553,200,51950057,51564704,385353,519.0046528767131
1747961147193966,51766844,1,554,200,52039693,51657264,382429,522.9728917001587
1747961147300509,51859404,1,555,200,52146236,51749824,396412,504.52559458341324
1747961147677144,52239004,1,559,200,52522871,52129424,393447,508.3276781879135
1747961147874327,52430364,1,561,200,52720054,52320784,399270,500.914168357252
1747961148152284,52714284,1,564,200,52998011,52604704,393307,508.5086204923889
1747961148258993,52809964,1,565,200,53104720,52700384,404336,494.6381227493966
1747961148341307,52905644,1,566,200,53187034,52796064,390970,511.5482006292043
1747961148545662,53093884,1,568,200,53391389,52984304,407085,491.2978861908447
1747961148725904,53285244,1,570,200,53571631,53175664,395967,505.09259610018006
1747961148844818,53377804,1,571,200,53690545,53268224,422321,473.57341927112316
1747961148930957,53470364,1,572,200,53776684,53360784,415900,480.884828083674
1747961149032576,53566044,1,573,200,53878303,53456464,421839,474.11453184745835
1747961149217739,53757404,1,575,200,54063466,53647824,415642,481.1833260353862
1747961149300452,53849964,1,576,200,54146179,53740384,405795,492.8596951662785
1747961149402052,53945644,1,577,200,54247779,53836064,411715,485.7729254460003
1747961149602443,54137004,1,579,200,54448170,54027424,420746,475.34617084892074
1747961149696497,54229564,1,580,200,54542224,54119984,422240,473.66426676771505
1747961149791057,54325244,1,581,200,54636784,54215664,421120,474.9240121580547
1747961149893437,54417804,1,582,200,54739164,54308224,430940,464.101731099457
1747961149963094,54513484,1,583,200,54808821,54403904,404917,493.92838532341193
1747961150057344,54606044,1,584,200,54903071,54496464,406607,491.8754472992349
1747961150175899,54698604,1,585,200,55021626,54589024,432602,462.31871327455724
1747961150262105,54791164,1,586,200,55107832,54681584,426248,469.210412717479
1747961150340078,54883724,1,587,200,55185805,54774144,411661,485.8366471441307
1747961150430091,54976284,1,588,200,55275818,54866704,409114,488.86129538466054
1747961150548081,55071964,1,589,200,55393808,54962384,431424,463.5810710577066
1747961150618368,55164524,1,590,200,55464095,55054944,409151,488.8170870900963
1747961150724176,55257084,1,591,200,55569903,55147504,422399,473.4859694270109
1747961150810303,55352764,1,592,200,55656030,55243184,412846,484.44214065293113
1747961150904949,55445324,1,593,200,55750676,55335744,414932,482.00669025286066
1747961150995232,55537884,1,594,200,55840959,55428304,412655,484.6663677890732
1747961151093350,55630444,1,595,200,55939077,55520864,418213,478.2252105984271
1747961151203368,55723004,1,596,200,56049095,55613424,435671,459.0619986182234
1747961151379397,55914364,1,598,200,56225124,55804784,420340,475.80530047104725
1747961151478156,56010044,1,599,200,56323883,55900464,423419,472.3453600334421
1747961151670013,56201404,1,601,200,56515740,56091824,423916,471.79158135102233
1747961151974048,56488444,1,604,200,56819775,56378864,440911,453.606283354237
1747961152358836,56871164,1,608,200,57204563,56761584,442979,451.4886710205224
1747961152748022,57253884,1,612,200,57593749,57144304,449445,444.9932694767992
1747961152841749,57349564,1,613,200,57687476,57239984,447492,446.9353642076283
1747961152919113,57445244,1,614,200,57764840,57335664,429176,466.00928290491544
1747961153011995,57537804,1,615,200,57857722,57428224,429498,465.6599099413734
1747961153308705,57821724,1,618,200,58154432,57712144,442288,452.1940455088087
1747961154177349,58682844,1,627,200,59023076,58573264,449812,444.6302010617769
1747961154259176,58778524,1,628,200,59104903,58668944,435959,458.758736486688
1747961156097795,60593324,1,647,200,60943522,60483744,459778,434.99253987794106
1747961156204474,60689004,1,648,200,61050201,60579424,470777,424.82959023061875
1747961156278369,60781564,1,649,200,61124096,60671984,452112,442.3682627313586
1747961156373038,60874124,1,650,200,61218765,60764544,454221,440.3142963447309
1747961156479229,60966684,1,651,200,61324956,60857104,467852,427.4856151090516
1747961156556143,61062364,1,652,200,61401870,60952784,449086,445.3489977420806
1747961156757783,61253724,1,654,200,61603510,61144144,459366,435.3826796062399
1747961156852089,61346284,1,655,200,61697816,61236704,461112,433.7341036451014
1747961156950403,61438844,1,656,200,61796130,61329264,466866,428.3884455068478
1747961157035548,61534524,1,657,200,61881275,61424944,456331,438.2783549660225
1747961157130311,61627084,1,658,200,61976038,61517504,458534,436.1726720374062
1747961157228363,61719644,1,659,200,62074090,61610064,464026,431.0103313176417
1747961157322977,61815324,1,660,200,62168704,61705744,462960,432.00276481769487
1747961157416222,61907884,1,661,200,62261949,61798304,463645,431.3645137982724
1747961157507332,62000444,1,662,200,62353059,61890864,462195,432.7177922738238
1747961157609648,62093004,1,663,200,62455375,61983424,471951,423.7728069227526
1747961157696089,62185564,1,664,200,62541816,62075984,465832,429.33933263494134
1747961157789920,62278124,1,665,200,62635647,62168544,467103,428.1710886035842
1747961157892426,62370684,1,666,200,62738153,62261104,477049,419.2441447314636
1747961157970077,62463244,1,667,200,62815804,62353664,462140,432.76929069113254
1747961158162438,62651484,1,669,200,63008165,62541904,466261,428.9443037268826
1747961158256810,62747164,1,670,200,63102537,62637584,464953,430.1510045101333
1747961158347038,62839724,1,671,200,63192765,62730144,462621,432.3193283486915
1747961158440711,62932284,1,672,200,63286438,62822704,463734,431.2817261619808
1747961158535528,63024844,1,673,200,63381255,62915264,465991,429.192838488297
1747961158636971,63117404,1,674,200,63482698,63007824,474874,421.16435096467694
1747961158728018,63209964,1,675,200,63573745,63100384,473361,422.5105152304478
1747961158834437,63302524,1,676,200,63680164,63192944,487220,410.49218012396864
1747961158916152,63398204,1,677,200,63761879,63288624,473255,422.605149443746
1747961159006251,63493884,1,678,200,63851978,63384304,467674,427.6483191282817
1747961159202614,63685244,1,680,200,64048341,63575664,472677,423.1219204657726
1747961159317874,63777812,1,681,200,64163601,63668232,495369,403.73943464366965
1747961159387169,63870364,1,682,200,64232896,63760784,472112,423.6282915918257
1747961159481354,63962924,1,683,200,64327081,63853344,473737,422.17517314459286
1747961159595628,64058604,1,684,200,64441355,63949024,492331,406.23076751210056
1747961159669589,64151164,1,685,200,64515316,64041584,473732,422.17962898854205
1747961159764068,64243732,1,686,200,64609795,64134152,475643,420.4834297992402
1747961159862110,64339404,1,687,200,64707837,64229824,478013,418.39866279787367
1747961159951306,64431964,1,688,200,64797033,64322384,474649,421.3639973959705
1747961160066525,64524524,1,689,200,64912252,64414944,497308,402.1652577477137
1747961160140338,64617084,1,690,200,64986065,64507504,478561,417.91955466492254
1747961160238909,64709652,1,691,200,65084636,64600072,484564,412.742176472045
1747961160324653,64802204,1,692,200,65170380,64692624,477756,418.6237326166495
1747961160418689,64894764,1,693,200,65264416,64785184,479232,417.33440170940173
1747961160521530,64987324,1,694,200,65367257,64877744,489513,408.56933319441976
1747961160611021,65083004,1,695,200,65456748,64973424,483324,413.8010940900928
1747961160710068,65178684,1,696,200,65555795,65069104,486691,410.9383571917295
1747961160799648,65271244,1,697,200,65645375,65161664,483711,413.4700265241022
1747961160894256,65363804,1,698,200,65739983,65254224,485759,411.7268027972719
1747961160992167,65456364,1,699,200,65837894,65346784,491110,407.24074036366596
1747961161078351,65548924,1,700,200,65924078,65439344,484734,412.5974245668759
1747961161197595,65641492,1,701,200,66043322,65531912,511410,391.07565358518605
1747961161287695,65734044,1,702,200,66133422,65624464,508958,392.9597334161168
1747961161373267,65826604,1,703,200,66218994,65717024,501970,398.4301850708209
1747961161463684,65922284,1,704,200,66309411,65812704,496707,402.6518651841025
1747961161557886,66017964,1,705,200,66403613,65908384,495229,403.8535707723094
1747961161651246,66113644,1,706,200,66496973,66004064,492909,405.75440902884714
1747961161758030,66209324,1,707,200,66603757,66099744,504013,396.81516151369107
1747961161843646,66305004,1,708,200,66689373,66195424,493949,404.9001010225752
1747961162052381,66493244,1,710,200,66898108,66383664,514444,388.76923435786983
1747961162126628,66588924,1,711,200,66972355,66479344,493011,405.670461713836
1747961162241644,66681484,1,712,200,67087371,66571904,515467,387.99767977387495
1747961162417709,66872844,1,714,200,67263436,66763264,500172,399.86244731812263
1747961162524483,66968524,1,715,200,67370210,66858944,511266,391.185801520148
1747961162613873,67064204,1,716,200,67459600,66954624,504976,396.0584265390831
1747961162917042,67351244,1,719,200,67762769,67241664,521105,383.799810019094
1747961163187661,67635164,1,722,200,68033388,67525584,507804,393.85274633520015
1747961163297845,67727724,1,723,200,68143572,67618144,525428,380.64206703868086
1747961163949421,68394364,1,730,200,68795148,68284784,510364,391.87717001982895
1747961164146326,68582604,1,732,200,68992053,68473024,519029,385.3349234821176
1747961164227628,68675164,1,733,200,69073355,68565584,507771,393.87834279626054
1747961164318457,68767724,1,734,200,69164184,68658144,506040,395.2256738597739
1747961164420538,68860284,1,735,200,69266265,68750704,515561,387.9269378405271
1747961164510245,68952844,1,736,200,69355972,68843264,512708,390.0855847773001
1747961164608981,69045404,1,737,200,69454708,68935824,518884,385.4426037418768
1747961164699225,69137964,1,738,200,69544952,69028384,516568,387.1707113100308
1747961164792692,69230524,1,739,200,69638419,69120944,517475,386.4921010676844
1747961164882838,69323084,1,740,200,69728565,69213504,515061,388.3035213304832
1747961164977733,69415644,1,741,200,69823460,69306064,517396,386.5511136537585
1747961165067924,69508204,1,742,200,69913651,69398624,515027,388.32915555883477
1747961165157817,69600764,1,743,200,70003544,69491184,512360,390.35053478023264
1747961165255483,69693324,1,744,200,70101210,69583744,517466,386.49882311108365
1747961165349986,69785884,1,745,200,70195713,69676304,519409,385.05301217345095
1747961165439653,69878444,1,746,200,70285380,69768864,516516,387.20968953527097
1747961165534025,69971004,1,747,200,70379752,69861424,518328,385.8560602552824
1747961165640595,70063564,1,748,200,70486322,69953984,532338,375.701152275434
1747961165723160,70156124,1,749,200,70568887,70046544,522343,382.8901698692239
1747961165816855,70248684,1,750,200,70662582,70139104,523478,382.05999105979623
1747961166013520,70436924,1,752,200,70859247,70327344,531903,376.00840754799276
1747961166197983,70625164,1,754,200,71043710,70515584,528126,378.69750779170124
1747961166287529,70717724,1,755,200,71133256,70608144,525112,380.8711284449793
1747961166377804,70810284,1,756,200,71223531,70700704,522827,382.5357144906441
1747961166468606,70902844,1,757,200,71314333,70793264,521069,383.8263262638921
1747961166566264,70995404,1,758,200,71411991,70885824,526167,380.107456377918
1747961166673127,71087964,1,759,200,71518854,70978384,540470,370.0482913020149
1747961166759721,71180524,1,760,200,71605448,71070944,534504,374.1786778022241
1747961166869970,71273084,1,761,200,71715697,71163504,552193,362.19220453718174
1747961166943211,71368764,1,762,200,71788938,71259184,529754,377.53372319982486
1747961167422333,71847164,1,767,200,72268060,71737584,530476,377.0198840286837
1747961167516742,71939724,1,768,200,72362469,71830144,532325,375.7103273376227
1747961167635625,72032292,1,769,200,72481352,71922712,558640,358.01231562365746
1747961167708854,72127964,1,770,200,72554581,72018384,536197,372.99723795545293
1747961168094181,72510684,1,774,200,72939908,72401104,538804,371.1924930030215
1747961168381301,72797724,1,777,200,73227028,72688144,538884,371.1373876381559
1747961168479247,72890284,1,778,200,73324974,72780704,544270,367.46467745787936
1747961168950093,73365564,1,783,200,73795820,73255984,539836,370.4828873954312
1747961169060794,73461244,1,784,200,73906521,73351664,554857,360.4532338963012
1747961169334900,73745164,1,787,200,74180627,73635584,545043,366.94352555669917
1747961169437784,73837724,1,788,200,74283511,73728144,555367,360.12222548332903
1747961169831079,74217324,1,792,200,74676806,74107744,569062,351.45555317346793
1747961170096202,74501244,1,795,200,74941929,74391664,550265,363.46124140187
1747961170302238,74689484,1,797,200,75147965,74579904,568061,352.074865199336
1747961170379603,74785164,1,798,200,75225330,74675584,549746,363.80437511141514
1747961170596522,74973404,1,800,200,75442249,74863824,578425,345.766521156589
1747961170670240,75065964,1,801,200,75515967,74956384,559583,357.40899920119085
1747961170760609,75158524,1,802,200,75606336,75048944,557392,358.8139047564371
1747961171141543,75538124,1,806,200,75987270,75428544,558726,357.9572097951411
1747961171330187,75726364,1,808,200,76175914,75616784,559130,357.6985674172375
1747961171522801,75914604,1,810,200,76368528,75805024,563504,354.9220591158182
1747961171629144,76007164,1,811,200,76474871,75897584,577287,346.44812718803644
1747961171805571,76195404,1,813,200,76651298,76085824,565474,353.6855805925648
1747961171895278,76287964,1,814,200,76741005,76178384,562621,355.47908805394746
1747961171993700,76380524,1,815,200,76839427,76270944,568483,351.8135106942512
1747961172473123,76855804,1,820,200,77318850,76746224,572626,349.2681086782647
1747961172669644,77044044,1,822,200,77515371,76934464,580907,344.2891891473162
1747961172971806,77331084,1,825,200,77817533,77221504,596029,335.5541424997777
1747961173054681,77423652,1,826,200,77900408,77314072,586336,341.1013480325274
1747961173152892,77519324,1,827,200,77998619,77409744,588875,339.6306516663129
1747961173247057,77611884,1,828,200,78092784,77502304,590480,338.70749220972766
1747961173332700,77707564,1,829,200,78178427,77597984,580443,344.5644102866259
1747961173419057,77800124,1,830,200,78264784,77690544,574240,348.2864307606576
1747961173538066,77892684,1,831,200,78383793,77783104,600689,332.9509946078586
1747961173721841,78084044,1,833,200,78567568,77974464,593104,337.2089886428013
1747961173894033,78272284,1,835,200,78739760,78162704,577056,346.5868130649365
1747961174004786,78364844,1,836,200,78850513,78255264,595249,335.99384459276706
1747961174082600,78460524,1,837,200,78928327,78350944,577383,346.39052414082164
1747961174188393,78553084,1,838,200,79034120,78443504,590616,338.62949869289014
1747961174463061,78837004,1,841,200,79308788,78727424,581364,344.01854948018797
1747961174582064,78929564,1,842,200,79427791,78819984,607807,329.05182072598706
1747961174937976,79309164,1,846,200,79783703,79199584,584119,342.39598437989514
1747961175147488,79497404,1,848,200,79993215,79387824,605391,330.3650037744202
1747961175245362,79593084,1,849,200,80091089,79483504,607585,329.17205000123437
1747961175342785,79688764,1,850,200,80188512,79579184,609328,328.23044403014467
1747961175515264,79877004,1,852,200,80360991,79767424,593567,336.94595555345904
1747961175613940,79969564,1,853,200,80459667,79859984,599683,333.5095375389998
1747961175802815,80157804,1,855,200,80648542,80048224,600318,333.1567602504006
1747961175884688,80250364,1,856,200,80730415,80140784,589631,339.19519156896433
1747961175986763,80342924,1,857,200,80832490,80233344,599146,333.80845403290687
1747961176171705,80531164,1,859,200,81017432,80421584,595848,335.65607336099134
1747961176265604,80623724,1,860,200,81111331,80514144,597187,334.90347244665406
1747961176359141,80716284,1,861,200,81204868,80606704,598164,334.3564641135207
1747961176454070,80808844,1,862,200,81299797,80699264,600533,333.03748503412805
1747961176552395,80904524,1,863,200,81398122,80794944,603178,331.5770800659175
1747961176650151,80997084,1,864,200,81495878,80887504,608374,328.7451468997689
1747961176740459,81092764,1,865,200,81586186,80983184,603002,331.6738584614976
1747961176834798,81188444,1,866,200,81680525,81078864,601661,332.4131030596964
1747961177023331,81376684,1,868,200,81869058,81267104,601954,332.251301594474
1747961177117522,81469244,1,869,200,81963249,81359664,603585,331.3534961935767
1747961177223365,81564924,1,870,200,82069092,81455344,613748,325.86664233529075
1747961177314174,81660604,1,871,200,82159901,81551024,608877,328.47356691088675
1747961177407059,81753164,1,872,200,82252786,81643584,609202,328.2983312595822
1747961177522599,81848844,1,873,200,82368326,81739264,629062,317.93368539190095
1747961177714680,82040204,1,875,200,82560407,81930624,629783,317.56970258009505
1747961177793356,82135884,1,876,200,82639083,82026304,612779,326.3819419399164
1747961178001128,82327244,1,878,200,82846855,82217664,629191,317.86850097982966
1747961183887632,88163724,1,939,200,88733359,88054144,679215,294.4575723445448
1747961184341835,88639004,1,944,200,89187562,88529424,658138,303.8876345082642
1747961185308275,89595804,1,954,200,90154002,89486224,667778,299.50073227929045
1747961185394256,89688364,1,955,200,90239983,89578784,661199,302.48079625044807
1747961185489046,89780924,1,956,200,90334773,89671344,663429,301.4640602084021
1747961185599110,89873484,1,957,200,90444837,89763904,680933,293.71465327719466
1747961187614792,91879644,1,978,200,92460519,91770064,690455,289.6640621039749
1747961187913866,92166684,1,981,200,92759593,92057104,702489,284.7019668635381
1747961188008061,92259244,1,982,200,92853788,92149664,704124,284.0408791633292
1747961188110374,92354924,1,983,200,92956101,92245344,710757,281.3901234880557
1747961188380401,92641964,1,986,200,93226128,92532384,693744,288.2907816139671
1747961188573021,92833324,1,988,200,93418748,92723744,695004,287.7681279532204
1747961188663280,92925884,1,989,200,93509007,92816304,692703,288.724027469204
1747961188867973,93117244,1,991,200,93713700,93007664,706036,283.2716745321768
1747961189354693,93595644,1,996,200,94200420,93486064,714356,279.97245071085007
1747961189530714,93787004,1,998,200,94376441,93677424,699017,286.1160744302356
1747961189621130,93882684,1,999,200,94466857,93773104,693753,288.2870416416217
1747961191194414,95429164,1,1015,200,96040141,95319584,720557,277.56305191678103
1747961202162316,106328364,1,1127,200,107008043,106218784,789259,253.40224184963364
1747961202371400,106520764,1,1129,200,107217127,106411184,805943,248.15650734605302
1747961202449366,106618524,1,1130,200,107295093,106508944,786149,254.40469936360665
1747961202575854,106716284,1,1131,200,107421581,106606704,814877,245.43581423944966
1747961202658244,106814044,1,1132,200,107503971,106704464,799507,250.15415749955912
1747961202846644,107009564,1,1134,200,107692371,106899984,792387,252.40191976900178
1747961202944953,107107324,1,1135,200,107790680,106997744,792936,252.22716587467337
1747961203047403,107205084,1,1136,200,107893130,107095504,797626,250.74408306649985
1747961203141475,107302844,1,1137,200,107987202,107193264,793938,251.9088392292597
1747961203358548,107498364,1,1139,200,108204275,107388784,815491,245.25102055080927
1747961203440434,107596124,1,1140,200,108286161,107486544,799617,250.1197448278363
1747961203547101,107693884,1,1141,200,108392828,107584304,808524,247.36433303154885
1747961204124439,108280444,1,1147,200,108970166,108170864,799302,250.21831548025654
1747961204628062,108766124,1,1152,200,109473789,108656544,817245,244.72465417347308
1747961204714216,108863884,1,1153,200,109559943,108754304,805639,248.2501467778993
1747961204816013,108961644,1,1154,200,109661740,108852064,809676,247.012385200994
1747961204910050,109059404,1,1155,200,109755777,108949824,805953,248.15342830165034
1747961205222163,109352684,1,1158,200,110067890,109243104,824786,242.48714211928913
1747961205901564,110037012,1,1165,200,110747291,109927432,819859,243.94438555898026
1747961206000601,110131644,1,1166,200,110846328,110022064,824264,242.64070734619006
1747961206090501,110229404,1,1167,200,110936228,110119824,816404,244.97675170626306
1747961206201202,110327164,1,1168,200,111046929,110217584,829345,241.1541638280812
1747961206393499,110522684,1,1170,200,111239226,110413104,826122,242.09499323344494
1747961206606403,110718204,1,1172,200,111452130,110608624,843506,237.10560446517275
1747961207170765,111304764,1,1178,200,112016492,111195184,821308,243.51400449039824
1747961207265151,111399404,1,1179,200,112110878,111289824,821054,243.58933760751427
1747961207368247,111494044,1,1180,200,112213974,111384464,829510,241.10619522368629
1747961207458361,111588684,1,1181,200,112304088,111479104,824984,242.42894407649118
1747961207572928,111683324,1,1182,200,112418655,111573744,844911,236.71132225761056
1747961207648879,111777964,1,1183,200,112494606,111668384,826222,242.06569178743726
1747961207749643,111875724,1,1184,200,112595370,111766144,829226,241.18877121556727
1747961207962538,112068124,1,1186,200,112808265,111958544,849721,235.37137483950616
1747961208048210,112165884,1,1187,200,112893937,112056304,837633,238.76805235705854
1747961208146413,112260524,1,1188,200,112992140,112150944,841196,237.75671781606187
1747961208236067,112355164,1,1189,200,113081794,112245584,836210,239.1743700745028
1747961208330877,112452924,1,1190,200,113176604,112343344,833260,240.02112185872357
1747961208428423,112547564,1,1191,200,113274150,112437984,836166,239.18695570018394
1747961208522842,112642204,1,1192,200,113368569,112532624,835945,239.25018990483824
1747961208616839,112736844,1,1193,200,113462566,112627264,835302,239.43436026730453
1747961208736286,112831484,1,1194,200,113582013,112721904,860109,232.52866787814102
1747961209817583,113903724,1,1205,200,114663310,113794144,869166,230.10564150001267
1747961209895715,114001484,1,1206,200,114741442,113891904,849538,235.42207646979887
1747961211266975,115370124,1,1220,200,116112702,115260544,852158,234.69826018179728
1747961211467176,115565644,1,1222,200,116312903,115456064,856839,233.41607933345705
1747961212557376,116641004,1,1233,200,117403103,116531424,871679,229.44226028159449
1747961214416772,118498444,1,1252,200,119262499,118388864,873635,228.9285571205366
1747961215031448,119081884,1,1258,200,119877175,118972304,904871,221.02598049887774
1747961215202797,119277404,1,1260,200,120048524,119167824,880700,227.09208584080844
1747961215296544,119372044,1,1261,200,120142271,119262464,879807,227.32258324837153
1747961215399359,119466684,1,1262,200,120245086,119357104,887982,225.2297906939555
1747961215493404,119564444,1,1263,200,120339131,119454864,884267,226.17603054281116
1747961215584011,119659084,1,1264,200,120429738,119549504,880234,227.212309454077
1747961215895163,119952364,1,1267,200,120740890,119842784,898106,222.69086277120965
1747961216005214,120050124,1,1268,200,120850941,119940544,910397,219.68437945204124
1747961216296481,120343404,1,1271,200,121142208,120233824,908384,220.17120512910842
1747961216382898,120441164,1,1272,200,121228625,120331584,897041,222.95524953708917
1747961216477086,120538924,1,1273,200,121322813,120429344,893469,223.84660240030712
1747961216575359,120633564,1,1274,200,121421086,120523984,897102,222.9400893097998
1747961216669611,120731324,1,1275,200,121515338,120621744,893594,223.81528971770177
1747961216759384,120825964,1,1276,200,121605111,120716384,888727,225.04098558950048
1747961216857248,120920604,1,1277,200,121702975,120811024,891951,224.22756407022356
1747961216956436,121015244,1,1278,200,121802163,120905664,896499,223.09004248749858
1747961217062997,121113004,1,1279,200,121908724,121003424,905300,220.92124157737766
1747961217169378,121210764,1,1280,200,122015105,121101184,913921,218.83729556493395
1747961217255244,121305404,1,1281,200,122100971,121195824,905147,220.9585846276903
1747961217341293,121400044,1,1282,200,122187020,121290464,896556,223.07585917667163
1747961217443698,121494684,1,1283,200,122289425,121385104,904321,221.1604065370593
1747961217550134,121589324,1,1284,200,122395861,121479744,916117,218.31272643123094
1747961217647550,121683964,1,1285,200,122493277,121574384,918893,217.6531979240238
1747961217730298,121781724,1,1286,200,122576025,121672144,903881,221.26806515459447
1747961217828458,121876364,1,1287,200,122674185,121766784,907401,220.40971962781614
1747961218025303,122068764,1,1289,200,122871030,121959184,911846,219.33528249287707
1747961218434318,122459804,1,1293,200,123280045,122350224,929821,215.09516347770162
1747961218512560,122557564,1,1294,200,123358287,122447984,910303,219.70706457080774
1747961218700092,122749972,1,1296,200,123545819,122640392,905427,220.89025399065855
1747961218901788,122945484,1,1298,200,123747515,122835904,911611,219.3918239248978
1747961218991515,123040124,1,1299,200,123837242,122930544,906698,220.5806122876636
1747961219090013,123134764,1,1300,200,123935740,123025184,910556,219.64601847662306
1747961219282652,123327164,1,1302,200,124128379,123217584,910795,219.58838157873066
1747961219385014,123424924,1,1303,200,124230741,123315344,915397,218.4844389920439
1747961223221978,127234444,1,1342,200,128067705,127124864,942841,212.12484395566165
1747961223332892,127332204,1,1343,200,128178619,127222624,955995,209.2061150947442
1747961223439161,127429964,1,1344,200,128284888,127320384,964504,207.36046714166037
1747961224819939,128798604,1,1358,200,129665666,128689024,976642,204.78332899875286
1747961224909715,128896364,1,1359,200,129755442,128786784,968658,206.4712210088597
1747961234275430,138183564,1,1454,200,139121157,138073984,1047173,190.99040941659115
1747961234563173,138476844,1,1457,200,139408900,138367264,1041636,192.00565264641392
1747961234658147,138574604,1,1458,200,139503874,138465024,1038850,192.52057563652113
1747961234849777,138770124,1,1460,200,139695504,138660544,1034960,193.24418335008113
1747961237205419,141116364,1,1484,200,142051146,141006784,1044362,191.5044783322258
1747961237503763,141409644,1,1487,200,142349490,141300064,1049426,190.5803744142036
1747961237606814,141507404,1,1488,200,142452541,141397824,1054717,189.62432576700672
1747961237999821,141898444,1,1492,200,142845548,141788864,1056684,189.27134318301404
1747961238093918,141996204,1,1493,200,142939645,141886624,1053021,189.92973549435388
1747961238183848,142090844,1,1494,200,143029575,141981264,1048311,190.78307868561905
1747961238282120,142185492,1,1495,200,143127847,142075912,1051935,190.12581575857823
1747961238376344,142280124,1,1496,200,143222071,142170544,1051527,190.1995859355014
1747961238474666,142374764,1,1497,200,143320393,142265184,1055209,189.53591184305668
1747961238572870,142469404,1,1498,200,143418597,142359824,1058773,188.89790351661782
1747961238663122,142564044,1,1499,200,143508849,142454464,1054385,189.68403382066325
1747961238753531,142658684,1,1500,200,143599258,142549104,1050154,190.4482580650076
