Tempo total receptor,Tempo total emissor,Id do pacote,Id da mensagem,Distancia (m),Tempo zerado receptor,Tempo zerado emissor,Delta tempo,Velocidade (m/s)
1747959403591799,109580,1,1,10,0,0,0,0
1747959403681335,197404,1,2,10,89536,87824,1712,5841.121495327103
1747959403772088,285804,1,3,10,180289,176224,4065,2460.0246002460026
1747959403857102,374204,1,4,10,265303,264624,679,14727.540500736377
1747959403947752,462604,1,5,10,355953,353024,2929,3414.1345168999655
1747959404037458,551004,1,6,10,445659,441424,4235,2361.275088547816
1747959404128249,639404,1,7,10,536450,529824,6626,1509.2061575611228
1747959404214181,727804,1,8,10,622382,618224,4158,2405.002405002405
1747959404304336,816204,1,9,10,712537,706624,5913,1691.188905800778
1747959404394189,904604,1,10,10,802390,795024,7366,1357.588922074396
1747959404484360,994044,1,11,10,892561,884464,8097,1235.0253180190193
1747959404573933,1083484,1,12,10,982134,973904,8230,1215.0668286755772
1747959404668381,1173964,1,13,10,1076582,1064384,12198,819.8065256599442
1747959404758731,1264444,1,14,10,1166932,1154864,12068,828.6377195889957
1747959404849395,1354924,1,15,10,1257596,1245344,12252,816.1932745674175
1747959404939348,1445404,1,16,10,1347549,1335824,11725,852.8784648187634
1747959405033194,1535884,1,17,10,1441395,1426304,15091,662.646610562587
1747959405122927,1626364,1,18,10,1531128,1516784,14344,697.1556051310652
1747959405213654,1716844,1,19,10,1621855,1607264,14591,685.3539853334247
1747959405303583,1807324,1,20,10,1711784,1697744,14040,712.2507122507122
1747959405397840,1897804,1,21,10,1806041,1788224,17817,561.2617163383286
1747959405486964,1988284,1,22,10,1895165,1878704,16461,607.4965068950853
1747959405577925,2078764,1,23,10,1986126,1969184,16942,590.2490851139181
1747959405668339,2169244,1,24,10,2076540,2059664,16876,592.5574780753734
1747959405762062,2259724,1,25,10,2170263,2150144,20119,497.04259655052437
1747959405851896,2350204,1,26,10,2260097,2240624,19473,513.5315565141477
1747959405942258,2440684,1,27,10,2350459,2331104,19355,516.6623611469904
1747959406032598,2531164,1,28,10,2440799,2421584,19215,520.4267499349467
1747959406125916,2621644,1,29,10,2534117,2512064,22053,453.45304493719675
1747959406217001,2712124,1,30,10,2625202,2602544,22658,441.3452202312649
1747959406306478,2802604,1,31,10,2714679,2693024,21655,461.78711613945967
1747959406397764,2893084,1,32,10,2805965,2783504,22461,445.21615244201064
1747959406490644,2983564,1,33,10,2898845,2873984,24861,402.2364345762439
1747959406581256,3074044,1,34,10,2989457,2964464,24993,400.1120313687832
1747959406670989,3164524,1,35,10,3079190,3054944,24246,412.4391652231296
1747959406761861,3255004,1,36,10,3170062,3145424,24638,405.87710041399464
1747959406855383,3345484,1,37,10,3263584,3235904,27680,361.27167630057806
1747959406945306,3435964,1,38,10,3353507,3326384,27123,368.6907790436161
1747959407035352,3526444,1,39,10,3443553,3416864,26689,374.68620030724264
1747959407126021,3616924,1,40,10,3534222,3507344,26878,372.05149192648264
1747959407219938,3707404,1,41,10,3628139,3597824,30315,329.86970146792015
1747959407310341,3797884,1,42,10,3718542,3688304,30238,330.70970302268665
1747959407400895,3888364,1,43,10,3809096,3778784,30312,329.9023489047242
1747959407490198,3978844,1,44,10,3898399,3869264,29135,343.2297923459756
1747959407584815,4069324,1,45,10,3993016,3959744,33272,300.5530175522962
1747959407674821,4159804,1,46,10,4083022,4050224,32798,304.89664003902675
1747959407764547,4250284,1,47,10,4172748,4140704,32044,312.07090250905003
1747959407855547,4340772,1,48,10,4263748,4231192,32556,307.16304214276937
1747959407949477,4431244,1,49,10,4357678,4321664,36014,277.66979507969126
1747959408040443,4521724,1,50,10,4448644,4412144,36500,273.972602739726
1747959408129762,4612204,1,51,10,4537963,4502624,35339,282.97348538441946
1747959408219578,4702684,1,52,10,4627779,4593104,34675,288.39221341023796
1747959408313830,4793164,1,53,10,4722031,4683584,38447,260.09831716388794
1747959408404158,4883644,1,54,10,4812359,4774064,38295,261.1306959133046
1747959408494228,4974124,1,55,10,4902429,4864544,37885,263.9567110993797
1747959408584072,5064604,1,56,10,4992273,4955024,37249,268.4635829149776
1747959408678552,5155084,1,57,10,5086753,5045504,41249,242.4301195180489
1747959408768174,5245564,1,58,10,5176375,5135984,40391,247.57990641479535
1747959408858678,5336044,1,59,10,5266879,5226464,40415,247.43288383026103
1747959408949144,5426524,1,60,10,5357345,5316944,40401,247.5186257765897
1747959409042744,5517004,1,61,10,5450945,5407424,43521,229.7741320282163
1747959409132844,5607484,1,62,10,5541045,5497904,43141,231.79805753227788
1747959409223280,5697964,1,63,10,5631481,5588384,43097,232.03471239297397
1747959409316654,5788444,1,64,10,5724855,5678864,45991,217.43384575242985
1747959409407146,5878924,1,65,10,5815347,5769344,46003,217.37712757863616
1747959409497372,5969404,1,66,10,5905573,5859824,45749,218.58401276530637
1747959409587778,6059884,1,67,10,5995979,5950304,45675,218.93814997263274
1747959409682203,6150364,1,68,10,6090404,6040784,49620,201.53164046755342
1747959409771331,6240844,1,69,10,6179532,6131264,48268,207.17659733156543
1747959409861280,6331324,1,70,10,6269481,6221744,47737,209.48111527745772
1747959409952092,6421804,1,71,10,6360293,6312224,48069,208.03428405001145
1747959410045735,6512284,1,72,10,6453936,6402704,51232,195.19050593379137
1747959410136634,6602772,1,73,10,6544835,6493192,51643,193.63708537459092
1747959410226369,6693244,1,74,10,6634570,6583664,50906,196.44049817310338
1747959410316478,6783724,1,75,10,6724679,6674144,50535,197.88265558523796
1747959410410801,6874204,1,76,10,6819002,6764624,54378,183.8978998859833
1747959410501156,6964684,1,77,10,6909357,6855104,54253,184.32160433524413
1747959410590705,7055164,1,78,10,6998906,6945584,53322,187.53985221859645
1747959410681093,7145644,1,79,10,7089294,7036064,53230,187.86398647379298
1747959410775115,7236124,1,80,10,7183316,7126544,56772,176.14316916789966
1747959410865677,7326604,1,81,10,7273878,7217024,56854,175.8891194990678
1747959410955899,7417084,1,82,10,7364100,7307504,56596,176.6909322213584
1747959411045926,7507564,1,83,10,7454127,7397984,56143,178.11659512316763
1747959411139609,7598044,1,84,10,7547810,7488464,59346,168.503353216729
1747959411229875,7688524,1,85,10,7638076,7578944,59132,169.1131705337212
1747959411320362,7779004,1,86,10,7728563,7669424,59139,169.0931534182181
1747959411409494,7869484,1,87,10,7817695,7759904,57791,173.03732415081933
1747959411504018,7959964,1,88,10,7912219,7850384,61835,161.7207083367025
1747959411594019,8050444,1,89,10,8002220,7940864,61356,162.98324532238087
1747959411684752,8140924,1,90,10,8092953,8031344,61609,162.3139476375205
1747959411774006,8231404,1,91,10,8182207,8121824,60383,165.60952585992746
1747959411868620,8321884,1,92,10,8276821,8212304,64517,154.99790752824836
1747959411959304,8412364,1,93,10,8367505,8302784,64721,154.50935554147804
1747959412048588,8502844,1,94,10,8456789,8393264,63525,157.41833923652106
1747959412138861,8593324,1,95,10,8547062,8483744,63318,157.93297324615435
1747959412233549,8683804,1,96,10,8641750,8574224,67526,148.09110564819477
1747959412323931,8774284,1,97,10,8732132,8664704,67428,148.30634157916592
1747959412413245,8864764,1,98,10,8821446,8755184,66262,150.91606048715704
1747959412503894,8955244,1,99,10,8912095,8845664,66431,150.53213108337974
1747959412597779,9045724,1,100,10,9005980,8936144,69836,143.19262271607766
1747959412688304,9137244,1,101,10,9096505,9027664,68841,145.2622710303453
1747959412782374,9228764,1,102,10,9190575,9119184,71391,140.07367875502516
1747959412872362,9320284,1,103,10,9280563,9210704,69859,143.14547875005368
1747959412966325,9411804,1,104,10,9374526,9302224,72302,138.3087604768886
1747959413056218,9503324,1,105,10,9464419,9393744,70675,141.49274849663954
1747959413150407,9594844,1,106,10,9558608,9485264,73344,136.3438045375218
1747959413241037,9686364,1,107,10,9649238,9576784,72454,138.01860490794158
1747959413335054,9777884,1,108,10,9743255,9668304,74951,133.42050139424424
1747959413424917,9869404,1,109,10,9833118,9759824,73294,136.43681611045926
1747959413519587,9960924,1,110,10,9927788,9851344,76444,130.81471403903512
1747959413613764,10052444,1,111,10,10021965,9942864,79101,126.4206520777234
1747959413703257,10145004,1,112,10,10111458,10035424,76034,131.52010942473103
1747959413798080,10237564,1,113,10,10206281,10127984,78297,127.71881425852841
1747959413892325,10330132,1,114,10,10300526,10220552,79974,125.0406382074174
1747959413986717,10422684,1,115,10,10394918,10313104,81814,122.22846945510548
1747959414080091,10515244,1,116,10,10488292,10405664,82628,121.02435009923998
1747959414170364,10607804,1,117,10,10578565,10498224,80341,124.4694489737494
1747959414265233,10700364,1,118,10,10673434,10590784,82650,120.99213551119178
1747959414359265,10792924,1,119,10,10767466,10683344,84122,118.87496730938399
1747959414453315,10885484,1,120,10,10861516,10775904,85612,116.80605522590292
1747959414543784,10978044,1,121,10,10951985,10868464,83521,119.73036721303625
1747959414637558,11070604,1,122,10,11045759,10961024,84735,118.01498790346373
1747959414731262,11163164,1,123,10,11139463,11053584,85879,116.44290222289501
1747959414826172,11255724,1,124,10,11234373,11146144,88229,113.34141835450929
1747959414916109,11348284,1,125,10,11324310,11238704,85606,116.81424199238371
1747959415010497,11440844,1,126,10,11418698,11331264,87434,114.3719834389368
1747959415104069,11533404,1,127,10,11512270,11423824,88446,113.06333808199354
1747959415198781,11625964,1,128,10,11606982,11516384,90598,110.37771253228549
1747959415288659,11718524,1,129,10,11696860,11608944,87916,113.74493835024342
1747959415383211,11811084,1,130,10,11791412,11701504,89908,111.22480758108289
1747959415476648,11903644,1,131,10,11884849,11794064,90785,110.15035523489563
1747959415571572,11996204,1,132,10,11979773,11886624,93149,107.35488303685494
1747959415665934,12088764,1,133,10,12074135,11979184,94951,105.31747954207961
1747959415755614,12181324,1,134,10,12163815,12071744,92071,108.61183217299693
1747959415849722,12273884,1,135,10,12257923,12164304,93619,106.81592411796751
1747959415944296,12366444,1,136,10,12352497,12256864,95633,104.56641535871509
1747959416038579,12459004,1,137,10,12446780,12349424,97356,102.71580590821316
1747959416128846,12551564,1,138,10,12537047,12441984,95063,105.19339806233761
1747959416222783,12644124,1,139,10,12630984,12534544,96440,103.69141435089175
1747959416316867,12736684,1,140,10,12725068,12627104,97964,102.07831448287126
1747959416411098,12829244,1,141,10,12819299,12719664,99635,100.36633713052642
1747959416501479,12921804,1,142,10,12909680,12812224,97456,102.61040879986865
1747959416595576,13014364,1,143,10,13003777,12904784,98993,101.01724364348995
1747959416689885,13106924,1,144,10,13098086,12997344,100742,99.26346508903933
1747959416783688,13199484,1,145,10,13191889,13089904,101985,98.05363533853017
1747959416873470,13292044,1,146,10,13281671,13182464,99207,100.79933875633776
1747959416968179,13384604,1,147,10,13376380,13275024,101356,98.66214136311615
1747959417062373,13477164,1,148,10,13470574,13367584,102990,97.09680551509855
1747959417156648,13569724,1,149,10,13564849,13460144,104705,95.50642280693376
1747959417250272,13662284,1,150,10,13658473,13552704,105769,94.54566082689635
1747959417340798,13754844,1,151,10,13748999,13645264,103735,96.39947944281101
1747959417434512,13847404,1,152,10,13842713,13737824,104889,95.33888205626901
1747959417528686,13939964,1,153,10,13936887,13830384,106503,93.89406871167948
1747959417623348,14032524,1,154,10,14031549,13922944,108605,92.07679204456517
1747959417713498,14125092,1,155,10,14121699,14015512,106187,94.17348639663989
1747959417807840,14217644,1,156,10,14216041,14108064,107977,92.61231558572659
1747959417901973,14310204,1,157,10,14310174,14200624,109550,91.28251939753538
1747959417996140,14402764,1,158,10,14404341,14293184,111157,89.96284534487256
1747959418085938,14495324,1,159,10,14494139,14385744,108395,92.25517782185524
1747959418180466,14587884,1,160,10,14588667,14478304,110363,90.61007765283655
1747959418274299,14680444,1,161,10,14682500,14570864,111636,89.57683901250493
1747959418368326,14773004,1,162,10,14776527,14663424,113103,88.4149845715852
1747959418458234,14865564,1,163,10,14866435,14755984,110451,90.53788557822021
1747959418553335,14958124,1,164,10,14961536,14848544,112992,88.50184083828944
1747959418647318,15050684,1,165,10,15055519,14941104,114415,87.40112747454442
1747959418741001,15143244,1,166,10,15149202,15033664,115538,86.5516107254756
1747959418835458,15235804,1,167,10,15243659,15126224,117435,85.1534891642185
1747959418925913,15328364,1,168,10,15334114,15218784,115330,86.70770831526923
1747959419019505,15420924,1,169,10,15427706,15311344,116362,85.93870851308847
1747959419114395,15513484,1,170,10,15522596,15403904,118692,84.2516766083645
1747959419208287,15606044,1,171,10,15616488,15496464,120024,83.31666999933346
1747959419298256,15698604,1,172,10,15706457,15589024,117433,85.15493941226062
1747959419392202,15791164,1,173,10,15800403,15681584,118819,84.16162398269637
1747959419486656,15883724,1,174,10,15894857,15774144,120713,82.8411190178357
1747959419581280,15976284,1,175,10,15989481,15866704,122777,81.44847976412521
1747959419671677,16068844,1,176,10,16079878,15959264,120614,82.90911502810619
1747959419765513,16161404,1,177,10,16173714,16051824,121890,82.0411846747067
1747959419859764,16253972,1,178,10,16267965,16144392,123573,80.9238264022076
1747959419953919,16346524,1,179,10,16362120,16236944,125176,79.88751837412921
1747959420043743,16439084,1,180,10,16451944,16329504,122440,81.67265599477295
1747959420137502,16531644,1,181,10,16545703,16422064,123639,80.88062828072049
1747959420232533,16624204,1,182,10,16640734,16514624,126110,79.29585282689715
1747959420325876,16716764,1,183,10,16734077,16607184,126893,78.80655355299346
1747959420420239,16809324,1,184,10,16828440,16699744,128696,77.70249269596569
1747959420510791,16901884,1,185,10,16918992,16792304,126688,78.93407426117707
1747959420605212,16994444,1,186,10,17013413,16884864,128549,77.7913480462703
1747959420699411,17087004,1,187,10,17107612,16977424,130188,76.81199496113314
1747959420792811,17179564,1,188,10,17201012,17069984,131028,76.31956528375613
1747959420883716,17272124,1,189,10,17291917,17162544,129373,77.29588090250671
1747959420978036,17364684,1,190,10,17386237,17255104,131133,76.25845515621545
1747959421071955,17457244,1,191,10,17480156,17347664,132492,75.47625517012348
1747959421165684,17549804,1,192,10,17573885,17440224,133661,74.8161393375779
1747959421260457,17642364,1,193,10,17668658,17532784,135874,73.59759777440864
1747959421354580,17734924,1,194,10,17762781,17625344,137437,72.76061031599933
1747959421444326,17827484,1,195,10,17852527,17717904,134623,74.2815120744598
1747959421538524,17920044,1,196,10,17946725,17810464,136261,73.38857046403594
1747959421628940,18012604,1,197,10,18037141,17903024,134117,74.56176323657702
1747959421722869,18105164,1,198,10,18131070,17995584,135486,73.80836396380438
1747959421816810,18197724,1,199,10,18225011,18088144,136867,73.06363111633922
1747959421911485,18290284,1,200,10,18319686,18180704,138982,71.95176353772432
1747959422004888,18382844,1,201,10,18413089,18273264,139825,71.51796888968353
1747959422095782,18475404,1,202,10,18503983,18365824,138159,72.38037333796568
1747959422189938,18567964,1,203,10,18598139,18458384,139755,71.55379056205503
1747959422283889,18660524,1,204,10,18692090,18550944,141146,70.84862482819209
1747959422377544,18753084,1,205,10,18785745,18643504,142241,70.30321777827771
1747959422468072,18845644,1,206,10,18876273,18736064,140209,71.3220977255383
1747959422562487,18938204,1,207,10,18970688,18828624,142064,70.39080977587567
1747959422656692,19030764,1,208,10,19064893,18921184,143709,69.58506426180685
1747959422751194,19123324,1,209,10,19159395,19013744,145651,68.65726977501012
1747959422840743,19215884,1,210,10,19248944,19106304,142640,70.10656197420079
1747959422935190,19308444,1,211,10,19343391,19198864,144527,69.1912237851751
1747959423029274,19401004,1,212,10,19437475,19291424,146051,68.46923334999418
1747959423124017,19493564,1,213,10,19532218,19383984,148234,67.46090640473845
1747959423213798,19586124,1,214,10,19621999,19476544,145455,68.74978515692139
1747959423307960,19678684,1,215,10,19716161,19569104,147057,68.00084321045581
1747959423401687,19771244,1,216,10,19809888,19661664,148224,67.46545768566494
1747959423496027,19863804,1,217,10,19904228,19754224,150004,66.66488893629503
1747959423590885,19956364,1,218,10,19999086,19846784,152302,65.65901957951964
1747959423680102,20048932,1,219,10,20088303,19939352,148951,67.13617229827258
1747959423774482,20141484,1,220,10,20182683,20031904,150779,66.32223320223639
1747959423868805,20234044,1,221,10,20277006,20124464,152542,65.55571580286085
1747959423963485,20326604,1,222,10,20371686,20217024,154662,64.65712327527125
1747959424052988,20419164,1,223,10,20461189,20309584,151605,65.96088519507933
1747959424147541,20511724,1,224,10,20555742,20402144,153598,65.10501438820818
1747959424242225,20604284,1,225,10,20650426,20494704,155722,64.21700209347426
1747959424335819,20696844,1,226,10,20744020,20587264,156756,63.793411416468906
1747959424425842,20789404,1,227,10,20834043,20679824,154219,64.8428533449186
1747959424520908,20881964,1,228,10,20929109,20772384,156725,63.80602966980379
1747959424614730,20974524,1,229,10,21022931,20864944,157987,63.29634716780495
1747959424708151,21067084,1,230,10,21116352,20957504,158848,62.9532634971797
1747959424798521,21159644,1,231,10,21206722,21050064,156658,63.83331843889237
1747959424893343,21252204,1,232,10,21301544,21142624,158920,62.924742008557764
1747959424986549,21344764,1,233,10,21394750,21235184,159566,62.66999235426093
1747959425081231,21437324,1,234,10,21489432,21327744,161688,61.847508782346246
1747959425175747,21529884,1,235,10,21583948,21420304,163644,61.10825939233946
1747959425266228,21622444,1,236,10,21674429,21512864,161565,61.89459350725715
1747959425359918,21715004,1,237,10,21768119,21605424,162695,61.464703893788986
1747959425453630,21807564,1,238,10,21861831,21697984,163847,61.03254865819942
1747959425548319,21900124,1,239,10,21956520,21790544,165976,60.24967465175688
1747959425638688,21992684,1,240,10,22046889,21883104,163785,61.05565222700492
1747959425732464,22085244,1,241,10,22140665,21975664,165001,60.60569329882849
1747959425826598,22177812,1,242,10,22234799,22068232,166567,60.03590146907851
1747959425920446,22270364,1,243,10,22328647,22160784,167863,59.572389388965995
1747959426011073,22362924,1,244,10,22419274,22253344,165930,60.266377388055204
1747959426105008,22455484,1,245,10,22513209,22345904,167305,59.77107677594812
1747959426199732,22548044,1,246,10,22607933,22438464,169469,59.007842142220696
1747959426294017,22640604,1,247,10,22702218,22531024,171194,58.41326214703786
1747959426383607,22733164,1,248,10,22791808,22623584,168224,59.44455012364466
1747959426477661,22825724,1,249,10,22885862,22716144,169718,58.92126939982795
1747959426571718,22918284,1,250,10,22979919,22808704,171215,58.406097596589085
1747959426666009,23010844,1,251,10,23074210,22901264,172946,57.821516542735885
1747959426760183,23103404,1,252,10,23168384,22993824,174560,57.28689275893676
1747959426851128,23195964,1,253,10,23259329,23086384,172945,57.82185087744659
1747959426944775,23288524,1,254,10,23352976,23178944,174032,57.460696883331806
1747959427039101,23381084,1,255,10,23447302,23271504,175798,56.88346852637686
1747959427133048,23473644,1,256,10,23541249,23364064,177185,56.438186076699495
1747959427223059,23566204,1,257,10,23631260,23456624,174636,57.26196202386678
1747959427317158,23658764,1,258,10,23725359,23549184,176175,56.76174258549737
1747959427411587,23751324,1,259,10,23819788,23641744,178044,56.1658915773629
1747959427505914,23843884,1,260,10,23914115,23734304,179811,55.61395020326899
1747959427596290,23936444,1,261,10,24004491,23826864,177627,56.29774752712144
1747959427690063,24029004,1,262,10,24098264,23919424,178840,55.91590248266607
1747959427784857,24121564,1,263,10,24193058,24011984,181074,55.22604018246683
1747959427878657,24214124,1,264,10,24286858,24104544,182314,54.850422896760534
1747959427969065,24306684,1,265,10,24377266,24197104,180162,55.50560051509198
1747959428062621,24399244,1,266,10,24470822,24289664,181158,55.200432771392926
1747959428157563,24491804,1,267,10,24565764,24382224,183540,54.48403617740002
1747959428251797,24584364,1,268,10,24659998,24474784,185214,53.99159890721004
1747959428345897,24676924,1,269,10,24754098,24567344,186754,53.546376516701116
1747959428436150,24769484,1,270,10,24844351,24659904,184447,54.216116282726205
1747959428530034,24862044,1,271,10,24938235,24752464,185771,53.829715079318085
1747959428624543,24954604,1,272,10,25032744,24845024,187720,53.27082889409759
1747959428718031,25047164,1,273,10,25126232,24937584,188648,53.008778253678805
1747959428808982,25139724,1,274,10,25217183,25030144,187039,53.46478541908372
1747959428902935,25232284,1,275,10,25311136,25122704,188432,53.06954232826696
1747959428996949,25324844,1,276,10,25405150,25215264,189886,52.66317685348051
1747959429091121,25417404,1,277,10,25499322,25307824,191498,52.21986652602116
1747959429181501,25509964,1,278,10,25589702,25400384,189318,52.821179180004016
1747959429275414,25602524,1,279,10,25683615,25492944,190671,52.44636048481416
1747959429369009,25695084,1,280,10,25777210,25585504,191706,52.163208245959964
1747959429463434,25787644,1,281,10,25871635,25678064,193571,51.66063098294683
1747959429554271,25880204,1,282,10,25962472,25770624,191848,52.12459864059047
1747959429648056,25972772,1,283,10,26056257,25863192,193065,51.79602724471034
1747959429741846,26065324,1,284,10,26150047,25955744,194303,51.46600927417487
1747959429836662,26157884,1,285,10,26244863,26048304,196559,50.87530970344782
1747959429930562,26250444,1,286,10,26338763,26140864,197899,50.530826330602984
1747959430020408,26343004,1,287,10,26428609,26233424,195185,51.23344519302201
1747959430114866,26435564,1,288,10,26523067,26325984,197083,50.74004353495735
1747959430208662,26528124,1,289,10,26616863,26418544,198319,50.42381214104549
1747959430303324,26620684,1,290,10,26711525,26511104,200421,49.894971085864256
1747959430393837,26713244,1,291,10,26802038,26603664,198374,50.40983193362033
1747959430487928,26805804,1,292,10,26896129,26696224,199905,50.02376128661114
1747959430581493,26898364,1,293,10,26989694,26788784,200910,49.77353043651386
1747959430676125,26990924,1,294,10,27084326,26881344,202982,49.265452109054
1747959430766355,27083484,1,295,10,27174556,26973904,200652,49.837529653330144
1747959430860806,27176044,1,296,10,27269007,27066464,202543,49.372232069239615
1747959430954828,27268604,1,297,10,27363029,27159024,204005,49.01840641160756
1747959431048382,27361164,1,298,10,27456583,27251584,204999,48.78072575963785
1747959431138908,27453724,1,299,10,27547109,27344144,202965,49.26957849875594
1747959431233364,27546284,1,300,10,27641565,27436704,204861,48.81358579719908
1747959431327215,27638844,1,301,10,27735416,27529264,206152,48.507897085645546
1747959431421739,27731404,1,302,10,27829940,27621824,208116,48.050125891329834
1747959431515796,27823964,1,303,10,27923997,27714384,209613,47.706964739782364
1747959431605386,27916524,1,304,10,28013587,27806944,206643,48.39263851182958
1747959431700453,28009084,1,305,10,28108654,27899504,209150,47.81257470714798
1747959431794033,28101652,1,306,10,28202234,27992072,210162,47.58234124151845
1747959431888254,28194204,1,307,10,28296455,28084624,211831,47.20744366971784
1747959431978299,28286764,1,308,10,28386500,28177184,209316,47.77465650021976
1747959432072721,28379324,1,309,10,28480922,28269744,211178,47.35341749614069
1747959432167003,28471884,1,310,10,28575204,28362304,212900,46.97040864255519
1747959432260692,28564444,1,311,10,28668893,28454864,214029,46.72264038985371
1747959432351440,28657004,1,312,10,28759641,28547424,212217,47.121578384389565
1747959432445388,28749564,1,313,10,28853589,28639984,213605,46.81538353502961
1747959432539836,28842124,1,314,10,28948037,28732544,215493,46.40521965910726
1747959432633983,28934684,1,315,10,29042184,28825104,217080,46.065966463976416
1747959432724380,29027244,1,316,10,29132581,28917664,214917,46.52959049307407
1747959432817911,29119804,1,317,10,29226112,29010224,215888,46.320314237011786
1747959432912766,29212364,1,318,10,29320967,29102784,218183,45.8330850707892
1747959433006845,29304924,1,319,10,29415046,29195344,219702,45.51619921530072
1747959433100853,29397484,1,320,10,29509054,29287904,221150,45.218177707438386
1747959433191275,29490044,1,321,10,29599476,29380464,219012,45.65959856080945
1747959433284606,29582604,1,322,10,29692807,29473024,219783,45.49942443228093
1747959433379586,29675164,1,323,10,29787787,29565584,222203,45.00389283673037
1747959433473727,29767724,1,324,10,29881928,29658144,223784,44.685947163336074
1747959433563455,29860284,1,325,10,29971656,29750704,220952,45.25869872189435
1747959433658191,29952844,1,326,10,30066392,29843264,223128,44.817324584991574
1747959433752451,30045404,1,327,10,30160652,29935824,224828,44.47844574519188
1747959433846180,30137964,1,328,10,30254381,30028384,225997,44.24837497842891
1747959433936729,30230524,1,329,10,30344930,30120944,223986,44.645647495825635
1747959434034896,30323084,1,330,10,30443097,30213504,229593,43.55533487519219
1747959434124615,30415644,1,331,10,30532816,30306064,226752,44.10104431272932
1747959434219209,30508204,1,332,10,30627410,30398624,228786,43.70896820609653
1747959434309121,30600764,1,333,10,30717322,30491184,226138,44.2207855380343
1747959434403655,30693324,1,334,10,30811856,30583744,228112,43.83811461036684
1747959434498384,30785884,1,335,10,30906585,30676304,230281,43.42520659542038
1747959434591881,30878444,1,336,10,31000082,30768864,231218,43.24922800128017
1747959434685375,30971004,1,337,10,31093576,30861424,232152,43.07522657569179
1747959434776381,31063564,1,338,10,31184582,30953984,230598,43.36551054215561
1747959434870489,31156124,1,339,10,31278690,31046544,232146,43.076339889552266
1747959434964848,31248684,1,340,10,31373049,31139104,233945,42.74508965782556
1747959435058759,31341244,1,341,10,31466960,31231664,235296,42.49966000271998
1747959435148962,31433804,1,342,10,31557163,31324224,232939,42.92969404007057
1747959435243454,31526364,1,343,10,31651655,31416784,234871,42.57656330496315
1747959435337526,31618924,1,344,10,31745727,31509344,236383,42.30422661528113
1747959435430738,31711484,1,345,10,31838939,31601904,237035,42.18786255194381
1747959435521512,31804044,1,346,10,31929713,31694464,235249,42.50815093794235
1747959435615397,31896612,1,347,10,32023598,31787032,236566,42.2715013991867
1747959435710085,31989164,1,348,10,32118286,31879584,238702,41.89323926904676
1747959435804375,32081724,1,349,10,32212576,31972144,240432,41.59180142410328
1747959435894574,32174284,1,350,10,32302775,32064704,238071,42.00427603530039
1747959435988310,32266844,1,351,10,32396511,32157264,239247,41.79780728702973
1747959436082901,32359404,1,352,10,32491102,32249824,241278,41.44596689296165
1747959436176747,32451964,1,353,10,32584948,32342384,242564,41.226233076631324
1747959436271312,32544524,1,354,10,32679513,32434944,244569,40.88825648385527
1747959436360759,32637084,1,355,10,32768960,32527504,241456,41.415413160161684
1747959436454978,32729644,1,356,10,32863179,32620064,243115,41.132797235876026
1747959436549981,32822204,1,357,10,32958182,32712624,245558,40.723576507383186
1747959436643927,32914764,1,358,10,33052128,32805184,246944,40.495011014643
1747959436734177,33007324,1,359,10,33142378,32897744,244634,40.87739234938725
1747959436828115,33099884,1,360,10,33236316,32990304,246012,40.64842365413069
1747959436922136,33192444,1,361,10,33330337,33082864,247473,40.40844859843296
1747959437016690,33285004,1,362,10,33424891,33175424,249467,40.08546220542196
1747959437106715,33377564,1,363,10,33514916,33267984,246932,40.49697892537217
1747959437201145,33470124,1,364,10,33609346,33360544,248802,40.19260295335246
1747959437295235,33562684,1,365,10,33703436,33453104,250332,39.946950449802664
1747959437388942,33655244,1,366,10,33797143,33545664,251479,39.76475172877258
1747959437479510,33747804,1,367,10,33887711,33638224,249487,40.082248774485244
1747959437573543,33840364,1,368,10,33981744,33730784,250960,39.84698756773987
1747959437667984,33932924,1,369,10,34076185,33823344,252841,39.55054757733121
1747959437762159,34025492,1,370,10,34170360,33915912,254448,39.3007608627303
1747959437856281,34118044,1,371,10,34264482,34008464,256018,39.05975361107422
1747959437946299,34210604,1,372,10,34354500,34101024,253476,39.45146680553583
1747959438040852,34303164,1,373,10,34449053,34193584,255469,39.14369258109595
1747959438134903,34395724,1,374,10,34543104,34286144,256960,38.916562889165625
1747959438229228,34488284,1,375,10,34637429,34378704,258725,38.65107739878249
1747959438319141,34580844,1,376,10,34727342,34471264,256078,39.05060176977327
1747959438413268,34673404,1,377,10,34821469,34563824,257645,38.813095538434666
1747959438507298,34765964,1,378,10,34915499,34656384,259115,38.592902765181485
1747959438601137,34858524,1,379,10,35009338,34748944,260394,38.40334262694225
1747959438691774,34951084,1,380,10,35099975,34841504,258471,38.68905989453362
1747959438785666,35043644,1,381,10,35193867,34934064,259803,38.49070257079402
1747959438879842,35136204,1,382,10,35288043,35026624,261419,38.25276663134661
1747959438974380,35228764,1,383,10,35382581,35119184,263397,37.96550454257262
1747959439064607,35321324,1,384,10,35472808,35211744,261064,38.304783501363644
1747959439158672,35413884,1,385,10,35566873,35304304,262569,38.08522712125194
1747959439252744,35506444,1,386,10,35660945,35396864,264081,37.86716954267819
1747959439347280,35599004,1,387,10,35755481,35489424,266057,37.58593083437008
1747959439441197,35691564,1,388,10,35849398,35581984,267414,37.39519995213415
1747959439531400,35784124,1,389,10,35939601,35674544,265057,37.727734034566154
1747959439625638,35876684,1,390,10,36033839,35767104,266735,37.49039308677151
1747959439719338,35969244,1,391,10,36127539,35859664,267875,37.330844610359314
1747959439813559,36061804,1,392,10,36221760,35952224,269536,37.10079544105426
1747959439904124,36154364,1,393,10,36312325,36044784,267541,37.377448690107315
1747959439998458,36246924,1,394,10,36406659,36137344,269315,37.13124036908452
1747959440092520,36339484,1,395,10,36500721,36229904,270817,36.925303802937044
1747959440186724,36432044,1,396,10,36594925,36322464,272461,36.70250054136188
1747959440276999,36524604,1,397,10,36685200,36415024,270176,37.012910103043936
1747959440370361,36617164,1,398,10,36778562,36507584,270978,36.903364848806916
1747959440465405,36709724,1,399,10,36873606,36600144,273462,36.56815206500355
1747959440559385,36802284,1,400,10,36967586,36692704,274882,36.37924636753225
1747959440649085,36894844,1,401,10,37057286,36785264,272022,36.76173250692959
1747959440743803,36987404,1,402,10,37152004,36877824,274180,36.47239040046685
1747959440837213,37079964,1,403,10,37245414,36970384,275030,36.359669854197726
1747959440932287,37172524,1,404,10,37340488,37062944,277544,36.03032311993774
1747959441026335,37265084,1,405,10,37434536,37155504,279032,35.83818343415809
1747959441116310,37357644,1,406,10,37524511,37248064,276447,36.173299041045844
1747959441209656,37450204,1,407,10,37617857,37340624,277233,36.070741939090944
1747959441303947,37542764,1,408,10,37712148,37433184,278964,35.84691931575401
1747959441398450,37635324,1,409,10,37806651,37525744,280907,35.59897047777378
1747959441489169,37727884,1,410,10,37897370,37618304,279066,35.83381708986405
1747959441583328,37820452,1,411,10,37991529,37710872,280657,35.630680866680684
1747959441677403,37913004,1,412,10,38085604,37803424,282180,35.438372669927
1747959441771660,38005564,1,413,10,38179861,37895984,283877,35.22652416363425
1747959441861310,38098124,1,414,10,38269511,37988544,280967,35.59136838134015
1747959441955273,38190684,1,415,10,38363474,38081104,282370,35.414527038991395
1747959442050371,38283244,1,416,10,38458572,38173664,284908,35.09904951773906
1747959442144234,38375804,1,417,10,38552435,38266224,286211,34.93925809979351
1747959442234531,38468364,1,418,10,38642732,38358784,283948,35.21771591981631
1747959442328405,38560924,1,419,10,38736606,38451344,285262,35.05549284517391
1747959442422949,38653484,1,420,10,38831150,38543904,287246,34.81336554730092
1747959442516908,38746044,1,421,10,38925109,38636464,288645,34.64463268028201
1747959442610730,38838604,1,422,10,39018931,38729024,289907,34.49382043206959
1747959442700502,38931164,1,423,10,39108703,38821584,287119,34.82876437992609
1747959442795082,39023724,1,424,10,39203283,38914144,289139,34.58544160421113
1747959442889826,39116284,1,425,10,39298027,39006704,291323,34.32616031003388
1747959442983495,39208844,1,426,10,39391696,39099264,292432,34.195984023636264
1747959443074343,39301404,1,427,10,39482544,39191824,290720,34.39735828288388
1747959443167522,39393964,1,428,10,39575723,39284384,291339,34.32427515711937
1747959443262176,39486524,1,429,10,39670377,39376944,293433,34.079329864057556
1747959443356795,39579084,1,430,10,39764996,39469504,295492,33.841863739119844
1747959443446725,39671644,1,431,10,39854926,39562064,292862,34.14577514324152
1747959443540514,39764204,1,432,10,39948715,39654624,294091,34.00308067910953
1747959443635368,39856764,1,433,10,40043569,39747184,296385,33.73989911770164
1747959443728987,39949332,1,434,10,40137188,39839752,297436,33.62067806183515
1747959443819610,40041884,1,435,10,40227811,39932304,295507,33.8401459187092
1747959443914050,40134444,1,436,10,40322251,40024864,297387,33.62621768940808
1747959444008007,40227004,1,437,10,40416208,40117424,298784,33.46899432365856
1747959444102116,40319564,1,438,10,40510317,40209984,300333,33.296374357796175
1747959444196089,40412124,1,439,10,40604290,40302544,301746,33.140455880111084
1747959444286018,40504684,1,440,10,40694219,40395104,299115,33.43195760827775
1747959444380689,40597244,1,441,10,40788890,40487664,301226,33.197665540159214
1747959444475041,40689804,1,442,10,40883242,40580224,303018,33.00133985439809
1747959444568302,40782364,1,443,10,40976503,40672784,303719,32.92517096395023
1747959444659168,40874924,1,444,10,41067369,40765344,302025,33.109841900504925
1747959444752990,40967484,1,445,10,41161191,40857904,303287,32.97206936004511
1747959444847459,41060044,1,446,10,41255660,40950464,305196,32.765829172073026
1747959444941371,41152604,1,447,10,41349572,41043024,306548,32.62131868418649
1747959445031957,41245164,1,448,10,41440158,41135584,304574,32.83274343837622
1747959445126164,41337724,1,449,10,41534365,41228144,306221,32.65615356229651
1747959445220468,41430284,1,450,10,41628669,41320704,307965,32.47122237916646
1747959445313795,41522844,1,451,10,41721996,41413264,308732,32.39055232369822
1747959445404789,41615404,1,452,10,41812990,41505824,307166,32.555686501761265
1747959445498820,41707964,1,453,10,41907021,41598384,308637,32.40052229641942
1747959445592850,41800524,1,454,10,42001051,41690944,310107,32.24693412273828
1747959445686964,41893084,1,455,10,42095165,41783504,311661,32.086144881778594
1747959445781180,41985644,1,456,10,42189381,41876064,313317,31.916557352457733
1747959445871360,42078204,1,457,10,42279561,41968624,310937,32.16085573604942
1747959445965638,42170764,1,458,10,42373839,42061184,312655,31.98413586860917
1747959446059938,42263324,1,459,10,42468139,42153744,314395,31.807121614529496
1747959446153481,42355884,1,460,10,42561682,42246304,315378,31.70798216743083
1747959446244378,42448444,1,461,10,42652579,42338864,313715,31.876065855952056
1747959446338350,42541004,1,462,10,42746551,42431424,315127,31.733237710510366
1747959446432692,42633564,1,463,10,42840893,42523984,316909,31.55479964279967
1747959446526639,42726124,1,464,10,42934840,42616544,318296,31.41729710709528
1747959446616327,42818684,1,465,10,43024528,42709104,315424,31.703358019681446
1747959446711119,42911244,1,466,10,43119320,42801664,317656,31.480595361019468
1747959446805357,43003804,1,467,10,43213558,42894224,319334,31.31517470735969
1747959446899577,43096364,1,468,10,43307778,42986784,320994,31.153230278447573
1747959446989627,43188924,1,469,10,43397828,43079344,318484,31.398751585636955
1747959447083813,43281484,1,470,10,43492014,43171904,320110,31.23926150385805
1747959447177040,43374044,1,471,10,43585241,43264464,320777,31.174304890936696
1747959447272173,43466604,1,472,10,43680374,43357024,323350,30.926240915416727
1747959447366391,43559164,1,473,10,43774592,43449584,325008,30.76847339142421
1747959447456722,43651724,1,474,10,43864923,43542144,322779,30.9809498139594
1747959447550540,43744292,1,475,10,43958741,43634712,324029,30.86143524190736
1747959447644976,43836844,1,476,10,44053177,43727264,325913,30.68303504309432
1747959447738814,43929404,1,477,10,44147015,43819824,327191,30.563187862746837
1747959447829060,44021964,1,478,10,44237261,43912384,324877,30.780880148486965
1747959447923490,44114524,1,479,10,44331691,44004944,326747,30.604718635519223
1747959448017204,44207084,1,480,10,44425405,44097504,327901,30.49700976819223
1747959448111913,44299644,1,481,10,44520114,44190064,330050,30.298439630359034
1747959448202115,44392204,1,482,10,44610316,44282624,327692,30.516460578836227
1747959448296248,44484764,1,483,10,44704449,44375184,329265,30.370674077111143
1747959448390239,44577324,1,484,10,44798440,44467744,330696,30.239252969494643
1747959448484720,44669884,1,485,10,44892921,44560304,332617,30.06460884440663
1747959448574818,44762444,1,486,10,44983019,44652864,330155,30.288803743696146
1747959448668957,44855004,1,487,10,45077158,44745424,331734,30.144633953709903
1747959448763041,44947564,1,488,10,45171242,44837984,333258,30.006781532626373
1747959448857364,45040124,1,489,10,45265565,44930544,335021,29.848875145140155
1747959448950846,45132684,1,490,10,45359047,45023104,335943,29.766954513116808
1747959449041587,45225244,1,491,10,45449788,45115664,334124,29.929008392093955
1747959449135416,45317804,1,492,10,45543617,45208224,335393,29.81576836725871
1747959449230032,45410364,1,493,10,45638233,45300784,337449,29.634107672566817
1747959449324131,45502924,1,494,10,45732332,45393344,338988,29.499569306288127
1747959449413467,45595484,1,495,10,45821668,45485904,335764,29.782823649944604
1747959449508552,45688044,1,496,10,45916753,45578464,338289,29.560523694237766
1747959449602790,45780604,1,497,10,46010991,45671024,339967,29.41461965426056
1747959449696567,45873172,1,498,10,46104768,45763592,341176,29.310385255703803
1747959449786875,45965724,1,499,10,46195076,45856144,338932,29.504443369171398
1747959449880895,46058284,1,500,10,46289096,45948704,340392,29.37789372253167
1747959449974288,46150844,1,501,10,46382489,46041264,341225,29.306176276650305
1747959450068879,46243404,1,502,10,46477080,46133824,343256,29.132775537791037
1747959450159555,46335964,1,503,10,46567756,46226384,341372,29.293556589292617
1747959450253370,46428524,1,504,10,46661571,46318944,342627,29.18625794231044
1747959450348074,46521084,1,505,10,46756275,46411504,344771,29.004759681063664
1747959450441689,46613644,1,506,10,46849890,46504064,345826,28.916275815005232
1747959450536573,46706204,1,507,10,46944774,46596624,348150,28.723251472066636
1747959450626374,46798764,1,508,10,47034575,46689184,345391,28.952694192958127
1747959450720922,46891324,1,509,10,47129123,46781744,347379,28.78700209281505
1747959450814364,46983884,1,510,10,47222565,46874304,348261,28.71409661144946
1747959450909119,47076444,1,511,10,47317320,46966864,350456,28.53425251672107
1747959450999286,47169004,1,512,10,47407487,47059424,348063,28.73043098519521
1747959451093354,47261564,1,513,10,47501555,47151984,349571,28.606491957284785
1747959451187873,47354124,1,514,10,47596074,47244544,351530,28.447074218416635
1747959451280999,47446684,1,515,10,47689200,47337104,352096,28.40134508770335
1747959451371962,47539244,1,516,10,47780163,47429664,350499,28.530751870904055
1747959451466345,47631804,1,517,10,47874546,47522224,352322,28.38312679878066
1747959451559971,47724364,1,518,10,47968172,47614784,353388,28.297508687335167
1747959451654508,47816924,1,519,10,48062709,47707344,355365,28.14008132483503
1747959451743927,47909484,1,520,10,48152128,47799904,352224,28.39102389388571
1747959451838482,48002044,1,521,10,48246683,47892464,354219,28.23112255412612
1747959451933213,48094604,1,522,10,48341414,47985024,356390,28.059148685428884
1747959452027187,48187164,1,523,10,48435388,48077584,357804,27.94826217705783
1747959452121037,48279724,1,524,10,48529238,48170144,359094,27.847861562710598
1747959452211698,48372284,1,525,10,48619899,48262704,357195,27.995912596760874
1747959452305939,48464844,1,526,10,48714140,48355264,358876,27.864777806261774
1747959452400202,48557404,1,527,10,48808403,48447824,360579,27.733173590253454
1747959452493425,48649964,1,528,10,48901626,48540384,361242,27.68227393270993
1747959452584462,48742524,1,529,10,48992663,48632944,359719,27.79947681384636
1747959452682920,48835084,1,530,10,49091121,48725504,365617,27.351025800222637
1747959452772729,48927644,1,531,10,49180930,48818064,362866,27.5583824331847
1747959452867116,49020204,1,532,10,49275317,48910624,364693,27.420323395294126
1747959452956423,49112764,1,533,10,49364624,49003184,361440,27.667109340416115
1747959453051405,49205324,1,534,10,49459606,49095744,363862,27.48294683149106
1747959453144884,49297884,1,535,10,49553085,49188304,364781,27.413708499072044
1747959453239643,49390444,1,536,10,49647844,49280864,366980,27.24944138645158
1747959453329892,49483004,1,537,10,49738093,49373424,364669,27.422128011977986
1747959453424041,49575564,1,538,10,49832242,49465984,366258,27.30315788324078
1747959453517791,49668132,1,539,10,49925992,49558552,367440,27.21532767254518
1747959453612777,49760684,1,540,10,50020978,49651104,369874,27.036233960754203
1747959453706360,49853244,1,541,10,50114561,49743664,370897,26.961663211080168
1747959453796780,49945804,1,542,10,50204981,49836224,368757,27.118129282969544
1747959453890387,50038364,1,543,10,50298588,49928784,369804,27.04135163492012
1747959453984804,50130924,1,544,10,50393005,50021344,371661,26.906239826078064
1747959454079290,50223484,1,545,10,50487491,50113904,373587,26.767526707299773
1747959454169278,50316044,1,546,10,50577479,50206464,371015,26.953088150074795
1747959454263559,50408604,1,547,10,50671760,50299024,372736,26.82864010989011
1747959454357854,50501164,1,548,10,50766055,50391584,374471,26.704337585554022
1747959454452098,50593724,1,549,10,50860299,50484144,376155,26.584785527242758
1747959454542168,50686284,1,550,10,50950369,50576704,373665,26.761939170112264
1747959454636557,50778844,1,551,10,51044758,50669264,375494,26.631583993352756
1747959454730393,50871404,1,552,10,51138594,50761824,376770,26.54139129973193
1747959454824809,50963964,1,553,10,51233010,50854384,378626,26.411287127666878
1747959454914825,51056524,1,554,10,51323026,50946944,376082,26.589945809690438
1747959455008997,51149084,1,555,10,51417198,51039504,377694,26.47645977960995
1747959455102717,51241644,1,556,10,51510918,51132064,378854,26.39539242029911
1747959455197226,51334204,1,557,10,51605427,51224624,380803,26.260297319086245
1747959455291869,51426764,1,558,10,51700070,51317184,382886,26.117434432180858
1747959455381886,51519324,1,559,10,51790087,51409744,380343,26.292057432370257
1747959455476052,51611884,1,560,10,51884253,51502304,381949,26.18150590785681
1747959455570181,51704444,1,561,10,51978382,51594864,383518,26.07439546514114
1747959455664275,51797012,1,562,10,52072476,51687432,385044,25.971057853128475
1747959455754264,51889564,1,563,10,52162465,51779984,382481,26.145089560004287
1747959455847978,51982124,1,564,10,52256179,51872544,383635,26.066443364135182
1747959455942089,52074684,1,565,10,52350290,51965104,385186,25.961483543015582
1747959456036925,52167244,1,566,10,52445126,52057664,387462,25.80898255828959
1747959456126423,52259804,1,567,10,52534624,52150224,384400,26.014568158168572
1747959456221103,52352364,1,568,10,52629304,52242784,386520,25.871882438166203
1747959456315209,52444924,1,569,10,52723410,52335344,388066,25.768812521581378
1747959456409166,52537484,1,570,10,52817367,52427904,389463,25.676380041236268
1747959456499314,52630044,1,571,10,52907515,52520464,387051,25.836388486271836
1747959456593163,52722604,1,572,10,53001364,52613024,388340,25.750630890456815
1747959456687431,52815164,1,573,10,53095632,52705584,390048,25.637870210845843
1747959456782433,52907724,1,574,10,53190634,52798144,392490,25.478356136462075
1747959456876648,53000284,1,575,10,53284849,52890704,394145,25.3713734793033
1747959456966415,53092844,1,576,10,53374616,52983264,391352,25.55244383572845
1747959457060484,53185404,1,577,10,53468685,53075824,392861,25.45429553964379
1747959457154432,53277964,1,578,10,53562633,53168384,394249,25.36468069671705
1747959457249019,53370524,1,579,10,53657220,53260944,396276,25.234937265945955
1747959457339363,53463084,1,580,10,53747564,53353504,394060,25.376846165558543
1747959457433231,53555644,1,581,10,53841432,53446064,395368,25.292891685720644
1747959457527581,53648204,1,582,10,53935782,53538624,397158,25.1788960564813
1747959457621835,53740764,1,583,10,54030036,53631184,398852,25.07195651519862
1747959457711819,53833324,1,584,10,54120020,53723744,396276,25.234937265945955
1747959457806018,53925884,1,585,10,54214219,53816304,397915,25.130995313069374
1747959457900288,54018444,1,586,10,54308489,53908864,399625,25.023459493274945
1747959457994291,54111004,1,587,10,54402492,54001424,401068,24.933427747913072
1747959458084718,54203564,1,588,10,54492919,54093984,398935,25.066740195771242
1747959458178907,54296124,1,589,10,54587108,54186544,400564,24.96479963251815
1747959458272413,54388684,1,590,10,54680614,54279104,401510,24.90597992578018
1747959458366621,54481244,1,591,10,54774822,54371664,403158,24.80417106940703
1747959458461437,54573804,1,592,10,54869638,54464224,405414,24.666143744419283
1747959458551830,54666364,1,593,10,54960031,54556784,403247,24.798696580507727
1747959458645855,54758924,1,594,10,55054056,54649344,404712,24.708928818517858
1747959458740368,54851484,1,595,10,55148569,54741904,406665,24.590264714199648
1747959458834052,54944044,1,596,10,55242253,54834464,407789,24.52248589343999
1747959458924411,55036604,1,597,10,55332612,54927024,405588,24.65556180163121
1747959459018180,55129164,1,598,10,55426381,55019584,406797,24.58228551341332
1747959459112861,55221724,1,599,10,55521062,55112144,408918,24.454780665072214
1747959459206620,55314284,1,600,10,55614821,55204704,410117,24.38328574528732
1747959459296611,55406844,1,601,10,55704812,55297264,407548,24.53698705428563
1747959459391157,55499404,1,602,10,55799358,55389824,409534,24.417997040538758
1747959459485776,55591972,1,603,10,55893977,55482392,411585,24.296317893023314
1747959459579771,55684524,1,604,10,55987972,55574944,413028,24.21143360740676
1747959459670148,55777084,1,605,10,56078349,55667504,410845,24.340079592060267
1747959459764108,55869644,1,606,10,56172309,55760064,412245,24.257419738262442
1747959459858202,55962204,1,607,10,56266403,55852624,413779,24.167490375296957
1747959459951888,56054764,1,608,10,56360089,55945184,414905,24.10190284522963
1747959460046307,56147324,1,609,10,56454508,56037744,416764,23.994394909349175
1747959460136929,56239884,1,610,10,56545130,56130304,414826,24.106492842782277
1747959460230536,56332444,1,611,10,56638737,56222864,415873,24.045802444496278
1747959460324546,56425004,1,612,10,56732747,56315424,417323,23.962254656465134
1747959460418808,56517564,1,613,10,56827009,56407984,419025,23.864924527176186
1747959460509173,56610124,1,614,10,56917374,56500544,416830,23.990595686490895
1747959460602561,56702684,1,615,10,57010762,56593104,417658,23.943034731766183
1747959460698113,56795244,1,616,10,57106314,56685664,420650,23.77273267562106
1747959460791859,56887804,1,617,10,57200060,56778224,421836,23.705895182013865
1747959460881872,56980364,1,618,10,57290073,56870784,419289,23.849898280183833
1747959460976497,57072924,1,619,10,57384698,56963344,421354,23.733013095876625
1747959461070634,57165484,1,620,10,57478835,57055904,422931,23.644518845863747
1747959461164718,57258044,1,621,10,57572919,57148464,424455,23.559623517216192
1747959461254354,57350604,1,622,10,57662555,57241024,421531,23.72304765248582
1747959461349260,57443164,1,623,10,57757461,57333584,423877,23.59174949336718
1747959461443441,57535724,1,624,10,57851642,57426144,425498,23.501873099286012
1747959461537621,57628284,1,625,10,57945822,57518704,427118,23.412733717614337
1747959461630822,57720852,1,626,10,58039023,57611272,427751,23.37808678413376
1747959461721967,57813404,1,627,10,58130168,57703824,426344,23.455238023755467
1747959461816202,57905964,1,628,10,58224403,57796384,428019,23.363448818860846
1747959461910413,57998524,1,629,10,58318614,57888944,429670,23.27367514604231
1747959462003507,58091084,1,630,10,58411708,57981504,430204,23.244786194456584
1747959462094617,58183644,1,631,10,58502818,58074064,428754,23.32339756597023
1747959462188749,58276204,1,632,10,58596950,58166624,430326,23.238196158261413
1747959462282003,58368764,1,633,10,58690204,58259184,431020,23.200779546192752
1747959462377342,58461324,1,634,10,58785543,58351744,433799,23.052150880937948
1747959462467348,58553884,1,635,10,58875549,58444304,431245,23.188674651300307
1747959462561741,58646444,1,636,10,58969942,58536864,433078,23.090528726926788
1747959462655210,58739004,1,637,10,59063411,58629424,433987,23.042164857472688
1747959462749615,58831564,1,638,10,59157816,58721984,435832,22.944620863084857
1747959462840026,58924124,1,639,10,59248227,58814544,433683,23.05831678899104
1747959462934335,59016684,1,640,10,59342536,58907104,435432,22.96569843282074
1747959463028521,59109244,1,641,10,59436722,58999664,437058,22.880258455399513
1747959463122099,59201804,1,642,10,59530300,59092224,438076,22.82708936348944
1747959463216580,59294364,1,643,10,59624781,59184784,439997,22.727427687006955
1747959463306308,59386924,1,644,10,59714509,59277344,437165,22.874658309791496
1747959463404363,59479484,1,645,10,59812564,59369904,442660,22.590701667193784
1747959463494633,59572044,1,646,10,59902834,59462464,440370,22.708177214614985
1747959463589574,59664604,1,647,10,59997775,59555024,442751,22.586058529512073
1747959463679606,59757164,1,648,10,60087807,59647584,440223,22.71575996710758
1747959463773698,59849724,1,649,10,60181899,59740144,441755,22.636982037554752
1747959463867581,59942284,1,650,10,60275782,59832704,443078,22.569389588289194
1747959463962334,60034844,1,651,10,60370535,59925264,445271,22.458233300619174
1747959464052343,60127404,1,652,10,60460544,60017824,442720,22.587640043368268
1747959464145981,60219964,1,653,10,60554182,60110384,443798,22.532773919666152
1747959464240586,60312524,1,654,10,60648787,60202944,445843,22.429420221916683
1747959464335081,60405084,1,655,10,60743282,60295504,447778,22.332495120349815
1747959464425065,60497644,1,656,10,60833266,60388064,445202,22.46171400847256
1747959464518778,60590204,1,657,10,60926979,60480624,446355,22.40369212846277
1747959464613331,60682764,1,658,10,61021532,60573184,448348,22.30410306279943
1747959464707622,60775324,1,659,10,61115823,60665744,450079,22.21832167241751
1747959464801722,60867884,1,660,10,61209923,60758304,451619,22.142558218321195
1747959464891881,60960444,1,661,10,61300082,60850864,449218,22.260906731252977
1747959464985571,61053004,1,662,10,61393772,60943424,450348,22.205050316644016
1747959465080761,61145564,1,663,10,61488962,61035984,452978,22.076127317441465
1747959465174304,61238124,1,664,10,61582505,61128544,453961,22.02832401902366
1747959465263927,61330684,1,665,10,61672128,61221104,451024,22.171769129802406
1747959465358807,61423244,1,666,10,61767008,61313664,453344,22.058304510482106
1747959465452870,61515812,1,667,10,61861071,61406232,454839,21.985801569346517
1747959465546514,61608364,1,668,10,61954715,61498784,455931,21.933143392311557
1747959465637692,61700924,1,669,10,62045893,61591344,454549,21.99982840133847
1747959465730920,61793484,1,670,10,62139121,61683904,455217,21.967545148797168
1747959465825738,61886044,1,671,10,62233939,61776464,457475,21.85911798458932
1747959465919882,61978604,1,672,10,62328083,61869024,459059,21.783692292276157
1747959466009953,62071164,1,673,10,62418154,61961584,456570,21.902446503274415
1747959466103833,62163724,1,674,10,62512034,62054144,457890,21.839306383629253
1747959466198430,62256284,1,675,10,62606631,62146704,459927,21.74258088783655
1747959466292428,62348844,1,676,10,62700629,62239264,461365,21.67481278380458
1747959466386562,62441404,1,677,10,62794763,62331824,462939,21.601118073871504
1747959466476938,62533964,1,678,10,62885139,62424384,460755,21.703508372128354
1747959466571056,62626524,1,679,10,62979257,62516944,462313,21.63036730526721
1747959466665517,62719084,1,680,10,63073718,62609504,464214,21.541788916318765
1747959466759323,62811644,1,681,10,63167524,62702064,465460,21.484123232930866
1747959466849876,62904204,1,682,10,63258077,62794624,463453,21.577161006617715
1747959466944115,62996764,1,683,10,63352316,62887184,465132,21.49927332456163
1747959467038144,63089324,1,684,10,63446345,62979744,466601,21.43158715905024
1747959467132331,63181884,1,685,10,63540532,63072304,468228,21.357116618399584
1747959467222398,63274444,1,686,10,63630599,63164864,465735,21.471437620105853
1747959467316757,63367004,1,687,10,63724958,63257424,467534,21.388818781093995
1747959467410702,63459564,1,688,10,63818903,63349984,468919,21.325644727554227
1747959467505104,63552124,1,689,10,63913305,63442544,470761,21.242201456790177
1747959467594739,63644692,1,690,10,64002940,63535112,467828,21.37537727540891
1747959467689415,63737244,1,691,10,64097616,63627664,469952,21.27876889554678
1747959467783093,63829804,1,692,10,64191294,63720224,471070,21.22826756108434
1747959467877085,63922364,1,693,10,64285286,63812784,472502,21.163931581241986
1747959467971274,64014924,1,694,10,64379475,63905344,474131,21.0912174061599
1747959468062088,64107484,1,695,10,64470289,63997904,472385,21.169173449622658
1747959468156407,64200044,1,696,10,64564608,64090464,474144,21.090639130728217
1747959468250045,64292604,1,697,10,64658246,64183024,475222,21.042796840213626
1747959468344601,64385164,1,698,10,64752802,64275584,477218,20.954783767586303
1747959468434759,64477724,1,699,10,64842960,64368144,474816,21.060789863863054
1747959468528228,64570284,1,700,10,64936429,64460704,475725,21.020547585264595
1747959468623282,64662844,1,701,10,65031483,64553264,478219,20.9109215652243
1747959468716914,64755404,1,702,10,65125115,64645824,479291,20.864151423665373
1747959468807702,64847964,1,703,10,65215903,64738384,477519,20.941575099629542
1747959468900976,64940524,1,704,10,65309177,64830944,478233,20.910309409848338
1747959468996040,65033084,1,705,10,65404241,64923504,480737,20.801394525488988
1747959469089216,65125644,1,706,10,65497417,65016064,481353,20.774774437886542
1747959469180200,65218204,1,707,10,65588401,65108624,479777,20.843016651486003
1747959469274352,65310764,1,708,10,65682553,65201184,481369,20.774083914834566
1747959469368364,65403324,1,709,10,65776565,65293744,482821,20.71160947846096
1747959469462719,65495884,1,710,10,65870920,65386304,484616,20.634894431880088
1747959469556312,65588444,1,711,10,65964513,65478864,485649,20.59100296716353
1747959469646765,65681004,1,712,10,66054966,65571424,483542,20.68072680346278
1747959469741329,65773564,1,713,10,66149530,65663984,485546,20.595370984417542
1747959469835201,65866124,1,714,10,66243402,65756544,486858,20.53986994154353
1747959469928988,65958684,1,715,10,66337189,65849104,488085,20.488234631262998
1747959470019433,66051244,1,716,10,66427634,65941664,485970,20.577401897236456
1747959470113958,66143804,1,717,10,66522159,66034224,487935,20.49453308330003
1747959470207387,66236364,1,718,10,66615588,66126784,488804,20.45809772424121
1747959470302112,66328924,1,719,10,66710313,66219344,490969,20.367884734066713
1747959470392594,66421484,1,720,10,66800795,66311904,488891,20.45445712848058
1747959470486515,66514044,1,721,10,66894716,66404464,490252,20.397673033460343
1747959470581029,66606604,1,722,10,66989230,66497024,492206,20.316696667655414
1747959470674342,66699164,1,723,10,67082543,66589584,492959,20.285662702171987
1747959470765128,66791724,1,724,10,67173329,66682144,491185,20.358927898856848
1747959470859369,66884284,1,725,10,67267570,66774704,492866,20.289490449736846
1747959470953752,66976844,1,726,10,67361953,66867264,494689,20.214720763954727
1747959471047510,67069404,1,727,10,67455711,66959824,495887,20.165884566443562
1747959471141596,67161964,1,728,10,67549797,67052384,497413,20.10401819011566
1747959471231366,67254524,1,729,10,67639567,67144944,494623,20.21741811440228
1747959471326200,67347084,1,730,10,67734401,67237504,496897,20.124895098984297
1747959471420226,67439652,1,731,10,67828427,67330072,498355,20.066017196576738
1747959471514393,67532204,1,732,10,67922594,67422624,499970,20.00120007200432
1747959471603886,67624764,1,733,10,68012087,67515184,496903,20.124652095076907
1747959471698623,67717324,1,734,10,68106824,67607744,499080,20.03686783681975
1747959471792545,67809884,1,735,10,68200746,67700304,500442,19.982335615316057
1747959471886990,67902444,1,736,10,68295191,67792864,502327,19.907351187573035
1747959471976585,67995004,1,737,10,68384786,67885424,499362,20.02555260512414
1747959472070993,68087564,1,738,10,68479194,67977984,501210,19.951716845234532
1747959472165049,68180124,1,739,10,68573250,68070544,502706,19.892342641623532
1747959472260045,68272684,1,740,10,68668246,68163104,505142,19.796413681697423
1747959472349384,68365244,1,741,10,68757585,68255664,501921,19.92345408938857
1747959472443564,68457804,1,742,10,68851765,68348224,503541,19.85935604052103
1747959472538395,68550364,1,743,10,68946596,68440784,505812,19.77019129637098
1747959472632334,68642924,1,744,10,69040535,68533344,507191,19.716438186008823
1747959472727001,68735484,1,745,10,69135202,68625904,509298,19.634869958256264
1747959472816978,68828044,1,746,10,69225179,68718464,506715,19.73495949399564
1747959472910428,68920604,1,747,10,69318629,68811024,507605,19.700357561489742
1747959473005361,69013164,1,748,10,69413562,68903584,509978,19.608689002270683
1747959473099513,69105724,1,749,10,69507714,68996144,511570,19.547666985945227
1747959473189513,69198284,1,750,10,69597714,69088704,509010,19.645979450305497
1747959473283224,69290844,1,751,10,69691425,69181264,510161,19.60165516376203
1747959473377179,69383404,1,752,10,69785380,69273824,511556,19.54820195638405
1747959473471688,69475964,1,753,10,69879889,69366384,513505,19.474007069064566
1747959473562001,69568532,1,754,10,69970202,69458952,511250,19.559902200489
1747959473655987,69661084,1,755,10,70064188,69551504,512684,19.505192282185515
1747959473751011,69753644,1,756,10,70159212,69644064,515148,19.411897163533585
1747959473845490,69846204,1,757,10,70253691,69736624,517067,19.33985344259061
1747959473935214,69938764,1,758,10,70343415,69829184,514231,19.446513337391174
1747959474029211,70031324,1,759,10,70437412,69921744,515668,19.392322191797824
1747959474124904,70123884,1,760,10,70533105,70014304,518801,19.275213424800647
1747959474217889,70216444,1,761,10,70626090,70106864,519226,19.259436160746958
1747959474311812,70309004,1,762,10,70720013,70199424,520589,19.209011331395786
1747959474402279,70401564,1,763,10,70810480,70291984,518496,19.286551873109918
1747959474496128,70494124,1,764,10,70904329,70384544,519785,19.238723703069535
1747959474590875,70586684,1,765,10,70999076,70477104,521972,19.158115760998676
1747959474684756,70679244,1,766,10,71092957,70569664,523293,19.109753044661403
1747959474774955,70771804,1,767,10,71183156,70662224,520932,19.196363440909757
1747959474869138,70864364,1,768,10,71277339,70754784,522555,19.13674158700998
1747959474962846,70956924,1,769,10,71371047,70847344,523703,19.09479227730221
1747959475057501,71049484,1,770,10,71465702,70939904,525798,19.018710607495656
1747959475147548,71142044,1,771,10,71555749,71032464,523285,19.110045195256887
1747959475240913,71234604,1,772,10,71649114,71125024,524090,19.08069224751474
1747959475336060,71327164,1,773,10,71744261,71217584,526677,18.986969243008524
1747959475430190,71419724,1,774,10,71838391,71310144,528247,18.930538176269813
1747959475520342,71512284,1,775,10,71928543,71402704,525839,19.01722770657939
1747959475614541,71604844,1,776,10,72022742,71495264,527478,18.958136642665664
1747959475708401,71697404,1,777,10,72116602,71587824,528778,18.911528089292673
1747959475802304,71789964,1,778,10,72210505,71680384,530121,18.863617928737025
1747959475896676,71882524,1,779,10,72304877,71772944,531933,18.799360069783226
1747959475986339,71975084,1,780,10,72394540,71865504,529036,18.902305325157457
1747959476081031,72067644,1,781,10,72489232,71958064,531168,18.826435327429365
1747959476175603,72160204,1,782,10,72583804,72050624,533180,18.755392175250385
1747959476269614,72252764,1,783,10,72677815,72143184,534631,18.704489638647967
1747959476360073,72345324,1,784,10,72768274,72235744,532530,18.77828479146715
1747959476454214,72437884,1,785,10,72862415,72328304,534111,18.72269996311628
1747959476548584,72530444,1,786,10,72956785,72420864,535921,18.659466600487757
1747959476642056,72623004,1,787,10,73050257,72513424,536833,18.627766921929165
1747959476732665,72715564,1,788,10,73140866,72605984,534882,18.695712325335307
1747959476826972,72808124,1,789,10,73235173,72698544,536629,18.63484828438269
1747959476920444,72900684,1,790,10,73328645,72791104,537541,18.603232125549493
1747959477015252,72993244,1,791,10,73423453,72883664,539789,18.525757286643486
1747959477105417,73085804,1,792,10,73513618,72976224,537394,18.6083208967722
1747959477199682,73178364,1,793,10,73607883,73068784,539099,18.54946865047051
1747959477293722,73270924,1,794,10,73701923,73161344,540579,18.498683818646303
1747959477387944,73363492,1,795,10,73796145,73253912,542233,18.442256373182747
1747959477482124,73456044,1,796,10,73890325,73346464,543861,18.387051103131128
1747959477572207,73548604,1,797,10,73980408,73439024,541384,18.47117757451273
1747959477665270,73641164,1,798,10,74073471,73531584,541887,18.454031929166042
1747959477760851,73733724,1,799,10,74169052,73624144,544908,18.351721758535387
1747959477854537,73826284,1,800,10,74262738,73716704,546034,18.313877890387776
1747959477945037,73918844,1,801,10,74353238,73809264,543974,18.38323155150798
1747959478039287,74011404,1,802,10,74447488,73901824,545664,18.32629603565564
1747959478133326,74103964,1,803,10,74541527,73994384,547143,18.27675763008939
1747959478226830,74196524,1,804,10,74635031,74086944,548087,18.24527857803597
1747959478317091,74289084,1,805,10,74725292,74179504,545788,18.322132403057594
1747959478411769,74381644,1,806,10,74819970,74272064,547906,18.25130588093578
1747959478505327,74474204,1,807,10,74913528,74364624,548904,18.218121930246458
1747959478600348,74566764,1,808,10,75008549,74457184,551365,18.136805927108178
1747959478690341,74659324,1,809,10,75098542,74549744,548798,18.22164074941964
1747959478784015,74751884,1,810,10,75192216,74642304,549912,18.184727738256303
1747959478878752,74844444,1,811,10,75286953,74734864,552089,18.113021632381734
1747959478972334,74937004,1,812,10,75380535,74827424,553111,18.079553651979438
1747959479067173,75029564,1,813,10,75475374,74919984,555390,18.005365598948487
1747959479156981,75122124,1,814,10,75565182,75012544,552638,18.09502784824786
1747959479251443,75214684,1,815,10,75659644,75105104,554540,18.032964258664837
1747959479345717,75307244,1,816,10,75753918,75197664,556254,17.977398814210773
1747959479439343,75399804,1,817,10,75847544,75290224,557320,17.943012990741405
1747959479529993,75492372,1,818,10,75938194,75382792,555402,18.004976575525475
1747959479624238,75584924,1,819,10,76032439,75475344,557095,17.95025983001104
1747959479717788,75677484,1,820,10,76125989,75567904,558085,17.918417445371222
1747959479812685,75770044,1,821,10,76220886,75660464,560422,17.843696357387827
1747959479902029,75862604,1,822,10,76310230,75753024,557206,17.946683991198945
1747959479996740,75955164,1,823,10,76404941,75845584,559357,17.87767025352324
1747959480091030,76047724,1,824,10,76499231,75938144,561087,17.8225480184
1747959480184857,76140284,1,825,10,76593058,76030704,562354,17.78239329674902
1747959480275158,76232844,1,826,10,76683359,76123264,560095,17.854114034226335
1747959480369384,76325404,1,827,10,76777585,76215824,561761,17.801164552185007
1747959480463405,76417964,1,828,10,76871606,76308384,563222,17.754988263952757
1747959480558118,76510524,1,829,10,76966319,76400944,565375,17.687375635640063
1747959480652306,76603084,1,830,10,77060507,76493504,567003,17.636590988054735
1747959480742294,76695644,1,831,10,77150495,76586064,564431,17.71695743146638
1747959480836545,76788204,1,832,10,77244746,76678624,566122,17.664037080346638
1747959480930270,76880764,1,833,10,77338471,76771184,567287,17.6277616092031
1747959481024500,76973324,1,834,10,77432701,76863744,568957,17.576020683461138
1747959481114951,77065884,1,835,10,77523152,76956304,566848,17.641413571186632
1747959481209011,77158444,1,836,10,77617212,77048864,568348,17.594853857143864
1747959481303276,77251004,1,837,10,77711477,77141424,570053,17.542228529627945
1747959481397148,77343564,1,838,10,77805349,77233984,571365,17.501947091613943
1747959481487020,77436124,1,839,10,77895221,77326544,568677,17.584674604388784
1747959481581396,77528684,1,840,10,77989597,77419104,570493,17.528698862212156
1747959481675405,77621244,1,841,10,78083606,77511664,571942,17.484290365106954
1747959481770290,77713804,1,842,10,78178491,77604224,574267,17.413502778324368
1747959481860146,77806364,1,843,10,78268347,77696784,571563,17.49588409326706
1747959481953978,77898924,1,844,10,78362179,77789344,572835,17.457033875374236
1747959482048227,77991484,1,845,10,78456428,77881904,574524,17.40571325131761
1747959482142421,78084044,1,846,10,78550622,77974464,576158,17.356350167835906
1747959482236789,78176604,1,847,10,78644990,78067024,577966,17.302055830273755
1747959482327026,78269164,1,848,10,78735227,78159584,575643,17.371878056364796
1747959482421705,78361724,1,849,10,78829906,78252144,577762,17.308164953735275
1747959482514892,78454284,1,850,10,78923093,78344704,578389,17.289402115185453
1747959482609516,78546844,1,851,10,79017717,78437264,580453,17.22792370786265
1747959482700009,78639404,1,852,10,79108210,78529824,578386,17.28949179267825
1747959482793438,78731964,1,853,10,79201639,78622384,579255,17.263554047871835
1747959482887582,78824524,1,854,10,79295783,78714944,580839,17.21647478905514
1747959482982315,78917084,1,855,10,79390516,78807504,583012,17.15230561292049
1747959483072618,79009644,1,856,10,79480819,78900064,580755,17.218964968015772
1747959483166171,79102204,1,857,10,79574372,78992624,581748,17.189573492302507
1747959483261297,79194764,1,858,10,79669498,79085184,584314,17.11408591955695
1747959483354920,79287332,1,859,10,79763121,79177752,585369,17.083241510910213
1747959483444531,79379884,1,860,10,79852732,79270304,582428,17.169504213396337
1747959483543487,79472444,1,861,10,79951688,79362864,588824,16.983003410187084
1747959483633557,79565004,1,862,10,80041758,79455424,586334,17.055125576889623
1747959483727475,79657564,1,863,10,80135676,79547984,587692,17.015715715034407
1747959483821813,79750124,1,864,10,80230014,79640544,589470,16.964391741734097
1747959483911841,79842684,1,865,10,80320042,79733104,586938,17.03757466717098
1747959484005826,79935244,1,866,10,80414027,79825664,588363,16.996310101077057
1747959484100905,80027804,1,867,10,80509106,79918224,590882,16.923852816636824
1747959484194967,80120364,1,868,10,80603168,80010784,592384,16.880942091616248
1747959484284761,80212924,1,869,10,80692962,80103344,589618,16.960133510170994
1747959484379273,80305484,1,870,10,80787474,80195904,591570,16.904170258802846
1747959484473393,80398044,1,871,10,80881594,80288464,593130,16.859710350176183
1747959484567489,80490604,1,872,10,80975690,80381024,594666,16.81616234995779
1747959484657543,80583164,1,873,10,81065744,80473584,592160,16.887327749256958
1747959484752256,80675724,1,874,10,81160457,80566144,594313,16.826150530107874
1747959484845945,80768284,1,875,10,81254146,80658704,595442,16.794246962760436
1747959484940372,80860844,1,876,10,81348573,80751264,597309,16.741753430803822
1747959485030705,80953404,1,877,10,81438906,80843824,595082,16.80440678763599
1747959485124699,81045964,1,878,10,81532900,80936384,596516,16.76400968289199
1747959485218727,81138524,1,879,10,81626928,81028944,597984,16.72285546101568
1747959485313028,81231084,1,880,10,81721229,81121504,599725,16.674309058318396
1747959485406845,81323644,1,881,10,81815046,81214064,600982,16.639433460569535
1747959485497404,81416212,1,882,10,81905605,81306632,598973,16.69524335821481
1747959485591641,81508764,1,883,10,81999842,81399184,600658,16.64840891156032
1747959485685761,81601324,1,884,10,82093962,81491744,602218,16.60528247246014
1747959485779956,81693884,1,885,10,82188157,81584304,603853,16.56032180017322
1747959485869679,81786444,1,886,10,82277880,81676864,601016,16.6384921532871
1747959485964491,81879004,1,887,10,82372692,81769424,603268,16.576380646744067
1747959486057874,81971564,1,888,10,82466075,81861984,604091,16.553797358345015
1747959486152180,82064124,1,889,10,82560381,81954544,605837,16.50608992187668
1747959486242426,82156684,1,890,10,82650627,82047104,603523,16.56937680916883
1747959486336713,82249244,1,891,10,82744914,82139664,605250,16.522098306484924
1747959486431187,82341804,1,892,10,82839388,82232224,607164,16.470014691253105
1747959486524996,82434364,1,893,10,82933197,82324784,608413,16.43620369715966
1747959486615181,82526924,1,894,10,83023382,82417344,606038,16.500615472957143
1747959486708728,82619484,1,895,10,83116929,82509904,607025,16.473786087887646
1747959486803219,82712044,1,896,10,83211420,82602464,608956,16.421547698027442
1747959486897892,82804604,1,897,10,83306093,82695024,611069,16.364764044649622
1747959486988096,82897164,1,898,10,83396297,82787584,608713,16.428103227629443
1747959487082133,82989724,1,899,10,83490334,82880144,610190,16.388338058637473
1747959487175962,83082284,1,900,10,83584163,82972704,611459,16.354326291705576
1747959487270045,83174844,1,901,10,83678246,83065264,612982,16.313692734860076
1747959487364964,83267404,1,902,10,83773165,83157824,615341,16.25115180038385
1747959487454497,83359964,1,903,10,83862698,83250384,612314,16.331490052489407
1747959487548653,83452524,1,904,10,83956854,83342944,613910,16.28903259435422
1747959487642850,83545084,1,905,10,84051051,83435504,615547,16.245713162439262
1747959487736796,83637644,1,906,10,84144997,83528064,616933,16.20921558743008
1747959487827799,83730204,1,907,10,84236000,83620624,615376,16.250227503185044
1747959487921418,83822764,1,908,10,84329619,83713184,616435,16.22231054369074
1747959488015634,83915324,1,909,10,84423835,83805744,618091,16.17884745126527
1747959488109947,84007884,1,910,10,84518148,83898304,619844,16.133091552067942
1747959488200493,84100444,1,911,10,84608694,83990864,617830,16.185682145574024
1747959488294418,84193004,1,912,10,84702619,84083424,619195,16.15000121125009
1747959488388802,84285564,1,913,10,84797003,84175984,621019,16.102566910191154
1747959488482779,84378124,1,914,10,84890980,84268544,622436,16.06590878419629
1747959488573217,84470684,1,915,10,84981418,84361104,620314,16.12086781855641
1747959488667191,84563244,1,916,10,85075392,84453664,621728,16.084204024911216
1747959488761624,84655804,1,917,10,85169825,84546224,623601,16.03589474680124
1747959488855683,84748364,1,918,10,85263884,84638784,625100,15.997440409534475
1747959488949777,84840924,1,919,10,85357978,84731344,626634,15.958278676228867
1747959489039797,84933484,1,920,10,85447998,84823904,624094,16.023227270250956
1747959489133389,85026044,1,921,10,85541590,84916464,625126,15.99677505014989
1747959489227860,85118604,1,922,10,85636061,85009024,627037,15.94802220602612
1747959489322134,85211172,1,923,10,85730335,85101592,628743,15.904749635383613
1747959489412651,85303724,1,924,10,85820852,85194144,626708,15.95639436547802
1747959489506438,85396284,1,925,10,85914639,85286704,627935,15.925215189470247
1747959489600765,85488844,1,926,10,86008966,85379264,629702,15.88052761464947
1747959489695499,85581404,1,927,10,86103700,85471824,631876,15.825889889788503
1747959489785948,85673964,1,928,10,86194149,85564384,629765,15.878938969298071
1747959489879319,85766524,1,929,10,86287520,85656944,630576,15.858516657785897
1747959489973281,85859084,1,930,10,86381482,85749504,631978,15.823335622442553
1747959490067574,85951644,1,931,10,86475775,85842064,633711,15.78006378301781
1747959490162318,86044204,1,932,10,86570519,85934624,635895,15.725866691828054
1747959490252592,86136764,1,933,10,86660793,86027184,633609,15.78260409811098
1747959490345989,86229324,1,934,10,86754190,86119744,634446,15.76178272067284
1747959490440914,86321884,1,935,10,86849115,86212304,636811,15.703246332114238
1747959490534949,86414444,1,936,10,86943150,86304864,638286,15.666958072086807
1747959490624539,86507004,1,937,10,87032740,86397424,635316,15.740198578345264
1747959490718748,86599564,1,938,10,87126949,86489984,636965,15.699449734286814
1747959490812922,86692124,1,939,10,87221123,86582544,638579,15.659769582150368
1747959490907066,86784684,1,940,10,87315267,86675104,640163,15.62102152108135
1747959490997435,86877244,1,941,10,87405636,86767664,637972,15.674669107735136
1747959491092437,86969804,1,942,10,87500638,86860224,640414,15.614899112136836
1747959491186128,87062364,1,943,10,87594329,86952784,641545,15.587371111925117
1747959491279860,87154924,1,944,10,87688061,87045344,642717,15.558947406090084
1747959491370603,87247484,1,945,10,87778804,87137904,640900,15.603058199407084
1747959491464535,87340052,1,946,10,87872736,87230472,642264,15.569921403036759
1747959491559165,87432604,1,947,10,87967366,87323024,644342,15.519708477795954
1747959491653118,87525164,1,948,10,88061319,87415584,645735,15.486228870976486
1747959491746972,87617724,1,949,10,88155173,87508144,647029,15.455257801427758
1747959491837054,87710284,1,950,10,88245255,87600704,644551,15.514676107864235
1747959491931222,87802844,1,951,10,88339423,87693264,646159,15.476067036131973
1747959492025380,87895404,1,952,10,88433581,87785824,647757,15.437887973422132
1747959492121672,87987964,1,953,10,88529873,87878384,651489,15.34945332921968
1747959492210293,88080524,1,954,10,88618494,87970944,647550,15.442822948034902
1747959492303582,88173084,1,955,10,88711783,88063504,648279,15.425457249116505
1747959492398817,88265644,1,956,10,88807018,88156064,650954,15.362068594708688
1747959492491985,88358204,1,957,10,88900186,88248624,651562,15.347733600179263
1747959492583278,88450764,1,958,10,88991479,88341184,650295,15.377636303523786
1747959492676472,88543324,1,959,10,89084673,88433744,650929,15.362658600246725
1747959492771419,88635884,1,960,10,89179620,88526304,653316,15.306528540553117
1747959492865300,88728444,1,961,10,89273501,88618864,654637,15.27564130961128
1747959492956249,88821004,1,962,10,89364450,88711424,653026,15.313325962519103
1747959493049976,88913564,1,963,10,89458177,88803984,654193,15.286008868942345
1747959493143462,89006124,1,964,10,89551663,88896544,655119,15.264402345222775
1747959493237629,89098684,1,965,10,89645830,88989104,656726,15.227050550762417
1747959493328590,89191244,1,966,10,89736791,89081664,655127,15.26421594591583
1747959493422131,89283804,1,967,10,89830332,89174224,656108,15.241393185268278
1747959493516715,89376364,1,968,10,89924916,89266784,658132,15.194520248217682
1747959493611072,89468924,1,969,10,90019273,89359344,659929,15.15314526259643
1747959493704978,89561484,1,970,10,90113179,89451904,661275,15.122301614305698
1747959493795115,89654044,1,971,10,90203316,89544464,658852,15.17791552579335
1747959493889275,89746604,1,972,10,90297476,89637024,660452,15.14114576078201
1747959493983188,89839164,1,973,10,90391389,89729584,661805,15.11019106836606
1747959494077638,89931724,1,974,10,90485839,89822144,663695,15.067161874053593
1747959494167614,90024284,1,975,10,90575815,89914704,661111,15.126052962361843
1747959494262210,90116844,1,976,10,90670411,90007264,663147,15.079612815861339
1747959494356016,90209404,1,977,10,90764217,90099824,664393,15.05133256972906
1747959494449606,90301964,1,978,10,90857807,90192384,665423,15.02803479891738
1747959494540326,90394524,1,979,10,90948527,90284944,663583,15.06970492010796
1747959494633990,90487084,1,980,10,91042191,90377504,664687,15.044675162896219
1747959494729129,90579644,1,981,10,91137330,90470064,667266,14.986527112126199
1747959494822451,90672204,1,982,10,91230652,90562624,668028,14.969432419000402
1747959494916966,90764764,1,983,10,91325167,90655184,669983,14.925751847434935
1747959495007711,90857324,1,984,10,91415912,90747744,668168,14.96629590162953
1747959495101027,90949884,1,985,10,91509228,90840304,668924,14.949381394597893
1747959495196127,91042444,1,986,10,91604328,90932864,671464,14.892831186779933
1747959495290054,91135012,1,987,10,91698255,91025432,672823,14.862749935718607
1747959495379791,91227564,1,988,10,91787992,91117984,670008,14.925194923045694
1747959495474799,91320124,1,989,10,91883000,91210544,672456,14.870861439261452
1747959495568198,91412684,1,990,10,91976399,91303104,673295,14.852330701995411
1747959495661980,91505244,1,991,10,92070181,91395664,674517,14.825423228769623
1747959495752569,91597804,1,992,10,92160770,91488224,672546,14.868871422921258
1747959495846852,91690364,1,993,10,92255053,91580784,674269,14.830876104344112
1747959495941014,91782924,1,994,10,92349215,91673344,675871,14.795722852437818
1747959496035302,91875484,1,995,10,92443503,91765904,677599,14.757991083221789
1747959496125570,91968044,1,996,10,92533771,91858464,675307,14.808079880706108
1747959496219553,92060604,1,997,10,92627754,91951024,676730,14.776942059610183
1747959496313933,92153164,1,998,10,92722134,92043584,678550,14.737307493920861
1747959496407783,92245724,1,999,10,92815984,92136144,679840,14.709343374911745
1747959496502333,92338284,1,1000,10,92910534,92228704,681830,14.666412448850885
1747959496596671,92431884,1,1001,10,93004872,92322304,682568,14.650554963022
1747959496691163,92525484,1,1002,10,93099364,92415904,683460,14.631434173177656
1747959496784941,92619084,1,1003,10,93193142,92509504,683638,14.627624561536955
1747959496878733,92712684,1,1004,10,93286934,92603104,683830,14.623517540909289
1747959496977500,92806284,1,1005,10,93385701,92696704,688997,14.513851293982412
1747959497067245,92899884,1,1006,10,93475446,92790304,685142,14.595514506481868
1747959497162050,92993484,1,1007,10,93570251,92883904,686347,14.569889574806911
1747959497255530,93087084,1,1008,10,93663731,92977504,686227,14.572437400452037
1747959497350170,93180684,1,1009,10,93758371,93071104,687267,14.55038580347958
1747959497443777,93274284,1,1010,10,93851978,93164704,687274,14.550237605380095
1747959497538200,93367884,1,1011,10,93946401,93258304,688097,14.532834760215493
1747959497633184,93461484,1,1012,10,94041385,93351904,689481,14.503662900065411
1747959497726273,93555084,1,1013,10,94134474,93445504,688970,14.51442007634585
1747959497821450,93648684,1,1014,10,94229651,93539104,690547,14.4812735411203
1747959497914895,93742284,1,1015,10,94323096,93632704,690392,14.484524733774435
1747959498009605,93835884,1,1016,10,94417806,93726304,691502,14.461274153943156
1747959498103929,93929492,1,1017,10,94512130,93819912,692218,14.446316044945378
1747959498198049,94023084,1,1018,10,94606250,93913504,692746,14.435305292271627
1747959498292160,94116684,1,1019,10,94700361,94007104,693257,14.424665023216498
1747959498386553,94210284,1,1020,10,94794754,94100704,694050,14.408183848425907
1747959498480741,94303884,1,1021,10,94888942,94194304,694638,14.395987550349966
1747959498574812,94397484,1,1022,10,94983013,94287904,695109,14.386232950515675
1747959498669453,94491084,1,1023,10,95077654,94381504,696150,14.364720247073187
1747959498762723,94584684,1,1024,10,95170924,94475104,695820,14.371532867695668
1747959498857375,94678284,1,1025,10,95265576,94568704,696872,14.349837559838821
1747959498951825,94771884,1,1026,10,95360026,94662304,697722,14.332355866663228
1747959499045772,94865484,1,1027,10,95453973,94755904,698069,14.325231459927313
1747959499140175,94959084,1,1028,10,95548376,94849504,698872,14.308771849494613
1747959499234059,95052684,1,1029,10,95642260,94943104,699156,14.302959568393891
1747959499328973,95146284,1,1030,10,95737174,95036704,700470,14.276128884891572
1747959499422638,95239884,1,1031,10,95830839,95130304,700535,14.274804256746629
1747959499516757,95333484,1,1032,10,95924958,95223904,701054,14.26423642116014
1747959499611576,95427084,1,1033,10,96019777,95317504,702273,14.239476670753396
1747959499705170,95520684,1,1034,10,96113371,95411104,702267,14.239598329410324
1747959499798993,95614284,1,1035,10,96207194,95504704,702490,14.235078079403266
1747959499893460,95707884,1,1036,10,96301661,95598304,703357,14.217531068859769
1747959499992030,95801484,1,1037,10,96400231,95691904,708327,14.117773288325871
1747959500085525,95895084,1,1038,10,96493726,95785504,708222,14.119866369584678
1747959500180320,95988684,1,1039,10,96588521,95879104,709417,14.09608171216647
1747959500274763,96082284,1,1040,10,96682964,95972704,710260,14.079351223495621
1747959500368778,96175884,1,1041,10,96776979,96066304,710675,14.071129559925424
1747959500462846,96269484,1,1042,10,96871047,96159904,711143,14.06186941304351
1747959500557189,96363084,1,1043,10,96965390,96253504,711886,14.047192949432915
1747959500651132,96456684,1,1044,10,97059333,96347104,712229,14.040428008407408
1747959500745334,96550284,1,1045,10,97153535,96440704,712831,14.028570586857194
1747959500840003,96643884,1,1046,10,97248204,96534304,713900,14.007564084605688
1747959500934144,96737484,1,1047,10,97342345,96627904,714441,13.996957061534822
1747959501028154,96831084,1,1048,10,97436355,96721504,714851,13.98892916146162
1747959501122380,96924692,1,1049,10,97530581,96815112,715469,13.976845956987654
1747959501216230,97018284,1,1050,10,97624431,96908704,715727,13.97180768645028
1747959501310041,97111884,1,1051,10,97718242,97002304,715938,13.967689939631645
1747959501404362,97205484,1,1052,10,97812563,97095904,716659,13.953637643565488
1747959501499170,97299084,1,1053,10,97907371,97189504,717867,13.930156978938996
1747959501593312,97392684,1,1054,10,98001513,97283104,718409,13.919647443169561
1747959501686744,97486284,1,1055,10,98094945,97376704,718241,13.922903315182507
1747959501781643,97579884,1,1056,10,98189844,97470304,719540,13.897768018456237
1747959501875596,97673484,1,1057,10,98283797,97563904,719893,13.890953238884112
1747959501969934,97767084,1,1058,10,98378135,97657504,720631,13.876727479112056
1747959502063846,97860684,1,1059,10,98472047,97751104,720943,13.870722095921591
1747959502158671,97954284,1,1060,10,98566872,97844704,722168,13.847193450831385
1747959502252682,98047884,1,1061,10,98660883,97938304,722579,13.839317223445464
1747959502346136,98141484,1,1062,10,98754337,98031904,722433,13.842114078398966
1747959502441044,98235084,1,1063,10,98849245,98125504,723741,13.817097552853854
1747959502535563,98328684,1,1064,10,98943764,98219104,724660,13.799574973090829
1747959502629013,98422284,1,1065,10,99037214,98312704,724510,13.802431988516377
1747959502723550,98515884,1,1066,10,99131751,98406304,725447,13.784604526588435
1747959502817865,98609484,1,1067,10,99226066,98499904,726162,13.77103180832927
1747959502911520,98703084,1,1068,10,99319721,98593504,726217,13.769988860079012
1747959503005740,98796684,1,1069,10,99413941,98687104,726837,13.758242907281826
1747959503091705,98890284,1,1070,10,99499906,98780704,719202,13.90429948748752
1747959503194533,98983884,1,1071,10,99602734,98874304,728430,13.728155073239707
1747959503288550,99077484,1,1072,10,99696751,98967904,728847,13.720300694110012
1747959503383236,99171084,1,1073,10,99791437,99061504,729933,13.699887523923428
1747959503477132,99264684,1,1074,10,99885333,99155104,730229,13.694334243093605
1747959503570737,99358284,1,1075,10,99978938,99248704,730234,13.69424047634046
1747959503665129,99451884,1,1076,10,100073330,99342304,731026,13.679404015725844
1747959503760038,99545484,1,1077,10,100168239,99435904,732335,13.654952992824324
1747959503854313,99639084,1,1078,10,100262514,99529504,733010,13.642378685147541
1747959503947950,99732684,1,1079,10,100356151,99623104,733047,13.641690096269407
1747959504042260,99826284,1,1080,10,100450461,99716704,733757,13.628490085954887
1747959504136428,99919892,1,1081,10,100544629,99810312,734317,13.618096816497507
1747959504235093,100013484,1,1082,10,100643294,99903904,739390,13.524662221561016
1747959504328941,100108124,1,1083,10,100737142,99998544,738598,13.539164741848746
1747959504423064,100202764,1,1084,10,100831265,100093184,738081,13.548648454573414
1747959504521291,100297404,1,1085,10,100929492,100187824,741668,13.483121828095591
1747959504618564,100392044,1,1086,10,101026765,100282464,744301,13.435424646749098
1747959504709619,100486684,1,1087,10,101117820,100377104,740716,13.500450915060563
1747959504804772,100581324,1,1088,10,101212973,100471744,741229,13.49110733659908
1747959504902838,100675964,1,1089,10,101311039,100566384,744655,13.429037608019822
1747959504996302,100770604,1,1090,10,101404503,100661024,743479,13.450279026038395
1747959505091013,100865244,1,1091,10,101499214,100755664,743550,13.448994687647097
1747959505185240,100959884,1,1092,10,101593441,100850304,743137,13.45646899562261
1747959505283306,101054524,1,1093,10,101691507,100944944,746563,13.394716855777745
1747959505377595,101149164,1,1094,10,101785796,101039584,746212,13.401017405241406
1747959505472231,101243804,1,1095,10,101880432,101134224,746208,13.401089240533471
1747959505570584,101338444,1,1096,10,101978785,101228864,749921,13.334737925728177
1747959505664357,101433084,1,1097,10,102072558,101323504,749054,13.350172350725048
1747959505758864,101527724,1,1098,10,102167065,101418144,748921,13.352543192139091
1747959505853431,101622364,1,1099,10,102261632,101512784,748848,13.353844839006047
1747959505951221,101717012,1,1100,10,102359422,101607432,751990,13.298049176185852
1747959506045333,101811644,1,1101,10,102453534,101702064,751470,13.307251121135907
1747959506139399,101906284,1,1102,10,102547600,101796704,750896,13.31742345145
1747959506237813,102000924,1,1103,10,102646014,101891344,754670,13.250824863847775
1747959506332335,102095564,1,1104,10,102740536,101985984,754552,13.25289708330241
1747959506426154,102190204,1,1105,10,102834355,102080624,753731,13.267332775220867
1747959506520297,102284844,1,1106,10,102928498,102175264,753234,13.276086846849719
1747959506618973,102379484,1,1107,10,103027174,102269904,757270,13.205329671055239
1747959506712531,102474124,1,1108,10,103120732,102364544,756188,13.224224663707968
1747959506807469,102568764,1,1109,10,103215670,102459184,756486,13.219015289113084
1747959506901553,102663404,1,1110,10,103309754,102553824,755930,13.228738110671623
1747959506999701,102758044,1,1111,10,103407902,102648464,759438,13.167631854081572
1747959507093506,102852684,1,1112,10,103501707,102743104,758603,13.182125565018856
1747959507188281,102947324,1,1113,10,103596482,102837744,758738,13.179780108548668
1747959507286025,103041964,1,1114,10,103694226,102932384,761842,13.12608126094387
1747959507380585,103136604,1,1115,10,103788786,103027024,761762,13.127459757772112
1747959507474847,103231244,1,1116,10,103883048,103121664,761384,13.133977073329621
1747959507568454,103325884,1,1117,10,103976655,103216304,760351,13.15182067229477
1747959507667485,103420524,1,1118,10,104075686,103310944,764742,13.076305472956893
1747959507761690,103515172,1,1119,10,104169891,103405592,764299,13.08388471004149
1747959507855521,103609804,1,1120,10,104263722,103500224,763498,13.097611257658828
1747959507949736,103704444,1,1121,10,104357937,103594864,763073,13.104906083690551
1747959508048344,103799084,1,1122,10,104456545,103689504,767041,13.037112748862187
1747959508142153,103893724,1,1123,10,104550354,103784144,766210,13.051252267655082
1747959508236430,103988364,1,1124,10,104644631,103878784,765847,13.057438365626554
1747959508334909,104083004,1,1125,10,104743110,103973424,769686,12.992311150261276
1747959508428938,104177644,1,1126,10,104837139,104068064,769075,13.002633033189221
1747959508523455,104272284,1,1127,10,104931656,104162704,768952,13.004712907957844
1747959508617301,104366924,1,1128,10,105025502,104257344,768158,13.018155119129137
1747959508715914,104461564,1,1129,10,105124115,104351984,772131,12.95117020298369
1747959508810035,104556204,1,1130,10,105218236,104446624,771612,12.959881391165508
1747959508904356,104650844,1,1131,10,105312557,104541264,771293,12.965241484105261
1747959509002517,104745484,1,1132,10,105410718,104635904,774814,12.906323324049385
1747959509096826,104840124,1,1133,10,105505027,104730544,774483,12.911839252766038
1747959509191132,104934764,1,1134,10,105599333,104825184,774149,12.91740995596455
1747959509285323,105029404,1,1135,10,105693524,104919824,773700,12.924906294429364
1747959509383474,105124044,1,1136,10,105791675,105014464,777211,12.86651887325321
1747959509478020,105218684,1,1137,10,105886221,105109104,777117,12.868075206178736
1747959509571875,105313324,1,1138,10,105980076,105203744,776332,12.881086957641834
1747959509666234,105407964,1,1139,10,106074435,105298384,776051,12.885751065329469
1747959509763704,105502604,1,1140,10,106171905,105393024,778881,12.838931749522711
1747959509858301,105597244,1,1141,10,106266502,105487664,778838,12.839640592780526
1747959509952938,105691884,1,1142,10,106361139,105582304,778835,12.839690049882195
1747959510050634,105786524,1,1143,10,106458835,105676944,781891,12.789506465734993
1747959510144431,105881164,1,1144,10,106552632,105771584,781048,12.803310423943215
1747959510239355,105975804,1,1145,10,106647556,105866224,781332,12.798656652997701
1747959510333087,106070444,1,1146,10,106741288,105960864,780424,12.813547507508739
1747959510431400,106165084,1,1147,10,106839601,106055504,784097,12.753524117551782
1747959510526144,106259724,1,1148,10,106934345,106150144,784201,12.751832757163022
1747959510620054,106354364,1,1149,10,107028255,106244784,783471,12.763714291913804
1747959510714620,106449004,1,1150,10,107122821,106339424,783397,12.764919957569406
1747959510813007,106543644,1,1151,10,107221208,106434064,787144,12.70415578343988
1747959510907206,106638284,1,1152,10,107315407,106528704,786703,12.711277318123866
1747959511001398,106732924,1,1153,10,107409599,106623344,786255,12.718520073004305
1747959511099696,106827564,1,1154,10,107507897,106717984,789913,12.659622009006055
1747959511193277,106922204,1,1155,10,107601478,106812624,788854,12.676616965877082
1747959511288081,107016844,1,1156,10,107696282,106907264,789018,12.673982089128511
1747959511382081,107111484,1,1157,10,107790282,107001904,788378,12.684270743222159
1747959511480485,107206124,1,1158,10,107888686,107096544,792142,12.623999232460847
1747959511574246,107300764,1,1159,10,107982447,107191184,791263,12.638023008784689
1747959511668944,107395404,1,1160,10,108077145,107285824,791321,12.637096702855098
1747959511766691,107490044,1,1161,10,108174892,107380464,794428,12.587673143444087
1747959511861341,107584684,1,1162,10,108269542,107475104,794438,12.587514695923408
1747959511955730,107679324,1,1163,10,108363931,107569744,794187,12.591492935542888
1747959512049530,107773972,1,1164,10,108457731,107664392,793339,12.604951981435427
1747959512147843,107868604,1,1165,10,108556044,107759024,797020,12.54673659381195
1747959512242399,107963244,1,1166,10,108650600,107853664,796936,12.548059066223637
1747959512336420,108057884,1,1167,10,108744621,107948304,796317,12.557813031744894
1747959512429970,108152524,1,1168,10,108838171,108042944,795227,12.575025747365217
1747959512528241,108247164,1,1169,10,108936442,108137584,798858,12.517869258366318
1747959512623356,108341804,1,1170,10,109031557,108232224,799333,12.51043057148898
1747959512717337,108436444,1,1171,10,109125538,108326864,798674,12.52075314834338
1747959512815166,108531084,1,1172,10,109223367,108421504,801863,12.47095825596143
1747959512909974,108625724,1,1173,10,109318175,108516144,802031,12.468345986626451
1747959513003976,108720364,1,1174,10,109412177,108610784,801393,12.47827220851692
1747959513098357,108815004,1,1175,10,109506558,108705424,801134,12.482306330776124
1747959513196590,108909644,1,1176,10,109604791,108800064,804727,12.426574478052807
1747959513290772,109004284,1,1177,10,109698973,108894704,804269,12.433650930223594
1747959513384396,109098924,1,1178,10,109792597,108989344,803253,12.449377717854773
1747959513478588,109193564,1,1179,10,109886789,109083984,802805,12.456325010432172
1747959513576609,109288204,1,1180,10,109984810,109178624,806186,12.404085409570497
1747959513671832,109382844,1,1181,10,110080033,109273264,806769,12.395121775873887
1747959513765784,109477484,1,1182,10,110173985,109367904,806081,12.40570116402694
1747959513864159,109572132,1,1183,10,110272360,109462552,809808,12.348606089344635
1747959513958261,109666764,1,1184,10,110366462,109557184,809278,12.356693250032745
1747959514052047,109761404,1,1185,10,110460248,109651824,808424,12.369746568632301
1747959514146892,109856044,1,1186,10,110555093,109746464,808629,12.36661064592044
1747959514244426,109950684,1,1187,10,110652627,109841104,811523,12.322509651605685
1747959514339334,110045324,1,1188,10,110747535,109935744,811791,12.318441569320182
1747959514433261,110139964,1,1189,10,110841462,110030384,811078,12.329270427751709
1747959514531887,110234604,1,1190,10,110940088,110125024,815064,12.268975197039742
1747959514625675,110329244,1,1191,10,111033876,110219664,814212,12.28181358172073
1747959514720082,110423884,1,1192,10,111128283,110314304,813979,12.285329228395327
1747959514813989,110518524,1,1193,10,111222190,110408944,813246,12.296402318609621
1747959514912655,110613164,1,1194,10,111320856,110503584,817272,12.235828463473604
1747959515006780,110707804,1,1195,10,111414981,110598224,816757,12.24354367333246
1747959515100873,110802444,1,1196,10,111509074,110692864,816210,12.25174893716078
1747959515194990,110897084,1,1197,10,111603191,110787504,815687,12.259604480640245
1747959515293450,110991724,1,1198,10,111701651,110882144,819507,12.202458307250579
1747959515387750,111086364,1,1199,10,111795951,110976784,819167,12.20752300812899
1747959515482122,111181004,1,1200,10,111890323,111071424,818899,12.211518148147695
1747959515579846,111275644,1,1201,10,111988047,111166064,821983,12.165701723758277
1747959515674454,111370284,1,1202,10,112082655,111260704,821951,12.166175355951875
1747959515768749,111464924,1,1203,10,112176950,111355344,821606,12.171284046124299
1747959515862898,111559564,1,1204,10,112271099,111449984,821115,12.178562077175547
1747959515960487,111654204,1,1205,10,112368688,111544624,824064,12.1349798073936
1747959516054635,111748844,1,1206,10,112462836,111639264,823572,12.142229216146252
1747959516149007,111843484,1,1207,10,112557208,111733904,823304,12.146181726312516
1747959516246978,111938124,1,1208,10,112655179,111828544,826635,12.097237595795
1747959516342039,112032764,1,1209,10,112750240,111923184,827056,12.091079685051556
1747959516437348,112127404,1,1210,10,112845549,112017824,827725,12.081307197438763
1747959516530288,112222044,1,1211,10,112938489,112112464,826025,12.106171120728792
1747959516627972,112316684,1,1212,10,113036173,112207104,829069,12.061722245072486
1747959516722830,112411324,1,1213,10,113131031,112301744,829287,12.058551502676396
1747959516816532,112505964,1,1214,10,113224733,112396384,828349,12.072206280203151
1747959516911435,112600604,1,1215,10,113319636,112491024,828612,12.068374583037658
1747959517009283,112695244,1,1216,10,113417484,112585664,831820,12.021831646269625
1747959517102991,112789884,1,1217,10,113511192,112680304,830888,12.035316432539645
1747959517197805,112884524,1,1218,10,113606006,112774944,831062,12.03279659038676
1747959517296113,112979164,1,1219,10,113704314,112869584,834730,11.9799216513124
1747959517389893,113073804,1,1220,10,113798094,112964224,833870,11.992276973628982
1747959517484571,113168444,1,1221,10,113892772,113058864,833908,11.991730502645376
1747959517578441,113263084,1,1222,10,113986642,113153504,833138,12.0028134594749
1747959517677191,113357724,1,1223,10,114085392,113248144,837248,11.943892371197064
1747959517771195,113452364,1,1224,10,114179396,113342784,836612,11.952972226073735
1747959517864820,113547004,1,1225,10,114273021,113437424,835597,11.967491506072903
1747959517959951,113641644,1,1226,10,114368152,113532064,836088,11.960463491881237
1747959518057378,113736284,1,1227,10,114465579,113626704,838875,11.920727164357025
1747959518152259,113830932,1,1228,10,114560460,113721352,839108,11.917417066694634
1747959518245720,113925564,1,1229,10,114653921,113815984,837937,11.934071415870166
1747959518343941,114020204,1,1230,10,114752142,113910624,841518,11.883287107346487
1747959518438785,114114844,1,1231,10,114846986,114005264,841722,11.880407070267855
1747959518532637,114209484,1,1232,10,114940838,114099904,840934,11.891539645204023
1747959518634746,114304124,1,1233,10,115042947,114194544,848403,11.786851295905365
1747959518725611,114398764,1,1234,10,115133812,114289184,844628,11.839531722841297
1747959518819616,114493404,1,1235,10,115227817,114383824,843993,11.848439501275484
1747959518913998,114588044,1,1236,10,115322199,114478464,843735,11.852062555186166
1747959519011449,114682684,1,1237,10,115419650,114573104,846546,11.812707165351911
1747959519106385,114777324,1,1238,10,115514586,114667744,846842,11.808578223564727
1747959519200865,114871964,1,1239,10,115609066,114762384,846682,11.81080972549316
1747959519295372,114966604,1,1240,10,115703573,114857024,846549,11.81266530348509
1747959519393513,115061244,1,1241,10,115801714,114951664,850050,11.76401388153638
1747959519487541,115155884,1,1242,10,115895742,115046304,849438,11.772489575460481
1747959519581312,115250524,1,1243,10,115989513,115140944,848569,11.784545511325538
1747959519676010,115345164,1,1244,10,116084211,115235584,848627,11.783740088401618
1747959519774032,115439804,1,1245,10,116182233,115330224,852009,11.736965219850964
1747959519868464,115534444,1,1246,10,116276665,115424864,851801,11.739831251665588
1747959519962754,115629092,1,1247,10,116370955,115519512,851443,11.744767412498547
1747959520060517,115723724,1,1248,10,116468718,115614144,854574,11.701736771771667
1747959520155213,115818364,1,1249,10,116563414,115708784,854630,11.700970010413863
1747959520249558,115913004,1,1250,10,116657759,115803424,854335,11.705010329671616
1747959520343271,116007644,1,1251,10,116751472,115898064,853408,11.717724699088828
1747959520441692,116102284,1,1252,10,116849893,115992704,857189,11.666038644919615
1747959520536021,116196924,1,1253,10,116944222,116087344,856878,11.670272780955981
1747959520630579,116291564,1,1254,10,117038780,116181984,856796,11.671389689027492
1747959520724566,116386204,1,1255,10,117132767,116276624,856143,11.680291726966173
1747959520822808,116480844,1,1256,10,117231009,116371264,859745,11.631355808989875
1747959520917115,116575484,1,1257,10,117325316,116465904,859412,11.635862659585857
1747959521011316,116670124,1,1258,10,117419517,116560544,858973,11.641809463161241
1747959521109111,116764764,1,1259,10,117517312,116655184,862128,11.599205686394596
1747959521203715,116859404,1,1260,10,117611916,116749824,862092,11.599690056281696
1747959521297485,116954044,1,1261,10,117705686,116844464,861222,11.611407976108366
1747959521392047,117048684,1,1262,10,117800248,116939104,861144,11.612459704764824
1747959521490336,117143324,1,1263,10,117898537,117033744,864793,11.563460851325114
1747959521583949,117237964,1,1264,10,117992150,117128384,863766,11.577209568332163
1747959521678650,117332604,1,1265,10,118086851,117223024,863827,11.576392032200891
1747959521777026,117427244,1,1266,10,118185227,117317664,867563,11.526540435680175
1747959521871329,117521884,1,1267,10,118279530,117412304,867226,11.531019595814701
1747959521965395,117616524,1,1268,10,118373596,117506944,866652,11.53865680803829
1747959522059780,117711164,1,1269,10,118467981,117601584,866397,11.542052892611586
1747959522157545,117805804,1,1270,10,118565746,117696224,869522,11.500571578407447
1747959522252253,117900444,1,1271,10,118660454,117790864,869590,11.49967225934061
1747959522345689,117995084,1,1272,10,118753890,117885504,868386,11.515616327301453
1747959522440655,118089724,1,1273,10,118848856,117980144,868712,11.511294882538747
1747959522538885,118184364,1,1274,10,118947086,118074784,872302,11.463919605824588
1747959522633059,118279004,1,1275,10,119041260,118169424,871836,11.470047118953564
1747959522727387,118373644,1,1276,10,119135588,118264064,871524,11.474153322226353
1747959522825155,118468284,1,1277,10,119233356,118358704,874652,11.433118543146303
1747959522919283,118562924,1,1278,10,119327484,118453344,874140,11.439815132587457
1747959523014001,118657564,1,1279,10,119422202,118547984,874218,11.438794442576107
1747959523108076,118752204,1,1280,10,119516277,118642624,873653,11.446192023606626
1747959523206418,118846844,1,1281,10,119614619,118737264,877355,11.39789480882881
1747959523300387,118941484,1,1282,10,119708588,118831904,876684,11.406618576362748
1747959523394355,119036124,1,1283,10,119802556,118926544,876012,11.415368739241014
1747959523492912,119130764,1,1284,10,119901113,119021184,879929,11.364553276457533
1747959523587590,119225404,1,1285,10,119995791,119115824,879967,11.364062515980713
1747959523681136,119320044,1,1286,10,120089337,119210464,878873,11.378208228037497
1747959523775483,119414684,1,1287,10,120183684,119305104,878580,11.382002777208678
1747959523873291,119509324,1,1288,10,120281492,119399744,881748,11.341108797524917
1747959523967920,119603964,1,1289,10,120376121,119494384,881737,11.3412502821136
1747959524062301,119698604,1,1290,10,120470502,119589024,881478,11.344582621460773
1747959524156709,119793244,1,1291,10,120564910,119683664,881246,11.347569237193701
1747959524254934,119887892,1,1292,10,120663135,119778312,884823,11.301695367322052
1747959524349262,119982524,1,1293,10,120757463,119872944,884519,11.30557964272107
1747959524443376,120077164,1,1294,10,120851577,119967584,883993,11.312306771659957
1747959524540891,120171804,1,1295,10,120949092,120062224,886868,11.275635156528367
1747959524635798,120266444,1,1296,10,121043999,120156864,887135,11.272241541591754
1747959524737895,120361084,1,1297,10,121146096,120251504,894592,11.178280154528544
1747959524823717,120455724,1,1298,10,121231918,120346144,885774,11.289561445696082
1747959524922716,120550364,1,1299,10,121330917,120440784,890133,11.234276226136993
1747959525016732,120645004,1,1300,10,121424933,120535424,889509,11.242157190090264
1747959525144973,120739644,1,1301,10,121553174,120630064,923110,10.832945152798692
1747959525205410,120834284,1,1302,10,121613611,120724704,888907,11.249770785920237
1747959525302929,120928924,1,1303,10,121711130,120819344,891786,11.213452554760895
1747959525397384,121023564,1,1304,10,121805585,120913984,891601,11.215779255519005
1747959525492113,121118204,1,1305,10,121900314,121008624,891690,11.214659803294868
1747959525590098,121212844,1,1306,10,121998299,121103264,895035,11.17274743445787
1747959525684406,121307484,1,1307,10,122092607,121197904,894703,11.176893337789188
1747959525778331,121402124,1,1308,10,122186532,121292544,893988,11.185832472024233
1747959525873065,121496764,1,1309,10,122281266,121387184,894082,11.184656440908103
1747959525970601,121591404,1,1310,10,122378802,121481824,896978,11.148545449275232
1747959526064946,121686052,1,1311,10,122473147,121576472,896675,11.152312710848411
1747959526159495,121780684,1,1312,10,122567696,121671104,896592,11.153345111265772
1747959526257172,121875324,1,1313,10,122665373,121765744,899629,11.115693246882882
1747959526351865,121969964,1,1314,10,122760066,121860384,899682,11.115038424687834
1747959526445823,122064604,1,1315,10,122854024,121955024,899000,11.123470522803114
1747959526540358,122159244,1,1316,10,122948559,122049664,898895,11.124769856323597
1747959526638244,122253884,1,1317,10,123046445,122144304,902141,11.084741742144521
1747959526732832,122348524,1,1318,10,123141033,122238944,902089,11.08538071077244
1747959526827158,122443164,1,1319,10,123235359,122333584,901775,11.089240664245516
1747959526921396,122537804,1,1320,10,123329597,122428224,901373,11.094186313546112
1747959527019505,122632444,1,1321,10,123427706,122522864,904842,11.051653216804702
1747959527113235,122727084,1,1322,10,123521436,122617504,903932,11.062779058601754
1747959527207869,122821724,1,1323,10,123616070,122712144,903926,11.062852490137466
1747959527306169,122916364,1,1324,10,123714370,122806784,907586,11.018239593823616
1747959527400373,123011004,1,1325,10,123808574,122901424,907150,11.023535247753955
1747959527493832,123105644,1,1326,10,123902033,122996064,905969,11.037905270489388
1747959527588598,123200284,1,1327,10,123996799,123090704,906095,11.036370358516491
1747959527686745,123294924,1,1328,10,124094946,123185344,909602,10.993819274803705
1747959527780758,123389564,1,1329,10,124188959,123279984,908975,11.001402678841552
1747959527875532,123484204,1,1330,10,124283733,123374624,909109,10.999781104356025
1747959527969502,123578844,1,1331,10,124377703,123469264,908439,11.007893760615737
1747959528067400,123673484,1,1332,10,124475601,123563904,911697,10.968556439255586
1747959528162327,123768124,1,1333,10,124570528,123658544,911984,10.96510465095879
1747959528256518,123862764,1,1334,10,124664719,123753184,911535,10.970505795169686
1747959528354540,123957404,1,1335,10,124762741,123847824,914917,10.929953208870312
1747959528448582,124052044,1,1336,10,124856783,123942464,914319,10.937101821136824
1747959528542287,124146684,1,1337,10,124950488,124037104,913384,10.948297758664483
1747959528637356,124241324,1,1338,10,125045557,124131744,913813,10.943157954636233
1747959528735874,124335964,1,1339,10,125144075,124226384,917691,10.8969141028952
1747959528830065,124430604,1,1340,10,125238266,124321024,917242,10.902248261636515
1747959528924203,124525244,1,1341,10,125332404,124415664,916740,10.908218251630778
1747959529021626,124619884,1,1342,10,125429827,124510304,919523,10.875203774130718
1747959529116783,124714524,1,1343,10,125524984,124604944,920040,10.869092648145733
1747959529210531,124809164,1,1344,10,125618732,124699584,919148,10.87964071074517
1747959529304879,124903804,1,1345,10,125713080,124794224,918856,10.883098113306112
1747959529403284,124998444,1,1346,10,125811485,124888864,922621,10.83868674135967
1747959529497299,125093084,1,1347,10,125905500,124983504,921996,10.846034039193228
1747959529591553,125187724,1,1348,10,125999754,125078144,921610,10.850576708152039
1747959529685330,125282364,1,1349,10,126093531,125172784,920747,10.860746763225945
1747959529783216,125377004,1,1350,10,126191417,125267424,923993,10.822592811850306
1747959529878731,125471644,1,1351,10,126286932,125362064,924868,10.812353762915356
1747959529972165,125566284,1,1352,10,126380366,125456704,923662,10.826471155032902
1747959530070508,125660924,1,1353,10,126478709,125551344,927365,10.783240687323762
1747959530164607,125755564,1,1354,10,126572808,125645984,926824,10.789535014199028
1747959530259055,125850204,1,1355,10,126667256,125740624,926632,10.791770627390378
1747959530353224,125944852,1,1356,10,126761425,125835272,926153,10.797352057381447
1747959530451225,126039484,1,1357,10,126859426,125929904,929522,10.758217664563077
1747959530546092,126134124,1,1358,10,126954293,126024544,929749,10.755591025104625
1747959530639848,126228764,1,1359,10,127048049,126119184,928865,10.765827111582414
1747959530738403,126323404,1,1360,10,127146604,126213824,932780,10.720641523188746
1747959530832590,126418044,1,1361,10,127240791,126308464,932327,10.725850479499146
1747959530926905,126512684,1,1362,10,127335106,126403104,932002,10.729590709032813
1747959531020386,126607324,1,1363,10,127428587,126497744,930843,10.742950207500083
1747959531118992,126701964,1,1364,10,127527193,126592384,934809,10.697372404416303
1747959531212707,126796604,1,1365,10,127620908,126687024,933884,10.70796801315795
1747959531306780,126891244,1,1366,10,127714981,126781664,933317,10.714473217567022
1747959531401371,126985884,1,1367,10,127809572,126876304,933268,10.71503576678939
1747959531499817,127080524,1,1368,10,127908018,126970944,937074,10.671515803447754
1747959531593775,127175164,1,1369,10,128001976,127065584,936392,10.679288161368316
1747959531688353,127269804,1,1370,10,128096554,127160224,936330,10.679995300802068
1747959531786555,127364444,1,1371,10,128194756,127254864,939892,10.639520285309377
1747959531880871,127459084,1,1372,10,128289072,127349504,939568,10.643189210360507
1747959531974932,127553724,1,1373,10,128383133,127444144,938989,10.649752020524202
1747959532069541,127648364,1,1374,10,128477742,127538784,938958,10.650103625508276
1747959532167365,127743012,1,1375,10,128575566,127633432,942134,10.614201376874203
1747959532262055,127837644,1,1376,10,128670256,127728064,942192,10.613547981727715
1747959532356046,127932284,1,1377,10,128764247,127822704,941543,10.620863837339346
1747959532449126,128026924,1,1378,10,128857327,127917344,939983,10.638490270568722
1747959532547667,128121564,1,1379,10,128955868,128011984,943884,10.594522208237453
1747959532642071,128216204,1,1380,10,129050272,128106624,943648,10.597171826782867
1747959532736629,128310844,1,1381,10,129144830,128201264,943566,10.59809276722561
1747959532834958,128405484,1,1382,10,129243159,128295904,947255,10.556819441438684
1747959532928729,128500124,1,1383,10,129336930,128390544,946386,10.566513029567217
1747959533023793,128594764,1,1384,10,129431994,128485184,946810,10.561781138771241
1747959533117683,128689404,1,1385,10,129525884,128579824,946060,10.570154112846966
1747959533215331,128784044,1,1386,10,129623532,128674464,949068,10.53665280043158
1747959533309892,128878684,1,1387,10,129718093,128769104,948989,10.537529939756942
1747959533404475,128973324,1,1388,10,129812676,128863744,948932,10.538162903137422
1747959533502320,129067964,1,1389,10,129910521,128958384,952137,10.502690264111152
1747959533596862,129162604,1,1390,10,130005063,129053024,952039,10.50377137911367
1747959533691147,129257244,1,1391,10,130099348,129147664,951684,10.507689527196002
1747959533785400,129351884,1,1392,10,130193601,129242304,951297,10.511964192045177
1747959533884149,129446524,1,1393,10,130292350,129336944,955406,10.466754447847302
1747959533977985,129541164,1,1394,10,130386186,129431584,954602,10.475569923381682
1747959534072489,129635804,1,1395,10,130480690,129526224,954466,10.477062566922237
1747959534167040,129730444,1,1396,10,130575241,129620864,954377,10.478039600702866
1747959534264174,129825084,1,1397,10,130672375,129715504,956871,10.450729513173666
1747959534358317,129919724,1,1398,10,130766518,129810144,956374,10.456160456055896
1747959534452860,130014364,1,1399,10,130861061,129904784,956277,10.457221077156515
1747959534551097,130109004,1,1400,10,130959298,129999424,959874,10.418034033633582
1747959534646674,130203644,1,1401,10,131054875,130094064,960811,10.407874181290598
1747959534740243,130298284,1,1402,10,131148444,130188704,959740,10.419488611498947
1747959534834099,130392924,1,1403,10,131242300,130283344,958956,10.428007124414467
1747959534932332,130487564,1,1404,10,131340533,130377984,962549,10.389081490916308
1747959535026218,130582204,1,1405,10,131434419,130472624,961795,10.397226020097838
1747959535121160,130676844,1,1406,10,131529361,130567264,962097,10.393962355147142
1747959535214909,130771484,1,1407,10,131623110,130661904,961206,10.403597147749807
1747959535313032,130866124,1,1408,10,131721233,130756544,964689,10.366035064150207
1747959535407038,130960764,1,1409,10,131815239,130851184,964055,10.37285217129728
1747959535501037,131055404,1,1410,10,131909238,130945824,963414,10.379753667685959
1747959535599915,131150044,1,1411,10,132008116,131040464,967652,10.334293733697653
1747959535693514,131244684,1,1412,10,132101715,131135104,966611,10.345423339895781
1747959535788307,131339324,1,1413,10,132196508,131229744,966764,10.343786073953934
1747959535882593,131433964,1,1414,10,132290794,131324384,966410,10.34757504578802
1747959535980126,131528604,1,1415,10,132388327,131419024,969303,10.316691478309671
1747959536074572,131623244,1,1416,10,132482773,131513664,969109,10.318756713641086
