Tempo total receptor,Tempo total emissor,Id do pacote,Id da mensagem,Distancia (m),Tempo zerado receptor,Tempo zerado emissor,Delta tempo,Velocidade (m/s)
1747959551561279,109580,1,1,25,0,0,0,0
1747959551651027,197404,1,2,25,89748,87824,1924,12993.762993762994
1747959551741176,285804,1,3,25,179897,176224,3673,6806.425265450585
1747959551827464,374204,1,4,25,266185,264624,1561,16015.374759769378
1747959551917119,462604,1,5,25,355840,353024,2816,8877.84090909091
1747959552007389,551004,1,6,25,446110,441424,4686,5335.0405463081515
1747959552097330,639404,1,7,25,536051,529824,6227,4014.774369680424
1747959552183040,727804,1,8,25,621761,618224,3537,7068.136839129205
1747959552273576,816204,1,9,25,712297,706624,5673,4406.839414771725
1747959552363526,904604,1,10,25,802247,795024,7223,3461.165720614703
1747959552453800,994044,1,11,25,892521,884464,8057,3102.8918952463696
1747959552544375,1083484,1,12,25,983096,973904,9192,2719.7563098346386
1747959552638165,1173964,1,13,25,1076886,1064384,12502,1999.6800511918095
1747959552727864,1264444,1,14,25,1166585,1154864,11721,2132.9238119614365
1747959552818240,1354924,1,15,25,1256961,1245344,11617,2152.0185934406472
1747959552908052,1445404,1,16,25,1346773,1335824,10949,2283.3135446159467
1747959553002502,1535884,1,17,25,1441223,1426304,14919,1675.715530531537
1747959553092876,1626364,1,18,25,1531597,1516784,14813,1687.7067440761493
1747959553183336,1716844,1,19,25,1622057,1607264,14793,1689.988508078145
1747959553272943,1807324,1,20,25,1711664,1697744,13920,1795.9770114942528
1747959553367056,1897804,1,21,25,1805777,1788224,17553,1424.2579616020055
1747959553457393,1988284,1,22,25,1896114,1878704,17410,1435.9563469270536
1747959553546590,2078764,1,23,25,1985311,1969184,16127,1550.195324610901
1747959553638426,2169244,1,24,25,2077147,2059664,17483,1429.9605330892869
1747959553732151,2259724,1,25,25,2170872,2150144,20728,1206.0980316480125
1747959553821414,2350204,1,26,25,2260135,2240624,19511,1281.3284813694838
1747959553911265,2440684,1,27,25,2349986,2331104,18882,1324.0122868340218
1747959554004296,2531164,1,28,25,2443017,2421584,21433,1166.425605374889
1747959554096204,2621644,1,29,25,2534925,2512064,22861,1093.5654608284851
1747959554186039,2712124,1,30,25,2624760,2602544,22216,1125.315088224703
1747959554275961,2802604,1,31,25,2714682,2693024,21658,1154.3078769969527
1747959554366168,2893084,1,32,25,2804889,2783504,21385,1169.0437222352116
1747959554460258,2983564,1,33,25,2898979,2873984,24995,1000.2000400080016
1747959554550606,3074044,1,34,25,2989327,2964464,24863,1005.5101958733861
1747959554641074,3164524,1,35,25,3079795,3054944,24851,1005.9957345780854
1747959554734750,3255004,1,36,25,3173471,3145424,28047,891.3609298677221
1747959554825060,3345484,1,37,25,3263781,3235904,27877,896.7966423933709
1747959554915534,3435964,1,38,25,3354255,3326384,27871,896.9897025582146
1747959555005936,3526444,1,39,25,3444657,3416864,27793,899.5070701255711
1747959555099768,3616924,1,40,25,3538489,3507344,31145,802.6970621287526
1747959555189932,3707404,1,41,25,3628653,3597824,30829,810.9247786175355
1747959555279831,3797884,1,42,25,3718552,3688304,30248,826.5009256810367
1747959555370184,3888364,1,43,25,3808905,3778784,30121,829.985724245543
1747959555464117,3978844,1,44,25,3902838,3869264,33574,744.6238160481325
1747959555553632,4069324,1,45,25,3992353,3959744,32609,766.6595111778956
1747959555644071,4159804,1,46,25,4082792,4050224,32568,767.6246622451487
1747959555734601,4250284,1,47,25,4173322,4140704,32618,766.447973511558
1747959555828255,4340772,1,48,25,4266976,4231192,35784,698.6362620165437
1747959555919210,4431244,1,49,25,4357931,4321664,36267,689.3318995229823
1747959556008561,4521724,1,50,25,4447282,4412144,35138,711.4804485172747
1747959556098432,4612204,1,51,25,4537153,4502624,34529,724.0290770077327
1747959556193205,4702684,1,52,25,4631926,4593104,38822,643.9647622482097
1747959556283116,4793164,1,53,25,4721837,4683584,38253,653.5435129270907
1747959556373714,4883644,1,54,25,4812435,4774064,38371,651.5337103541736
1747959556463204,4974124,1,55,25,4901925,4864544,37381,668.7889569567428
1747959556557033,5064604,1,56,25,4995754,4955024,40730,613.7981831573778
1747959556647382,5155084,1,57,25,5086103,5045504,40599,615.7787137614226
1747959556738018,5245564,1,58,25,5176739,5135984,40755,613.421666053245
1747959556827708,5336044,1,59,25,5266429,5226464,39965,625.5473539346929
1747959556922241,5426524,1,60,25,5360962,5316944,44018,567.9494752146849
1747959557012641,5517004,1,61,25,5451362,5407424,43938,568.9835677545633
1747959557102235,5607484,1,62,25,5540956,5497904,43052,580.693115302425
1747959557192186,5697964,1,63,25,5630907,5588384,42523,587.9171272017496
1747959557286117,5788444,1,64,25,5724838,5678864,45974,543.7856179579762
1747959557376461,5878924,1,65,25,5815182,5769344,45838,545.3990139185829
1747959557467433,5969404,1,66,25,5906154,5859824,46330,539.6071659831642
1747959557557012,6059884,1,67,25,5995733,5950304,45429,550.3092738118823
1747959557650900,6150364,1,68,25,6089621,6040784,48837,511.9069557917153
1747959557740819,6240844,1,69,25,6179540,6131264,48276,517.8556632695335
1747959557831507,6331324,1,70,25,6270228,6221744,48484,515.6340235954129
1747959557922074,6421804,1,71,25,6360795,6312224,48571,514.7104239155051
1747959558016049,6512284,1,72,25,6454770,6402704,52066,480.15979718050164
1747959558106060,6602772,1,73,25,6544781,6493192,51589,484.59943011107015
1747959558195672,6693244,1,74,25,6634393,6583664,50729,492.8147607877151
1747959558286680,6783724,1,75,25,6725401,6674144,51257,487.73826014007847
1747959558379158,6874204,1,76,25,6817879,6764624,53255,469.43948924983573
1747959558469775,6964684,1,77,25,6908496,6855104,53392,468.23494156427927
1747959558560234,7055164,1,78,25,6998955,6945584,53371,468.4191789548631
1747959558650503,7145644,1,79,25,7089224,7036064,53160,470.2784048156509
1747959558744746,7236124,1,80,25,7183467,7126544,56923,439.1897826888955
1747959558834438,7326604,1,81,25,7273159,7217024,56135,445.3549478934711
1747959558924188,7417084,1,82,25,7362909,7307504,55405,451.222813825467
1747959559014518,7507564,1,83,25,7453239,7397984,55255,452.447742285766
1747959559109272,7598044,1,84,25,7547993,7488464,59529,419.96337919333433
1747959559199444,7688524,1,85,25,7638165,7578944,59221,422.1475490113304
1747959559290005,7779004,1,86,25,7728726,7669424,59302,421.5709419581127
1747959559379904,7869484,1,87,25,7818625,7759904,58721,425.74206842526524
1747959559473070,7959964,1,88,25,7911791,7850384,61407,407.1197094793753
1747959559564088,8050444,1,89,25,8002809,7940864,61945,403.5838243603196
1747959559653810,8140924,1,90,25,8092531,8031344,61187,408.5835226436988
1747959559743937,8231404,1,91,25,8182658,8121824,60834,410.9544004997206
1747959559838270,8321884,1,92,25,8276991,8212304,64687,386.4764172090219
1747959559928362,8412364,1,93,25,8367083,8302784,64299,388.8085351249631
1747959560017877,8502844,1,94,25,8456598,8393264,63334,394.7326870243471
1747959560108538,8593324,1,95,25,8547259,8483744,63515,393.6078091789341
1747959560201816,8683804,1,96,25,8640537,8574224,66313,376.9999849200006
1747959560293048,8774284,1,97,25,8731769,8664704,67065,372.7726832177738
1747959560383468,8864764,1,98,25,8822189,8755184,67005,373.1064845907022
1747959560473087,8955244,1,99,25,8911808,8845664,66144,377.9632317368167
1747959560567367,9045724,1,100,25,9006088,8936144,69944,357.4288001830035
1747959560657095,9137244,1,101,25,9095816,9027664,68152,366.82709238173493
1747959560751752,9228764,1,102,25,9190473,9119184,71289,350.6852389569218
1747959560841908,9320284,1,103,25,9280629,9210704,69925,357.5259206292456
1747959560935937,9411804,1,104,25,9374658,9302224,72434,345.1417842449678
1747959561029473,9503324,1,105,25,9468194,9393744,74450,335.795836131632
1747959561119936,9594844,1,106,25,9558657,9485264,73393,340.6319403757852
1747959561213849,9686364,1,107,25,9652570,9576784,75786,329.8762304383395
1747959561303851,9777884,1,108,25,9742572,9668304,74268,336.6187321592072
1747959561398292,9869404,1,109,25,9837013,9759824,77189,323.8803456451049
1747959561488726,9960924,1,110,25,9927447,9851344,76103,328.50216154422293
1747959561582208,10052444,1,111,25,10020929,9942864,78065,320.24594888874657
1747959561676444,10145004,1,112,25,10115165,10035424,79741,313.51500482813105
1747959561767196,10237564,1,113,25,10205917,10127984,77933,320.78836949687553
1747959561861343,10330132,1,114,25,10300064,10220552,79512,314.4179494919006
1747959561955796,10422684,1,115,25,10394517,10313104,81413,307.07626546128995
1747959562049723,10515244,1,116,25,10488444,10405664,82780,302.00531529354913
1747959562139798,10607804,1,117,25,10578519,10498224,80295,311.3518899059717
1747959562234154,10700364,1,118,25,10672875,10590784,82091,304.54008356579897
1747959562327987,10792924,1,119,25,10766708,10683344,83364,299.8896406122547
1747959562422670,10885484,1,120,25,10861391,10775904,85487,292.4421257033233
1747959562512626,10978044,1,121,25,10951347,10868464,82883,301.63000856629225
1747959562606387,11070604,1,122,25,11045108,10961024,84084,297.32172589315445
1747959562700839,11163164,1,123,25,11139560,11053584,85976,290.7788219968363
1747959562794692,11255724,1,124,25,11233413,11146144,87269,286.47056801384224
1747959562888826,11348284,1,125,25,11327547,11238704,88843,281.39527030829663
1747959562978875,11440844,1,126,25,11417596,11331264,86332,289.5797618496038
1747959563073886,11533404,1,127,25,11512607,11423824,88783,281.58543865379636
1747959563167536,11625964,1,128,25,11606257,11516384,89873,278.17030698875084
1747959563262167,11718524,1,129,25,11700888,11608944,91944,271.90463760549903
1747959563352573,11811084,1,130,25,11791294,11701504,89790,278.4274418086647
1747959563446571,11903644,1,131,25,11885292,11794064,91228,274.03867233744023
1747959563540129,11996204,1,132,25,11978850,11886624,92226,271.07323314466635
1747959563634987,12088764,1,133,25,12073708,11979184,94524,264.48309424061614
1747959563724856,12181324,1,134,25,12163577,12071744,91833,272.233293042806
1747959563819831,12273884,1,135,25,12258552,12164304,94248,265.25761819879466
1747959563913805,12366444,1,136,25,12352526,12256864,95662,261.3367899479417
1747959564007661,12459004,1,137,25,12446382,12349424,96958,257.84360238453763
1747959564097369,12551564,1,138,25,12536090,12441984,94106,265.6578751620513
1747959564191453,12644124,1,139,25,12630174,12534544,95630,261.42423925546376
1747959564286386,12736684,1,140,25,12725107,12627104,98003,255.0942318092303
1747959564380783,12829244,1,141,25,12819504,12719664,99840,250.40064102564102
1747959564474630,12921804,1,142,25,12913351,12812224,101127,247.21389935427732
1747959564564548,13014364,1,143,25,13003269,12904784,98485,253.84576331421027
1747959564658408,13106924,1,144,25,13097129,12997344,99785,250.53865811494714
1747959564753261,13199484,1,145,25,13191982,13089904,102078,244.91075452105252
1747959564847241,13292044,1,146,25,13285962,13182464,103498,241.55056136350458
1747959564938349,13384604,1,147,25,13377070,13275024,102046,244.9875546322247
1747959565035286,13477164,1,148,25,13474007,13367584,106423,234.91162624620617
1747959565125607,13569724,1,149,25,13564328,13460144,104184,239.9600706442448
1747959565703371,14140684,1,155,25,14142092,14031104,110988,225.2495765307961
1747959565793389,14233244,1,156,25,14232110,14123664,108446,230.52948010991645
1747959565887072,14325804,1,157,25,14325793,14216224,109569,228.16672599001544
1747959565982373,14418364,1,158,25,14421094,14308784,112310,222.5981657911139
1747959566071920,14510924,1,159,25,14510641,14401344,109297,228.7345489812163
1747959566166211,14603484,1,160,25,14604932,14493904,111028,225.168425982635
1747959566260793,14696044,1,161,25,14699514,14586464,113050,221.14108801415304
1747959566354535,14788604,1,162,25,14793256,14679024,114232,218.85286084459696
1747959566445110,14881164,1,163,25,14883831,14771584,112247,222.72310173100394
1747959566538810,14973724,1,164,25,14977531,14864144,113387,220.48382971592864
1747959566633141,15066284,1,165,25,15071862,14956704,115158,217.09303739210478
1747959566726467,15158844,1,166,25,15165188,15049264,115924,215.65853490217728
1747959566817218,15251404,1,167,25,15255939,15141824,114115,219.07724663716428
1747959566911558,15343964,1,168,25,15350279,15234384,115895,215.71249838215627
1747959567005537,15436524,1,169,25,15444258,15326944,117314,213.10329542936051
1747959567099893,15529084,1,170,25,15538614,15419504,119110,209.8900176307615
1747959567194194,15621644,1,171,25,15632915,15512064,120851,206.8663064434717
1747959567284772,15714204,1,172,25,15723493,15604624,118869,210.3155574624166
1747959567378499,15806764,1,173,25,15817220,15697184,120036,208.27085207771
1747959567472904,15899324,1,174,25,15911625,15789744,121881,205.11810700601407
1747959567567100,15991884,1,175,25,16005821,15882304,123517,202.40128889140766
1747959567661144,16084444,1,176,25,16099865,15974864,125001,199.9984000127999
1747959567750956,16177004,1,177,25,16189677,16067424,122253,204.4939592484438
1747959567845520,16269564,1,178,25,16284241,16159984,124257,201.19590848000513
1747959567939586,16362124,1,179,25,16378307,16252544,125763,198.7866065535968
1747959568029125,16454692,1,180,25,16467846,16345112,122734,203.69253833493573
1747959568123666,16547244,1,181,25,16562387,16437664,124723,200.44418431243636
1747959568217652,16639804,1,182,25,16656373,16530224,126149,198.17834465592273
1747959568312313,16732364,1,183,25,16751034,16622784,128250,194.9317738791423
1747959568401559,16824924,1,184,25,16840280,16715344,124936,200.1024524556573
1747959568496148,16917484,1,185,25,16934869,16807904,126965,196.90465876422638
1747959568590503,17010044,1,186,25,17029224,16900464,128760,194.15967691829758
1747959568685185,17102604,1,187,25,17123906,16993024,130882,191.01175104292417
1747959568779233,17195164,1,188,25,17217954,17085584,132370,188.8645463473597
1747959568869154,17287724,1,189,25,17307875,17178144,129731,192.70644641604548
1747959568962688,17380284,1,190,25,17401409,17270704,130705,191.27041811713403
1747959569056954,17472844,1,191,25,17495675,17363264,132411,188.8060659612872
1747959569151476,17565404,1,192,25,17590197,17455824,134373,186.04928073348069
1747959569242086,17657964,1,193,25,17680807,17548384,132423,188.78895660119463
1747959569336172,17750524,1,194,25,17774893,17640944,133949,186.63819812018005
1747959569430329,17843084,1,195,25,17869050,17733504,135546,184.4392309621826
1747959569524914,17935644,1,196,25,17963635,17826064,137571,181.72434597407883
1747959569615280,18028204,1,197,25,18054001,17918624,135377,184.6694785672603
1747959569708411,18120764,1,198,25,18147132,18011184,135948,183.893841763027
1747959569803411,18213324,1,199,25,18242132,18103744,138388,180.6515015752811
1747959569897831,18305884,1,200,25,18336552,18196304,140248,178.25566139980603
1747959570016039,18398444,1,201,25,18454760,18288864,165896,150.69682210541546
1747959570086067,18494124,1,202,25,18524788,18384544,140244,178.2607455577422
1747959570179411,18586684,1,203,25,18618132,18477104,141028,177.26976203307146
1747959570273741,18679244,1,204,25,18712462,18569664,142798,175.07248000672277
1747959570364113,18771804,1,205,25,18802834,18662224,140610,177.79674276367254
1747959570458434,18864364,1,206,25,18897155,18754784,142371,175.59755849154675
1747959570552398,18956924,1,207,25,18991119,18847344,143775,173.88280299078423
1747959570646828,19049492,1,208,25,19085549,18939912,145637,171.6596743959296
1747959570737116,19142044,1,209,25,19175837,19032464,143373,174.3703486709492
1747959570834682,19234604,1,210,25,19273403,19125024,148379,168.48745442414358
1747959570925881,19327164,1,211,25,19364602,19217584,147018,170.0472051041369
1747959571019554,19419724,1,212,25,19458275,19310144,148131,168.76953507368478
1747959571137741,19512284,1,213,25,19576462,19402704,173758,143.87826747545438
1747959571220407,19604844,1,214,25,19659128,19495264,163864,152.5655421569106
1747959571297798,19697404,1,215,25,19736519,19587824,148695,168.12939238037595
1747959571392237,19789964,1,216,25,19830958,19680384,150574,166.03132014823274
1747959571481900,19882524,1,217,25,19920621,19772944,147677,169.28837936848663
1747959571576708,19975084,1,218,25,20015429,19865504,149925,166.75004168751042
1747959571670748,20067644,1,219,25,20109469,19958064,151405,165.1200422707308
1747959571765421,20160204,1,220,25,20204142,20050624,153518,162.84735340481248
1747959571859369,20252764,1,221,25,20298090,20143184,154906,161.38819671284523
1747959571949226,20345324,1,222,25,20387947,20235744,152203,164.25431824602668
1747959572043238,20437884,1,223,25,20481959,20328304,153655,162.7021574306075
1747959572137562,20530444,1,224,25,20576283,20420864,155419,160.85549385853724
1747959572231398,20623004,1,225,25,20670119,20513424,156695,159.54561409106864
1747959572322096,20715564,1,226,25,20760817,20605984,154833,161.46428732892858
1747959572416249,20808124,1,227,25,20854970,20698544,156426,159.8199787759068
1747959572510726,20900684,1,228,25,20949447,20791104,158343,157.88509754141324
1747959572604540,20993244,1,229,25,21043261,20883664,159597,156.64454845642464
1747959572694692,21085804,1,230,25,21133413,20976224,157189,159.0442079280357
1747959572788640,21178364,1,231,25,21227361,21068784,158577,157.6521185291688
1747959572883271,21270924,1,232,25,21321992,21161344,160648,155.6197400527862
1747959572977835,21363484,1,233,25,21416556,21253904,162652,153.70238300174606
1747959573067001,21456044,1,234,25,21505722,21346464,159258,156.97798540732646
1747959573161229,21548604,1,235,25,21599950,21439024,160926,155.35090662789108
1747959573255789,21641164,1,236,25,21694510,21531584,162926,153.44389477431474
1747959573350021,21733724,1,237,25,21788742,21624144,164598,151.88519909111898
1747959573443943,21826284,1,238,25,21882664,21716704,165960,150.63870812243914
1747959573534322,21918844,1,239,25,21973043,21809264,163779,152.6447224613656
1747959573628671,22011404,1,240,25,22067392,21901824,165568,150.9953614224971
1747959573722853,22103964,1,241,25,22161574,21994384,167190,149.53047431066452
1747959573816785,22196524,1,242,25,22255506,22086944,168562,148.31338023991174
1747959573906673,22289084,1,243,25,22345394,22179504,165890,150.70227259027064
1747959574001260,22381644,1,244,25,22439981,22272064,167917,148.88307914028954
1747959574094620,22474204,1,245,25,22533341,22364624,168717,148.17712500814974
1747959574189955,22566764,1,246,25,22628676,22457184,171492,145.77939495719917
1747959574280045,22659324,1,247,25,22718766,22549744,169022,147.90973956053057
1747959574374097,22751884,1,248,25,22812818,22642304,170514,146.6155271707895
1747959574468274,22844452,1,249,25,22906995,22734872,172123,145.24497016668312
1747959574561926,22937004,1,250,25,23000647,22827424,173223,144.32263613954268
1747959574652284,23029564,1,251,25,23091005,22919984,171021,146.18087837166195
1747959574746969,23122124,1,252,25,23185690,23012544,173146,144.3868180610583
1747959574841108,23214684,1,253,25,23279829,23105104,174725,143.0819859779654
1747959574934599,23307244,1,254,25,23373320,23197664,175656,142.32363255453842
1747959575028934,23399804,1,255,25,23467655,23290224,177431,140.89984275577547
1747959575119902,23492364,1,256,25,23558623,23382784,175839,142.17551282707478
1747959575213720,23584924,1,257,25,23652441,23475344,177097,141.16557592731667
1747959575307689,23677484,1,258,25,23746410,23567904,178506,140.05131480174336
1747959575401497,23770044,1,259,25,23840218,23660464,179754,139.07896347230104
1747959575492018,23862604,1,260,25,23930739,23753024,177715,140.6746757448724
1747959575586376,23955164,1,261,25,24025097,23845584,179513,139.2656799229025
1747959575680351,24047724,1,262,25,24119072,23938144,180928,138.17651220374955
1747959575774045,24140284,1,263,25,24212766,24030704,182062,137.31585943250101
1747959575865288,24232844,1,264,25,24304009,24123264,180745,138.31641262552216
1747959575958696,24325404,1,265,25,24397417,24215824,181593,137.67050492034383
1747959576053080,24417964,1,266,25,24491801,24308384,183417,136.30143334587308
1747959576146908,24510524,1,267,25,24585629,24400944,184685,135.3656225464981
1747959576237385,24603084,1,268,25,24676106,24493504,182602,136.90978193009934
1747959576330834,24695644,1,269,25,24769555,24586064,183491,136.2464644042487
1747959576425688,24788204,1,270,25,24864409,24678624,185785,134.56414672874558
1747959576520004,24880764,1,271,25,24958725,24771184,187541,133.30418415173216
1747959576613689,24973332,1,272,25,25052410,24863752,188658,132.5149211801249
1747959576703534,25065884,1,273,25,25142255,24956304,185951,134.4440201988696
1747959576798555,25158444,1,274,25,25237276,25048864,188412,132.68793919707875
1747959576892670,25251004,1,275,25,25331391,25141424,189967,131.60180452394363
1747959576986100,25343564,1,276,25,25424821,25233984,190837,131.0018497461184
1747959577076557,25436124,1,277,25,25515278,25326544,188734,132.461559655388
1747959577169698,25528684,1,278,25,25608419,25419104,189315,132.05504054089744
1747959577265389,25621244,1,279,25,25704110,25511664,192446,129.90657119399728
1747959577359270,25713804,1,280,25,25797991,25604224,193767,129.02093751774038
1747959577448894,25806364,1,281,25,25887615,25696784,190831,131.00596863193087
1747959577542883,25898924,1,282,25,25981604,25789344,192260,130.0322479975034
1747959577638098,25991484,1,283,25,26076819,25881904,194915,128.261036862222
1747959577731884,26084044,1,284,25,26170605,25974464,196141,127.45932772852183
1747959577821930,26176604,1,285,25,26260651,26067024,193627,129.1142247723716
1747959577915928,26269164,1,286,25,26354649,26159584,195065,128.16240740266065
1747959578010213,26361724,1,287,25,26448934,26252144,196790,127.03897555770111
1747959578104801,26454284,1,288,25,26543522,26344704,198818,125.74314196903701
1747959578198437,26546844,1,289,25,26637158,26437264,199894,125.0662851311195
1747959578288374,26639404,1,290,25,26727095,26529824,197271,126.7292202097622
1747959578383003,26731964,1,291,25,26821724,26622384,199340,125.4138657569981
1747959578477670,26824524,1,292,25,26916391,26714944,201447,124.10212115345476
1747959578571882,26917084,1,293,25,27010603,26807504,203099,123.09267893982738
1747959578661850,27009644,1,294,25,27100571,26900064,200507,124.68392624696395
1747959578756487,27102204,1,295,25,27195208,26992624,202584,123.40559965248984
1747959578850865,27194764,1,296,25,27289586,27085184,204402,122.30800090018688
1747959578944639,27287324,1,297,25,27383360,27177744,205616,121.58586880398413
1747959579034342,27379884,1,298,25,27473063,27270304,202759,123.29908906632998
1747959579128876,27472444,1,299,25,27567597,27362864,204733,122.1102606809845
1747959579223358,27565004,1,300,25,27662079,27455424,206655,120.97457114514529
1747959579317555,27657564,1,301,25,27756276,27547984,208292,120.02381272444453
1747959579407190,27750124,1,302,25,27845911,27640544,205367,121.73328723699524
1747959579501760,27842684,1,303,25,27940481,27733104,207377,120.55338827353081
1747959579595413,27935244,1,304,25,28034134,27825664,208470,119.92133160646617
1747959579689520,28027804,1,305,25,28128241,27918224,210017,119.03798263950061
1747959579784262,28120364,1,306,25,28222983,28010784,212199,117.81393880272763
1747959579874025,28212924,1,307,25,28312746,28103344,209402,119.38758942130447
1747959579968377,28305484,1,308,25,28407098,28195904,211194,118.37457503527563
1747959580062222,28398044,1,309,25,28500943,28288464,212479,117.65868627017258
1747959580156798,28490604,1,310,25,28595519,28381024,214495,116.55283339937995
1747959580246850,28583164,1,311,25,28685571,28473584,211987,117.93175996641303
1747959580341522,28675724,1,312,25,28780243,28566144,214099,116.76841087534271
1747959580435661,28768292,1,313,25,28874382,28658712,215670,115.91783743682478
1747959580529802,28860844,1,314,25,28968523,28751264,217259,115.07003162124468
1747959580619526,28953404,1,315,25,29058247,28843824,214423,116.59197007783679
1747959580714053,29045964,1,316,25,29152774,28936384,216390,115.53214104163779
1747959580808511,29138524,1,317,25,29247232,29028944,218288,114.52759656966943
1747959580901826,29231084,1,318,25,29340547,29121504,219043,114.13284149687505
1747959580992710,29323644,1,319,25,29431431,29214064,217367,115.01285843757331
1747959581086355,29416204,1,320,25,29525076,29306624,218452,114.44161646494425
1747959581180756,29508764,1,321,25,29619477,29399184,220293,113.4852219543971
1747959581275304,29601324,1,322,25,29714025,29491744,222281,112.47025161844692
1747959581369594,29693884,1,323,25,29808315,29584304,224011,111.60166241836339
1747959581460025,29786444,1,324,25,29898746,29676864,221882,112.67250159994953
1747959581553999,29879004,1,325,25,29992720,29769424,223296,111.95901404413873
1747959581647902,29971564,1,326,25,30086623,29861984,224639,111.28966920258726
1747959581741400,30064124,1,327,25,30180121,29954544,225577,110.82690167880591
1747959581832662,30156684,1,328,25,30271383,30047104,224279,111.46830510212726
1747959581926539,30249244,1,329,25,30365260,30139664,225596,110.81756768737034
1747959582021031,30341804,1,330,25,30459752,30232224,227528,109.87658661791076
1747959582114734,30434364,1,331,25,30553455,30324784,228671,109.32737426258686
1747959582205036,30526924,1,332,25,30643757,30417344,226413,110.41768803028094
1747959582298417,30619484,1,333,25,30737138,30509904,227234,110.01874719452195
1747959582393307,30712044,1,334,25,30832028,30602464,229564,108.9020926626126
1747959582487664,30804604,1,335,25,30926385,30695024,231361,108.05624111237417
1747959582577860,30897172,1,336,25,31016581,30787592,228989,109.17554991724494
1747959582671423,30989724,1,337,25,31110144,30880144,230000,108.69565217391303
1747959582765828,31082284,1,338,25,31204549,30972704,231845,107.83066272725313
1747959582859723,31174844,1,339,25,31298444,31065264,233180,107.21331160476885
1747959582954928,31267404,1,340,25,31393649,31157824,235825,106.0108131029365
1747959583044391,31359964,1,341,25,31483112,31250384,232728,107.42153930768967
1747959583138661,31452524,1,342,25,31577382,31342944,234438,106.63800237162917
1747959583232539,31545084,1,343,25,31671260,31435504,235756,106.04183986833846
1747959583327532,31637644,1,344,25,31766253,31528064,238189,104.95866727682638
1747959583417698,31730204,1,345,25,31856419,31620624,235795,106.02430076973643
1747959583511692,31822764,1,346,25,31950413,31713184,237229,105.38340590737221
1747959583605044,31915324,1,347,25,32043765,31805744,238021,105.03274921120405
1747959583699894,32007884,1,348,25,32138615,31898304,240311,104.03185871641331
1747959583789991,32100444,1,349,25,32228712,31990864,237848,105.10914533651744
1747959583884386,32193004,1,350,25,32323107,32083424,239683,104.30443544181273
1747959583978194,32285564,1,351,25,32416915,32175984,240931,103.76414824161274
1747959584072528,32378124,1,352,25,32511249,32268544,242705,103.00570651614099
1747959584162082,32470684,1,353,25,32600803,32361104,239699,104.2974730808222
1747959584257367,32563244,1,354,25,32696088,32453664,242424,103.12510312510312
1747959584350993,32655804,1,355,25,32789714,32546224,243490,102.67362109326871
1747959584445274,32748364,1,356,25,32883995,32638784,245211,101.95301189587742
1747959584539302,32840924,1,357,25,32978023,32731344,246679,101.34628403714949
1747959584629010,32933484,1,358,25,33067731,32823904,243827,102.5317130588491
1747959584723855,33026044,1,359,25,33162576,32916464,246112,101.57976856065531
1747959584817902,33118604,1,360,25,33256623,33009024,247599,100.96971312485107
1747959584912553,33211164,1,361,25,33351274,33101584,249690,100.12415395089911
1747959585001987,33303724,1,362,25,33440708,33194144,246564,101.39355299232653
1747959585096789,33396284,1,363,25,33535510,33286704,248806,100.47989196402015
1747959585191205,33488844,1,364,25,33629926,33379264,250662,99.73589933855152
1747959585284888,33581404,1,365,25,33723609,33471824,251785,99.29106181861509
1747959585375589,33673964,1,366,25,33814310,33564384,249926,100.0296087641942
1747959585468806,33766524,1,367,25,33907527,33656944,250583,99.76734255715671
1747959585563773,33859084,1,368,25,34002494,33749504,252990,98.81813510415432
1747959585657415,33951644,1,369,25,34096136,33842064,254072,98.39730470102963
1747959585748223,34044204,1,370,25,34186944,33934624,252320,99.08053265694357
1747959585842099,34136764,1,371,25,34280820,34027184,253636,98.56644955763379
1747959585936019,34229324,1,372,25,34374740,34119744,254996,98.04075358044832
1747959586030056,34321884,1,373,25,34468777,34212304,256473,97.47614758668554
1747959586123703,34414444,1,374,25,34562424,34304864,257560,97.06476160894549
1747959586214561,34507004,1,375,25,34653282,34397424,255858,97.7104487645491
1747959586308546,34599564,1,376,25,34747267,34489984,257283,97.16926497281204
1747959586402981,34692132,1,377,25,34841702,34582552,259150,96.46922631680495
1747959586496687,34784684,1,378,25,34935408,34675104,260304,96.04155141680498
1747959586587272,34877244,1,379,25,35025993,34767664,258329,96.77581688467033
1747959586681492,34969804,1,380,25,35120213,34860224,259989,96.1579143733004
1747959586775757,35062364,1,381,25,35214478,34952784,261694,95.53142219538852
1747959586869877,35154924,1,382,25,35308598,35045344,263254,94.96531866562331
1747959586959632,35247484,1,383,25,35398353,35137904,260449,95.98808211972403
1747959587053962,35340044,1,384,25,35492683,35230464,262219,95.34015460359471
1747959587148302,35432604,1,385,25,35587023,35323024,263999,94.69732839897121
1747959587242205,35525164,1,386,25,35680926,35415584,265342,94.21802805436002
1747959587332369,35617724,1,387,25,35771090,35508144,262946,95.07655564260342
1747959587426999,35710284,1,388,25,35865720,35600704,265016,94.33392700818065
1747959587521238,35802844,1,389,25,35959959,35693264,266695,93.74004012073716
1747959587615467,35895404,1,390,25,36054188,35785824,268364,93.15705534274345
1747959587709321,35987964,1,391,25,36148042,35878384,269658,92.7100252912949
1747959587799600,36080524,1,392,25,36238321,35970944,267377,93.50093687938754
1747959587893666,36173084,1,393,25,36332387,36063504,268883,92.97724289003024
1747959587987987,36265644,1,394,25,36426708,36156064,270644,92.37226762832356
1747959588081537,36358204,1,395,25,36520258,36248624,271634,92.03560673553385
1747959588172855,36450764,1,396,25,36611576,36341184,270392,92.45835675611704
1747959588266661,36543324,1,397,25,36705382,36433744,271638,92.03425146702597
1747959588361243,36635884,1,398,25,36799964,36526304,273660,91.35423518234305
1747959588455098,36728444,1,399,25,36893819,36618864,274955,90.92396937680711
1747959588544854,36821012,1,400,25,36983575,36711432,272143,91.8634688380741
1747959588639990,36913564,1,401,25,37078711,36803984,274727,90.99942852358888
1747959588733011,37006124,1,402,25,37171732,36896544,275188,90.84698460688693
1747959588827702,37098684,1,403,25,37266423,36989104,277319,90.14888990656969
1747959588917354,37191244,1,404,25,37356075,37081664,274411,91.10421958303421
1747959589011372,37283804,1,405,25,37450093,37174224,275869,90.62272310408201
1747959589106608,37376364,1,406,25,37545329,37266784,278545,89.7521046868549
1747959589200207,37468924,1,407,25,37638928,37359344,279584,89.41856472473388
1747959589294664,37561484,1,408,25,37733385,37451904,281481,88.81594139568924
1747959589384803,37654044,1,409,25,37823524,37544464,279060,89.58646885974343
1747959589478783,37746604,1,410,25,37917504,37637024,280480,89.13291500285226
1747959589573480,37839164,1,411,25,38012201,37729584,282617,88.4589391296348
1747959589666934,37931724,1,412,25,38105655,37822144,283511,88.180000070544
1747959589756935,38024284,1,413,25,38195656,37914704,280952,88.98317150260543
1747959589851487,38116844,1,414,25,38290208,38007264,282944,88.35670662745986
1747959589946309,38209404,1,415,25,38385030,38099824,285206,87.65593991711253
1747959590039685,38301964,1,416,25,38478406,38192384,286022,87.40586388459629
1747959590129845,38394524,1,417,25,38568566,38284944,283622,88.14548941901545
1747959590223571,38487084,1,418,25,38662292,38377504,284788,87.78459766563198
1747959590318434,38579644,1,419,25,38757155,38470064,287091,87.08040307776977
1747959590412249,38672204,1,420,25,38850970,38562624,288346,86.70139346479577
1747959590502995,38764764,1,421,25,38941716,38655184,286532,87.2502896709617
1747959590597148,38857324,1,422,25,39035869,38747744,288125,86.76789587852494
1747959590690760,38949884,1,423,25,39129481,38840304,289177,86.45224205244538
1747959590785673,39042444,1,424,25,39224394,38932864,291530,85.75446780777278
1747959590879559,39135004,1,425,25,39318280,39025424,292856,85.36618679487529
1747959590969896,39227564,1,426,25,39408617,39117984,290633,86.0191375377194
1747959591063287,39320124,1,427,25,39502008,39210544,291464,85.77388631186012
1747959591157484,39412684,1,428,25,39596205,39303104,293101,85.29483010975738
1747959591251908,39505244,1,429,25,39690629,39395664,294965,84.75581848693913
1747959591341725,39597804,1,430,25,39780446,39488224,292222,85.5513958565748
1747959591435679,39690364,1,431,25,39874400,39580784,293616,85.14522369353169
1747959591529931,39782924,1,432,25,39968652,39673344,295308,84.65737467322253
1747959591624815,39875484,1,433,25,40063536,39765904,297632,83.99634447908826
1747959591714234,39968044,1,434,25,40152955,39858464,294491,84.89223779334513
1747959591808998,40060604,1,435,25,40247719,39951024,296695,84.26161546369167
1747959591902995,40153164,1,436,25,40341716,40043584,298132,83.8554734144607
1747959591997089,40245724,1,437,25,40435810,40136144,299666,83.42621451883097
1747959592087340,40338284,1,438,25,40526061,40228704,297357,84.07402549797045
1747959592181943,40430844,1,439,25,40620664,40321264,299400,83.500334001336
1747959592275983,40523404,1,440,25,40714704,40413824,300880,83.08960382876894
1747959592370540,40615972,1,441,25,40809261,40506392,302869,82.543938138271
1747959592463737,40708524,1,442,25,40902458,40598944,303514,82.36852336300797
1747959592554560,40801084,1,443,25,40993281,40691504,301777,82.84262882857209
1747959592648828,40893644,1,444,25,41087549,40784064,303485,82.37639422047218
1747959592742644,40986204,1,445,25,41181365,40876624,304741,82.03687721704661
1747959592837183,41078764,1,446,25,41275904,40969184,306720,81.5075639019301
1747959592926602,41171324,1,447,25,41365323,41061744,303579,82.35088724845922
1747959593020676,41263884,1,448,25,41459397,41154304,305093,81.94222745195727
1747959593115669,41356444,1,449,25,41554390,41246864,307526,81.29393937423177
1747959593209438,41449004,1,450,25,41648159,41339424,308735,80.97559395598167
1747959593299373,41541564,1,451,25,41738094,41431984,306110,81.66998791284179
1747959593393666,41634124,1,452,25,41832387,41524544,307843,81.21022729118415
1747959593488296,41726684,1,453,25,41927017,41617104,309913,80.66780031815381
1747959593582176,41819244,1,454,25,42020897,41709664,311233,80.32567240620372
1747959593672744,41911804,1,455,25,42111465,41802224,309241,80.8430964846188
1747959593766843,42004364,1,456,25,42205564,41894784,310780,80.44275693416564
1747959593861381,42096924,1,457,25,42300102,41987344,312758,79.93400648424661
1747959593955258,42189484,1,458,25,42393979,42079904,314075,79.59882193743533
1747959594049660,42282044,1,459,25,42488381,42172464,315917,79.1347094331739
1747959594140143,42374604,1,460,25,42578864,42265024,313840,79.65842467499363
1747959594233769,42467164,1,461,25,42672490,42357584,314906,79.3887699821534
1747959594328096,42559724,1,462,25,42766817,42450144,316673,78.94578950526252
1747959594422391,42652284,1,463,25,42861112,42542704,318408,78.5156151855481
1747959594512828,42744852,1,464,25,42951549,42635272,316277,79.04463492444914
1747959594606197,42837404,1,465,25,43044918,42727824,317094,78.84097460059162
1747959594700786,42929964,1,466,25,43139507,42820384,319123,78.33969973959884
1747959594795053,43022524,1,467,25,43233774,42912944,320830,77.92288751051959
1747959594884966,43115084,1,468,25,43323687,43005504,318183,78.57113673577784
1747959594979379,43207644,1,469,25,43418100,43098064,320036,78.11621192615831
1747959595073593,43300204,1,470,25,43512314,43190624,321690,77.71456992757003
1747959595167165,43392764,1,471,25,43605886,43283184,322702,77.47085546417438
1747959595257664,43485324,1,472,25,43696385,43375744,320641,77.96881871002148
1747959595352179,43577884,1,473,25,43790900,43468304,322596,77.49631117558805
1747959595446326,43670444,1,474,25,43885047,43560864,324183,77.11693703864792
1747959595540859,43763004,1,475,25,43979580,43653424,326156,76.65043721409387
1747959595634024,43855564,1,476,25,44072745,43745984,326761,76.50851845844515
1747959595724583,43948124,1,477,25,44163304,43838544,324760,76.97992363591575
1747959595818745,44040684,1,478,25,44257466,43931104,326362,76.60205538635013
1747959595913198,44133244,1,479,25,44351919,44023664,328255,76.16030220407914
1747959596007278,44225804,1,480,25,44445999,44116224,329775,75.80926389204761
1747959596097526,44318364,1,481,25,44536247,44208784,327463,76.34450304309189
1747959596191742,44410924,1,482,25,44630463,44301344,329119,75.96036691895637
1747959596285224,44503484,1,483,25,44723945,44393904,330041,75.74816462197121
1747959596380436,44596044,1,484,25,44819157,44486464,332693,75.14435230076978
1747959596469591,44688604,1,485,25,44908312,44579024,329288,75.92138189062462
1747959596564172,44781164,1,486,25,45002893,44671584,331309,75.4582580008391
1747959596658628,44873724,1,487,25,45097349,44764144,333205,75.02888612115665
1747959596752413,44966284,1,488,25,45191134,44856704,334430,74.75405914541159
1747959596842541,45058844,1,489,25,45281262,44949264,331998,75.30165844372556
1747959596937299,45151404,1,490,25,45376020,45041824,334196,74.8064010341237
1747959597031261,45243964,1,491,25,45469982,45134384,335598,74.4938885213857
1747959597125513,45336524,1,492,25,45564234,45226944,337290,74.12019330546414
1747959597219864,45429084,1,493,25,45658585,45319504,339081,73.72869609326385
1747959597308953,45521644,1,494,25,45747674,45412064,335610,74.49122493370281
1747959597404080,45614204,1,495,25,45842801,45504624,338177,73.92578442649855
1747959597498284,45706764,1,496,25,45937005,45597184,339821,73.56814322834668
1747959597591620,45799324,1,497,25,46030341,45689744,340597,73.40052907101355
1747959597681794,45891884,1,498,25,46120515,45782304,338211,73.91835274429276
1747959597776239,45984444,1,499,25,46214960,45874864,340096,73.50865637937524
1747959597870662,46077004,1,500,25,46309383,45967424,341959,73.10817963557034
1747959597965143,46169564,1,501,25,46403864,46059984,343880,72.69977899267185
1747959598055163,46262124,1,502,25,46493884,46152544,341340,73.24075701646453
1747959598148928,46354684,1,503,25,46587649,46245104,342545,72.98311170795078
1747959598243495,46447244,1,504,25,46682216,46337664,344552,72.55798834428475
1747959598337159,46539812,1,505,25,46775880,46430232,345648,72.327917418877
1747959598427899,46632364,1,506,25,46866620,46522784,343836,72.70908223688038
1747959598521576,46724924,1,507,25,46960297,46615344,344953,72.47364133664585
1747959598615886,46817484,1,508,25,47054607,46707904,346703,72.10782716042262
1747959598710291,46910044,1,509,25,47149012,46800464,348548,71.72613241217852
1747959598803870,47002604,1,510,25,47242591,46893024,349567,71.51704823395801
1747959598894197,47095164,1,511,25,47332918,46985584,347334,71.97682921913778
1747959598988294,47187724,1,512,25,47427015,47078144,348871,71.6597252279496
1747959599083056,47280284,1,513,25,47521777,47170704,351073,71.21026111378545
1747959599177459,47372844,1,514,25,47616180,47263264,352916,70.8383864715683
1747959599266348,47465404,1,515,25,47705069,47355824,349245,71.58298615585048
1747959599361146,47557964,1,516,25,47799867,47448384,351483,71.1271953408842
1747959599455470,47650524,1,517,25,47894191,47540944,353247,70.77200938719933
1747959599549429,47743084,1,518,25,47988150,47633504,354646,70.49282946938636
1747959599640316,47835644,1,519,25,48079037,47726064,352973,70.82694710360283
1747959599734434,47928204,1,520,25,48173155,47818624,354531,70.51569538347846
1747959599828536,48020764,1,521,25,48267257,47911184,356073,70.21032204070514
1747959599923398,48113324,1,522,25,48362119,48003744,358375,69.75933031042902
1747959600012894,48205884,1,523,25,48451615,48096304,355311,70.36089510316314
1747959600107243,48298444,1,524,25,48545964,48188864,357100,70.00840100812098
1747959600200874,48391004,1,525,25,48639595,48281424,358171,69.79906245899305
1747959600294865,48483564,1,526,25,48733586,48373984,359602,69.521304108431
1747959600389692,48576124,1,527,25,48828413,48466544,361869,69.08577413373348
1747959600480124,48668692,1,528,25,48918845,48559112,359733,69.49598730169319
1747959600573608,48761244,1,529,25,49012329,48651664,360665,69.3164016469577
1747959600668823,48853804,1,530,25,49107544,48744224,363320,68.8098645821865
1747959600762455,48946364,1,531,25,49201176,48836784,364392,68.60743375266198
1747959600852692,49038924,1,532,25,49291413,48929344,362069,69.04761247165597
1747959600947277,49131484,1,533,25,49385998,49021904,364094,68.66358687591666
1747959601041002,49224044,1,534,25,49479723,49114464,365259,68.44458315879965
1747959601134240,49316604,1,535,25,49572961,49207024,365937,68.31777054520313
1747959601224831,49409164,1,536,25,49663552,49299584,363968,68.68735713029717
1747959601319633,49501724,1,537,25,49758354,49392144,366210,68.26684142978073
1747959601413082,49594284,1,538,25,49851803,49484704,367099,68.10152029833914
1747959601507675,49686844,1,539,25,49946396,49577264,369132,67.7264501587508
1747959601597328,49779404,1,540,25,50036049,49669824,366225,68.26404532732609
1747959601692286,49871964,1,541,25,50131007,49762384,368623,67.81996782620726
1747959601785814,49964524,1,542,25,50224535,49854944,369591,67.64233977558978
1747959601880159,50057084,1,543,25,50318880,49947504,371376,67.31722028348628
1747959601974382,50149644,1,544,25,50413103,50040064,373039,67.01712153420956
1747959602064348,50242204,1,545,25,50503069,50132624,370445,67.48640149009974
1747959602158470,50334764,1,546,25,50597191,50225184,372007,67.20303650200131
1747959602253171,50427324,1,547,25,50691892,50317744,374148,66.81847824924897
1747959602346810,50519884,1,548,25,50785531,50410304,375227,66.6263355248956
1747959602436903,50612444,1,549,25,50875624,50502864,372760,67.06728189719928
1747959602531721,50705004,1,550,25,50970442,50595424,375018,66.66346682025929
1747959602625524,50797564,1,551,25,51064245,50687984,376261,66.44324019762877
1747959602719541,50890124,1,552,25,51158262,50780544,377718,66.18694369873822
1747959602809847,50982684,1,553,25,51248568,50873104,375464,66.58427971789573
1747959602904523,51075244,1,554,25,51343244,50965664,377580,66.21113406430425
1747959602998701,51167804,1,555,25,51437422,51058224,379198,65.92861776697134
1747959603092590,51260364,1,556,25,51531311,51150784,380527,65.69836043171706
1747959603182380,51352924,1,557,25,51621101,51243344,377757,66.18011049431247
1747959603276597,51445484,1,558,25,51715318,51335904,379414,65.89108467267945
1747959603370891,51538044,1,559,25,51809612,51428464,381148,65.59131885776654
1747959603464875,51630604,1,560,25,51903596,51521024,382572,65.34717647919868
1747959603560029,51723164,1,561,25,51998750,51613584,385166,64.90707902566686
1747959603649453,51815724,1,562,25,52088174,51706144,382030,65.4398869198754
1747959603743645,51908284,1,563,25,52182366,51798704,383662,65.1615223816797
1747959603837795,52000844,1,564,25,52276516,51891264,385252,64.89258978538723
1747959603932167,52093404,1,565,25,52370888,51983824,387064,64.58880185189012
1747959604022562,52185964,1,566,25,52461283,52076384,384899,64.9521043182757
1747959604117078,52278524,1,567,25,52555799,52168944,386855,64.62369621692882
1747959604211253,52371084,1,568,25,52649974,52261504,388470,64.3550338507478
1747959604305798,52463652,1,569,25,52744519,52354072,390447,64.0291768152912
1747959604395631,52556204,1,570,25,52834352,52446624,387728,64.4781908967111
1747959604488908,52648764,1,571,25,52927629,52539184,388445,64.35917568767779
1747959604583466,52741324,1,572,25,53022187,52631744,390443,64.02983277968872
1747959604678480,52833884,1,573,25,53117201,52724304,392897,63.629908092960754
1747959604768100,52926444,1,574,25,53206821,52816864,389957,64.1096326005175
1747959604862817,53019004,1,575,25,53301538,52909424,392114,63.756968636671985
1747959604956576,53111564,1,576,25,53395297,53001984,393313,63.5626078975269
1747959605050284,53204124,1,577,25,53489005,53094544,394461,63.37762161531812
1747959605145048,53296684,1,578,25,53583769,53187104,396665,63.02547489695335
1747959605235104,53389244,1,579,25,53673825,53279664,394161,63.42585897640812
1747959605329193,53481804,1,580,25,53767914,53372224,395690,63.180772827213225
1747959605423798,53574364,1,581,25,53862519,53464784,397735,62.855921656379245
1747959605517787,53666924,1,582,25,53956508,53557344,399164,62.630898578028074
1747959605607713,53759484,1,583,25,54046434,53649904,396530,63.04693213628225
1747959605701817,53852044,1,584,25,54140538,53742464,398074,62.80239352482202
1747959605796642,53944604,1,585,25,54235363,53835024,400339,62.44707610300271
1747959605890339,54037164,1,586,25,54329060,53927584,401476,62.27022287758172
1747959605980476,54129724,1,587,25,54419197,54020144,399053,62.64831989735699
1747959606074507,54222284,1,588,25,54513228,54112704,400524,62.418232115928134
1747959606168397,54314844,1,589,25,54607118,54205264,401854,62.211649006853236
1747959606262290,54407404,1,590,25,54701011,54297824,403187,62.0059674543078
1747959606352675,54499964,1,591,25,54791396,54390384,401012,62.34227404666195
1747959606446566,54592532,1,592,25,54885287,54482952,402335,62.137273664980675
1747959606541222,54685084,1,593,25,54979943,54575504,404439,61.81401892498003
1747959606634804,54777644,1,594,25,55073525,54668064,405461,61.65821127062775
1747959606729662,54870204,1,595,25,55168383,54760624,407759,61.31072520778205
1747959606819646,54962764,1,596,25,55258367,54853184,405183,61.7005155695081
1747959606914252,55055324,1,597,25,55352973,54945744,407229,61.39051983036571
1747959607008413,55147884,1,598,25,55447134,55038304,408830,61.15011129320255
1747959607102414,55240444,1,599,25,55541135,55130864,410271,60.93533298722064
1747959607191959,55333004,1,600,25,55630680,55223424,407256,61.38644980061681
1747959607286750,55425564,1,601,25,55725471,55315984,409487,61.05199920876609
1747959607380288,55518124,1,602,25,55819009,55408544,410465,60.90653283471185
1747959607474487,55610684,1,603,25,55913208,55501104,412104,60.664298332459765
1747959607565802,55703244,1,604,25,56004523,55593664,410859,60.84812551264546
1747959607658704,55795804,1,605,25,56097425,55686224,411201,60.797517515764795
1747959607753872,55888364,1,606,25,56192593,55778784,413809,60.41434574888415
1747959607848062,55980924,1,607,25,56286783,55871344,415439,60.17730641562299
1747959607937620,56073484,1,608,25,56376341,55963904,412437,60.61531821829758
1747959608032402,56166044,1,609,25,56471123,56056464,414659,60.29050376333325
1747959608126524,56258604,1,610,25,56565245,56149024,416221,60.064244716148394
1747959608220739,56351164,1,611,25,56659460,56241584,417876,59.8263599728149
1747959608314841,56443724,1,612,25,56753562,56334144,419418,59.606406973472765
1747959608404221,56536284,1,613,25,56842942,56426704,416238,60.06179157116842
1747959608499093,56628844,1,614,25,56937814,56519264,418550,59.73002030820691
1747959608592661,56721404,1,615,25,57031382,56611824,419558,59.58651723957117
1747959608686763,56813964,1,616,25,57125484,56704384,421100,59.368321063880316
1747959608777371,56906524,1,617,25,57216092,56796944,419148,59.6448032675809
1747959608871175,56999084,1,618,25,57309896,56889504,420392,59.46830577175589
1747959608965521,57091644,1,619,25,57404242,56982064,422178,59.21672848893121
1747959609060273,57184204,1,620,25,57498994,57074624,424370,58.910856092560735
1747959609150339,57276764,1,621,25,57589060,57167184,421876,59.2591187931999
1747959609243729,57369324,1,622,25,57682450,57259744,422706,59.142761162604735
1747959609338548,57461884,1,623,25,57777269,57352304,424965,58.82837410139659
1747959609432536,57554444,1,624,25,57871257,57444864,426393,58.63135651851695
1747959609522754,57647004,1,625,25,57961475,57537424,424051,58.955172844775745
1747959609616896,57739564,1,626,25,58055617,57629984,425633,58.73604725197529
1747959609710859,57832124,1,627,25,58149580,57722544,427036,58.543073651870095
1747959609805632,57924684,1,628,25,58244353,57815104,429249,58.2412539109002
1747959609899495,58017244,1,629,25,58338216,57907664,430552,58.06499563351233
1747959609989577,58109804,1,630,25,58428298,58000224,428074,58.4011175637857
1747959610084177,58202364,1,631,25,58522898,58092784,430114,58.12412523191526
1747959610177693,58294924,1,632,25,58616414,58185344,431070,57.99522119377363
1747959610272115,58387492,1,633,25,58710836,58277912,432924,57.74685626114515
1747959610362378,58480044,1,634,25,58801099,58370464,430635,58.05380426579354
1747959610456926,58572604,1,635,25,58895647,58463024,432623,57.7870339764645
1747959610551094,58665164,1,636,25,58989815,58555584,434231,57.57304291955204
1747959610645049,58757724,1,637,25,59083770,58648144,435626,57.388677443495105
1747959610735166,58850284,1,638,25,59173887,58740704,433183,57.71232943121037
1747959610829230,58942844,1,639,25,59267951,58833264,434687,57.51264703108214
1747959610923477,59035404,1,640,25,59362198,58925824,436374,57.29030602189865
1747959611017316,59127964,1,641,25,59456037,59018384,437653,57.12288045552069
1747959611107499,59220524,1,642,25,59546220,59110944,435276,57.4348229629017
1747959611202426,59313084,1,643,25,59641147,59203504,437643,57.12418569473292
1747959611295870,59405644,1,644,25,59734591,59296064,438527,57.00903251111106
1747959611390177,59498204,1,645,25,59828898,59388624,440274,56.78282160654501
1747959611484782,59590764,1,646,25,59923503,59481184,442319,56.52029417682713
1747959611574336,59683324,1,647,25,60013057,59573744,439313,56.907034392335305
1747959611669357,59775884,1,648,25,60108078,59666304,441774,56.5900211420319
1747959611762861,59868444,1,649,25,60201582,59758864,442718,56.46935521031447
1747959611856823,59961004,1,650,25,60295544,59851424,444120,56.29109249752319
1747959611947772,60053564,1,651,25,60386493,59943984,442509,56.49602606952627
1747959612041463,60146124,1,652,25,60480184,60036544,443640,56.35199711477775
1747959612135417,60238684,1,653,25,60574138,60129104,445034,56.175483221506674
1747959612229923,60331244,1,654,25,60668644,60221664,446980,55.93091413486062
1747959612319793,60423804,1,655,25,60758514,60314224,444290,56.26955366990029
1747959612414682,60516372,1,656,25,60853403,60406792,446611,55.977125507432646
1747959612508448,60608924,1,657,25,60947169,60499344,447825,55.82537821693742
1747959612602224,60701484,1,658,25,61040945,60591904,449041,55.67420346917096
1747959612692409,60794044,1,659,25,61131130,60684464,446666,55.97023279139223
1747959612786685,60886604,1,660,25,61225406,60777024,448382,55.756029457025484
1747959612880993,60979164,1,661,25,61319714,60869584,450130,55.539510807988805
1747959612975012,61071724,1,662,25,61413733,60962144,451589,55.360072986720226
1747959613069908,61164284,1,663,25,61508629,61054704,453925,55.075177617447814
1747959613159253,61256844,1,664,25,61597974,61147264,450710,55.46803931574627
1747959613253719,61349404,1,665,25,61692440,61239824,452616,55.23445923255033
1747959613348585,61441964,1,666,25,61787306,61332384,454922,54.95447571231991
1747959613442181,61534524,1,667,25,61880902,61424944,455958,54.82961149930476
1747959613532211,61627084,1,668,25,61970932,61517504,453428,55.13554522437961
1747959613626943,61719644,1,669,25,62065664,61610064,455600,54.87269534679543
1747959613720698,61812204,1,670,25,62159419,61702624,456795,54.7291454591228
1747959613814522,61904764,1,671,25,62253243,61795184,458059,54.57812203231462
1747959613905418,61997324,1,672,25,62344139,61887744,456395,54.77711193155052
1747959614003399,62089884,1,673,25,62442120,61980304,461816,54.13411401943631
1747959614093250,62182444,1,674,25,62531971,62072864,459107,54.45353697504068
1747959614187810,62275004,1,675,25,62626531,62165424,461107,54.21735085348954
1747959614278157,62367564,1,676,25,62716878,62257984,458894,54.47881210039791
1747959614371842,62460124,1,677,25,62810563,62350544,460019,54.34558137816047
1747959614466362,62552684,1,678,25,62905083,62443104,461979,54.11501388591257
1747959614560016,62645244,1,679,25,62998737,62535664,463073,53.98716832983136
1747959614654709,62737804,1,680,25,63093430,62628224,465206,53.7396336246738
1747959614744772,62830364,1,681,25,63183493,62720784,462709,54.029638498494734
1747959614839476,62922924,1,682,25,63278197,62813344,464853,53.780442419431516
1747959614933306,63015484,1,683,25,63372027,62905904,466123,53.63391207900061
1747959615027294,63108044,1,684,25,63466015,62998464,467551,53.47010272676136
1747959615118084,63200604,1,685,25,63556805,63091024,465781,53.67329281357548
1747959615211517,63293164,1,686,25,63650238,63183584,466654,53.57288269253022
1747959615305972,63385724,1,687,25,63744693,63276144,468549,53.356212477243574
1747959615400045,63478284,1,688,25,63838766,63368704,470062,53.18447353753335
1747959615490665,63570844,1,689,25,63929386,63461264,468122,53.40488163342035
1747959615585000,63663404,1,690,25,64023721,63553824,469897,53.20314877515711
1747959615679105,63755964,1,691,25,64117826,63646384,471442,53.02879251318296
1747959615773467,63848524,1,692,25,64212188,63738944,473244,52.826871550405286
1747959615863042,63941084,1,693,25,64301763,63831504,470259,53.16219359969719
1747959615957558,64033644,1,694,25,64396279,63924064,472215,52.94198617155321
1747959616051205,64126204,1,695,25,64489926,64016624,473302,52.82039797000647
1747959616146092,64218764,1,696,25,64584813,64109184,475629,52.561975825696074
1747959616239466,64311332,1,697,25,64678187,64201752,476435,52.47305508621323
1747959616329522,64403884,1,698,25,64768243,64294304,473939,52.749404459223655
1747959616424546,64496444,1,699,25,64863267,64386864,476403,52.47657970247878
1747959616518669,64589004,1,700,25,64957390,64479424,477966,52.304975667725316
1747959616612564,64681564,1,701,25,65051285,64571984,479301,52.15929029983247
1747959616702342,64774124,1,702,25,65141063,64664544,476519,52.463805220778184
1747959616797206,64866684,1,703,25,65235927,64757104,478823,52.21135993885006
1747959616891485,64959244,1,704,25,65330206,64849664,480542,52.02458890169849
1747959616985622,65051804,1,705,25,65424343,64942224,482119,51.85441768526027
1747959617075102,65144364,1,706,25,65513823,65034784,479039,52.18781769334021
1747959617169515,65236924,1,707,25,65608236,65127344,480892,51.98672466998827
1747959617263536,65329484,1,708,25,65702257,65219904,482353,51.82926197204122
1747959617358373,65422044,1,709,25,65797094,65312464,484630,51.585745826713165
1747959617448307,65514604,1,710,25,65887028,65405024,482004,51.866789487224175
1747959617542703,65607164,1,711,25,65981424,65497584,483840,51.669973544973544
1747959617636869,65699724,1,712,25,66075590,65590144,485446,51.49903387812445
1747959617730043,65792284,1,713,25,66168764,65682704,486060,51.433979344113894
1747959617833294,65884844,1,714,25,66272015,65775264,496751,50.32702500850527
1747959617927116,65977404,1,715,25,66365837,65867824,498013,50.19949278432491
1747959618009587,66069964,1,716,25,66448308,65960384,487924,51.2374878054779
1747959618103595,66162524,1,717,25,66542316,66052944,489372,51.08588149710241
1747959618197962,66255084,1,718,25,66636683,66145504,491179,50.897941483654634
1747959618287420,66347644,1,719,25,66726141,66238064,488077,51.22142612743481
1747959618382153,66440212,1,720,25,66820874,66330632,490242,50.99522276753114
1747959618476223,66532764,1,721,25,66914944,66423184,491760,50.83780706035465
1747959618571307,66625324,1,722,25,67010028,66515744,494284,50.578210097838486
1747959618660521,66717884,1,723,25,67099242,66608304,490938,50.922927131328194
1747959618753916,66810444,1,724,25,67192637,66700864,491773,50.83646316491552
1747959618849231,66903004,1,725,25,67287952,66793424,494528,50.553254820758376
1747959618942831,66995564,1,726,25,67381552,66885984,495568,50.447163658670455
1747959619033180,67088124,1,727,25,67471901,66978544,493357,50.67324472947582
1747959619127755,67180684,1,728,25,67566476,67071104,495372,50.46712369693887
1747959619221946,67273244,1,729,25,67660667,67163664,497003,50.301507234362774
1747959619314923,67365804,1,730,25,67753644,67256224,497420,50.259338185034785
1747959619409945,67458364,1,731,25,67848666,67348784,499882,50.01180278545737
1747959619499809,67550924,1,732,25,67938530,67441344,497186,50.2829926828189
1747959619594676,67643484,1,733,25,68033397,67533904,499493,50.05075146198245
1747959619688764,67736044,1,734,25,68127485,67626464,501021,49.89810806333467
1747959619781908,67828604,1,735,25,68220629,67719024,501605,49.84001355648369
1747959619873254,67921164,1,736,25,68311975,67811584,500391,49.96093055230809
1747959619967088,68013724,1,737,25,68405809,67904144,501665,49.83405260482593
1747959620061052,68106284,1,738,25,68499773,67996704,503069,49.69497226026648
1747959620155558,68198844,1,739,25,68594279,68089264,505015,49.503480094650655
1747959620245309,68291404,1,740,25,68684030,68181824,502206,49.780369011919404
1747959620339171,68383964,1,741,25,68777892,68274384,503508,49.651644065238294
1747959620433547,68476524,1,742,25,68872268,68366944,505324,49.473209267717344
1747959620528386,68569084,1,743,25,68967107,68459504,507603,49.251087956532956
1747959620618492,68661644,1,744,25,69057213,68552064,505149,49.49034839225654
1747959620711883,68754204,1,745,25,69150604,68644624,505980,49.40906755207716
1747959620805971,68846764,1,746,25,69244692,68737184,507508,49.26030722668411
1747959620901329,68939324,1,747,25,69340050,68829744,510306,48.99021371490831
1747959620994455,69031884,1,748,25,69433176,68922304,510872,48.93593698617266
1747959621085241,69124444,1,749,25,69523962,69014864,509098,49.10645887432282
1747959621179424,69217004,1,750,25,69618145,69107424,510721,48.950405407257584
1747959621273211,69309564,1,751,25,69711932,69199984,511948,48.83308461015572
1747959621367574,69402124,1,752,25,69806295,69292544,513751,48.66170576796931
1747959621457906,69494684,1,753,25,69896627,69385104,511523,48.873657684991684
1747959621551591,69587244,1,754,25,69990312,69477664,512648,48.76640501864827
1747959621646394,69679804,1,755,25,70085115,69570224,514891,48.55396579081786
1747959621740601,69772364,1,756,25,70179322,69662784,516538,48.39914972373765
1747959621830125,69864924,1,757,25,70268846,69755344,513502,48.6853021020366
1747959621924658,69957484,1,758,25,70363379,69847904,515475,48.49895727241864
1747959622018377,70050044,1,759,25,70457098,69940464,516634,48.39015628084872
1747959622113107,70142604,1,760,25,70551828,70033024,518804,48.187754913223486
1747959622203329,70235172,1,761,25,70642050,70125592,516458,48.40664681348726
1747959622297144,70327724,1,762,25,70735865,70218144,517721,48.288556964079106
1747959622391851,70420284,1,763,25,70830572,70310704,519868,48.08913031769603
1747959622485388,70512844,1,764,25,70924109,70403264,520845,47.99892482408394
1747959622580008,70605404,1,765,25,71018729,70495824,522905,47.80983161377306
1747959622670515,70697964,1,766,25,71109236,70588384,520852,47.99827974165406
1747959622764649,70790524,1,767,25,71203370,70680944,522426,47.85366731364825
1747959622858262,70883084,1,768,25,71296983,70773504,523479,47.75740765150082
1747959622952466,70975644,1,769,25,71391187,70866064,525123,47.607893769650154
1747959623042322,71068204,1,770,25,71481043,70958624,522419,47.85430851481283
1747959623137251,71160764,1,771,25,71575972,71051184,524788,47.63828441199112
1747959623230609,71253324,1,772,25,71669330,71143744,525586,47.56595495313802
1747959623325146,71345884,1,773,25,71763867,71236304,527563,47.387705354621154
1747959623415554,71438444,1,774,25,71854275,71328864,525411,47.581797868716116
1747959623509781,71531004,1,775,25,71948502,71421424,527078,47.43130997689146
1747959623604035,71623564,1,776,25,72042756,71513984,528772,47.27935669816102
1747959623697638,71716124,1,777,25,72136359,71606544,529815,47.186282004095766
1747959623788474,71808684,1,778,25,72227195,71699104,528091,47.34032581505839
1747959623882055,71901244,1,779,25,72320776,71791664,529112,47.24897564220807
1747959623976555,71993804,1,780,25,72415276,71884224,531052,47.076369169120916
1747959624070968,72086364,1,781,25,72509689,71976784,532905,46.912676743509635
1747959624165392,72178924,1,782,25,72604113,72069344,534769,46.749157112697254
1747959624255598,72271484,1,783,25,72694319,72161904,532415,46.9558521078482
1747959624349709,72364052,1,784,25,72788430,72254472,533958,46.820161885391734
1747959624443735,72456604,1,785,25,72882456,72347024,535432,46.69126985312794
1747959624538086,72549164,1,786,25,72976807,72439584,537223,46.53560997946849
1747959624628483,72641724,1,787,25,73067204,72532144,535060,46.72373191791575
1747959624722419,72734284,1,788,25,73161140,72624704,536436,46.603881916948154
1747959624816358,72826844,1,789,25,73255079,72717264,537815,46.484385894777944
1747959624910903,72919404,1,790,25,73349624,72809824,539800,46.31344942571323
1747959625001047,73011964,1,791,25,73439768,72902384,537384,46.52166793205604
1747959625094593,73104524,1,792,25,73533314,72994944,538370,46.43646562772814
1747959625189224,73197084,1,793,25,73627945,73087504,540441,46.25851850618292
1747959625284125,73289644,1,794,25,73722846,73180064,542782,46.05900711519542
1747959625373576,73382204,1,795,25,73812297,73272624,539673,46.324348262744294
1747959625467862,73474764,1,796,25,73906583,73365184,541399,46.176664530226326
1747959625561996,73567324,1,797,25,74000717,73457744,542973,46.042805075022144
1747959625655444,73659884,1,798,25,74094165,73550304,543861,45.96762775782783
1747959625749881,73752444,1,799,25,74188602,73642864,545738,45.809527648798515
1747959625840554,73845004,1,800,25,74279275,73735424,543851,45.96847298248969
1747959625933712,73937564,1,801,25,74372433,73827984,544449,45.917983135243155
1747959626028708,74030124,1,802,25,74467429,73920544,546885,45.71344981120345
1747959626123257,74122684,1,803,25,74561978,74013104,548874,45.54779421142193
1747959626213080,74215244,1,804,25,74651801,74105664,546137,45.77605985311378
1747959626307686,74307804,1,805,25,74746407,74198224,548183,45.605208479650045
1747959626401061,74400364,1,806,25,74839782,74290784,548998,45.537506511863434
1747959626495926,74492924,1,807,25,74934647,74383344,551303,45.347114018969606
1747959626585635,74585484,1,808,25,75024356,74475904,548452,45.58284043088547
1747959626680039,74678044,1,809,25,75118760,74568464,550296,45.43009580298603
1747959626774418,74770604,1,810,25,75213139,74661024,552115,45.28042165128642
1747959626867886,74863164,1,811,25,75306607,74753584,553023,45.20607641996806
1747959626957960,74955724,1,812,25,75396681,74846144,550537,45.410208578170035
1747959627052867,75048284,1,813,25,75491588,74938704,552884,45.21744163332634
1747959627146470,75140844,1,814,25,75585191,75031264,553927,45.132300826643224
1747959627241102,75233404,1,815,25,75679823,75123824,555999,44.96410964767922
1747959627335097,75325964,1,816,25,75773818,75216384,557434,44.84835872946394
1747959627425203,75418524,1,817,25,75863924,75308944,554980,45.04666834840895
1747959627519773,75511084,1,818,25,75958494,75401504,556990,44.884109229968224
1747959627613705,75603644,1,819,25,76052426,75494064,558362,44.77382056801859
1747959627707666,75696204,1,820,25,76146387,75586624,559763,44.6617586371375
1747959627798224,75788764,1,821,25,76236945,75679184,557761,44.822065364914366
1747959627892492,75881324,1,822,25,76331213,75771744,559469,44.685228314705554
1747959627985749,75973884,1,823,25,76424470,75864304,560166,44.62962764609062
1747959628080603,76066444,1,824,25,76519324,75956864,562460,44.44760516303382
1747959628170618,76159012,1,825,25,76609339,76049432,559907,44.650272277360344
1747959628264879,76251564,1,826,25,76703600,76141984,561616,44.514401299108286
1747959628359012,76344124,1,827,25,76797733,76234544,563189,44.39007153903929
1747959628452890,76436684,1,828,25,76891611,76327104,564507,44.286430460561164
1747959628547762,76529244,1,829,25,76986483,76419664,566819,44.10579038458485
1747959628637682,76621804,1,830,25,77076403,76512224,564179,44.31217751812811
1747959628732129,76714364,1,831,25,77170850,76604784,566066,44.164461387894704
1747959628825846,76806924,1,832,25,77264567,76697344,567223,44.074376391648435
1747959628920086,76899484,1,833,25,77358807,76789904,568903,43.94422247729402
1747959629010621,76992044,1,834,25,77449342,76882464,566878,44.101199905447025
1747959629104501,77084604,1,835,25,77543222,76975024,568198,43.998746915687846
1747959629198934,77177164,1,836,25,77637655,77067584,570071,43.85418658377641
1747959629293134,77269724,1,837,25,77731855,77160144,571711,43.728387244604356
1747959629382465,77362284,1,838,25,77821186,77252704,568482,43.976766194883915
1747959629477409,77454844,1,839,25,77916130,77345264,570866,43.793114321049075
1747959629571607,77547404,1,840,25,78010328,77437824,572504,43.667817168089655
1747959629665872,77639964,1,841,25,78104593,77530384,574209,43.53815422607448
1747959629755836,77732524,1,842,25,78194557,77622944,571613,43.73588424336045
1747959629851215,77825084,1,843,25,78289936,77715504,574432,43.52125229792212
1747959629944546,77917644,1,844,25,78383267,77808064,575203,43.46291657032387
1747959630037290,78010204,1,845,25,78476011,77900624,575387,43.449017791503806
1747959630128938,78102764,1,846,25,78567659,77993184,574475,43.51799469080465
1747959630222781,78195324,1,847,25,78661502,78085744,575758,43.42102063714269
1747959630317104,78287892,1,848,25,78755825,78178312,577513,43.289068817498475
1747959630410823,78380444,1,849,25,78849544,78270864,578680,43.20176954448054
1747959630505498,78473004,1,850,25,78944219,78363424,580795,43.044447696691606
1747959630595482,78565564,1,851,25,79034203,78455984,578219,43.236213268675016
1747959630689122,78658124,1,852,25,79127843,78548544,579299,43.15560703539968
