Tempo total receptor,Tempo total emissor,Id do pacote,Id da mensagem,Distancia (m),Tempo zerado receptor,Tempo zerado emissor,Delta tempo,Velocidade (m/s)
1747352847177226,841164,1,9,100,0,0,0,0.0
1747352847266470,929564,1,10,100,89244,88400,844,118483.41232227487
1747352847385795,1019004,1,11,100,208569,177840,30729,3254.254938331869
1747352847459806,1109484,1,12,100,282580,268320,14260,7012.622720897616
1747352847544904,1199964,1,13,100,367678,358800,8878,11263.798152737105
1747352847722017,1384044,1,15,100,544791,542880,1911,52328.62375719519
1747352848118960,1755324,1,19,100,941734,914160,27574,3626.60477261188
1747352848196218,1848924,1,20,100,1018992,1007760,11232,8903.133903133903
1747352848479339,2126604,1,23,100,1302113,1285440,16673,5997.720866070893
1747352848565450,2217084,1,24,100,1388224,1375920,12304,8127.43823146944
1747352848655430,2307564,1,25,100,1478204,1466400,11804,8471.704506946797
1747352849044662,2678844,1,29,100,1867436,1837680,29756,3360.666756284447
1747352849142032,2772444,1,30,100,1964806,1931280,33526,2982.759649227465
1747352849219909,2866044,1,31,100,2042683,2024880,17803,5617.030837499298
1747352849310689,2956524,1,32,100,2133463,2115360,18103,5523.946307241893
1747352849420646,3047004,1,33,100,2243420,2205840,37580,2660.989888238425
1747352850362874,3979884,1,43,100,3185648,3138720,46928,2130.923968632799
1747352850432925,4070364,1,44,100,3255699,3229200,26499,3773.7273104645456
1747352850522997,4160844,1,45,100,3345771,3319680,26091,3832.7392587482273
1747352853181386,6778524,1,73,100,6004160,5937360,66800,1497.005988023952
1747352853357002,6965724,1,75,100,6179776,6124560,55216,1811.0692552883224
1747352853443685,7059324,1,76,100,6266459,6218160,48299,2070.4362409159608
1747352853533775,7149804,1,77,100,6356549,6308640,47909,2087.290488217245
1747352853840824,7427484,1,80,100,6663598,6586320,77278,1294.029348585626
1747352854020551,7614684,1,82,100,6843325,6773520,69805,1432.562137382709
1747352854397629,7989084,1,86,100,7220403,7147920,72483,1379.6338451774898
1747352854573635,8173164,1,88,100,7396409,7332000,64409,1552.578055861759
1747352854654857,8263644,1,89,100,7477631,7422480,55151,1813.2037497053543
1747352854746037,8354124,1,90,100,7568811,7512960,55851,1790.4782367370326
1747352854835788,8444604,1,91,100,7658562,7603440,55122,1814.1576865861184
1747352854929717,8535084,1,92,100,7752491,7693920,58571,1707.3295658260915
1747352855020246,8625564,1,93,100,7843020,7784400,58620,1705.90242238144
1747352855114006,8716044,1,94,100,7936780,7874880,61900,1615.5088852988692
1747352855208181,8806524,1,95,100,8030955,7965360,65595,1524.5064410397133
1747352855294565,8897004,1,96,100,8117339,8055840,61499,1626.0426998812989
1747352855384052,8987484,1,97,100,8206826,8146320,60506,1652.728655009421
1747352855474259,9077964,1,98,100,8297033,8236800,60233,1660.21948101539
1747352855564490,9168444,1,99,100,8387264,8327280,59984,1667.111229661243
1747352855658723,9258924,1,100,100,8481497,8417760,63737,1568.9473931939062
1747352856044114,9634364,1,104,100,8866888,8793200,73688,1357.0730648138094
1747352856137856,9725884,1,105,100,8960630,8884720,75910,1317.3494928204452
1747352856609629,10201164,1,110,100,9432403,9360000,72403,1381.1582392994767
1747352856728268,10293724,1,111,100,9551042,9452560,98482,1015.4139842813915
1747352856814169,10389404,1,112,100,9636943,9548240,88703,1127.3575865528787
1747352856908224,10485084,1,113,100,9730998,9643920,87078,1148.3956912193664
1747352857002526,10580764,1,114,100,9825300,9739600,85700,1166.8611435239206
1747352857108578,10673324,1,115,100,9931352,9832160,99192,1008.145818211146
1747352858349662,11914044,1,128,100,11172436,11072880,99556,1004.4598015187432
1747352858456130,12009724,1,129,100,11278904,11168560,110344,906.2567969259768
1747352858746674,12296764,1,132,100,11569448,11455600,113848,878.3641346356545
1747352858816424,12392444,1,133,100,11639198,11551280,87918,1137.4235082690689
1747352858906341,12485004,1,134,100,11729115,11643840,85275,1172.6766344180592
1747352859000835,12577564,1,135,100,11823609,11736400,87209,1146.6706417915582
1747352859095435,12670124,1,136,100,11918209,11828960,89249,1120.4607334535965
1747352859189442,12762684,1,137,100,12012216,11921520,90696,1102.5844579694806
1747352859283602,12855244,1,138,100,12106376,12014080,92296,1083.470572939239
1747352859374088,12947804,1,139,100,12196862,12106640,90222,1108.3771142293454
1747352859475705,13040364,1,140,100,12298479,12199200,99279,1007.262361627333
1747352863428513,16963244,1,181,100,16251287,16122080,129207,773.9518756723708
1747352863518845,17058924,1,182,100,16341619,16217760,123859,807.3696703509636
1747352866229524,19734844,1,210,100,19052298,18893680,158618,630.4454727710599
1747352866315875,19830524,1,211,100,19138649,18989360,149289,669.8417164024141
1747352866402157,19923084,1,212,100,19224931,19081920,143011,699.2469110767703
1747352866492295,20015644,1,213,100,19315069,19174480,140589,711.293202170867
1747352866590464,20108204,1,214,100,19413238,19267040,146198,684.0038851420676
1747352866680082,20200764,1,215,100,19502856,19359600,143256,698.0510414921539
1747352866774547,20293324,1,216,100,19597321,19452160,145161,688.8902666694222
1747352866873456,20385884,1,217,100,19696230,19544720,151510,660.0224407629859
1747352866958593,20478444,1,218,100,19781367,19637280,144087,694.0251375904836
1747352867057127,20571004,1,219,100,19879901,19729840,150061,666.3956657625898
1747352867147131,20663564,1,220,100,19969905,19822400,147505,677.9431205721841
1747352867241536,20756124,1,221,100,20064310,19914960,149350,669.5681285570806
1747352867331322,20848684,1,222,100,20154096,20007520,146576,682.239930138631
1747352867426275,20941244,1,223,100,20249049,20100080,148969,671.280602004444
1747352867524087,21033804,1,224,100,20346861,20192640,154221,648.4201243669798
1747352867618313,21126364,1,225,100,20441087,20285200,155887,641.490310288863
1747352867707574,21218924,1,226,100,20530348,20377760,152588,655.3595302382887
1747352867798560,21311484,1,227,100,20621334,20470320,151014,662.1902605056484
1747352867896773,21404044,1,228,100,20719547,20562880,156667,638.2965142627356
1747352867986545,21496604,1,229,100,20809319,20655440,153879,649.8612546221382
1747352868085320,21589164,1,230,100,20908094,20748000,160094,624.6330280959936
1747352868179233,21681724,1,231,100,21002007,20840560,161447,619.3983164753757
1747352868265231,21774284,1,232,100,21088005,20933120,154885,645.6403137811925
1747352868359840,21866844,1,233,100,21182614,21025680,156934,637.2105471089758
1747352868454054,21959404,1,234,100,21276828,21118240,158588,630.5647337755694
1747352868552691,22055084,1,235,100,21375465,21213920,161545,619.022563372435
1747352868670937,22147644,1,236,100,21493711,21306480,187231,534.0995882092175
1747352868748315,22243324,1,237,100,21571089,21402160,168929,591.964671548402
1747352868859032,22339004,1,238,100,21681806,21497840,183966,543.5787047606623
1747352868949237,22434684,1,239,100,21772011,21593520,178491,560.2523376528789
1747352869146473,22622924,1,241,100,21969247,21781760,187487,533.3703136750815
1747352869343011,22814284,1,243,100,22165785,21973120,192665,519.0356317961227
1747352869608536,23101324,1,246,100,22431310,22260160,171150,584.28279287175
1747352869793297,23289564,1,248,100,22616071,22448400,167671,596.406057099916
1747352870473028,23956204,1,255,100,23295802,23115040,180762,553.2136179064183
1747352870575634,24051884,1,256,100,23398408,23210720,187688,532.7991134222752
1747352870862315,24335804,1,259,100,23685089,23494640,190449,525.0749544497477
1747352870960663,24431484,1,260,100,23783437,23590320,193117,517.820802932937
1747352871046862,24527164,1,261,100,23869636,23686000,183636,544.5555337733342
1747352871156587,24622844,1,262,100,23979361,23781680,197681,505.8655105953532
1747352871234432,24718524,1,263,100,24057206,23877360,179846,556.0312711986923
1747352871349171,24811084,1,264,100,24171945,23969920,202025,494.9882440292043
1747352871439343,24903644,1,265,100,24262117,24062480,199637,500.909150107445
1747352871812206,25286364,1,269,100,24634980,24445200,189780,526.9259142164611
1747352872771007,26243164,1,279,100,25593781,25402000,191781,521.4280872453476
1747352872967909,26431404,1,281,100,25790683,25590240,200443,498.8949476908647
1747352873065435,26527084,1,282,100,25888209,25685920,202289,494.3422529153834
1747352873147150,26619644,1,283,100,25969924,25778480,191444,522.345960176344
1747352873241357,26712204,1,284,100,26064131,25871040,193091,517.8905283001279
1747352873332319,26804764,1,285,100,26155093,25963600,191493,522.2123001885186
1747352873425863,26897324,1,286,100,26248637,26056160,192477,519.5425946996264
1747352873519926,26989884,1,287,100,26342700,26148720,193980,515.5170636148056
1747352873610314,27082444,1,288,100,26433088,26241280,191808,521.3546880213547
1747352873704752,27175004,1,289,100,26527526,26333840,193686,516.2995776669454
1747352873798863,27267564,1,290,100,26621637,26426400,195237,512.1979952570466
1747352873893189,27360124,1,291,100,26715963,26518960,197003,507.6064831500028
1747352873986620,27452684,1,292,100,26809394,26611520,197874,505.37210548126586
1747352874077684,27545244,1,293,100,26900458,26704080,196378,509.2220106121867
1747352874171138,27637804,1,294,100,26993912,26796640,197272,506.914311204834
1747352874265297,27730364,1,295,100,27088071,26889200,198871,502.8385234649597
1747352874359773,27822924,1,296,100,27182547,26981760,200787,498.04021176669806
1747352874450286,27915484,1,297,100,27273060,27074320,198740,503.1699708161417
1747352874544396,28008044,1,298,100,27367170,27166880,200290,499.2760497278946
1747352874638185,28100604,1,299,100,27460959,27259440,201519,496.23112460859767
1747352874732852,28193164,1,300,100,27555626,27352000,203626,491.0964218714702
1747352874831239,28285724,1,301,100,27654013,27444560,209453,477.4340782896402
1747352874917176,28378284,1,302,100,27739950,27537120,202830,493.02371444066455
1747352875010798,28470844,1,303,100,27833572,27629680,203892,490.455731465678
1747352875105248,28563404,1,304,100,27928022,27722240,205782,485.95115219018186
1747352875199209,28655964,1,305,100,28021983,27814800,207183,482.6650835251927
1747352875289379,28748524,1,306,100,28112153,27907360,204793,488.2979398709917
1747352875383610,28841084,1,307,100,28206384,27999920,206464,484.3459392436454
1747352875486609,28933644,1,308,100,28309383,28092480,216903,461.0355781155632
1747352875571890,29026204,1,309,100,28394664,28185040,209624,477.0446132122276
1747352875666699,29118764,1,310,100,28489473,28277600,211873,471.9808564564621
1747352875760709,29211324,1,311,100,28583483,28370160,213323,468.77270617795546
1747352875850730,29303884,1,312,100,28673504,28462720,210784,474.4193107636253
1747352875944656,29396444,1,313,100,28767430,28555280,212150,471.36460051850105
1747352876035544,29489004,1,314,100,28858318,28647840,210478,475.1090375241118
1747352876129694,29581564,1,315,100,28952468,28740400,212068,471.5468623271781
1747352876223627,29674124,1,316,100,29046401,28832960,213441,468.51354706921353
1747352876317255,29766692,1,317,100,29140029,28925528,214501,466.1982927818518
1747352876411464,29859244,1,318,100,29234238,29018080,216158,462.62456166322784
1747352876501510,29951804,1,319,100,29324284,29110640,213644,468.06837542828254
1747352876595658,30044364,1,320,100,29418432,29203200,215232,464.6149271483794
1747352876689950,30136924,1,321,100,29512724,29295760,216964,460.905956748585
1747352876780245,30229484,1,322,100,29603019,29388320,214699,465.7683547664405
1747352876874915,30322044,1,323,100,29697689,29480880,216809,461.2354653173992
1747352876969175,30414604,1,324,100,29791949,29573440,218509,457.6470534394464
1747352877062491,30507164,1,325,100,29885265,29666000,219265,456.0691400816364
1747352877157521,30599724,1,326,100,29980295,29758560,221735,450.9887929284957
1747352877247773,30692284,1,327,100,30070547,29851120,219427,455.7324303754779
1747352877341531,30784844,1,328,100,30164305,29943680,220625,453.257790368272
1747352877435262,30877404,1,329,100,30258036,30036240,221796,450.8647586070082
1747352877530304,30969964,1,330,100,30353078,30128800,224278,445.87520844666
1747352877620381,31062524,1,331,100,30443155,30221360,221795,450.86679140647897
1747352877714482,31155084,1,332,100,30537256,30313920,223336,447.7558476913708
1747352877808203,31247644,1,333,100,30630977,30406480,224497,445.4402508719493
1747352877902923,31340204,1,334,100,30725697,30499040,226657,441.1952862695615
1747352877997129,31432764,1,335,100,30819903,30591600,228303,438.014393152959
1747352878086869,31525324,1,336,100,30909643,30684160,225483,443.4924140622575
1747352878181420,31617884,1,337,100,31004194,30776720,227474,439.61068078110026
1747352878274755,31710444,1,338,100,31097529,30869280,228249,438.1180202322902
1747352878365090,31803004,1,339,100,31187864,30961840,226024,442.4308922946236
1747352878459775,31895572,1,340,100,31282549,31054408,228141,438.3254215594741
1747352878553970,31988124,1,341,100,31376744,31146960,229784,435.19131009992
1747352878647744,32080684,1,342,100,31470518,31239520,230998,432.90418098858
1747352878741651,32173244,1,343,100,31564425,31332080,232345,430.3944565194
1747352878832251,32265804,1,344,100,31655025,31424640,230385,434.0560366343295
1747352878925817,32358364,1,345,100,31748591,31517200,231391,432.168926189869
1747352879020517,32450924,1,346,100,31843291,31609760,233531,428.2086746513311
1747352879115213,32543484,1,347,100,31937987,31702320,235667,424.3275469200185
1747352879204389,32636044,1,348,100,32027163,31794880,232283,430.5093355949424
1747352879298787,32728604,1,349,100,32121561,31887440,234121,427.12956120980175
1747352879393568,32821164,1,350,100,32216342,31980000,236342,423.1156544329827
1747352879487232,32913724,1,351,100,32310006,32072560,237446,421.14838742282456
1747352879578185,33006284,1,352,100,32400959,32165120,235839,424.0180801309368
1747352879671760,33098844,1,353,100,32494534,32257680,236854,422.2010183488562
1747352879766627,33191404,1,354,100,32589401,32350240,239161,418.12837377331584
1747352879859895,33283964,1,355,100,32682669,32442800,239869,416.8942214291968
1747352879954847,33376524,1,356,100,32777621,32535360,242261,412.7779543550138
1747352880048352,33469084,1,357,100,32871126,32627920,243206,411.17406642928216
1747352880138799,33561644,1,358,100,32961573,32720480,241093,414.777699891743
1747352880232745,33654204,1,359,100,33055519,32813040,242479,412.4068476032976
1747352880331658,33746764,1,360,100,33154432,32905600,248832,401.8775720164609
1747352880417569,33839324,1,361,100,33240343,32998160,242183,412.9108979573298
1747352880511295,33931884,1,362,100,33334069,33090720,243349,410.932446815068
1747352880605637,34024444,1,363,100,33428411,33183280,245131,407.945139537635
1747352880703965,34117004,1,364,100,33526739,33275840,250899,398.5667539527858
1747352880790147,34209564,1,365,100,33612921,33368400,244521,408.9628293684388
1747352880888307,34302124,1,366,100,33711081,33460960,250121,399.80649365707
1747352880978344,34394684,1,367,100,33801118,33553520,247598,403.88048368726726
1747352881072709,34487244,1,368,100,33895483,33646080,249403,400.9574864777088
1747352881162268,34579804,1,369,100,33985042,33738640,246402,405.8408616813175
1747352881257366,34672364,1,370,100,34080140,33831200,248940,401.7032216598377
1747352881351167,34764924,1,371,100,34173941,33923760,250181,399.71060951870845
1747352881445651,34857484,1,372,100,34268425,34016320,252105,396.6601217746573
1747352881539288,34950044,1,373,100,34362062,34108880,253182,394.9727863750188
1747352881629806,35042604,1,374,100,34452580,34201440,251140,398.1842796846381
1747352881727444,35135164,1,375,100,34550218,34294000,256218,390.2926414225386
1747352881818112,35227724,1,376,100,34640886,34386560,254326,393.1961340956096
1747352881912055,35320284,1,377,100,34734829,34479120,255709,391.0695360742093
1747352882002262,35412844,1,378,100,34825036,34571680,253356,394.7015267055053
1747352882096262,35505404,1,379,100,34919036,34664240,254796,392.4708394166313
1747352882190907,35597964,1,380,100,35013681,34756800,256881,389.2853110973563
1747352882284775,35690532,1,381,100,35107549,34849368,258181,387.3251711008944
1747352882375776,35783084,1,382,100,35198550,34941920,256630,389.6660561898453
1747352882469901,35875644,1,383,100,35292675,35034480,258195,387.3041693293828
1747352882564300,35968204,1,384,100,35387074,35127040,260034,384.5650953336872
1747352882658380,36060764,1,385,100,35481154,35219600,261554,382.3302262630279
1747352882747786,36153324,1,386,100,35570560,35312160,258400,386.9969040247678
1747352882842098,36245884,1,387,100,35664872,35404720,260152,384.3906639195548
1747352882936904,36338444,1,388,100,35759678,35497280,262398,381.1004657047691
1747352883030411,36431004,1,389,100,35853185,35589840,263345,379.7300119614954
1747352883124283,36523564,1,390,100,35947057,35682400,264657,377.8475536260141
1747352883215296,36616124,1,391,100,36038070,35774960,263110,380.06917258941127
1747352883308956,36708684,1,392,100,36131730,35867520,264210,378.4868097346807
1747352883402650,36801244,1,393,100,36225424,35960080,265344,376.8692715870719
1747352883497548,36893804,1,394,100,36320322,36052640,267682,373.5776032755285
1747352883587684,36986364,1,395,100,36410458,36145200,265258,376.991457373576
1747352883681406,37078924,1,396,100,36504180,36237760,266420,375.3471961564448
1747352883775344,37171484,1,397,100,36598118,36330320,267798,373.4157835383386
1747352883869630,37264044,1,398,100,36692404,36422880,269524,371.0244727742242
1747352883959793,37356604,1,399,100,36782567,36515440,267127,374.3537718014278
1747352884054480,37449164,1,400,100,36877254,36608000,269254,371.3965252141101
1747352884148794,37541724,1,401,100,36971568,36700560,271008,368.9927972605975
1747352884242718,37634284,1,402,100,37065492,36793120,272372,367.1449341341988
1747352884333262,37726844,1,403,100,37156036,36885680,270356,369.8826732160559
1747352884427463,37819412,1,404,100,37250237,36978248,271989,367.6619275044212
1747352884521333,37911964,1,405,100,37344107,37070800,273307,365.8889088095072
1747352884623299,38004524,1,406,100,37446073,37163360,282713,353.7156055788025
1747352884709397,38097084,1,407,100,37532171,37255920,276251,361.98963985650727
1747352884803543,38189644,1,408,100,37626317,37348480,277837,359.92326436003844
1747352884898575,38282204,1,409,100,37721349,37441040,280309,356.7491589638578
1747352884988751,38374764,1,410,100,37811525,37533600,277925,359.8093010704327
1747352885082211,38467324,1,411,100,37904985,37626160,278825,358.6478974267014
1747352885181151,38559884,1,412,100,38003925,37718720,285205,350.6249890429691
1747352885267093,38652444,1,413,100,38089867,37811280,278587,358.9542943497005
1747352885373559,38745004,1,414,100,38196333,37903840,292493,341.88852382792066
1747352885454882,38837564,1,415,100,38277656,37996400,281256,355.5479705321842
1747352885549298,38930124,1,416,100,38372072,38088960,283112,353.2171013591794
1747352885643347,39022684,1,417,100,38466121,38181520,284601,351.36910973608667
1747352885733514,39115244,1,418,100,38556288,38274080,282208,354.3485655970064
1747352885828169,39207804,1,419,100,38650943,38366640,284303,351.73740692148874
1747352885918319,39300364,1,420,100,38741093,38459200,281893,354.7445307261975
1747352886012713,39392924,1,421,100,38835487,38551760,283727,352.45147624300824
1747352886106727,39485484,1,422,100,38929501,38644320,285181,350.6544966179373
1747352886200894,39578044,1,423,100,39023668,38736880,286788,348.6896243915366
1747352886294855,39670604,1,424,100,39117629,38829440,288189,346.994507076953
1747352886384763,39763164,1,425,100,39207537,38922000,285537,350.21730984075623
1747352886487205,39855724,1,426,100,39309979,39014560,295419,338.5022628876274
1747352886573728,39948284,1,427,100,39396502,39107120,289382,345.56399499623336
1747352886667212,40040844,1,428,100,39489986,39199680,290306,344.4641171729141
1747352886757694,40133404,1,429,100,39580468,39292240,288228,346.9475554075246
1747352886851585,40225964,1,430,100,39674359,39384800,289559,345.3527605772917
1747352886945799,40318524,1,431,100,39768573,39477360,291213,343.39126343947555
1747352887039769,40411084,1,432,100,39862543,39569920,292623,341.7366372431422
1747352887130446,40503644,1,433,100,39953220,39662480,290740,343.9499208915182
1747352887224056,40596204,1,434,100,40046830,39755040,291790,342.71222454504954
1747352887318289,40688764,1,435,100,40141063,39847600,293463,340.75846018067017
1747352887422192,40781324,1,436,100,40244966,39940160,304806,328.0775312821926
1747352887621612,40969564,1,438,100,40444386,40128400,315986,316.4697170127791
1747352887699502,41062124,1,439,100,40522276,40220960,301316,331.8774973781678
1747352887793768,41154684,1,440,100,40616542,40313520,303022,330.0090422477576
1747352887880228,41247244,1,441,100,40703002,40406080,296922,336.788786280572
1747352887978238,41339804,1,442,100,40801012,40498640,302372,330.7184527667906
1747352888068314,41432364,1,443,100,40891088,40591200,299888,333.4578242543883
1747352888161984,41524924,1,444,100,40984758,40683760,300998,332.22812111708384
1747352888256205,41617484,1,445,100,41078979,40776320,302659,330.4048450566479
1747352888346563,41710044,1,446,100,41169337,40868880,300457,332.8263278938417
1747352888440801,41802604,1,447,100,41263575,40961440,302135,330.97787412911447
1747352888551358,41895164,1,448,100,41374132,41054000,320132,312.37114690190293
1747352888633387,41990844,1,449,100,41456161,41149680,306481,326.2845005073724
1747352888743939,42086524,1,450,100,41566713,41245360,321353,311.18427399152955
1747352888846128,42179084,1,451,100,41668902,41337920,330982,302.1312337226798
1747352888919868,42274764,1,452,100,41742642,41433600,309042,323.58061363827574
1747352889018094,42367324,1,453,100,41840868,41526160,314708,317.75487118217524
1747352889104673,42459884,1,454,100,41927447,41618720,308727,323.910769061339
1747352889198646,42552444,1,455,100,42021420,41711280,310140,322.43502934158766
1747352889289126,42645004,1,456,100,42111900,41803840,308060,324.6120885541778
1747352889383031,42737564,1,457,100,42205805,41896400,309405,323.2009825309869
1747352889477331,42830124,1,458,100,42300105,41988960,311145,321.3935624869434
1747352889566764,42922684,1,459,100,42389538,42081520,308018,324.6563512521996
1747352889661783,43015244,1,460,100,42484557,42174080,310477,322.08504977824447
1747352889756008,43107804,1,461,100,42578782,42266640,312142,320.3670124494621
1747352889849775,43200364,1,462,100,42672549,42359200,313349,319.13297952123673
1747352889940154,43292924,1,463,100,42762928,42451760,311168,321.3698066639243
1747352890033906,43385484,1,464,100,42856680,42544320,312360,320.1434242540658
1747352890128151,43478052,1,465,100,42950925,42636888,314037,318.4338151236956
1747352890221966,43570604,1,466,100,43044740,42729440,315300,317.15826197272435
1747352890316627,43663164,1,467,100,43139401,42822000,317401,315.0588687496259
1747352890407262,43755724,1,468,100,43230036,42914560,315476,316.9813234604217
1747352890501359,43848284,1,469,100,43324133,43007120,317013,315.4444770403737
1747352890595463,43940844,1,470,100,43418237,43099680,318557,313.91556299186647
1747352890689027,44033404,1,471,100,43511801,43192240,319561,312.9292998832774
1747352890779781,44125964,1,472,100,43602555,43284800,317755,314.7078724174285
1747352890873609,44218524,1,473,100,43696383,43377360,319023,313.4570234747965
1747352890968067,44311084,1,474,100,43790841,43469920,320921,311.6031671345908
1747352891062044,44403644,1,475,100,43884818,43562480,322338,310.2333575315352
1747352891151947,44496204,1,476,100,43974721,43655040,319681,312.8118342973152
1747352891246279,44588764,1,477,100,44069053,43747600,321453,311.0874684635079
1747352891340672,44681324,1,478,100,44163446,43840160,323286,309.3236329442042
1747352891435004,44773884,1,479,100,44257778,43932720,325058,307.63740624750045
1747352891525452,44866444,1,480,100,44348226,44025280,322946,309.6492912127724
1747352891619502,44959004,1,481,100,44442276,44117840,324436,308.2272004339839
1747352891713750,45051564,1,482,100,44536524,44210400,326124,306.63183329040487
1747352891807380,45144124,1,483,100,44630154,44302960,327194,305.62907632780554
1747352891901489,45236684,1,484,100,44724263,44395520,328743,304.18898653355353
1747352891991479,45329244,1,485,100,44814253,44488080,326173,306.58576890177915
1747352892086514,45421804,1,486,100,44909288,44580640,328648,304.2769163360191
1747352892180589,45514364,1,487,100,45003363,44673200,330163,302.88069832173807
1747352892274619,45606932,1,488,100,45097393,44765768,331625,301.5454202789295
1747352892365028,45699484,1,489,100,45187802,44858320,329482,303.50671660363844
1747352892459058,45792044,1,490,100,45281832,44950880,330952,302.1586211897797
1747352892552552,45884604,1,491,100,45375326,45043440,331886,301.3082805541662
1747352892647099,45977164,1,492,100,45469873,45136000,333873,299.5150850772599
1747352892737248,46069724,1,493,100,45560022,45228560,331462,301.69370847940337
1747352893028235,46353644,1,496,100,45851009,45512480,338529,295.3956677271371
1747352893122518,46446204,1,497,100,45945292,45605040,340252,293.8998154309159
1747352893212513,46538772,1,498,100,46035287,45697608,337679,296.13923282170344
1747352893307039,46631324,1,499,100,46129813,45790160,339653,294.41812673522685
1747352893396742,46723884,1,500,100,46219516,45882720,336796,296.91564032826994
1747352893491032,46816444,1,501,100,46313806,45975280,338526,295.3982855083509
1747352893589283,46909004,1,502,100,46412057,46067840,344217,290.5144138726443
1747352893896447,47192924,1,505,100,46719221,46351760,367461,272.1377234590882
1747352893965652,47285484,1,506,100,46788426,46444320,344106,290.6081265656513
1747352894059896,47378044,1,507,100,46882670,46536880,345790,289.19286272014807
1747352894149850,47470612,1,508,100,46972624,46629448,343176,291.3956686947805
1747352894244145,47563164,1,509,100,47066919,46722000,344919,289.92314137522146
1747352894334360,47655724,1,510,100,47157134,46814560,342574,291.9077338034994
1747352894428515,47748284,1,511,100,47251289,46907120,344169,290.55493086245417
1747352894523405,47840844,1,512,100,47346179,46999680,346499,288.6011215039581
1747352894617426,47933404,1,513,100,47440200,47092240,347960,287.3893550982872
1747352894711671,48025964,1,514,100,47534445,47184800,349645,286.0043758669508
1747352894801444,48118524,1,515,100,47624218,47277360,346858,288.30241770407486
1747352894896143,48211084,1,516,100,47718917,47369920,348997,286.5354143445359
1747352894990152,48303644,1,517,100,47812926,47462480,350446,285.3506674352112
1747352895091925,48396204,1,518,100,47914699,47555040,359659,278.0411445285673
1747352895178617,48488764,1,519,100,48001391,47647600,353791,282.6527526138313
1747352895272259,48581324,1,520,100,48095033,47740160,354873,281.79095056541354
1747352895363041,48673884,1,521,100,48185815,47832720,353095,283.2099010181396
1747352895457178,48766444,1,522,100,48279952,47925280,354672,281.95064735868635
1747352895550695,48859004,1,523,100,48373469,48017840,355629,281.1919162947904
1747352895640777,48951564,1,524,100,48463551,48110400,353151,283.1649917457405
1747352895743792,49044124,1,525,100,48566566,48202960,363606,275.0229644175289
1747352895845328,49136684,1,526,100,48668102,48295520,372582,268.3972924081142
1747352895948676,49232364,1,527,100,48771450,48391200,380250,262.98487836949374
1747352896042124,49324924,1,528,100,48864898,48483760,381138,262.37215916544665
1747352896222895,49516284,1,530,100,49045669,48675120,370549,269.8698417753117
1747352897463278,50757004,1,543,100,50286052,49915840,370212,270.1155013883937
1747352897570430,50849564,1,544,100,50393204,50008400,384804,259.8725584973129
1747352897647948,50942124,1,545,100,50470722,50100960,369762,270.4442316949822
1747352897750828,51034684,1,546,100,50573602,50193520,380082,263.1011202845702
1747352897938878,51222924,1,548,100,50761652,50381760,379892,263.2327082433955
1747352898024708,51315484,1,549,100,50847482,50474320,373162,267.9801265938118
1747352898131450,51408044,1,550,100,50954224,50566880,387344,258.1684497500929
1747352898208940,51500604,1,551,100,51031714,50659440,372274,268.6193502635156
1747352898311045,51593164,1,552,100,51133819,50752000,381819,261.9042006814747
1747352898397048,51685724,1,553,100,51219822,50844560,375262,266.48048563403705
1747352898487533,51778284,1,554,100,51310307,50937120,373187,267.9621744594533
1747352898598057,51870844,1,555,100,51420831,51029680,391151,255.65574420108857
1747352898684142,51963404,1,556,100,51506916,51122240,384676,259.9590304568
1747352898770698,52055964,1,557,100,51593472,51214800,378672,264.08078759454094
1747352898862118,52148524,1,558,100,51684892,51307360,377532,264.878208999502
1747352898958632,52241084,1,559,100,51781406,51399920,381486,262.1328174559486
1747352899057154,52333644,1,560,100,51879928,51492480,387448,258.0991513699903
1747352899261350,52521884,1,562,100,52084124,51680720,403404,247.8904522513411
1747352899548906,52808924,1,565,100,52371680,51967760,403920,247.57377698554168
1747352899622442,52904604,1,566,100,52445216,52063440,381776,261.9336993420225
1747352900318695,53571244,1,573,100,53141469,52730080,411389,243.07893502256988
1747352900416316,53666924,1,574,100,53239090,52825760,413330,241.9374349793144
1747352900506579,53759484,1,575,100,53329353,52918320,411033,243.28946824220927
1747352900609488,53855164,1,576,100,53432262,53014000,418262,239.08459291066364
1747352900772039,54046524,1,578,100,53594813,53205360,389453,256.7703933465656
1747352900891436,54142204,1,579,100,53714210,53301040,413170,242.03112520270108
1747352900965232,54234764,1,580,100,53788006,53393600,394406,253.54583855215185
1747352901059854,54327332,1,581,100,53882628,53486168,396460,252.2322554608284
1747352901154128,54419884,1,582,100,53976902,53578720,398182,251.1414378349599
1747352901243856,54512444,1,583,100,54066630,53671280,395350,252.94043252813964
1747352901338546,54605004,1,584,100,54161320,53763840,397480,251.58498540807085
1747352901428794,54697564,1,585,100,54251568,53856400,395168,253.05692768645235
1747352901526767,54790124,1,586,100,54349541,53948960,400581,249.6374016740684
1747352901616773,54882684,1,587,100,54439547,54041520,398027,251.2392375391619
1747352901711378,54975244,1,588,100,54534152,54134080,400072,249.9550080985423
1747352901805547,55067804,1,589,100,54628321,54226640,401681,248.95377177411925
1747352901895628,55160364,1,590,100,54718402,54319200,399202,250.49974699525552
1747352901989354,55252924,1,591,100,54812128,54411760,400368,249.77021140550693
1747352902084056,55345484,1,592,100,54906830,54504320,402510,248.4410325209312
1747352902178150,55438044,1,593,100,55000924,54596880,404044,247.4977972696043
1747352902268149,55530604,1,594,100,55090923,54689440,401483,249.07654869571067
1747352902362365,55623164,1,595,100,55185139,54782000,403139,248.0534009361535
1747352902456577,55715724,1,596,100,55279351,54874560,404791,247.0410656363408
1747352902550933,55808284,1,597,100,55373707,54967120,406587,245.9498213174548
1747352902641015,55900844,1,598,100,55463789,55059680,404109,247.45798782011784
1747352902734694,55993404,1,599,100,55557468,55152240,405228,246.77465525580664
1747352902829594,56085964,1,600,100,55652368,55244800,407568,245.35782985906647
1747352902927822,56178524,1,601,100,55750596,55337360,413236,241.99246919435868
1747352903013019,56271084,1,602,100,55835793,55429920,405873,246.38248910373443
1747352903111539,56363644,1,603,100,55934313,55522480,411833,242.81686994485628
1747352903201583,56456212,1,604,100,56024357,55615048,409309,244.31419783097857
1747352903296486,56548764,1,605,100,56119260,55707600,411660,242.91891366661807
1747352903385783,56641324,1,606,100,56208557,55800160,408397,244.85978104638377
1747352903480676,56733884,1,607,100,56303450,55892720,410730,243.46894553599688
1747352903578439,56826444,1,608,100,56401213,55985280,415933,240.423337412516
1747352903672405,56919004,1,609,100,56495179,56077840,417339,239.6133598824936
1747352903762392,57011564,1,610,100,56585166,56170400,414766,241.09980085156448
1747352903856619,57104124,1,611,100,56679393,56262960,416433,240.13466752154608
1747352903951213,57196684,1,612,100,56773987,56355520,418467,238.96746935839624
1747352904041576,57289244,1,613,100,56864350,56448080,416270,240.2286977202297
1747352904139581,57381804,1,614,100,56962355,56540640,421715,237.1269696358916
1747352904226025,57474364,1,615,100,57048799,56633200,415599,240.6165558627427
1747352904324447,57566924,1,616,100,57147221,56725760,421461,237.26987787719384
1747352904414359,57659484,1,617,100,57237133,56818320,418813,238.7700477301325
1747352904511991,57752044,1,618,100,57334765,56910880,423885,235.913042452552
1747352904598910,57844604,1,619,100,57421684,57003440,418244,239.0948824131368
1747352904693143,57937164,1,620,100,57515917,57096000,419917,238.1422995496729
1747352904786515,58029724,1,621,100,57609289,57188560,420729,237.68268885672248
1747352904880738,58122284,1,622,100,57703512,57281120,422392,236.7469080853804
1747352904979469,58214844,1,623,100,57802243,57373680,428563,233.33792231247213
1747352905069033,58307404,1,624,100,57891807,57466240,425567,234.9806258473989
1747352905159918,58399964,1,625,100,57982692,57558800,423892,235.90914666943468
1747352905257414,58492524,1,626,100,58080188,57651360,428828,233.19372802149115
1747352905351643,58585084,1,627,100,58174417,57743920,430497,232.28965590933268
1747352905442562,58677644,1,628,100,58265336,57836480,428856,233.1785028074692
1747352905532688,58770204,1,629,100,58355462,57929040,426422,234.50947652794648
1747352905626958,58862764,1,630,100,58449732,58021600,428132,233.5728233348593
1747352905732959,58955324,1,631,100,58555733,58114160,441573,226.4631216129609
1747352905815056,59047884,1,632,100,58637830,58206720,431110,231.95936072000185
1747352905917609,59140444,1,633,100,58740383,58299280,441103,226.7044205094955
1747352906011479,59233004,1,634,100,58834253,58391840,442413,226.0331409791304
1747352906114142,59325564,1,635,100,58936916,58484400,452516,220.98666124512727
1747352906191726,59421244,1,636,100,59014500,58580080,434420,230.19198011141293
1747352906282148,59513804,1,637,100,59104922,58672640,432282,231.3304740886736
1747352906474376,59702044,1,639,100,59297150,58860880,436270,229.21585256836363
1747352906564431,59794604,1,640,100,59387205,58953440,433765,230.5395778820329
1747352906658947,59887164,1,641,100,59481721,59046000,435721,229.50466009212315
1747352906753305,59979724,1,642,100,59576079,59138560,437519,228.56150247189265
1747352906843158,60072284,1,643,100,59665932,59231120,434812,229.98445305097377
1747352906937153,60164844,1,644,100,59759927,59323680,436247,229.22793738409663
1747352907031305,60257404,1,645,100,59854079,59416240,437839,228.3944554961984
1747352907125166,60349964,1,646,100,59947940,59508800,439140,227.71781208726148
1747352907215584,60442524,1,647,100,60038358,59601360,436998,228.8339992402711
1747352907309307,60535084,1,648,100,60132081,59693920,438161,228.2266107663621
1747352907404444,60627644,1,649,100,60227218,59786480,440738,226.8921672286029
1747352907498356,60720204,1,650,100,60321130,59879040,442090,226.19828541699653
1747352907592259,60812764,1,651,100,60415033,59971600,443433,225.5132116915069
1747352907682451,60905324,1,652,100,60505225,60064160,441065,226.72395225193569
1747352907789307,60997884,1,653,100,60612081,60156720,455361,219.6059829453993
1747352907878900,61090444,1,654,100,60701674,60249280,452394,221.0462561395597
1747352907965159,61183012,1,655,100,60787933,60341848,446085,224.1725231738345
1747352908055467,61275564,1,656,100,60878241,60434400,443841,225.305909098078
1747352908251854,61463804,1,658,100,61074628,60622640,451988,221.24481180916308
1747352908358435,61556364,1,659,100,61181209,60715200,466009,214.5881302721621
1747352908432428,61648932,1,660,100,61255202,60807768,447434,223.4966497852197
1747352908526386,61741484,1,661,100,61349160,60900320,448840,222.79654219766508
1747352908620530,61834044,1,662,100,61443304,60992880,450424,222.01303660550948
1747352908735317,61926604,1,663,100,61558091,61085440,472651,211.5725979634022
1747352908820928,62019164,1,664,100,61643702,61178000,465702,214.72959102602093
1747352908911523,62111724,1,665,100,61734297,61270560,463737,215.6394680605601
1747352908996707,62204284,1,666,100,61819481,61363120,456361,219.1247718363313
1747352909099115,62296844,1,667,100,61921889,61455680,466209,214.49607364937185
1747352909177212,62389404,1,668,100,61999986,61548240,451746,221.3633324921527
1747352909279240,62481964,1,669,100,62102014,61640800,461214,216.81909048727923
1747352909365667,62574524,1,670,100,62188441,61733360,455081,219.74110103476085
1747352909459841,62667084,1,671,100,62282615,61825920,456695,218.9645168000525
1747352909554472,62759644,1,672,100,62377246,61918480,458766,217.9760487917588
1747352909644352,62852204,1,673,100,62467126,62011040,456086,219.2568945330486
1747352909738060,62944764,1,674,100,62560834,62103600,457234,218.70639541241465
1747352909833015,63037324,1,675,100,62655789,62196160,459629,217.5667766829334
1747352909927055,63129884,1,676,100,62749829,62288720,461109,216.8684627712753
1747352910017166,63222444,1,677,100,62839940,62381280,458660,218.02642480268608
1747352910111016,63315004,1,678,100,62933790,62473840,459950,217.4149364061311
1747352910205327,63407564,1,679,100,63028101,62566400,461701,216.590390750724
1747352910295773,63500124,1,680,100,63118547,62658960,459587,217.58665932674336
1747352910393391,63592684,1,681,100,63216165,62751520,464645,215.2180697091328
1747352910484214,63685244,1,682,100,63306988,62844080,462908,216.02564656476017
1747352910577780,63777812,1,683,100,63400554,62936648,463906,215.5609110466345
1747352912212247,65401244,1,700,100,65035021,64560080,474941,210.5524686224184
1747352912306988,65493804,1,701,100,65129762,64652640,477122,209.590000041918
1747352912405468,65586364,1,702,100,65228242,64745200,483042,207.02133561884887
1747352912495568,65678924,1,703,100,65318342,64837760,480582,208.08103507830089
1747352912585479,65771484,1,704,100,65408253,64930320,477933,209.23434874762785
1747352912679382,65864044,1,705,100,65502156,65022880,479276,208.6480441332343
1747352912777556,65956604,1,706,100,65600330,65115440,484890,206.2323413557714
1747352912867824,66049164,1,707,100,65690598,65208000,482598,207.21179946870893
1747352912962086,66141724,1,708,100,65784860,65300560,484300,206.48358455502787
1747352913056164,66234284,1,709,100,65878938,65393120,485818,205.8384003886229
1747352913150645,66326844,1,710,100,65973419,65485680,487739,205.02768898939803
1747352913244551,66419404,1,711,100,66067325,65578240,489085,204.4634368259096
1747352913334436,66511964,1,712,100,66157210,65670800,486410,205.58787853868137
1747352913429275,66604524,1,713,100,66252049,65763360,488689,204.62911995154383
1747352913519105,66697084,1,714,100,66341879,65855920,485959,205.77867680195243
1747352913609092,66789644,1,715,100,66431866,65948480,483386,206.8740095906791
1747352913719584,66882204,1,716,100,66542358,66041040,501318,199.47418604558385
1747352913801680,66974764,1,717,100,66624454,66133600,490854,203.7265663517054
1747352913891659,67067324,1,718,100,66714433,66226160,488273,204.8034603592662
1747352913986029,67159884,1,719,100,66808803,66318720,490083,204.04706957801025
1747352914075702,67252444,1,720,100,66898476,66411280,487196,205.25620078982584
1747352914170041,67345004,1,721,100,66992815,66503840,488975,204.50943299759703
1747352914264236,67437564,1,722,100,67087010,66596400,490610,203.82788773159945
1747352914362244,67530124,1,723,100,67185018,66688960,496058,201.5893302799269
1747352914452330,67622684,1,724,100,67275104,66781520,493584,202.599760121884
1747352914547227,67715244,1,725,100,67370001,66874080,495921,201.6450200737617
1747352914637309,67807804,1,726,100,67460083,66966640,493443,202.65765245428548
1747352914734908,67900364,1,727,100,67557682,67059200,498482,200.6090490729856
1747352914825748,67992924,1,728,100,67648522,67151760,496762,201.30364238810537
1747352914914996,68085484,1,729,100,67737770,67244320,493450,202.6547775863816
1747352915009438,68178044,1,730,100,67832212,67336880,495332,201.8847964597482
1747352915120646,68270604,1,731,100,67943420,67429440,513980,194.56009961477105
1747352915215026,68363164,1,732,100,68037800,67522000,515800,193.87359441644043
1747352916835975,69989724,1,749,100,69658749,69148560,510189,196.0057939312686
1747352916946943,70082284,1,750,100,69769717,69241120,528597,189.18003696577924
1747352917033162,70177964,1,751,100,69855936,69336800,519136,192.6277507242804
1747352917229630,70366204,1,753,100,70052404,69525040,527364,189.62234813146137
1747352917307765,70458764,1,754,100,70130539,69617600,512939,194.95495565749533
1747352917401859,70551324,1,755,100,70224633,69710160,514473,194.3736600365812
1747352917492237,70643884,1,756,100,70315011,69802720,512291,195.2015553659932
1747352917590256,70736444,1,757,100,70413030,69895280,517750,193.1434089811685
1747352917680595,70829004,1,758,100,70503369,69987840,515529,193.9755086522776
1747352917774176,70921564,1,759,100,70596950,70080400,516550,193.5921014422612
1747352917868953,71014124,1,760,100,70691727,70172960,518767,192.7647672269053
1747352917970950,71106684,1,761,100,70793724,70265520,528204,189.32079272402328
1747352918053174,71199244,1,762,100,70875948,70358080,517868,193.09939984706529
1747352918146810,71291804,1,763,100,70969584,70450640,518944,192.69901954738856
1747352918240957,71384364,1,764,100,71063731,70543200,520531,192.11151689332624
1747352918335826,71476924,1,765,100,71158600,70635760,522840,191.2631015224543
1747352918425704,71569484,1,766,100,71248478,70728320,520158,192.2492781039607
1747352918519978,71662044,1,767,100,71342752,70820880,521872,191.61786798295367
1747352918613630,71754604,1,768,100,71436404,70913440,522964,191.21775112627256
1747352918704229,71847164,1,769,100,71527003,71006000,521003,191.9374744483237
1747352918798226,71939724,1,770,100,71621000,71098560,522440,191.4095398514661
1747352918892252,72032292,1,771,100,71715026,71191128,523898,190.8768500738693
1747352918986767,72124844,1,772,100,71809541,71283680,525861,190.16432098976725
1747352919080817,72217404,1,773,100,71903591,71376240,527351,189.6270226092299
1747352919175404,72309964,1,774,100,71998178,71468800,529378,188.9009365708436
1747352919265377,72402524,1,775,100,72088151,71561360,526791,189.8286037536708
1747352919359447,72495084,1,776,100,72182221,71653920,528301,189.28603201583945
1747352919453468,72587644,1,777,100,72276242,71746480,529762,188.76401100871715
1747352919543919,72680204,1,778,100,72366693,71839040,527653,189.51849037151308
1747352919638259,72772764,1,779,100,72461033,71931600,529433,188.8813126495704
1747352919732502,72865324,1,780,100,72555276,72024160,531116,188.2827856814707
1747352919826600,72957884,1,781,100,72649374,72116720,532654,187.7391327203025
1747352919916439,73050444,1,782,100,72739213,72209280,529933,188.70310020323325
1747352920010730,73143004,1,783,100,72833504,72301840,531664,188.08871768635828
1747352920104836,73235564,1,784,100,72927610,72394400,533210,187.5433694041748
1747352920199422,73328124,1,785,100,73022196,72486960,535236,186.8334715901023
1747352920289202,73420684,1,786,100,73111976,72579520,532456,187.80894571570232
1747352920387585,73513244,1,787,100,73210359,72672080,538279,185.77726420685187
1747352920477389,73605804,1,788,100,73300163,72764640,535523,186.73334291897828
1747352920571179,73698364,1,789,100,73393953,72857200,536753,186.3054328527274
1747352920661749,73790924,1,790,100,73484523,72949760,534763,186.9987265386723
1747352920756002,73883484,1,791,100,73578776,73042320,536456,186.40857777711497
1747352920850081,73976044,1,792,100,73672855,73134880,537975,185.88224359868025
1747352920944032,74068604,1,793,100,73766806,73227440,539366,185.40286187857595
1747352921034559,74161172,1,794,100,73857333,73320008,537325,186.1071046387196
1747352921129024,74253724,1,795,100,73951798,73412560,539238,185.44687132583385
1747352921226885,74346284,1,796,100,74049659,73505120,544539,183.64157571817628
1747352921317583,74438844,1,797,100,74140357,73597680,542677,184.27167541650007
1747352921423457,74531404,1,798,100,74246231,73690240,555991,179.8590264950332
1747352921505685,74623964,1,799,100,74328459,73782800,545659,183.26463963757584
1747352921604252,74716524,1,800,100,74427026,73875360,551666,181.2691012315423
1747352921690073,74809084,1,801,100,74512847,73967920,544927,183.5108188803271
1747352921784216,74901644,1,802,100,74606990,74060480,546510,182.9792684488847
1747352921874059,74994204,1,803,100,74696833,74153040,543793,183.8935035941985
1747352921984775,75086764,1,804,100,74807549,74245600,561949,177.95209173786233
1747352922070777,75179324,1,805,100,74893551,74338160,555391,180.05333179687824
1747352922169332,75271884,1,806,100,74992106,74430720,561386,178.13055544669797
1747352922279245,75364444,1,807,100,75102019,74523280,578739,172.78946122518096
1747352922755085,75839724,1,812,100,75577859,74998560,579299,172.62242814159873
1747352922832443,75935404,1,813,100,75655217,75094240,560977,178.26042778937463
1747352922918098,76027964,1,814,100,75740872,75186800,554072,180.481959023376
1747352923008813,76120524,1,815,100,75831587,75279360,552227,181.08495238371177
1747352923102327,76213084,1,816,100,75925101,75371920,553181,180.77265849694768
1747352923196859,76305644,1,817,100,76019633,75464480,555153,180.13052257665905
1747352923291048,76398204,1,818,100,76113822,75557040,556782,179.6035072972905
1747352923381291,76490772,1,819,100,76204065,75649608,554457,180.35663721442785
1747352923475139,76583324,1,820,100,76297913,75742160,555753,179.9360507275714
1747352923570155,76675884,1,821,100,76392929,75834720,558209,179.1443706568687
1747352923664140,76768444,1,822,100,76486914,75927280,559634,178.68821408277554
1747352923758149,76861004,1,823,100,76580923,76019840,561083,178.22675076592947
1747352923852669,76953564,1,824,100,76675443,76112400,563043,177.606328468696
1747352923941767,77046124,1,825,100,76764541,76204960,559581,178.70513830884178
1747352924036579,77138684,1,826,100,76859353,76297520,561833,177.98883298061878
1747352924130673,77231244,1,827,100,76953447,76390080,563367,177.5041846611534
1747352924220664,77323804,1,828,100,77043438,76482640,560798,178.31732638133516
1747352924315523,77416364,1,829,100,77138297,76575200,563097,177.58929633793113
1747352924413630,77508924,1,830,100,77236404,76667760,568644,175.85695092184213
1747352924503584,77601484,1,831,100,77326358,76760320,566038,176.6665842222607
1747352924593291,77694044,1,832,100,77416065,76852880,563185,177.5615472713229
1747352924691490,77786604,1,833,100,77514264,76945440,568824,175.8013023360477
1747352924782173,77879164,1,834,100,77604947,77038000,566947,176.38333036421395
1747352924876566,77971724,1,835,100,77699340,77130560,568780,175.81490207109957
1747352924970846,78064284,1,836,100,77793620,77223120,570500,175.28483786152498
1747352925060958,78156844,1,837,100,77883732,77315680,568052,176.0402216698471
1747352925155116,78249404,1,838,100,77977890,77408240,569650,175.54638813306417
1747352925249203,78341964,1,839,100,78071977,77500800,571177,175.0770776834501
1747352925342721,78434524,1,840,100,78165495,77593360,572135,174.783923374728
1747352925433702,78527084,1,841,100,78256476,77685920,570556,175.26763367662423
1747352925527424,78619644,1,842,100,78350198,77778480,571718,174.91140737216602
1747352925621872,78712204,1,843,100,78444646,77871040,573606,174.33569383862792
1747352925716210,78804764,1,844,100,78538984,77963600,575384,173.7969773229704
1747352925805921,78897324,1,845,100,78628695,78056160,572535,174.66181106831897
1747352925900216,78989884,1,846,100,78722990,78148720,574270,174.13411809775891
1747352925994691,79082444,1,847,100,78817465,78241280,576185,173.5553685014362
1747352926088019,79175004,1,848,100,78910793,78333840,576953,173.32434357737978
1747352926178399,79267564,1,849,100,79001173,78426400,574773,173.98172843887934
1747352926272882,79360124,1,850,100,79095656,78518960,576696,173.40158419687322
1747352926366939,79452684,1,851,100,79189713,78611520,578193,172.95263000416818
1747352926461104,79545244,1,852,100,79283878,78704080,579798,172.4738615862766
1747352926551062,79637804,1,853,100,79373836,78796640,577196,173.25137388339488
1747352926650112,79730364,1,854,100,79472886,78889200,583686,171.32499323266276
1747352926747606,79822924,1,855,100,79570380,78981760,588620,169.8888926641976
1747352926834044,79915484,1,856,100,79656818,79074320,582498,171.6744091825208
1747352926928024,80008044,1,857,100,79750798,79166880,583918,171.25692306111472
1747352927018341,80100604,1,858,100,79841115,79259440,581675,171.91730777496022
1747352927112199,80193164,1,859,100,79934973,79352000,582973,171.5345307587144
1747352927207074,80285732,1,860,100,80029848,79444568,585280,170.85839256424276
1747352927300510,80378284,1,861,100,80123284,79537120,586164,170.60071925263236
1747352927390121,80470844,1,862,100,80212895,79629680,583215,171.46335399466747
1747352927489089,80563404,1,863,100,80311863,79722240,589623,169.5998968832627
1747352927579405,80655964,1,864,100,80402179,79814800,587379,170.24782976579007
1747352927673176,80748524,1,865,100,80495950,79907360,588590,169.89755177627893
1747352927764140,80841084,1,866,100,80586914,79999920,586994,170.35949260128723
1747352927862203,80933644,1,867,100,80684977,80092480,592497,168.77722587624916
1747352927952383,81026204,1,868,100,80775157,80185040,590117,169.4579210563329
1747352928045979,81118764,1,869,100,80868753,80277600,591153,169.16094479770888
1747352928140499,81211324,1,870,100,80963273,80370160,593113,168.60193588742786
1747352928230487,81303884,1,871,100,81053261,80462720,590541,169.33625269032973
1747352928325240,81396444,1,872,100,81148014,80555280,592734,168.70974163790166
1747352928427273,81489004,1,873,100,81250047,80647840,602207,166.05585786947012
1747352928513384,81581564,1,874,100,81336158,80740400,595758,167.85339013492057
1747352928607382,81674124,1,875,100,81430156,80832960,597196,167.4492126538021
1747352928697901,81766684,1,876,100,81520675,80925520,595155,168.023456074468
1747352928791911,81859244,1,877,100,81614685,81018080,596605,167.61508871028568
1747352928886139,81951804,1,878,100,81708913,81110640,598273,167.1477736752285
1747352928976341,82044364,1,879,100,81799115,81203200,595915,167.80916741481587
1747352929069753,82136924,1,880,100,81892527,81295760,596767,167.5695874604326
1747352929164152,82229484,1,881,100,81986926,81388320,598606,167.0547906302309
1747352929258305,82322044,1,882,100,82081079,81480880,600199,166.6114072166065
1747352929352703,82414612,1,883,100,82175477,81573448,602029,166.10495507691488
1747352929450855,82507164,1,884,100,82273629,81666000,607629,164.5741068974654
1747352929537010,82599724,1,885,100,82359784,81758560,601224,166.3273588546033
1747352929631169,82692284,1,886,100,82453943,81851120,602823,165.88617222634173
1747352929721259,82784844,1,887,100,82544033,81943680,600353,166.56866876654234
1747352929816043,82877404,1,888,100,82638817,82036240,602577,165.9538946889775
1747352929909897,82969964,1,889,100,82732671,82128800,603871,165.59828175222853
1747352930004192,83062524,1,890,100,82826966,82221360,605606,165.12385940694116
1747352930098514,83155084,1,891,100,82921288,82313920,607368,164.6448281766573
1747352930188662,83247644,1,892,100,83011436,82406480,604956,165.30127810948233
1747352930283023,83340204,1,893,100,83105797,82499040,606757,164.81062435208824
1747352930381045,83432764,1,894,100,83203819,82591600,612219,163.3402426255964
1747352930475105,83525324,1,895,100,83297879,82684160,613719,162.94102023890412
1747352930564831,83617884,1,896,100,83387605,82776720,610885,163.696931501019
1747352930684491,83710444,1,897,100,83507265,82869280,637985,156.74349710416388
1747352933952231,86960444,1,931,100,86775005,86119280,655725,152.50295474474817
1747352934046335,87053004,1,932,100,86869109,86211840,657269,152.14470787455366
1747352934214604,87241244,1,934,100,87037378,86400080,637298,156.91246481237977
1747352934312432,87333804,1,935,100,87135206,86492640,642566,155.62603685847057
1747352934402945,87426364,1,936,100,87225719,86585200,640519,156.12339368543323
1747352934492942,87518924,1,937,100,87315716,86677760,637956,156.75062229997053
1747352934612253,87611484,1,938,100,87435027,86770320,664707,150.44222492015277
1747352934689944,87704044,1,939,100,87512718,86862880,649838,153.88450660010648
1747352934775979,87796604,1,940,100,87598753,86955440,643313,155.44532754662194
1747352934869384,87889164,1,941,100,87692158,87048000,644158,155.24141592590638
1747352934959453,87981724,1,942,100,87782227,87140560,641667,155.84407488619487
1747352935053845,88074284,1,943,100,87876619,87233120,643499,155.40039689261366
1747352935152689,88166844,1,944,100,87975463,87325680,649783,153.8975319452802
1747352935922633,88929164,1,952,100,88745407,88088000,657407,152.11277032340698
1747352936114512,89117404,1,954,100,88937286,88276240,661046,151.27540292203568
1747352936504305,89497004,1,958,100,89327079,88655840,671239,148.978232790407
1747352936585401,89589564,1,959,100,89408175,88748400,659775,151.56682202265924
1747352936680151,89682124,1,960,100,89502925,88840960,661965,151.06538865347866
1747352936765846,89774684,1,961,100,89588620,88933520,655100,152.64845061822624
1747352936860741,89867244,1,962,100,89683515,89026080,657435,152.1062918767635
1747352936950763,89959804,1,963,100,89773537,89118640,654897,152.69576742602274
1747352937045042,90052364,1,964,100,89867816,89211200,656616,152.29601471788686
1747352937138852,90144924,1,965,100,89961626,89303760,657866,152.0066396500199
1747352937228879,90237484,1,966,100,90051653,89396320,655333,152.59417731138214
1747352937323068,90330044,1,967,100,90145842,89488880,656962,152.21580548037784
1747352937416831,90422604,1,968,100,90239605,89581440,658165,151.93758404047617
1747352937511750,90515164,1,969,100,90334524,89674000,660524,151.39495309784354
1747352938014732,90990444,1,974,100,90837506,90149280,688226,145.30110748504126
1747352938084528,91086124,1,975,100,90907302,90244960,662342,150.97940338978958
1747352938178728,91178684,1,976,100,91001502,90337520,663982,150.606492344672
1747352938273562,91271244,1,977,100,91096336,90430080,666256,150.09245695348335
1747352938420561,91363804,1,978,100,91243335,90522640,720695,138.754951817343
1747352938462015,91456364,1,979,100,91284789,90615200,669589,149.34534468158827
1747352938551588,91548924,1,980,100,91374362,90707760,666602,150.0145514114869
1747352938645722,91641484,1,981,100,91468496,90800320,668176,149.66116711764565
1747352938740358,91734052,1,982,100,91563132,90892888,670244,149.19939604084485
1747352938829810,91826604,1,983,100,91652584,90985440,667144,149.89267684338014
1747352938923473,91919164,1,984,100,91746247,91078000,668247,149.6452658971907
1747352939018526,92011724,1,985,100,91841300,91170560,670740,149.08906580791364
1747352939112849,92104284,1,986,100,91935623,91263120,672503,148.6982214205736
1747352939202802,92196844,1,987,100,92025576,91355680,669896,149.2769026834016
1747352939301477,92289404,1,988,100,92124251,91448240,676011,147.92658699340691
1747352939390731,92381964,1,989,100,92213505,91540800,672705,148.65357028712438
1747352939489962,92474524,1,990,100,92312736,91633360,679376,147.1938955747627
1747352939575503,92567084,1,991,100,92398277,91725920,672357,148.73051072570078
1747352939670158,92659644,1,992,100,92492932,91818480,674452,148.26852022086078
1747352939764135,92752204,1,993,100,92586909,91911040,675869,147.9576663525032
1747352939857708,92844764,1,994,100,92680482,92003600,676882,147.7362376307835
1747352939948077,92937324,1,995,100,92770851,92096160,674691,148.21599813840706
1747352940046218,93029884,1,996,100,92868992,92188720,680272,147.00002352000377
1747352940136944,93122444,1,997,100,92959718,92281280,678438,147.3974040369201
1747352940230765,93215004,1,998,100,93053539,92373840,679699,147.12394751206048
1747352940325342,93307564,1,999,100,93148116,92466400,681716,146.68865040574082
1747352940419431,93400124,1,1000,100,93242205,92558960,683245,146.36038317148314
1747352940513645,93493724,1,1001,100,93336419,92652560,683859,146.2289741013864
1747352940611483,93587324,1,1002,100,93434257,92746160,688097,145.3283476021549
1747352940702117,93680924,1,1003,100,93524891,92839760,685131,145.95748842192222
1747352940796234,93774524,1,1004,100,93619008,92933360,685648,145.84743191841878
1747352940890696,93868124,1,1005,100,93713470,93026960,686510,145.66430204949674
1747352940984464,93961724,1,1006,100,93807238,93120560,686678,145.6286643812675
1747352941078386,94055324,1,1007,100,93901160,93214160,687000,145.56040756914118
1747352941173276,94148924,1,1008,100,93996050,93307760,688290,145.28759679786137
1747352941267381,94242524,1,1009,100,94090155,93401360,688795,145.18107709841098
1747352941361834,94336124,1,1010,100,94184608,93494960,689648,145.00150801568336
1747352941456043,94429724,1,1011,100,94278817,93588560,690257,144.87357607383916
1747352941549385,94523324,1,1012,100,94372159,93682160,689999,144.92774627209604
1747352941644002,94616924,1,1013,100,94466776,93775760,691016,144.71444944834852
1747352941738080,94710524,1,1014,100,94560854,93869360,691494,144.6144145863883
1747352941832198,94804124,1,1015,100,94654972,93962960,692012,144.50616463298326
1747352941926225,94897724,1,1016,100,94748999,94056560,692439,144.41705334332698
1747352942020740,94991324,1,1017,100,94843514,94150160,693354,144.2264701725237
1747352942114550,95084924,1,1018,100,94937324,94243760,693564,144.18280072206747
1747352942209136,95178524,1,1019,100,95031910,94337360,694550,143.97811532647037
1747352942303632,95272124,1,1020,100,95126406,94430960,695446,143.79261653672606
1747352942398299,95365724,1,1021,100,95221073,94524560,696513,143.57233820474275
1747352942491863,95459324,1,1022,100,95314637,94618160,696477,143.5797592741756
1747352942585800,95552924,1,1023,100,95408574,94711760,696814,143.51031982709875
1747352942680080,95646524,1,1024,100,95502854,94805360,697494,143.37040892108033
1747352942774987,95740124,1,1025,100,95597761,94898960,698801,143.102256579484
1747352942869309,95833724,1,1026,100,95692083,94992560,699523,142.95455617613715
1747352942963765,95927332,1,1027,100,95786539,95086168,700371,142.78146867874312
1747352943057195,96020924,1,1028,100,95879969,95179760,700209,142.81450252710263
1747352943151426,96114524,1,1029,100,95974200,95273360,700840,142.68591975343872
1747352943245645,96208124,1,1030,100,96068419,95366960,701459,142.56000707097633
1747352943340067,96301724,1,1031,100,96162841,95460560,702281,142.3931446244452
1747352943434004,96395324,1,1032,100,96256778,95554160,702618,142.3248479259
1747352943528286,96488924,1,1033,100,96351060,95647760,703300,142.18683349921795
1747352943622559,96582524,1,1034,100,96445333,95741360,703973,142.05090252040918
1747352943717036,96676124,1,1035,100,96539810,95834960,704850,141.87415762218913
1747352943810875,96769724,1,1036,100,96633649,95928560,705089,141.82606734752636
1747352943909195,96863324,1,1037,100,96731969,96022160,709809,140.88296992571242
1747352943999409,96956924,1,1038,100,96822183,96115760,706423,141.55824484763377
1747352944093632,97050524,1,1039,100,96916406,96209360,707046,141.43351351962957
1747352944191147,97144124,1,1040,100,97013921,96302960,710961,140.65469132624716
1747352944286011,97237724,1,1041,100,97108785,96396560,712225,140.4050686229773
1747352944375641,97331324,1,1042,100,97198415,96490160,708255,141.1920847717277
1747352944474124,97424924,1,1043,100,97296898,96583760,713138,140.22531403459078
1747352944564195,97518524,1,1044,100,97386969,96677360,709609,140.9226771362821
1747352944662509,97612124,1,1045,100,97485283,96770960,714323,139.9926923814577
1747352944756809,97705724,1,1046,100,97579583,96864560,715023,139.8556410073522
1747352944850480,97799324,1,1047,100,97673254,96958160,715094,139.84175506996283
1747352944945340,97892924,1,1048,100,97768114,97051760,716354,139.59578644078206
1747352945039613,97986524,1,1049,100,97862387,97145360,717027,139.4647621358749
1747352945133716,98080124,1,1050,100,97956490,97238960,717530,139.36699510821848
1747352945227592,98173724,1,1051,100,98050366,97332560,717806,139.31340780099356
1747352945321951,98267324,1,1052,100,98144725,97426160,718565,139.16625496649573
1747352945416546,98360924,1,1053,100,98239320,97519760,719560,138.9738173328145
1747352945510691,98454524,1,1054,100,98333465,97613360,720105,138.86863721262873
1747352945604425,98548124,1,1055,100,98427199,97706960,720239,138.8428007925147
1747352945698718,98641724,1,1056,100,98521492,97800560,720932,138.70933735775358
1747352945792713,98735324,1,1057,100,98615487,97894160,721327,138.63337986793783
1747352945887197,98828924,1,1058,100,98709971,97987760,722211,138.46368997425958
1747352945981743,98922532,1,1059,100,98804517,98081368,723149,138.28408806483864
1747352946075920,99016124,1,1060,100,98898694,98174960,723734,138.17231192675763
1747352946169361,99109724,1,1061,100,98992135,98268560,723575,138.2026742217462
1747352946264389,99203324,1,1062,100,99087163,98362160,725003,137.93046373601214
1747352946370845,99296924,1,1063,100,99193619,98455760,737859,135.52724843093327
1747352946551024,99487244,1,1065,100,99373798,98646080,727718,137.4158671353464
1747352946645041,99580844,1,1066,100,99467815,98739680,728135,137.33716961827133
1747352946738897,99674444,1,1067,100,99561671,98833280,728391,137.2889011533641
1747352946833621,99768044,1,1068,100,99656395,98926880,729515,137.07737332337237
1747352946927649,99861644,1,1069,100,99750423,99020480,729943,136.99699839576516
1747352947021375,99955244,1,1070,100,99844149,99114080,730069,136.97335457333486
1747352947115591,100048844,1,1071,100,99938365,99207680,730685,136.85787993458192
1747352947210204,100143484,1,1072,100,100032978,99302320,730658,136.86293724286875
1747352947324745,100238124,1,1073,100,100147519,99396960,750559,133.23402956996054
1747352948020632,100922444,1,1080,100,100843406,100081280,762126,131.21189934472778
1747352948209519,101114844,1,1082,100,101032293,100273680,758613,131.81951798875053
1747352948987794,101896924,1,1090,100,101810568,101055760,754808,132.4840224268953
1747352949196838,102092444,1,1092,100,102019612,101251280,768332,130.15206967821203
1747352949298552,102190204,1,1093,100,102121326,101349040,772286,129.48570866233493
1747352949389168,102284844,1,1094,100,102211942,101443680,768262,130.1639284514918
1747352949467045,102379484,1,1095,100,102289819,101538320,751499,133.06737600449236
1747352949564718,102474124,1,1096,100,102387492,101632960,754532,132.53248371175775
1747352949655385,102568764,1,1097,100,102478159,101727600,750559,133.23402956996054
1747352949749346,102663404,1,1098,100,102572120,101822240,749880,133.3546700805462
1747352949950058,102855804,1,1100,100,102772832,102014640,758192,131.8927131913816
1747352951523127,104416844,1,1116,100,104345901,103575680,770221,129.8328661514033
1747352951641847,104511484,1,1117,100,104464621,103670320,794301,125.89685774032765
1747352952808775,105684604,1,1129,100,105631549,104843440,788109,126.8860018093944
1747352952911069,105782364,1,1130,100,105733843,104941200,792643,126.16020074611144
1747352952993342,105877004,1,1131,100,105816116,105035840,780276,128.15977936012385
1747352953091139,105974764,1,1132,100,105913913,105133600,780313,128.1537024245399
1747352953186275,106069404,1,1133,100,106009049,105228240,780809,128.0722942486575
1747352953284442,106164044,1,1134,100,106107216,105322880,784336,127.49637910283349
1747352953382750,106258684,1,1135,100,106205524,105417520,788004,126.90290912228872
1747352953480453,106353324,1,1136,100,106303227,105512160,791067,126.41154289080444
1747352953582683,106447964,1,1137,100,106405457,105606800,798657,125.21019661757175
1747352953758722,106643492,1,1139,100,106581496,105802328,779168,128.3420263665859
1747352953852797,106738124,1,1140,100,106675571,105896960,778611,128.43383923422607
1747352953951886,106832764,1,1141,100,106774660,105991600,783060,127.70413505989325
1747352954045572,106927404,1,1142,100,106868346,106086240,782106,127.85990645769245
1747352954139940,107022044,1,1143,100,106962714,106180880,781834,127.9043889112011
1747352954234605,107116684,1,1144,100,107057379,106275520,781859,127.90029915879974
1747352954332091,107211324,1,1145,100,107154865,106370160,784705,127.4364251534016
1747352954426327,107305964,1,1146,100,107249101,106464800,784301,127.502068721065
1747352954521019,107400604,1,1147,100,107343793,106559440,784353,127.49361575719097
1747352954619009,107495244,1,1148,100,107441783,106654080,787703,126.95140173390224
1747352954713334,107589884,1,1149,100,107536108,106748720,787388,127.00218951774728
1747352954811957,107684524,1,1150,100,107634731,106843360,791371,126.36298272238936
1747352954901754,107779164,1,1151,100,107724528,106938000,786528,127.14105537247244
1747352955007770,107873804,1,1152,100,107830544,107032640,797904,125.32836030399648
1747352955098575,107968444,1,1153,100,107921349,107127280,794069,125.93364052746044
1747352955188779,108063084,1,1154,100,108011553,107221920,789633,126.64111049056966
1747352955282248,108157724,1,1155,100,108105022,107316560,788462,126.82919405120349
1747352955380810,108252364,1,1156,100,108203584,107411200,792384,126.20143768677814
1747352955479422,108347004,1,1157,100,108302196,107505840,796356,125.57198037058804
1747352955569902,108441644,1,1158,100,108392676,107600480,792196,126.23138718196002
1747352955667166,108536284,1,1159,100,108489940,107695120,794820,125.81464985782944
1747352955761886,108630924,1,1160,100,108584660,107789760,794900,125.8019876714052
1747352955856060,108725564,1,1161,100,108678834,107884400,794434,125.87578074453008
1747352955958781,108820204,1,1162,100,108781555,107979040,802515,124.60826277390454
1747352956049161,108914844,1,1163,100,108871935,108073680,798255,125.2732522815391
1747352956143102,109009484,1,1164,100,108965876,108168320,797556,125.38304520309543
1747352956245501,109104124,1,1165,100,109068275,108262960,805315,124.17501226228246
1747352957035822,109886204,1,1173,100,109858596,109045040,813556,122.91716857843836
1747352957133484,109983964,1,1174,100,109956258,109142800,813458,122.93197681994644
1747352957219496,110078604,1,1175,100,110042270,109237440,804830,124.24984158145196
1747352957318173,110173244,1,1176,100,110140947,109332080,808867,123.62971910091522
1747352957411901,110267884,1,1177,100,110234675,109426720,807955,123.76926932811853
1747352957506152,110362524,1,1178,100,110328926,109521360,807566,123.82888828900673
1747352957617805,110457164,1,1179,100,110440579,109616000,824579,121.27400770575046
1747352957703206,110551804,1,1180,100,110525980,109710640,815340,122.64822037432238
1747352957793503,110646444,1,1181,100,110616277,109805280,810997,123.3050183909435
1747352957887646,110741084,1,1182,100,110710420,109899920,810500,123.38062924120914
1747352957982161,110835732,1,1183,100,110804935,109994568,810367,123.40087886105924
1747352958076335,110930364,1,1184,100,110899109,110089200,809909,123.47066151876322
1747352958173777,111025004,1,1185,100,110996551,110183840,812711,123.04496924490996
1747352958268162,111119644,1,1186,100,111090936,110278480,812456,123.0835885266402
1747352958362906,111214284,1,1187,100,111185680,110373120,812560,123.06783499064686
1747352958460798,111308924,1,1188,100,111283572,110467760,815812,122.57726044725992
1747352958555395,111403564,1,1189,100,111378169,110562400,815769,122.58372161727156
1747352958649502,111498204,1,1190,100,111472276,110657040,815236,122.6638666594704
1747352958743960,111592844,1,1191,100,111566734,110751680,815054,122.69125726638973
1747352958850048,111687484,1,1192,100,111672822,110846320,826502,120.99184272996315
1747352958935820,111782124,1,1193,100,111758594,110940960,817634,122.30411161962444
1747352959030016,111876764,1,1194,100,111852790,111035600,817190,122.370562537476
1747352959124014,111971404,1,1195,100,111946788,111130240,816548,122.46677476400652
1747352959222526,112066044,1,1196,100,112045300,111224880,820420,121.8887886692182
1747352959316196,112160684,1,1197,100,112138970,111319520,819450,122.03307096223077
1747352959411289,112255324,1,1198,100,112234063,111414160,819903,121.96564715582208
1747352959509681,112349964,1,1199,100,112332455,111508800,823655,121.4100563949712
1747352959603129,112444604,1,1200,100,112425903,111603440,822463,121.5860166353988
1747352959697734,112539244,1,1201,100,112520508,111698080,822428,121.59119096139722
1747352959792095,112633892,1,1202,100,112614869,111792728,822141,121.63363705252505
1747352959890437,112728524,1,1203,100,112713211,111887360,825851,121.08721791218996
1747352959984149,112823164,1,1204,100,112806923,111982000,824923,121.22343539942516
1747352960079230,112917804,1,1205,100,112902004,112076640,825364,121.15866454073596
1747352960173375,113012444,1,1206,100,112996149,112171280,824869,121.23137128441002
1747352960271273,113107084,1,1207,100,113094047,112265920,828127,120.75442534780294
1747352960369172,113201724,1,1208,100,113191946,112360560,831386,120.28107281094462
1747352960463474,113296364,1,1209,100,113286248,112455200,831048,120.3299929727284
1747352960557987,113391004,1,1210,100,113380761,112549840,830921,120.34838450346062
1747352960652469,113485644,1,1211,100,113475243,112644480,830763,120.37127315491902
1747352960746745,113580284,1,1212,100,113569519,112739120,830399,120.4240371195052
1747352960840767,113674924,1,1213,100,113663541,112833760,829781,120.5137259108126
1747352960938851,113769564,1,1214,100,113761625,112928400,833225,120.01560202826369
1747352961033002,113864204,1,1215,100,113855776,113023040,832736,120.08607770049572
1747352961127563,113958844,1,1216,100,113950337,113117680,832657,120.09747110755087
1747352961225765,114053484,1,1217,100,114048539,113212320,836219,119.58589795256984
1747352961320089,114148124,1,1218,100,114142863,113306960,835903,119.63110552300924
1747352961414539,114242764,1,1219,100,114237313,113401600,835713,119.65830374781773
1747352961512416,114337404,1,1220,100,114335190,113496240,838950,119.19661481613925
1747352961606759,114432044,1,1221,100,114429533,113590880,838653,119.2388270238108
1747352961700713,114526684,1,1222,100,114523487,113685520,837967,119.33644164985016
1747352961799038,114621324,1,1223,100,114621812,113780160,841652,118.8139516094538
1747352961889108,114715964,1,1224,100,114711882,113874800,837082,119.46260939788456
1747352961987615,114810604,1,1225,100,114810389,113969440,840949,118.91327535914785
1747352962085514,114905244,1,1226,100,114908288,114064080,844208,118.45421981312664
1747352962175755,114999884,1,1227,100,114998529,114158720,839809,119.07469436502824
1747352962282456,115094524,1,1228,100,115105230,114253360,851870,117.38880345592636
1747352962368581,115189164,1,1229,100,115191355,114348000,843355,118.57402873048716
1747352962462268,115283804,1,1230,100,115285042,114442640,842402,118.70817020852276
1747352962556454,115378444,1,1231,100,115379228,114537280,841948,118.7721807047466
1747352962655374,115473084,1,1232,100,115478148,114631920,846228,118.17146206459724
1747352962757684,115567724,1,1233,100,115580458,114726560,853898,117.11000611314232
1747352962850979,115662364,1,1234,100,115673753,114821200,852553,117.29476056034052
1747352962941997,115757004,1,1235,100,115764771,114915840,848931,117.7952036148992
1747352963039681,115851644,1,1236,100,115862455,115010480,851975,117.37433610141142
1747352963134418,115946284,1,1237,100,115957192,115105120,852072,117.36097418997456
1747352963224478,116040924,1,1238,100,116047252,115199760,847492,117.99521411411553
1747352963322702,116135564,1,1239,100,116145476,115294400,851076,117.49831977402722
1747352963420788,116230204,1,1240,100,116243562,115389040,854522,117.02448854447282
1747352963510695,116324844,1,1241,100,116333469,115483680,849789,117.6762702270799
1747352963609716,116419484,1,1242,100,116432490,115578320,854170,117.07271386258004
1747352963703669,116514124,1,1243,100,116526443,115672960,853483,117.16695001540744
1747352963809684,116608764,1,1244,100,116632458,115767600,864858,115.6259177807224
1747352963900327,116703404,1,1245,100,116723101,115862240,860861,116.16277192252872
1747352963990020,116798044,1,1246,100,116812794,115956880,855914,116.83416791873952
1747352964096792,116892692,1,1247,100,116919566,116051528,868038,115.20232985191892
1747352964178182,116987324,1,1248,100,117000956,116146160,854796,116.98697700971928
1747352964277268,117081964,1,1249,100,117100042,116240800,859242,116.3816480106885
1747352964370968,117176604,1,1250,100,117193742,116335440,858302,116.5091075169346
1747352964465409,117271244,1,1251,100,117288183,116430080,858103,116.53612678198306
1747352964563661,117365884,1,1252,100,117386435,116524720,861715,116.04764916474704
1747352964657953,117460524,1,1253,100,117480727,116619360,861367,116.09453345670312
1747352964752256,117555164,1,1254,100,117575030,116714000,861030,116.1399718941268
1747352964846037,117649804,1,1255,100,117668811,116808640,860171,116.25595375803184
1747352964940429,117744444,1,1256,100,117763203,116903280,859923,116.28948173266676
1747352965038466,117839084,1,1257,100,117861240,116997920,863320,115.83190473984156
1747352965132896,117933724,1,1258,100,117955670,117092560,863110,115.86008735850588
1747352965231341,118028364,1,1259,100,118054115,117187200,866915,115.35156272529602
1747352965325477,118123004,1,1260,100,118148251,117281840,866411,115.41866389046308
1747352965419951,118217644,1,1261,100,118242725,117376480,866245,115.4407817649741
1747352965513324,118312284,1,1262,100,118336098,117471120,864978,115.60987678299333
1747352965608261,118406924,1,1263,100,118431035,117565760,865275,115.57019444685216
1747352965706463,118501564,1,1264,100,118529237,117660400,868837,115.09638746968648
1747352965800865,118596204,1,1265,100,118623639,117755040,868599,115.12792439318947
1747352965898631,118690852,1,1266,100,118721405,117849688,871717,114.716129202482
1747352965988342,118785484,1,1267,100,118811116,117944320,866796,115.36739901891563
1747352966086782,118880124,1,1268,100,118909556,118038960,870596,114.86384040358558
1747352966181693,118974764,1,1269,100,119004467,118133600,870867,114.828096597988
1747352966275671,119069404,1,1270,100,119098445,118228240,870205,114.91545095695842
1747352966369387,119164044,1,1271,100,119192161,118322880,869281,115.03760003957294
1747352966467830,119258684,1,1272,100,119290604,118417520,873084,114.5365165322008
1747352966561839,119353324,1,1273,100,119384613,118512160,872453,114.61935485349926
1747352966656536,119447964,1,1274,100,119479310,118606800,872510,114.61186691270014
1747352966754445,119542604,1,1275,100,119577219,118701440,875779,114.18405785021108
1747352966849303,119637244,1,1276,100,119672077,118796080,875997,114.15564208553224
1747352966947253,119731884,1,1277,100,119770027,118890720,879307,113.7259228005691
1747352967050032,119826524,1,1278,100,119872806,118985360,887446,112.68291253777696
1747352967135400,119921164,1,1279,100,119958174,119080000,878174,113.8726493838351
1747352967233772,120015804,1,1280,100,120056546,119174640,881906,113.39076953779654
1747352967528688,120305964,1,1283,100,120351462,119464800,886662,112.78254847957848
1747352967618497,120400604,1,1284,100,120441271,119559440,881831,113.40041345790746
1747352967713119,120495244,1,1285,100,120535893,119654080,881813,113.40272824283608
1747352967811425,120589884,1,1286,100,120634199,119748720,885479,112.93322597147984
1747352968004458,120782284,1,1288,100,120827232,119941120,886112,112.85255137048138
1747352968097973,120876924,1,1289,100,120920747,120035760,884987,112.996010110883
1747352968192924,120971564,1,1290,100,121015698,120130400,885298,112.95631527463068
1747352968286755,121066204,1,1291,100,121109529,120225040,884489,113.05963104120006
1747352968384849,121160844,1,1292,100,121207623,120319680,887943,112.6198415889308
1747352968478743,121255484,1,1293,100,121301517,120414320,887197,112.71453803383014
1747352968576850,121350124,1,1294,100,121399624,120508960,890664,112.27578525684208
1747352968773375,121542524,1,1296,100,121596149,120701360,894789,111.7581910372166
1747352968864062,121637164,1,1297,100,121686836,120796000,890836,112.25410737778896
1747352968962225,121731804,1,1298,100,121784999,120890640,894359,111.81192339988752
1747352969056844,121826444,1,1299,100,121879618,120985280,894338,111.81454886183973
1747352969150689,121921084,1,1300,100,121973463,121079920,893543,111.91403211708894
1747352969261116,122015724,1,1301,100,122083890,121174560,909330,109.97107760658947
1747352969371481,122113484,1,1302,100,122194255,121272320,921935,108.46751669043914
1747352969446117,122208124,1,1303,100,122268891,121366960,901931,110.87322644415148
1747352969535964,122302764,1,1304,100,122358738,121461600,897138,111.46557162889098
1747352969629765,122397404,1,1305,100,122452539,121556240,896299,111.5699113800194
1747352969739923,122492044,1,1306,100,122562697,121650880,911817,109.6711291849132
1747352969831032,122586684,1,1307,100,122653806,121745520,908286,110.09748030906565
1747352969920806,122681324,1,1308,100,122743580,121840160,903420,110.69048725952491
1747352970027217,122775964,1,1309,100,122849991,121934800,915191,109.26680878636265
1747352970108914,122870604,1,1310,100,122931688,122029440,902248,110.83427173016732
1747352970198796,122965244,1,1311,100,123021570,122124080,897490,111.42185428249896
1747352970302025,123059884,1,1312,100,123124799,122218720,906079,110.36565244310928
1747352970395589,123154524,1,1313,100,123218363,122313360,905003,110.49687128108968
1747352970616481,123350052,1,1315,100,123439255,122508888,930367,107.48446580757916
1747352971378996,124132124,1,1323,100,124201770,123290960,910810,109.7923826044949
1747352971477118,124226764,1,1324,100,124299892,123385600,914292,109.37424805204463
1747352971571109,124321404,1,1325,100,124393883,123480240,913643,109.45194129435676
1747352971665408,124416044,1,1326,100,124488182,123574880,913302,109.49280741748076
1747352971759899,124510684,1,1327,100,124582673,123669520,913153,109.51067345778856
1747352971854498,124605324,1,1328,100,124677272,123764160,913112,109.51559063948343
1747352971951973,124699964,1,1329,100,124774747,123858800,915947,109.17662266484852
1747352972045973,124797724,1,1330,100,124868747,123956560,912187,109.62664453670136
1747352972140285,124892364,1,1331,100,124963059,124051200,911859,109.6660777598291
1747352972243379,124987004,1,1332,100,125066153,124145840,920313,108.65868459969596
1747352972333807,125081644,1,1333,100,125156581,124240480,916101,109.15826966677254
1747352972428028,125176284,1,1334,100,125250802,124335120,915682,109.20821857369698
1747352972525676,125270924,1,1335,100,125348450,124429760,918690,108.85064602858418
1747352972619571,125365564,1,1336,100,125442345,124524400,917945,108.93898871936771
1747352972922893,125655724,1,1339,100,125745667,124814560,931107,107.39904221534152
1747352973103763,125848124,1,1341,100,125926537,125006960,919577,108.74565153325932
1747352973218366,125942764,1,1342,100,126041140,125101600,939540,106.43506396747344
1747352973791081,126526204,1,1348,100,126613855,125685040,928815,107.66406657945878
1747352973885397,126620844,1,1349,100,126708171,125779680,928491,107.70163631096048
1747352973987848,126715484,1,1350,100,126810622,125874320,936302,106.80314684791873
1747352974077320,126810132,1,1351,100,126900094,125968968,931126,107.39685069475024
1747352974172128,126904764,1,1352,100,126994902,126063600,931302,107.3765545440684
1747352974282567,126999404,1,1353,100,127105341,126158240,947101,105.5853599563299
1747352974376917,127094044,1,1354,100,127199691,126252880,946811,105.61769983660942
1747352975544556,128267164,1,1366,100,128367330,127426000,941330,106.23267079557648
1747352975859561,128557324,1,1369,100,128682335,127716160,966175,103.50091857065232
1747352975949432,128655084,1,1370,100,128772206,127813920,958286,104.35298021676202
1747352976031833,128749724,1,1371,100,128854607,127908560,946047,105.70299361448215
1747352976126338,128844364,1,1372,100,128949112,128003200,945912,105.71807948308088
1747352976219844,128939004,1,1373,100,129042618,128097840,944778,105.84497098789345
1747352976314533,129033644,1,1374,100,129137307,128192480,944827,105.8394817252259
1747352976408025,129128284,1,1375,100,129230799,128287120,943679,105.96823708061746
1747352976502745,129222924,1,1376,100,129325519,128381760,943759,105.95925442830216
1747352976600822,129317564,1,1377,100,129423596,128476400,947196,105.57477016372536
1747352976699434,129412204,1,1378,100,129522208,128571040,951168,105.13389853317184
1747352976789571,129506844,1,1379,100,129612345,128665680,946665,105.6339887922338
1747352976887110,129601484,1,1380,100,129709884,128760320,949564,105.3114903260865
1747352976981608,129696124,1,1381,100,129804382,128854960,949422,105.327241205702
1747352977075584,129790764,1,1382,100,129898358,128949600,948758,105.40095577586698
1747352977169966,129885404,1,1383,100,129992740,129044240,948500,105.42962572482868
1747352977268796,129980044,1,1384,100,130091570,129138880,952690,104.96593855293956
1747352977362997,130074684,1,1385,100,130185771,129233520,952251,105.01432920522004
1747352977457211,130169324,1,1386,100,130279985,129328160,951825,105.06132955112548
1747352977555086,130263964,1,1387,100,130377860,129422800,955060,104.70546353108703
1747352977649383,130358604,1,1388,100,130472157,129517440,954717,104.7430809339312
1747352977743436,130453244,1,1389,100,130566210,129612080,954130,104.80752098770608
1747352977838443,130547884,1,1390,100,130661217,129706720,954497,104.7672229456981
1747352977936085,130642524,1,1391,100,130758859,129801360,957499,104.4387513720641
1747352978030640,130737172,1,1392,100,130853414,129896008,957406,104.44889628851293
1747352978124003,130831804,1,1393,100,130946777,129990640,956137,104.58752249939076
1747352978218579,130926444,1,1394,100,131041353,130085280,956073,104.59452363993128
1747352978316451,131021084,1,1395,100,131139225,130179920,959305,104.2421336279911
1747352978411219,131115724,1,1396,100,131233993,130274560,959433,104.22822646292131
1747352978505758,131210364,1,1397,100,131328532,130369200,959332,104.23919977651116
1747352978603752,131305004,1,1398,100,131426526,130463840,962686,103.8760301905294
1747352978697865,131399644,1,1399,100,131520639,130558480,962159,103.9329258469754
1747352978795861,131494284,1,1400,100,131618635,130653120,965515,103.57166900566018
1747352978886333,131588924,1,1401,100,131709107,130747760,961347,104.02071260429378
1747352978984732,131683564,1,1402,100,131807506,130842400,965106,103.61556139947322
1747352979079051,131778204,1,1403,100,131901825,130937040,964785,103.65003601838752
1747352979172771,131872844,1,1404,100,131995545,131031680,963865,103.74896899462064
1747352979271567,131967484,1,1405,100,132094341,131126320,968021,103.3035440346852
1747352979364947,132062124,1,1406,100,132187721,131220960,966761,103.43818172226642
1747352979459250,132156764,1,1407,100,132282024,131315600,966424,103.47425146726488
1747352979554290,132251404,1,1408,100,132377064,131410240,966824,103.43144150331396
1747352979651746,132346044,1,1409,100,132474520,131504880,969640,103.1310589497133
1747352979745884,132440684,1,1410,100,132568658,131599520,969138,103.18447940334606
1747352979840736,132535332,1,1411,100,132663510,131694168,969342,103.1627640193038
1747352979935161,132629964,1,1412,100,132757935,131788800,969135,103.18479881543853
1747352980033497,132724604,1,1413,100,132856271,131883440,972831,102.79277695714876
1747352980127549,132819244,1,1414,100,132950323,131978080,972243,102.85494470003898
1747352980221483,132913884,1,1415,100,133044257,132072720,971537,102.92968770103457
1747352980319507,133008524,1,1416,100,133142281,132167360,974921,102.57241355966278
1747352980414423,133103164,1,1417,100,133237197,132262000,975197,102.54338354199204
1747352980508614,133197804,1,1418,100,133331388,132356640,974748,102.59061829313832
1747352980602164,133292444,1,1419,100,133424938,132451280,973658,102.7054674228528
1747352980700989,133387084,1,1420,100,133523763,132545920,977843,102.26590567197393
1747352980794927,133481724,1,1421,100,133617701,132640560,977141,102.3393757912113
1747352980889597,133576364,1,1422,100,133712371,132735200,977171,102.33623388332236
1747352980983836,133671004,1,1423,100,133806610,132829840,976770,102.37824667014752
1747352981080788,133765644,1,1424,100,133903562,132924480,979082,102.13649112127484
1747352981175276,133860284,1,1425,100,133998050,133019120,978930,102.1523500148121
1747352981270198,133954924,1,1426,100,134092972,133113760,979212,102.12293150002247
1747352981368206,134049564,1,1427,100,134190980,133208400,982580,101.77288363288486
1747352981461976,134144204,1,1428,100,134284750,133303040,981710,101.86307565370628
1747352981556751,134238844,1,1429,100,134379525,133397680,981845,101.84906986336948
1747352981655383,134333484,1,1430,100,134478157,133492320,985837,101.43664723478628
1747352981749380,134428124,1,1431,100,134572154,133586960,985194,101.50285121509064
1747352981843236,134522764,1,1432,100,134666010,133681600,984410,101.5836897227781
1747352981937241,134617404,1,1433,100,134760015,133776240,983775,101.64925923102336
1747352982036238,134712044,1,1434,100,134859012,133870880,988132,101.2010541101796
1747352982130271,134806684,1,1435,100,134953045,133965520,987525,101.263259157996
1747352982228796,134901324,1,1436,100,135051570,134060160,991410,100.86644274316376
1747352982519507,135191484,1,1439,100,135342281,134350320,991961,100.8104149255868
1747352982612913,135286124,1,1440,100,135435687,134444960,990727,100.93597933638632
1747352982707260,135380764,1,1441,100,135530034,134539600,990434,100.965839217959
1747352982801751,135475404,1,1442,100,135624525,134634240,990285,100.98103071338048
1747352982900441,135570044,1,1443,100,135723215,134728880,994335,100.56972750632332
1747352982994527,135664684,1,1444,100,135817301,134823520,993781,100.62579179919922
1747352983088218,135759324,1,1445,100,135910992,134918160,992832,100.72197511764328
1747352983182859,135853964,1,1446,100,136005633,135012800,992833,100.72187366858272
1747352983281395,135948604,1,1447,100,136104169,135107440,996729,100.32817345537252
1747352983375571,136043244,1,1448,100,136198345,135202080,996265,100.37490025244288
1747352983469687,136137884,1,1449,100,136292461,135296720,995741,100.42772166657797
1747352983567341,136232524,1,1450,100,136390115,135391360,998755,100.12465519571867
1747352983661661,136327164,1,1451,100,136484435,135486000,998435,100.15674530640452
1747352983755652,136421804,1,1452,100,136578426,135580640,997786,100.22189126726572
1747352983850000,136516444,1,1453,100,136672774,135675280,997494,100.25122958133082
1747352983948212,136611084,1,1454,100,136770986,135769920,1001066,99.89351351459344
1747352984042734,136705724,1,1455,100,136865508,135864560,1000948,99.90528978528356
1747352984137344,136800364,1,1456,100,136960118,135959200,1000918,99.90828419510888
1747352984235142,136895004,1,1457,100,137057916,136053840,1004076,99.5940546333146
1747352984329162,136989644,1,1458,100,137151936,136148480,1003456,99.65559027999235
1747352984436366,137084284,1,1459,100,137259140,136243120,1016020,98.42325938465778
1747352984522092,137178924,1,1460,100,137344866,136337760,1007106,99.2944138948631
1747352984616304,137273564,1,1461,100,137439078,136432400,1006678,99.33662998496044
1747352984709918,137368204,1,1462,100,137532692,136527040,1005652,99.43797655650263
1747352984807347,137462844,1,1463,100,137630121,136621680,1008441,99.1629654089828
1747352984996909,137655244,1,1465,100,137819683,136814080,1005603,99.4428218690676
1747352985095538,137749884,1,1466,100,137918312,136908720,1009592,99.049913232276
1747352985189187,137844524,1,1467,100,138011961,137003360,1008601,99.14723463490516
1747352985283604,137939164,1,1468,100,138106378,137098000,1008378,99.16916077106006
1747352985381683,138033804,1,1469,100,138204457,137192640,1011817,98.83210106175326
1747352985476585,138128444,1,1470,100,138299359,137287280,1012079,98.80651609212325
1747352985570027,138223084,1,1471,100,138392801,137381920,1010881,98.92361217591387
1747352985665189,138317724,1,1472,100,138487963,137476560,1011403,98.8725562411818
1747352985763007,138412364,1,1473,100,138585781,137571200,1014581,98.5628550110834
1747352985856553,138507004,1,1474,100,138679327,137665840,1013487,98.66924785419052
1747352985950964,138601644,1,1475,100,138773738,137760480,1013258,98.69154746372593
1747352986045867,138696284,1,1476,100,138868641,137855120,1013521,98.6659378542724
1747352986143734,138790932,1,1477,100,138966508,137949768,1016740,98.35356138245766
1747352986237921,138885564,1,1478,100,139060695,138044400,1016295,98.3966269636277
1747352986332369,138980204,1,1479,100,139155143,138139040,1016103,98.41521971689878
1747352986430596,139074844,1,1480,100,139253370,138233680,1019690,98.0690209769636
1747352986525075,139169484,1,1481,100,139347849,138328320,1019529,98.0845076501012
1747352986619230,139264124,1,1482,100,139442004,138422960,1019044,98.13118962478558
1747352986712884,139358764,1,1483,100,139535658,138517600,1018058,98.22623072555788
1747352986811587,139453404,1,1484,100,139634361,138612240,1022121,97.83577482509408
1747352986905445,139548044,1,1485,100,139728219,138706880,1021339,97.91068391591824
1747352987000177,139642684,1,1486,100,139822951,138801520,1021431,97.90186512843256
1747352987098220,139737324,1,1487,100,139920994,138896160,1024834,97.57677828799592
1747352987192700,139831964,1,1488,100,140015474,138990800,1024674,97.59201463099484
1747352987286835,139926604,1,1489,100,140109609,139085440,1024169,97.6401355635642
1747352987380830,140021244,1,1490,100,140203604,139180080,1023524,97.70166600880876
1747352987478712,140115884,1,1491,100,140301486,139274720,1026766,97.3931742967726
1747352987573683,140210524,1,1492,100,140396457,139369360,1027097,97.36178764031052
1747352987671793,140305164,1,1493,100,140494567,139464000,1030567,97.0339628573397
1747352987765118,140399804,1,1494,100,140587892,139558640,1029252,97.1579360545328
1747352987860345,140494444,1,1495,100,140683119,139653280,1029839,97.1025568074233
1747352987953719,140589092,1,1496,100,140776493,139747928,1028565,97.22282986490887
1747352988048406,140683724,1,1497,100,140871180,139842560,1028620,97.21763138962882
1747352988155068,140778364,1,1498,100,140977842,139937200,1040642,96.09452626359496
1747352988241129,140873004,1,1499,100,141063903,140031840,1032063,96.89330980763772
1747352988343002,140967644,1,1500,100,141165776,140126480,1039296,96.21897900117004
1747351963754720,109580,1,1,12,0,0,0,0.0
1747351963840605,197404,1,2,12,85885,87824,-1939,0.0
1747351963930698,285804,1,3,12,175978,176224,-246,0.0
1747351964020371,374204,1,4,12,265651,264624,1027,11684.518013631938
1747351964106461,462604,1,5,12,351741,353024,-1283,0.0
1747351964197102,551004,1,6,12,442382,441424,958,12526.096033402922
1747351964286870,639404,1,7,12,532150,529824,2326,5159.071367153912
1747351964376977,727804,1,8,12,622257,618224,4033,2975.45251673692
1747351964663499,1000284,1,11,12,908779,890704,18075,663.9004149377593
1747351964753696,1090764,1,12,12,998976,981184,17792,674.4604316546763
1747351964835861,1181244,1,13,12,1081141,1071664,9477,1266.2234884457107
1747351964926166,1271724,1,14,12,1171446,1162144,9302,1290.0451515803054
1747351965015670,1362204,1,15,12,1260950,1252624,8326,1441.268316118184
1747351965106312,1452684,1,16,12,1351592,1343104,8488,1413.760603204524
1747351965208649,1543164,1,17,12,1453929,1433584,20345,589.8255099533055
1747351965290074,1633644,1,18,12,1535354,1524064,11290,1062.887511071745
1747351965385058,1724124,1,19,12,1630338,1614544,15794,759.7821957705459
1747351965479331,1814604,1,20,12,1724611,1705024,19587,612.6512482769184
1747351965576707,1905084,1,21,12,1821987,1795504,26483,453.1208699920704
1747351965663643,1995564,1,22,12,1908923,1885984,22939,523.1265530319542
1747351965752999,2086044,1,23,12,1998279,1976464,21815,550.0802200320879
1747351965847470,2176524,1,24,12,2092750,2066944,25806,465.0081376424088
1747351965937482,2267004,1,25,12,2182762,2157424,25338,473.5969689793985
1747351966027912,2357484,1,26,12,2273192,2247904,25288,474.5333755140778
1747351966109544,2447964,1,27,12,2354824,2338384,16440,729.92700729927
1747351966199573,2538444,1,28,12,2444853,2428864,15989,750.5159797360685
1747351966293707,2628924,1,29,12,2538987,2519344,19643,610.9046479661965
1747351966383977,2719404,1,30,12,2629257,2609824,19433,617.5063037101837
1747351966477963,2809892,1,31,12,2723243,2700312,22931,523.3090576076054
1747351966568441,2900364,1,32,12,2813721,2790784,22937,523.1721672407028
1747351966658265,2990844,1,33,12,2903545,2881264,22281,538.5754678874378
1747351966756861,3081324,1,34,12,3002141,2971744,30397,394.7758002434451
1747351966838786,3171804,1,35,12,3084066,3062224,21842,549.4002380734365
1747351966940694,3262284,1,36,12,3185974,3152704,33270,360.6853020739405
1747351967031096,3352764,1,37,12,3276376,3243184,33192,361.532899493854
1747351967116850,3443244,1,38,12,3362130,3333664,28466,421.5555399423874
1747351967214670,3533724,1,39,12,3459950,3424144,35806,335.1393621180808
1747351967301810,3624204,1,40,12,3547090,3514624,32466,369.6174459434485
1747351967387070,3714684,1,41,12,3632350,3605104,27246,440.43162299053074
1747351967481558,3805164,1,42,12,3726838,3695584,31254,383.95085429065085
1747351967567551,3895644,1,43,12,3812831,3786064,26767,448.3132215040909
1747351967661461,3986124,1,44,12,3906741,3876544,30197,397.3904692519124
1747351967755839,4076604,1,45,12,4001119,3967024,34095,351.9577650681918
1747351967853908,4167084,1,46,12,4099188,4057504,41684,287.8802418194031
1747351967932398,4257564,1,47,12,4177678,4147984,29694,404.1220448575469
1747351968026479,4348044,1,48,12,4271759,4238464,33295,360.4144766481454
1747351968116354,4438524,1,49,12,4361634,4328944,32690,367.0847353930866
1747351968210282,4529004,1,50,12,4455562,4419424,36138,332.06043499916984
1747351968296761,4619484,1,51,12,4542041,4509904,32137,373.4013753617326
1747351968391270,4709964,1,52,12,4636550,4600384,36166,331.8033512138473
1747351968480881,4800444,1,53,12,4726161,4690864,35297,339.97223560075923
1747351968574592,4890924,1,54,12,4819872,4781344,38528,311.4617940199336
1747351968661733,4981404,1,55,12,4907013,4871824,35189,341.0156583023104
1747351968755806,5071892,1,56,12,5001086,4962312,38774,309.48573786558
1747351968847037,5162364,1,57,12,5092317,5052784,39533,303.54387473756105
1747351968935107,5252844,1,58,12,5180387,5143264,37123,323.2497373595884
1747351969025005,5343324,1,59,12,5270285,5233744,36541,328.39823759612494
1747351969120018,5433804,1,60,12,5365298,5324224,41074,292.1556215610849
1747351969209762,5524284,1,61,12,5455042,5414704,40338,297.48624126134166
1747351969299990,5614764,1,62,12,5545270,5505184,40086,299.356383774884
1747351969389971,5705244,1,63,12,5635251,5595664,39587,303.12981534342083
1747351969484534,5795724,1,64,12,5729814,5686144,43670,274.7881841080833
1747351969578353,5886204,1,65,12,5823633,5776624,47009,255.2702673956051
1747351969664146,5976684,1,66,12,5909426,5867104,42322,283.54047540286376
1747351969767184,6067164,1,67,12,6012464,5957584,54880,218.6588921282799
1747351969860809,6157644,1,68,12,6106089,6048064,58025,206.80741059887976
1747351969951661,6248124,1,69,12,6196941,6138544,58397,205.49000804835865
1747351970037671,6338604,1,70,12,6282951,6229024,53927,222.52304040647545
1747351970131458,6429084,1,71,12,6376738,6319504,57234,209.6655833944858
1747351970225672,6519564,1,72,12,6470952,6409984,60968,196.82456370555045
1747351970308058,6610044,1,73,12,6553338,6500464,52874,226.9546468963952
1747351970406151,6700524,1,74,12,6651431,6590944,60487,198.38973663762465
1747351970496130,6791004,1,75,12,6741410,6681424,59986,200.0466775580969
1747351970582055,6881484,1,76,12,6827335,6771904,55431,216.485360177518
1747351970680017,6971964,1,77,12,6925297,6862384,62913,190.73959277096944
1747351970770738,7062444,1,78,12,7016018,6952864,63154,190.011717389239
1747351970856616,7152924,1,79,12,7101896,7043344,58552,204.9460308785353
1747351970954875,7243404,1,80,12,7200155,7133824,66331,180.91088631258387
1747351971044942,7333884,1,81,12,7290222,7224304,65918,182.0443581419339
1747351971131204,7424364,1,82,12,7376484,7314784,61700,194.48946515397083
1747351971225223,7514844,1,83,12,7470503,7405264,65239,183.9390548598231
1747351971318912,7605324,1,84,12,7564192,7495744,68448,175.3155680224404
1747351971404929,7695804,1,85,12,7650209,7586224,63985,187.5439556145972
1747351971499087,7786284,1,86,12,7744367,7676704,67663,177.34951154988693
1747351971585375,7876764,1,87,12,7830655,7767184,63471,189.0627215578768
1747351971683589,7967244,1,88,12,7928869,7857664,71205,168.52749104697702
1747351971773419,8057724,1,89,12,8018699,7948144,70555,170.0800793707037
1747351971863617,8148204,1,90,12,8108897,8038624,70273,170.76259729910493
1747351971949608,8238684,1,91,12,8194888,8129104,65784,182.41517694272164
1747351972044481,8329164,1,92,12,8289761,8219584,70177,170.9961953346538
1747351972134333,8419644,1,93,12,8379613,8310064,69549,172.54022343958937
1747351972223771,8510124,1,94,12,8469051,8400544,68507,175.1645817215759
1747351972315112,8600612,1,95,12,8560392,8491032,69360,173.01038062283737
1747351972408711,8691084,1,96,12,8653991,8581504,72487,165.54692565563482
1747351972502669,8781564,1,97,12,8747949,8671984,75965,157.9674850259988
1747351972589209,8872044,1,98,12,8834489,8762464,72025,166.60881638320026
1747351972679014,8962524,1,99,12,8924294,8852944,71350,168.18500350385426
1747351972773012,9053004,1,100,12,9018292,8943424,74868,160.28209648982207
1747351972859584,9144524,1,101,12,9104864,9034944,69920,171.62471395881008
1747351972962099,9236044,1,102,12,9207379,9126464,80915,148.30377556695296
1747351973051373,9327564,1,103,12,9296653,9217984,78669,152.53784845364757
1747351973142232,9419084,1,104,12,9387512,9309504,78008,153.8303763716542
1747351973236317,9510604,1,105,12,9481597,9401024,80573,148.9332654859568
1747351973321830,9602124,1,106,12,9567110,9492544,74566,160.93125553201193
1747351973419979,9693644,1,107,12,9665259,9584064,81195,147.79235174579716
1747351973506864,9785164,1,108,12,9752144,9675584,76560,156.7398119122257
1747351973600264,9876684,1,109,12,9845544,9767104,78440,152.9831718510964
1747351973698526,9968204,1,110,12,9943806,9858624,85182,140.87483271113618
1747351973788876,10059724,1,111,12,10034156,9950144,84012,142.836737608913
1747351973878980,10152284,1,112,12,10124260,10042704,81556,147.138162734808
1747351973977765,10247964,1,113,12,10223045,10138384,84661,141.7417701184725
1747351974067502,10340524,1,114,12,10312782,10230944,81838,146.63114934382563
1747351974357926,10624444,1,117,12,10603206,10514864,88342,135.83572932467
1747351974448568,10717004,1,118,12,10693848,10607424,86424,138.8503193557345
1747351974542477,10809564,1,119,12,10787757,10699984,87773,136.71630227974433
1747351974632556,10902124,1,120,12,10877836,10792544,85292,140.69314824368053
1747351974727003,10994684,1,121,12,10972283,10885104,87179,137.64782803198017
1747351974821633,11087244,1,122,12,11066913,10977664,89249,134.45528801443157
1747351974914897,11179804,1,123,12,11160177,11070224,89953,133.40299934410191
1747351975009875,11272364,1,124,12,11255155,11162784,92371,129.9109027725152
1747351975099247,11364924,1,125,12,11344527,11255344,89183,134.55479183252413
1747351975194068,11457484,1,126,12,11439348,11347904,91444,131.22785529941822
1747351975288154,11550044,1,127,12,11533434,11440464,92970,129.07389480477573
1747351975382354,11642604,1,128,12,11627634,11533024,94610,126.83648662932036
1747351975472306,11735164,1,129,12,11717586,11625584,92002,130.43194713158408
1747351975566647,11827724,1,130,12,11811927,11718144,93783,127.95495985413132
1747351975660488,11920284,1,131,12,11905768,11810704,95064,126.23074981065388
1747351975758787,12012844,1,132,12,12004067,11903264,100803,119.0440760691646
1747351975845573,12105404,1,133,12,12090853,11995824,95029,126.27724168411748
1747351975938879,12197964,1,134,12,12184159,12088384,95775,125.29365700861392
1747351976032776,12290524,1,135,12,12278056,12180944,97112,123.56866298706647
1747351976127651,12383084,1,136,12,12372931,12273504,99427,120.69156265400746
1747351976217457,12475644,1,137,12,12462737,12366064,96673,124.12979839251912
1747351976311957,12568204,1,138,12,12557237,12458624,98613,121.6878099236409
1747351976405976,12660772,1,139,12,12651256,12551192,100064,119.92324912056284
1747351976499857,12753324,1,140,12,12745137,12643744,101393,118.35136547887922
1747351976594431,12845884,1,141,12,12839711,12736304,103407,116.0463024746874
1747351976684242,12938444,1,142,12,12929522,12828864,100658,119.21556160464148
1747351976779156,13031004,1,143,12,13024436,12921424,103012,116.49128256902108
1747351976881220,13123564,1,144,12,13126500,13013984,112516,106.65149845355327
1747351976966720,13216124,1,145,12,13212000,13106544,105456,113.79153390987712
1747351977056935,13308684,1,146,12,13302215,13199104,103111,116.37943575370232
1747351977151365,13401244,1,147,12,13396645,13291664,104981,114.30639830064489
1747351977246100,13493804,1,148,12,13491380,13384224,107156,111.98626301840308
1747351977339785,13586364,1,149,12,13585065,13476784,108281,110.82276669037044
1747351977429599,13678924,1,150,12,13674879,13569344,105535,113.706353342493
1747351977524096,13771484,1,151,12,13769376,13661904,107472,111.65698972755696
1747351977618870,13864044,1,152,12,13864150,13754464,109686,109.40320551392156
1747351977712713,13956604,1,153,12,13957993,13847024,110969,108.13830889707936
1747351977802377,14049164,1,154,12,14047657,13939584,108073,111.0360589601473
1747351977908737,14141724,1,155,12,14154017,14032144,121873,98.46315426714696
1747351977991210,14234284,1,156,12,14236490,14124704,111786,107.34796843969728
1747351978085663,14326844,1,157,12,14330943,14217264,113679,105.56039374026864
1747351978179527,14419404,1,158,12,14424807,14309824,114983,104.3632536983728
1747351978269354,14511964,1,159,12,14514634,14402384,112250,106.90423162583518
1747351978364179,14604524,1,160,12,14609459,14494944,114515,104.7897655328996
1747351978458176,14697084,1,161,12,14703456,14587504,115952,103.49109976542016
1747351978552295,14789652,1,162,12,14797575,14680072,117503,102.1250521263287
1747351978642462,14882204,1,163,12,14887742,14772624,115118,104.24086589412605
1747351978736488,14974764,1,164,12,14981768,14865184,116584,102.93007616825638
1747351978830995,15067324,1,165,12,15076275,14957744,118531,101.23933823219242
1747351978924482,15159884,1,166,12,15169762,15050304,119458,100.45371595037588
1747351979014922,15252444,1,167,12,15260202,15142864,117338,102.26865976921373
1747351979109369,15345004,1,168,12,15354649,15235424,119225,100.65003145313484
1747351979203584,15437564,1,169,12,15448864,15327984,120880,99.27200529450695
1747351979297905,15530124,1,170,12,15543185,15420544,122641,97.84656028571196
1747351979391486,15625804,1,171,12,15636766,15516224,120542,99.55036418841566
1747351979481366,15718364,1,172,12,15726646,15608784,117862,101.81398584785596
1747351979580715,15810924,1,173,12,15825995,15701344,124651,96.26878244057409
1747351979674548,15903484,1,174,12,15919828,15793904,125924,95.29557510879576
1747351979765107,15996044,1,175,12,16010387,15886464,123923,96.8343245402387
1747351979859285,16088604,1,176,12,16104565,15979024,125541,95.5863024828542
1747351979952973,16181164,1,177,12,16198253,16071584,126669,94.73509698505552
1747351980047030,16273724,1,178,12,16292310,16164144,128166,93.62857544122464
1747351980137026,16366284,1,179,12,16382306,16256704,125602,95.53987993821757
1747351980231873,16458844,1,180,12,16477153,16349264,127889,93.83136939064345
1747351980325698,16551404,1,181,12,16570978,16441824,129154,92.91233720984252
1747351980419993,16643964,1,182,12,16665273,16534384,130889,91.68073711312638
1747351980510314,16736524,1,183,12,16755594,16626944,128650,93.27633113097552
1747351980604647,16829084,1,184,12,16849927,16719504,130423,92.0083114174647
1747351980698539,16921644,1,185,12,16943819,16812064,131755,91.0781374520891
1747351980792650,17014204,1,186,12,17037930,16904624,133306,90.01845378302552
1747351980886375,17106764,1,187,12,17131655,16997184,134471,89.23857188538793
1747351980977124,17199324,1,188,12,17222404,17089744,132660,90.45680687471732
1747351981071186,17291884,1,189,12,17316466,17182304,134162,89.44410488812034
1747351981164906,17384444,1,190,12,17410186,17274864,135322,88.67737692319061
1747351981259079,17477004,1,191,12,17504359,17367424,136935,87.6328184905247
1747351981349540,17569564,1,192,12,17594820,17459984,134836,88.99700376753982
1747351981443485,17662124,1,193,12,17688765,17552544,136221,88.09214438302463
1747351981537715,17754684,1,194,12,17782995,17645104,137891,87.02525908144838
1747351981632490,17847244,1,195,12,17877770,17737664,140106,85.64943685495267
1747351981722981,17939804,1,196,12,17968261,17830224,138037,86.93321355868355
1747351981816328,18032364,1,197,12,18061608,17922784,138824,86.44038494784763
1747351981910634,18124924,1,198,12,18155914,18015344,140570,85.36672120651633
1747351982004497,18217484,1,199,12,18249777,18107904,141873,84.5826901524603
1747351982095571,18310044,1,200,12,18340851,18200464,140387,85.47800009972433
1747351982193712,18402604,1,201,12,18438992,18293024,145968,82.20979940808945
1747351982283856,18495164,1,202,12,18529136,18385584,143552,83.5934016941596
1747351982377197,18587724,1,203,12,18622477,18478144,144333,83.14106960986054
1747351982472253,18680284,1,204,12,18717533,18570704,146829,81.72772408720348
1747351982562421,18772844,1,205,12,18807701,18663264,144437,83.08120495440919
1747351982656262,18865404,1,206,12,18901542,18755824,145718,82.35084203735984
1747351982750953,18957964,1,207,12,18996233,18848384,147849,81.16389018525658
1747351982844781,19050532,1,208,12,19090061,18940952,149109,80.47803955495644
1747351982935012,19143084,1,209,12,19180292,19033504,146788,81.75055181622476
1747351983029348,19235644,1,210,12,19274628,19126064,148564,80.7732694327024
1747351983123312,19328204,1,211,12,19368592,19218624,149968,80.01707030833245
1747351983217247,19420764,1,212,12,19462527,19311184,151343,79.29008939957579
1747351983307219,19513324,1,213,12,19552499,19403744,148755,80.66955732580418
1747351983402168,19605884,1,214,12,19647448,19496304,151144,79.3944847297941
1747351983496011,19698444,1,215,12,19741291,19588864,152427,78.72620992343876
1747351983590714,19791004,1,216,12,19835994,19681424,154570,77.63472860192792
1747351983680552,19883564,1,217,12,19925832,19773984,151848,79.0263948158685
1747351983774850,19976124,1,218,12,20020130,19866544,153586,78.13212141731668
1747351983868285,20068684,1,219,12,20113565,19959104,154461,77.68951385786704
1747351983962270,20161244,1,220,12,20207550,20051664,155886,76.97933104961318
1747351984053100,20253804,1,221,12,20298380,20144224,154156,77.8432237473728
1747351984147513,20346364,1,222,12,20392793,20236784,156009,76.91863930927062
1747351984241110,20438924,1,223,12,20486390,20329344,157046,76.41073316098469
1747351984343271,20531484,1,224,12,20588551,20421904,166647,72.00849700264632
1747351984429882,20624044,1,225,12,20675162,20514464,160698,74.6742336556771
1747351984519327,20716604,1,226,12,20764607,20607024,157583,76.15034616678194
1747351984613963,20809164,1,227,12,20859243,20699584,159659,75.1601851445894
1747351984708326,20901724,1,228,12,20953606,20792144,161462,74.32089284165934
1747351984802080,20994284,1,229,12,21047360,20884704,162656,73.77532952980523
1747351984892322,21086844,1,230,12,21137602,20977264,160338,74.84189649365715
1747351984986787,21179412,1,231,12,21232067,21069832,162235,73.96677658951522
1747351985080681,21271964,1,232,12,21325961,21162384,163577,73.35994669177207
1747351985175175,21364524,1,233,12,21420455,21254944,165511,72.50273395725964
1747351985265508,21457084,1,234,12,21510788,21347504,163284,73.49158521349305
1747351985359176,21549644,1,235,12,21604456,21440064,164392,72.9962528590199
1747351985453186,21642204,1,236,12,21698466,21532624,165842,72.3580275201698
1747351985548101,21734764,1,237,12,21793381,21625184,168197,71.34491102695054
1747351985641663,21827324,1,238,12,21886943,21717744,169199,70.92240497875284
1747351985731265,21919884,1,239,12,21976545,21810304,166241,72.1843588525093
1747351985826511,22012444,1,240,12,22071791,21902864,168927,71.03660160897903
1747351985920202,22105004,1,241,12,22165482,21995424,170058,70.5641604629009
1747351986014884,22197564,1,242,12,22260164,22087984,172180,69.69450574979672
1747351986104887,22290124,1,243,12,22350167,22180544,169623,70.74512300808263
1747351986199036,22382684,1,244,12,22444316,22273104,171212,70.08854519543023
1747351986293383,22475244,1,245,12,22538663,22365664,172999,69.36456280094104
1747351986387117,22567804,1,246,12,22632397,22458224,174173,68.89701618505738
1747351986477330,22660364,1,247,12,22722610,22550784,171826,69.83809202332591
1747351986571322,22752924,1,248,12,22816602,22643344,173258,69.2608710708885
1747351986665639,22845484,1,249,12,22910919,22735904,175015,68.56555152415507
1747351986759714,22938044,1,250,12,23004994,22828464,176530,67.97711437149493
1747351986850257,23030604,1,251,12,23095537,22921024,174513,68.76278558044386
1747351986944572,23123164,1,252,12,23189852,23013584,176268,68.0781537204711
1747351987038344,23215724,1,253,12,23283624,23106144,177480,67.6132521974307
1747351987133134,23308284,1,254,12,23378414,23198704,179710,66.77424739858661
1747351987226550,23400844,1,255,12,23471830,23291264,180566,66.457694139539
1747351987317397,23493404,1,256,12,23562677,23383824,178853,67.09420585620593
1747351987411646,23585964,1,257,12,23656926,23476384,180542,66.46652856399065
1747351987505353,23678524,1,258,12,23750633,23568944,181689,66.0469263411654
1747351987603637,23771084,1,259,12,23848917,23661504,187413,64.0297097853404
1747351987689984,23863644,1,260,12,23935264,23754064,181200,66.2251655629139
1747351987784533,23956204,1,261,12,24029813,23846624,183189,65.50611663364067
1747351987878467,24048764,1,262,12,24123747,23939184,184563,65.01844898489946
1747351987972862,24141324,1,263,12,24218142,24031744,186398,64.37837315851029
1747351988062492,24233884,1,264,12,24307772,24124304,183468,65.40650140623978
1747351988177315,24326444,1,265,12,24422595,24216864,205731,58.32859413505986
1747351988250929,24419004,1,266,12,24496209,24309424,186785,64.24498755253366
1747351988344844,24511564,1,267,12,24590124,24401984,188140,63.78228978420325
1747351988434974,24604124,1,268,12,24680254,24494544,185710,64.61687577405633
1747351988529967,24696684,1,269,12,24775247,24587104,188143,63.78127275529783
1747351988623858,24789244,1,270,12,24869138,24679664,189474,63.3332277779537
1747351988717320,24881804,1,271,12,24962600,24772224,190376,63.03315543976132
1747351988811542,24974372,1,272,12,25056822,24864792,192030,62.49023590064052
1747351988901606,25066924,1,273,12,25146886,24957344,189542,63.310506378533525
1747351988996342,25159484,1,274,12,25241622,25049904,191718,62.59193189997809
1747351989090708,25252044,1,275,12,25335988,25142464,193524,62.00781298443604
1747351989184920,25344604,1,276,12,25430200,25235024,195176,61.48296921752675
1747351989274803,25437164,1,277,12,25520083,25327584,192499,62.33798617135673
1747351989369498,25529724,1,278,12,25614778,25420144,194634,61.65418169487346
1747351989463435,25622284,1,279,12,25708715,25512704,196011,61.22105392044325
1747351989557059,25714844,1,280,12,25802339,25605264,197075,60.89052391221616
1747351989651559,25810524,1,281,12,25896839,25700944,195895,61.25730620995941
1747351989745949,25903084,1,282,12,25991229,25793504,197725,60.69035276267543
1747351989839810,25995644,1,283,12,26085090,25886064,199026,60.29362997799282
1747351989930415,26088204,1,284,12,26175695,25978624,197071,60.891759822602005
1747351990024780,26180764,1,285,12,26270060,26071184,198876,60.33910577445242
1747351990118372,26273324,1,286,12,26363652,26163744,199908,60.02761270184285
1747351990212583,26365884,1,287,12,26457863,26256304,201559,59.53591752290893
1747351990401272,26554124,1,289,12,26646552,26444544,202008,59.403587976713794
1747351990495098,26646684,1,290,12,26740378,26537104,203274,59.033619646388615
1747351990588953,26739244,1,291,12,26834233,26629664,204569,58.65991425875866
1747351990679644,26831804,1,292,12,26924924,26722224,202700,59.20078934385792
1747351990773802,26924364,1,293,12,27019082,26814784,204298,58.73772626261637
1747351990868031,27016924,1,294,12,27113311,26907344,205967,58.26176037908985
1747351990962003,27109484,1,295,12,27207283,26999904,207379,57.86506830489104
1747351991052140,27202044,1,296,12,27297420,27092464,204956,58.54915201311501
1747351991146697,27294604,1,297,12,27391977,27185024,206953,57.984179982894666
1747351991240533,27387164,1,298,12,27485813,27277584,208229,57.6288605333551
1747351991334992,27479724,1,299,12,27580272,27370144,210128,57.10804842762506
1747351991425411,27572284,1,300,12,27670691,27462704,207987,57.69591368691312
1747351991519474,27664844,1,301,12,27764754,27555264,209490,57.28197049978519
1747351991612942,27757404,1,302,12,27858222,27647824,210398,57.03476268785825
1747351991707505,27849964,1,303,12,27952785,27740384,212401,56.49690914826201
1747351991801432,27942524,1,304,12,28046712,27832944,213768,56.13562366677893
1747351991891809,28035092,1,305,12,28137089,27925512,211577,56.7169399320342
1747351991985756,28127644,1,306,12,28231036,28018064,212972,56.34543508066788
1747351992080413,28220204,1,307,12,28325693,28110624,215069,55.79604685008067
1747351992174751,28312764,1,308,12,28420031,28203184,216847,55.3385566782109
1747351992264398,28405324,1,309,12,28509678,28295744,213934,56.0920657772958
1747351992358987,28497884,1,310,12,28604267,28388304,215963,55.5650736468747
1747351992453657,28590444,1,311,12,28698937,28480864,218073,55.02744493816291
1747351992546659,28683004,1,312,12,28791939,28573424,218515,54.91613848019587
1747351992932265,29065724,1,316,12,29177545,28956144,221401,54.20029719829631
1747351993026625,29158284,1,317,12,29271905,29048704,223201,53.76319998566314
1747351993117008,29250844,1,318,12,29362288,29141264,221024,54.29274648906906
1747351993210815,29343404,1,319,12,29456095,29233824,222271,53.98814960116255
1747351993301148,29435964,1,320,12,29546428,29326384,220044,54.53454763592736
1747351993399416,29528524,1,321,12,29644696,29418944,225752,53.15567525426131
1747351993489112,29621084,1,322,12,29734392,29511504,222888,53.83869925702595
1747351993583629,29713644,1,323,12,29828909,29604064,224845,53.37009940181014
1747351993677333,29806204,1,324,12,29922613,29696624,225989,53.09992964259322
1747351993772238,29898772,1,325,12,30017518,29789192,228326,52.556432469363976
1747351993861586,29991324,1,326,12,30106866,29881744,225122,53.30443048658061
1747351993955750,30083884,1,327,12,30201030,29974304,226726,52.927321965720736
1747351994050478,30176444,1,328,12,30295758,30066864,228894,52.42601378804163
1747351994145025,30269004,1,329,12,30390305,30159424,230881,51.97482685885802
1747351994238613,30361564,1,330,12,30483893,30251984,231909,51.74443423929213
1747351994329157,30454124,1,331,12,30574437,30344544,229893,52.19819655230912
1747351994423609,30546684,1,332,12,30668889,30437104,231785,51.77211640097504
1747351994516901,30639244,1,333,12,30762181,30529664,232517,51.60912965503598
1747351994611894,30731804,1,334,12,30857174,30622224,234950,51.074696743988085
1747351994705903,30827484,1,335,12,30951183,30717904,233279,51.440549728008094
1747351994800287,30920044,1,336,12,31045567,30810464,235103,51.04145842460539
1747351994894005,31012604,1,337,12,31139285,30903024,236261,50.791285908380985
1747351994984607,31105164,1,338,12,31229887,30995584,234303,51.215733473323006
1747351995078753,31197724,1,339,12,31324033,31088144,235889,50.87138442233424
1747351995172501,31290284,1,340,12,31417781,31180704,237077,50.61646638012122
1747351995267305,31382844,1,341,12,31512585,31273264,239321,50.14185967800569
1747351995357433,31475404,1,342,12,31602713,31365824,236889,50.65663665260945
1747351995450790,31567964,1,343,12,31696070,31458384,237686,50.48677667174339
1747351995545716,31660524,1,344,12,31790996,31550944,240052,49.98916901338044
1747351995639291,31753084,1,345,12,31884571,31643504,241067,49.77869223079061
1747351995733865,31845644,1,346,12,31979145,31736064,243081,49.36626062917299
1747351995824185,31938204,1,347,12,32069465,31828624,240841,49.82540348196528
1747351995918334,32030764,1,348,12,32163614,31921184,242430,49.49882440292043
1747351996012740,32123324,1,349,12,32258020,32013744,244276,49.124760516792485
1747351996106882,32215884,1,350,12,32352162,32106304,245858,48.80866191053372
1747351996196489,32308444,1,351,12,32441769,32198864,242905,49.4020296000494
1747351996290751,32401004,1,352,12,32536031,32291424,244607,49.058285331163866
1747351996384956,32493564,1,353,12,32630236,32383984,246252,48.73056868573656
1747351996479505,32586124,1,354,12,32724785,32476544,248241,48.340121092003336
1747351996569025,32678684,1,355,12,32814305,32569104,245201,48.93944151940653
1747351996663146,32771244,1,356,12,32908426,32661664,246762,48.62985386728913
1747351996753833,32863804,1,357,12,32999113,32754224,244889,49.00179264891441
1747351996848074,32956364,1,358,12,33093354,32846784,246570,48.6677211339579
1747351996942452,33048924,1,359,12,33187732,32939344,248388,48.31151263346055
1747351997036448,33141484,1,360,12,33281728,33031904,249824,48.03381580632766
1747351997155112,33234044,1,361,12,33400392,33124464,275928,43.489605984169785
1747351997224908,33326604,1,362,12,33470188,33217024,253164,47.40010428022941
1747351997318323,33419164,1,363,12,33563603,33309584,254019,47.24056074545605
1747351997408782,33511724,1,364,12,33654062,33402144,251918,47.63454774966458
1747351997502989,33604284,1,365,12,33748269,33494704,253565,47.3251434543411
1747351997597118,33696844,1,366,12,33842398,33587264,255134,47.034107567004
1747351997691031,33789404,1,367,12,33936311,33679824,256487,46.78599695111253
1747351997781441,33881964,1,368,12,34026721,33772384,254337,47.18149541749726
1747351998162151,34261564,1,372,12,34407431,34151984,255447,46.97647652937792
1747351998453475,34548604,1,375,12,34698755,34439024,259731,46.20164708871872
1747351998551888,34641164,1,376,12,34797168,34531584,265584,45.18344478583048
1747351998642195,34733724,1,377,12,34887475,34624144,263331,45.57002403818768
1747351998735624,34826284,1,378,12,34980904,34716704,264200,45.42013626040878
1747351998821991,34918844,1,379,12,35067271,34809264,258007,46.510365997821765
1747351998920465,35011404,1,380,12,35165745,34901824,263921,45.46815145441249
1747351999010299,35103964,1,381,12,35255579,34994384,261195,45.942686498593005
1747351999104944,35196524,1,382,12,35350224,35086944,263280,45.57885141294439
1747351999198276,35289084,1,383,12,35443556,35179504,264052,45.44559404965688
1747351999288981,35381644,1,384,12,35534261,35272064,262197,45.76711404020641
1747351999387711,35474204,1,385,12,35632991,35364624,268367,44.71488670365581
1747351999476886,35566764,1,386,12,35722166,35457184,264982,45.28609490455956
1747351999571353,35659324,1,387,12,35816633,35549744,266889,44.9625125051988
1747351999665563,35751884,1,388,12,35910843,35642304,268539,44.68624669042485
1747351999755400,35844444,1,389,12,36000680,35734864,265816,45.14400938995395
1747351999850072,35937004,1,390,12,36095352,35827424,267928,44.7881520408468
1747351999943731,36029564,1,391,12,36189011,35919984,269027,44.605188326822216
1747352000038365,36122124,1,392,12,36283645,36012544,271101,44.2639459094581
1747352000132051,36214684,1,393,12,36377331,36105104,272227,44.0808589890055
1747352000226276,36307244,1,394,12,36471556,36197664,273892,43.81288975216509
1747352000317279,36399804,1,395,12,36562559,36290224,272335,44.06337782510512
1747352000411292,36492364,1,396,12,36656572,36382784,273788,43.82953233888995
1747352000501213,36584924,1,397,12,36746493,36475344,271149,44.25611010920196
1747352000599879,36677484,1,398,12,36845159,36567904,277255,43.281455699626704
1747352000690113,36770044,1,399,12,36935393,36660464,274929,43.64763266152352
1747352000780056,36862604,1,400,12,37025336,36753024,272312,44.06709950351068
1747352000877724,36955172,1,401,12,37123004,36845592,277412,43.25696076593659
1747352000972564,37047724,1,402,12,37217844,36938144,279700,42.90311047550947
1747352001066210,37140284,1,403,12,37311490,37030704,280786,42.73717350580157
1747352001152166,37232844,1,404,12,37397446,37123264,274182,43.76654922642624
1747352001250400,37325404,1,405,12,37495680,37215824,279856,42.879195014578926
1747352001344622,37417964,1,406,12,37589902,37308384,281518,42.62604877840849
1747352001439333,37510524,1,407,12,37684613,37400944,283669,42.302824771124094
1747352001533494,37603084,1,408,12,37778774,37493504,285270,42.06541171521716
1747352001623158,37695644,1,409,12,37868438,37586064,282374,42.496830444729326
1747352001713328,37788204,1,410,12,37958608,37678624,279984,42.85959197668438
1747352001807338,37880764,1,411,12,38052618,37771184,281434,42.63877143486573
1747352001902189,37973324,1,412,12,38147469,37863744,283725,42.294475284166005
1747352001996436,38065884,1,413,12,38241716,37956304,285412,42.04448306308074
1747352002089702,38158444,1,414,12,38334982,38048864,286118,41.9407377375768
1747352002180015,38251004,1,415,12,38425295,38141424,283871,42.27272246900881
1747352002275008,38343564,1,416,12,38520288,38233984,286304,41.91349055549346
1747352002369217,38436124,1,417,12,38614497,38326544,287953,41.67346754505076
1747352002459178,38528684,1,418,12,38704458,38419104,285354,42.05302886940432
1747352002552996,38621244,1,419,12,38798276,38511664,286612,41.86844933219824
1747352002647008,38713804,1,420,12,38892288,38604224,288064,41.65740946456343
1747352002741679,38806364,1,421,12,38986959,38696784,290175,41.35435513052468
1747352002836350,38898924,1,422,12,39081630,38789344,292286,41.05567834244541
1747352002930328,38991484,1,423,12,39175608,38881904,293704,40.85746193446463
1747352003020083,39084052,1,424,12,39265363,38974472,290891,41.25256539391043
1747352003118163,39176604,1,425,12,39363443,39067024,296419,40.48323488035518
1747352003208398,39269164,1,426,12,39453678,39159584,294094,40.80328058375893
1747352003302761,39361724,1,427,12,39548041,39252144,295897,40.55465246352615
1747352003396947,39454284,1,428,12,39642227,39344704,297523,40.33301627101098
1747352003486875,39546844,1,429,12,39732155,39437264,294891,40.69300182101183
1747352003581203,39639404,1,430,12,39826483,39529824,296659,40.45048355182213
1747352003675191,39731964,1,431,12,39920471,39622384,298087,40.25670357982737
1747352003769198,39824524,1,432,12,40014478,39714944,299534,40.06222999726241
1747352003859418,39917084,1,433,12,40104698,39807504,297194,40.377665767142
1747352003954041,40009644,1,434,12,40199321,39900064,299257,40.09931263094932
1747352004047696,40102204,1,435,12,40292976,39992624,300352,39.9531216705732
1747352004141861,40194764,1,436,12,40387141,40085184,301957,39.74075779001646
1747352004231968,40287324,1,437,12,40477248,40177744,299504,40.06624285485336
1747352004326494,40379884,1,438,12,40571774,40270304,301470,39.80495571698676
1747352004420973,40472444,1,439,12,40666253,40362864,303389,39.55318089976894
1747352004515347,40565004,1,440,12,40760627,40455424,305203,39.31809320353994
1747352004609078,40657564,1,441,12,40854358,40547984,306374,39.16781450123053
1747352004695335,40750124,1,442,12,40940615,40640544,300071,39.99053557324767
1747352004789013,40842684,1,443,12,41034293,40733104,301189,39.84209250669846
1747352004883364,40935244,1,444,12,41128644,40825664,302980,39.60657469139877
1747352004973997,41027804,1,445,12,41219277,40918224,301053,39.86009108030812
1747352005067453,41120364,1,446,12,41312733,41010784,301949,39.74181070313198
1747352005162416,41212924,1,447,12,41407696,41103344,304352,39.42803070129324
1747352005256602,41305484,1,448,12,41501882,41195904,305978,39.21850590565335
1747352005346962,41398044,1,449,12,41592242,41288464,303778,39.50253145389067
1747352005440319,41490604,1,450,12,41685599,41381024,304575,39.39916276779119
1747352005534380,41583164,1,451,12,41779660,41473584,306076,39.2059488493054
1747352005628735,41675724,1,452,12,41874015,41566144,307871,38.97736389591744
1747352005722807,41768284,1,453,12,41968087,41658704,309383,38.78687581412036
1747352005813194,41860844,1,454,12,42058474,41751264,307210,39.06122847563556
1747352005907596,41953404,1,455,12,42152876,41843824,309052,38.82841722428588
1747352006002108,42045964,1,456,12,42247388,41936384,311004,38.58471273681367
1747352006095697,42138524,1,457,12,42340977,42028944,312033,38.45747084442991
1747352006186198,42231084,1,458,12,42431478,42121504,309974,38.71292430978082
1747352006284189,42323644,1,459,12,42529469,42214064,315405,38.0463213963
1747352006374184,42416204,1,460,12,42619464,42306624,312840,38.35826620636748
1747352006468669,42508764,1,461,12,42713949,42399184,314765,38.12367957047321
1747352006562917,42601324,1,462,12,42808197,42491744,316453,37.92032308115265
1747352006653004,42693884,1,463,12,42898284,42584304,313980,38.2189948404357
1747352006751132,42786444,1,464,12,42996412,42676864,319548,37.553043674189794
1747352006841187,42879012,1,465,12,43086467,42769432,317035,37.85071048937815
1747352006935318,42971564,1,466,12,43180598,42861984,318614,37.66312842499074
1747352007025381,43064124,1,467,12,43270661,42954544,316117,37.96062850147256
1747352007119656,43156684,1,468,12,43364936,43047104,317832,37.75579551461149
1747352007214098,43249244,1,469,12,43459378,43139664,319714,37.53354560638571
1747352007308180,43341804,1,470,12,43553460,43232224,321236,37.35571355638845
1747352007398660,43434364,1,471,12,43643940,43324784,319156,37.59916780508591
1747352007496487,43526924,1,472,12,43741767,43417344,324423,36.988746173976566
1747352007587077,43619484,1,473,12,43832357,43509904,322453,37.21472586702559
1747352007685206,43712044,1,474,12,43930486,43602464,328022,36.58291212174793
1747352007779337,43804604,1,475,12,44024617,43695024,329593,36.40854022991993
1747352007873472,43897164,1,476,12,44118752,43787584,331168,36.235385061358585
1747352007963769,43989724,1,477,12,44209049,43880144,328905,36.48469922926073
1747352008057284,44082284,1,478,12,44302564,43972704,329860,36.379069908446006
1747352008151467,44174844,1,479,12,44396747,44065264,331483,36.20095148167477
1747352008246301,44267404,1,480,12,44491581,44157824,333757,35.95430208205371
1747352008336215,44359964,1,481,12,44581495,44250384,331111,36.241622899873455
1747352008430536,44452524,1,482,12,44675816,44342944,332872,36.04989305198394
1747352008524247,44545084,1,483,12,44769527,44435504,334023,35.92566978920613
1747352008618436,44637644,1,484,12,44863716,44528064,335652,35.751313860784386
1747352008708862,44730204,1,485,12,44954142,44620624,333518,35.98006704285826
1747352008803122,44822764,1,486,12,45048402,44713184,335218,35.79760036752203
1747352008897436,44915324,1,487,12,45142716,44805744,336972,35.61126740500694
1747352008991205,45007892,1,488,12,45236485,44898312,338173,35.484796243342906
1747352009085874,45100444,1,489,12,45331154,44990864,340290,35.26403949572424
1747352009175951,45193004,1,490,12,45421231,45083424,337807,35.52324256158102
1747352009270461,45285564,1,491,12,45515741,45175984,339757,35.31936060184191
1747352009359789,45378124,1,492,12,45605069,45268544,336525,35.65856919991085
1747352009454193,45470684,1,493,12,45699473,45361104,338369,35.464241700628605
1747352009544261,45563244,1,494,12,45789541,45453664,335877,35.7273644816406
1747352009638392,45655804,1,495,12,45883672,45546224,337448,35.56103458903297
1747352009732444,45748364,1,496,12,45977724,45638784,338940,35.40449637103912
1747352009826676,45840924,1,497,12,46071956,45731344,340612,35.230702382769834
1747352009916681,45933484,1,498,12,46161961,45823904,338057,35.496972404062035
1747352010011972,46026044,1,499,12,46257252,45916464,340788,35.21250748265784
1747352010105400,46118604,1,500,12,46350680,46009024,341656,35.12304774392957
1747352010195663,46211164,1,501,12,46440943,46101584,339359,35.36078312347691
1747352010294064,46303724,1,502,12,46539344,46194144,345200,34.762456546929315
1747352010384218,46396284,1,503,12,46629498,46286704,342794,35.00644702065964
1747352010478427,46488844,1,504,12,46723707,46379264,344443,34.8388557758468
1747352010572251,46581404,1,505,12,46817531,46471824,345707,34.71147532447998
1747352010666729,46673964,1,506,12,46912009,46564384,347625,34.51995685005394
1747352010757318,46766524,1,507,12,47002598,46656944,345654,34.716797722578065
1747352010850545,46859084,1,508,12,47095825,46749504,346321,34.64993459824845
1747352010940850,46951644,1,509,12,47186130,46842064,344066,34.87702940714863
1747352011035518,47044204,1,510,12,47280798,46934624,346174,34.66464841380346
1747352011129812,47136764,1,511,12,47375092,47027184,347908,34.491877162928134
1747352011223802,47229324,1,512,12,47469082,47119744,349338,34.350686154955945
1747352011317791,47321884,1,513,12,47563071,47212304,350767,34.21074388411681
1747352011407891,47414444,1,514,12,47653171,47304864,348307,34.452365298429264
1747352011502339,47507004,1,515,12,47747619,47397424,350195,34.26662288153743
1747352011596078,47599564,1,516,12,47841358,47489984,351374,34.151644686288684
1747352011690242,47692124,1,517,12,47935522,47582544,352978,33.996453036733165
1747352011784411,47784684,1,518,12,48029691,47675104,354587,33.842188235891335
1747352011874519,47877244,1,519,12,48119799,47767664,352135,34.07783946497792
1747352011969567,47969804,1,520,12,48214847,47860224,354623,33.838752703575345
1747352012063741,48062364,1,521,12,48309021,47952784,356237,33.68543974938033
1747352012157626,48154924,1,522,12,48402906,48045344,357562,33.56061326427305
1747352012251359,48247484,1,523,12,48496639,48137904,358735,33.450875994815114
1747352012342190,48340044,1,524,12,48587470,48230464,357006,33.61288045579066
1747352012436613,48432604,1,525,12,48681893,48323024,358869,33.43838559474349
1747352012530313,48525164,1,526,12,48775593,48415584,360009,33.33250002083281
1747352012624788,48617724,1,527,12,48870068,48508144,361924,33.15613222665532
1747352012715328,48710284,1,528,12,48960608,48600704,359904,33.34222459322486
1747352012809856,48802852,1,529,12,49055136,48693272,361864,33.1616297835651
1747352012899623,48895404,1,530,12,49144903,48785824,359079,33.418829839673165
1747352012993319,48987964,1,531,12,49238599,48878384,360215,33.31343780797579
1747352013087097,49080524,1,532,12,49332377,48970944,361433,33.2011742148614
1747352013181741,49173084,1,533,12,49427021,49063504,363517,33.0108358068536
1747352013275568,49265644,1,534,12,49520848,49156064,364784,32.8961796570025
1747352013366149,49358204,1,535,12,49611429,49248624,362805,33.07561913424567
1747352013460551,49450764,1,536,12,49705831,49341184,364647,32.908538943142275
1747352013554557,49543324,1,537,12,49799837,49433744,366093,32.778556268489154
1747352013648286,49635884,1,538,12,49893566,49526304,367262,32.674221672811235
1747352013738951,49728444,1,539,12,49984231,49618864,365367,32.84368867467505
1747352013833196,49821004,1,540,12,50078476,49711424,367052,32.69291544522302
1747352013926286,49913564,1,541,12,50171566,49803984,367582,32.645776996697336
1747352014021498,50006124,1,542,12,50266778,49896544,370234,32.411934074126094
1747352014111044,50098684,1,543,12,50356324,49989104,367220,32.67795871684549
1747352014205422,50191244,1,544,12,50450702,50081664,369038,32.516976571518384
1747352014300118,50283804,1,545,12,50545398,50174224,371174,32.32985068997289
1747352014394087,50376364,1,546,12,50639367,50266784,372583,32.20758864467783
1747352014484094,50468924,1,547,12,50729374,50359344,370030,32.42980298894684
1747352014582279,50561484,1,548,12,50827559,50451904,375655,31.94420412346435
1747352014671769,50654044,1,549,12,50917049,50544464,372585,32.20741575747816
1747352014766898,50746604,1,550,12,51012178,50637024,375154,31.986864061158887
1747352014861086,50839164,1,551,12,51106366,50729584,376782,31.84865519053458
1747352014950475,50931732,1,552,12,51195755,50822152,373603,32.11965642674176
1747352015045223,51024284,1,553,12,51290503,50914704,375799,31.931963629493428
1747352015138545,51116844,1,554,12,51383825,51007264,376561,31.86734685748126
1747352015233654,51209404,1,555,12,51478934,51099824,379110,31.653082218881064
1747352015327827,51301964,1,556,12,51573107,51192384,380723,31.518978364847936
1747352015421981,51394524,1,557,12,51667261,51284944,382317,31.38756581580207
1747352015512361,51487084,1,558,12,51757641,51377504,380137,31.567566429997605
1747352015606450,51579644,1,559,12,51851730,51470064,381666,31.441102953891622
1747352015699927,51672204,1,560,12,51945207,51562624,382583,31.36574285841242
1747352015794290,51764764,1,561,12,52039570,51655184,384386,31.21861878424292
1747352015884305,51857324,1,562,12,52129585,51747744,381841,31.426693309518885
1747352015978458,51949884,1,563,12,52223738,51840304,383434,31.296129190421297
1747352016076970,52042444,1,564,12,52322250,51932864,389386,30.81774896888948
1747352016167365,52135004,1,565,12,52412645,52025424,387221,30.990054774921816
1747352016257220,52227564,1,566,12,52502500,52117984,384516,31.20806416377992
1747352016351786,52320124,1,567,12,52597066,52210544,386522,31.04609828159846
1747352016445480,52412684,1,568,12,52690760,52303104,387656,30.95527993891492
1747352016539491,52505244,1,569,12,52784771,52395664,389107,30.839846109167915
1747352016629759,52597804,1,570,12,52875039,52488224,386815,31.022581854374828
1747352016728256,52690364,1,571,12,52973536,52580784,392752,30.553631808367623
1747352016818729,52782924,1,572,12,53064009,52673344,390665,30.716854594089565
1747352016908688,52875484,1,573,12,53153968,52765904,388064,30.922734394326707
1747352017011078,52968044,1,574,12,53256358,52858464,397894,30.15878600833388
1747352017097266,53060604,1,575,12,53342546,52951024,391522,30.64961866766108
1747352017191645,53153164,1,576,12,53436925,53043584,393341,30.507879931153884
1747352017284789,53245724,1,577,12,53530069,53136144,393925,30.46265151995938
1747352017379475,53338284,1,578,12,53624755,53228704,396051,30.299128142587698
1747352017473940,53430844,1,579,12,53719220,53321264,397956,30.15408738654525
1747352017563979,53523404,1,580,12,53809259,53413824,395435,30.346327462161923
1747352017657712,53615964,1,581,12,53902992,53506384,396608,30.256575762465708
1747352017751898,53708524,1,582,12,53997178,53598944,398234,30.133037359944154
1747352017846505,53801084,1,583,12,54091785,53691504,400281,29.97893979479416
1747352017940500,53893644,1,584,12,54185780,53784064,401716,29.871849764510248
1747352018034826,53986204,1,585,12,54280106,53876624,403482,29.741103692358024
1747352018124998,54078764,1,586,12,54370278,53969184,401094,29.91817379467157
1747352018218711,54171324,1,587,12,54463991,54061744,402247,29.832416400868123
1747352018309347,54263884,1,588,12,54554627,54154304,400323,29.975794545904183
1747352018402971,54356444,1,589,12,54648251,54246864,401387,29.89633446025905
1747352018497607,54449004,1,590,12,54742887,54339424,403463,29.74250426928863
1747352018591835,54541564,1,591,12,54837115,54431984,405131,29.62004882371381
1747352018681639,54634124,1,592,12,54926919,54524544,402375,29.82292637465052
1747352018780072,54726692,1,593,12,55025352,54617112,408240,29.394473838918284
1747352018874205,54819244,1,594,12,55119485,54709664,409821,29.281076372367448
1747352018964605,54911804,1,595,12,55209885,54802224,407661,29.436222743897503
1747352019058786,55004364,1,596,12,55304066,54894784,409282,29.31963780474099
1747352019148853,55096924,1,597,12,55394133,54987344,406789,29.49932274471532
1747352019243468,55189484,1,598,12,55488748,55079904,408844,29.35104832160922
1747352019337418,55282044,1,599,12,55582698,55172464,410234,29.25159786853357
1747352019431553,55374604,1,600,12,55676833,55265024,411809,29.139722541275205
1747352019521655,55467164,1,601,12,55766935,55357584,409351,29.31469570124416
1747352019615884,55559724,1,602,12,55861164,55450144,411020,29.195659578609312
1747352019709896,55652284,1,603,12,55955176,55542704,412472,29.092883880602805
1747352019804263,55744844,1,604,12,56049543,55635264,414279,28.96598669012912
1747352019894788,55837404,1,605,12,56140068,55727824,412244,29.10897429677569
1747352019988528,55929964,1,606,12,56233808,55820384,413424,29.02589109485661
1747352020082726,56022524,1,607,12,56328006,55912944,415062,28.911343365569483
1747352020172604,56115084,1,608,12,56417884,56005504,412380,29.099374363451183
1747352020267445,56207644,1,609,12,56512725,56098064,414661,28.93930222519118
1747352020361384,56300204,1,610,12,56606664,56190624,416040,28.843380444188057
1747352020451479,56392764,1,611,12,56696759,56283184,413575,29.01529347760382
1747352020549799,56485324,1,612,12,56795079,56375744,419335,28.616738407240035
1747352020639771,56577884,1,613,12,56885051,56468304,416747,28.79444843034263
1747352020734417,56670444,1,614,12,56979697,56560864,418833,28.6510375256964
1747352020828619,56763004,1,615,12,57073899,56653424,420475,28.53915214935489
1747352020922011,56855572,1,616,12,57167291,56745992,421299,28.483333689375005
1747352021016372,56948124,1,617,12,57261652,56838544,423108,28.361553078646587
1747352021106265,57040684,1,618,12,57351545,56931104,420441,28.541460038388266
1747352021200942,57133244,1,619,12,57446222,57023664,422558,28.39846837593893
1747352021294674,57225804,1,620,12,57539954,57116224,423730,28.319920704222028
1747352021389309,57318364,1,621,12,57634589,57208784,425805,28.181914256525875
1747352021479725,57410924,1,622,12,57725005,57301344,423661,28.32453305827065
1747352021573722,57503484,1,623,12,57819002,57393904,425098,28.228784891954326
1747352021668214,57596044,1,624,12,57913494,57486464,427030,28.10107018242278
1747352021762229,57688604,1,625,12,58007509,57579024,428485,28.005647805640805
1747352021852178,57781164,1,626,12,58097458,57671584,425874,28.1773482297581
1747352021946125,57873724,1,627,12,58191405,57764144,427261,28.08587725067348
1747352022040122,57966284,1,628,12,58285402,57856704,428698,27.99173310815539
1747352022134561,58058844,1,629,12,58379841,57949264,430577,27.869579657064826
1747352022224513,58151404,1,630,12,58469793,58041824,427969,28.039414069710656
1747352022319330,58243964,1,631,12,58564610,58134384,430226,27.89231706126548
1747352022417044,58336524,1,632,12,58662324,58226944,435380,27.56212963388305
1747352022511525,58429084,1,633,12,58756805,58319504,437301,27.441053187621343
1747352022601605,58521644,1,634,12,58846885,58412064,434821,27.597563135175164
1747352022696252,58614204,1,635,12,58941532,58504624,436908,27.46573649372408
1747352022789770,58706764,1,636,12,59035050,58597184,437866,27.405644649276265
1747352022880310,58799324,1,637,12,59125590,58689744,435846,27.532660618658884
1747352022974273,58891884,1,638,12,59219553,58782304,437249,27.444316625080905
1747352023068261,58984444,1,639,12,59313541,58874864,438677,27.35497872010614
1747352023161845,59077004,1,640,12,59407125,58967424,439701,27.291272933197785
1747352023253276,59169564,1,641,12,59498556,59059984,438572,27.36152786771613
1747352023347080,59262124,1,642,12,59592360,59152544,439816,27.284137002746604
1747352023441315,59354684,1,643,12,59686595,59245104,441491,27.18062202853512
1747352023535267,59447244,1,644,12,59780547,59337664,442883,27.095192183940227
1747352023629798,59539804,1,645,12,59875078,59430224,444854,26.975142406272617
1747352023723785,59632364,1,646,12,59969065,59522784,446281,26.888888390946512
1747352023810015,59724924,1,647,12,60055295,59615344,439951,27.27576480108012
1747352023908156,59817484,1,648,12,60153436,59707904,445532,26.93409227620014
1747352024002400,59910044,1,649,12,60247680,59800464,447216,26.83267146077064
1747352024096330,60002604,1,650,12,60341610,59893024,448586,26.750723384144848
1747352024186097,60095164,1,651,12,60431377,59985584,445793,26.91832307819997
1747352024280460,60187724,1,652,12,60525740,60078144,447596,26.809891062475984
1747352024375250,60280284,1,653,12,60620530,60170704,449826,26.676981766282964
1747352024468844,60372844,1,654,12,60714124,60263264,450860,26.615800913809167
1747352024559142,60465404,1,655,12,60804422,60355824,448598,26.75000780208561
1747352024653735,60557964,1,656,12,60899015,60448384,450631,26.62932643337897
1747352024747586,60650532,1,657,12,60992866,60540952,451914,26.55372482374965
1747352024842079,60743084,1,658,12,61087359,60633504,453855,26.44016260700004
1747352024935822,60835644,1,659,12,61181102,60726064,455038,26.37142392503484
1747352025026289,60928204,1,660,12,61271569,60818624,452945,26.49328284891101
1747352025120745,61020764,1,661,12,61366025,60911184,454841,26.38284587361297
1747352025210435,61113324,1,662,12,61455715,61003744,451971,26.55037601970038
1747352025304635,61205884,1,663,12,61549915,61096304,453611,26.454384924527844
1747352025398712,61298444,1,664,12,61643992,61188864,455128,26.366209066460424
1747352025492861,61391004,1,665,12,61738141,61281424,456717,26.27447631684391
1747352025586988,61483564,1,666,12,61832268,61373984,458284,26.18463660088504
1747352025680989,61576124,1,667,12,61926269,61466544,459725,26.10256131382892
1747352025771470,61668684,1,668,12,62016750,61559104,457646,26.221140357394145
1747352025866235,61761244,1,669,12,62111515,61651664,459851,26.095409165142623
1747352025959598,61853804,1,670,12,62204878,61744224,460654,26.04992033066032
1747352026050397,61946364,1,671,12,62295677,61836784,458893,26.14988679278176
1747352026148891,62038924,1,672,12,62394171,61929344,464827,25.816056296213432
1747352026234797,62131484,1,673,12,62480077,62021904,458173,26.19098026291379
1747352026328815,62224044,1,674,12,62574095,62114464,459631,26.10789959772078
1747352026423233,62316604,1,675,12,62668513,62207024,461489,26.0027866319674
1747352026517450,62409164,1,676,12,62762730,62299584,463146,25.909756318741824
1747352026607034,62501724,1,677,12,62852314,62392144,460170,26.07731925158093
1747352026701012,62594284,1,678,12,62946292,62484704,461588,25.997209632832742
1747352026799639,62686844,1,679,12,63044919,62577264,467655,25.659941623632808
1747352026889031,62779412,1,680,12,63134311,62669832,464479,25.83539837107813
1747352026979822,62871964,1,681,12,63225102,62762384,462718,25.93372205101163
1747352027078302,62964524,1,682,12,63323582,62854944,468638,25.60611815516454
1747352027171987,63057084,1,683,12,63417267,62947504,469763,25.544795992873
1747352027261962,63149644,1,684,12,63507242,63040064,467178,25.686141042600465
1747352027356500,63242204,1,685,12,63601780,63132624,469156,25.577846174833105
1747352027450988,63334764,1,686,12,63696268,63225184,471084,25.47316402170313
1747352027545460,63427324,1,687,12,63790740,63317744,472996,25.37019340544106
1747352027635176,63519884,1,688,12,63880456,63410304,470152,25.5236604332216
1747352027733177,63612444,1,689,12,63978457,63502864,475593,25.23165816149523
1747352027823428,63705004,1,690,12,64068708,63595424,473284,25.35475528435358
1747352027913872,63797564,1,691,12,64159152,63687984,471168,25.46862265688672
1747352028008247,63890124,1,692,12,64253527,63780544,472983,25.370890708545552
1747352028102499,63982684,1,693,12,64347779,63873104,474675,25.280455048190863
1747352028196098,64075244,1,694,12,64441378,63965664,475714,25.225240375519743
1747352028289948,64167804,1,695,12,64535228,64058224,477004,25.15702174405246
1747352028384853,64260364,1,696,12,64630133,64150784,479349,25.033952297803896
1747352028479199,64352924,1,697,12,64724479,64243344,481135,24.941024868280213
1747352028568729,64445484,1,698,12,64814009,64335904,478105,25.099089112224306
1747352028662999,64538044,1,699,12,64908279,64428464,479815,25.00963913174869
1747352028757012,64630604,1,700,12,65002292,64521024,481268,24.93413233375168
1747352028851156,64723164,1,701,12,65096436,64613584,482852,24.852335705350708
1747352028945692,64815724,1,702,12,65190972,64706144,484828,24.751045731682165
1747352029035721,64908284,1,703,12,65281001,64798704,482297,24.880934362021744
1747352029130456,65000844,1,704,12,65375736,64891264,484472,24.769233309664955
1747352029224433,65093404,1,705,12,65469713,64983824,485889,24.69699869723332
1747352029318938,65185964,1,706,12,65564218,65076384,487834,24.598531467671386
1747352029409002,65278524,1,707,12,65654282,65168944,485338,24.72503698453449
1747352029503078,65371084,1,708,12,65748358,65261504,486854,24.648046436919486
1747352029596576,65463644,1,709,12,65841856,65354064,487792,24.600649457145668
1747352029690821,65556204,1,710,12,65936101,65446624,489477,24.515962956379973
1747352029781628,65648764,1,711,12,66026908,65539184,487724,24.604079356357285
1747352029875036,65741324,1,712,12,66120316,65631744,488572,24.5613747820178
1747352029969636,65833884,1,713,12,66214916,65724304,490612,24.459246818259643
1747352030063369,65926444,1,714,12,66308649,65816864,491785,24.40090690037313
1747352030153960,66019004,1,715,12,66399240,65909424,489816,24.49899554118281
1747352030248186,66111564,1,716,12,66493466,66001984,491482,24.415950126352545
1747352030342519,66204124,1,717,12,66587799,66094544,493255,24.32818724594784
1747352030436421,66296684,1,718,12,66681701,66187104,494597,24.262177085586853
1747352030530613,66389244,1,719,12,66775893,66279664,496229,24.18238353663329
1747352030621266,66481804,1,720,12,66866546,66372224,494322,24.275674560306847
1747352030714789,66574372,1,721,12,66960069,66464792,495277,24.228865866979486
1747352030809004,66666924,1,722,12,67054284,66557344,496940,24.14778444077756
1747352030903098,66759484,1,723,12,67148378,66649904,498474,24.073472237268145
1747352030994053,66852044,1,724,12,67239333,66742464,496869,24.15123503378154
1747352031087928,66944604,1,725,12,67333208,66835024,498184,24.0874857482376
1747352031181675,67037164,1,726,12,67426955,66927584,499371,24.03023002937696
1747352031276625,67129724,1,727,12,67521905,67020144,501761,23.915768662769725
1747352031366477,67222284,1,728,12,67611757,67112704,499053,24.04554225703482
1747352031460211,67314844,1,729,12,67705491,67205264,500227,23.98910894453918
1747352031554343,67407404,1,730,12,67799623,67297824,501799,23.91395758062492
1747352031648434,67499964,1,731,12,67893714,67390384,503330,23.84121749150656
1747352031739287,67592524,1,732,12,67984567,67482944,501623,23.92234805820307
1747352031833708,67685084,1,733,12,68078988,67575504,503484,23.83392520914269
1747352031927033,67777644,1,734,12,68172313,67668064,504249,23.797766579606503
1747352032021514,67870204,1,735,12,68266794,67760624,506170,23.7074500661833
1747352032115487,67962764,1,736,12,68360767,67853184,507583,23.641453712988813
1747352032205770,68055324,1,737,12,68451050,67945744,505306,23.747986368655823
1747352032299788,68147884,1,738,12,68545068,68038304,506764,23.67966153870441
1747352032394194,68240444,1,739,12,68639474,68130864,508610,23.59371620691689
1747352032488355,68333004,1,740,12,68733635,68223424,510211,23.51968107312465
1747352032578394,68425564,1,741,12,68823674,68315984,507690,23.636471074868524
1747352032673367,68518124,1,742,12,68918647,68408544,510103,23.52466070577903
1747352032767422,68610684,1,743,12,69012702,68501104,511598,23.45591655948616
1747352032860980,68703252,1,744,12,69106260,68593672,512588,23.41061437255652
1747352032951851,68795804,1,745,12,69197131,68686224,510907,23.487640607781845
1747352033046007,68888364,1,746,12,69291287,68778784,512503,23.41449708587072
1747352033140162,68980924,1,747,12,69385442,68871344,514098,23.34185310971838
1747352033233878,69073484,1,748,12,69479158,68963904,515254,23.28948440963098
1747352033324289,69166044,1,749,12,69569569,69056464,513105,23.38702604730026
1747352033418009,69258604,1,750,12,69663289,69149024,514265,23.33427318600333
1747352033512147,69351164,1,751,12,69757427,69241584,515843,23.262892003962445
1747352033606638,69443724,1,752,12,69851918,69334144,517774,23.17613476149826
1747352033701266,69536284,1,753,12,69946546,69426704,519842,23.08393704240904
1747352033791321,69628844,1,754,12,70036601,69519264,517337,23.19571188606266
1747352033884919,69721404,1,755,12,70130199,69611824,518375,23.14926452857487
1747352033979816,69813964,1,756,12,70225096,69704384,520712,23.04536864908049
1747352034073910,69906524,1,757,12,70319190,69796944,522246,22.977677186613207
1747352034163597,69999084,1,758,12,70408877,69889504,519373,23.10478211227769
1747352034258312,70091644,1,759,12,70503592,69982064,521528,23.00931110122563
1747352034352110,70184204,1,760,12,70597390,70074624,522766,22.95482108629865
1747352034445941,70276764,1,761,12,70691221,70167184,524037,22.899146434316663
1747352034536229,70369324,1,762,12,70781509,70259744,521765,22.998859639876187
1747352034631045,70461884,1,763,12,70876325,70352304,524021,22.89984561687413
1747352034724562,70554444,1,764,12,70969842,70444864,524978,22.858100720411144
1747352034814933,70647004,1,765,12,71060213,70537424,522789,22.95381119342603
1747352034913734,70742684,1,766,12,71159014,70633104,525910,22.81759236371242
1747352035007272,70835244,1,767,12,71252552,70725664,526888,22.775238760419672
1747352035102005,70927804,1,768,12,71347285,70818224,529061,22.681694549399783
1747352035196031,71020364,1,769,12,71441311,70910784,530527,22.619018447694465
1747352035286184,71112924,1,770,12,71531464,71003344,528120,22.72210861167916
1747352035384449,71208604,1,771,12,71629729,71099024,530705,22.611431963143367
1747352035478673,71301164,1,772,12,71723953,71191584,532369,22.54075650535625
1747352035568709,71393724,1,773,12,71813989,71284144,529845,22.648132944540382
1747352035662393,71486284,1,774,12,71907673,71376704,530969,22.60018946492168
1747352035753112,71578844,1,775,12,71998392,71469264,529128,22.678822515535
1747352035851545,71674524,1,776,12,72096825,71564944,531881,22.561437614804813
1747352035945020,71767084,1,777,12,72190300,71657504,532796,22.522691611798887
1747352036039613,71859644,1,778,12,72284893,71750064,534829,22.437078019329544
1747352036134011,71952204,1,779,12,72379291,71842624,536667,22.36023455886052
1747352036223895,72044764,1,780,12,72469175,71935184,533991,22.47228885880099
1747352036317894,72137324,1,781,12,72563174,72027744,535430,22.41189324468185
1747352036412525,72229884,1,782,12,72657805,72120304,537501,22.32553985946073
1747352036506612,72322444,1,783,12,72751892,72212864,539028,22.262294352055925
1747352036600761,72415004,1,784,12,72846041,72305424,540617,22.19686025411705
1747352036690765,72507564,1,785,12,72936045,72397984,538061,22.302304013857164
1747352036784399,72600124,1,786,12,73029679,72490544,539135,22.25787604217868
1747352036879674,72692684,1,787,12,73124954,72583104,541850,22.14635046599612
1747352036973425,72785244,1,788,12,73218705,72675664,543041,22.097778989063443
1747352037063955,72877804,1,789,12,73309235,72768224,541011,22.18069503207883
1747352037157734,72970364,1,790,12,73403014,72860784,542230,22.13083009055198
1747352037251709,73062924,1,791,12,73496989,72953344,543645,22.073227933669948
1747352037345555,73155484,1,792,12,73590835,73045904,544931,22.02113662096669
1747352037436399,73248044,1,793,12,73681679,73138464,543215,22.090700735436243
1747352037530548,73340604,1,794,12,73775828,73231024,544804,22.02626999801764
1747352037624275,73433164,1,795,12,73869555,73323584,545971,21.97918937086402
1747352037718959,73525724,1,796,12,73964239,73416144,548095,21.8940147237249
1747352037813198,73618284,1,797,12,74058478,73508704,549774,21.82715079287125
1747352037902615,73710844,1,798,12,74147895,73601264,546631,21.95265178886672
1747352037997423,73803404,1,799,12,74242703,73693824,548879,21.862742061547262
1747352038091126,73895972,1,800,12,74336406,73786392,550014,21.81762646041737
1747352038186051,73988524,1,801,12,74431331,73878944,552387,21.72390009178348
1747352038275620,74081084,1,802,12,74520900,73971504,549396,21.842168490487737
1747352038370265,74173644,1,803,12,74615545,74064064,551481,21.7595891789563
1747352038468425,74269324,1,804,12,74713705,74159744,553961,21.66217477403644
1747352038557922,74361892,1,805,12,74803202,74252312,550890,21.78293307193813
1747352038652112,74454444,1,806,12,74897392,74344864,552528,21.71835635479107
1747352038746343,74547004,1,807,12,74991623,74437424,554199,21.65287198280762
1747352038841223,74639564,1,808,12,75086503,74529984,556519,21.56260612845204
1747352038930920,74732124,1,809,12,75176200,74622544,553656,21.67410811045125
1747352039025329,74824684,1,810,12,75270609,74715104,555505,21.60196577888588
1747352039119200,74917244,1,811,12,75364480,74807664,556816,21.55110485330881
1747352039214026,75009804,1,812,12,75459306,74900224,559082,21.463756658236186
1747352039304060,75102364,1,813,12,75549340,74992784,556556,21.56117264030933
1747352039398232,75194924,1,814,12,75643512,75085344,558168,21.49890355591865
1747352039492646,75287484,1,815,12,75737926,75177904,560022,21.42772962490759
1747352039585972,75380044,1,816,12,75831252,75270464,560788,21.39846073739096
1747352039680224,75472604,1,817,12,75925504,75363024,562480,21.33409187882236
1747352039770734,75565164,1,818,12,76016014,75455584,560430,21.41212997162893
1747352039865042,75657724,1,819,12,76110322,75548144,562178,21.345552476261968
1747352039958880,75750284,1,820,12,76204160,75640704,563456,21.297137664697868
1747352040053101,75842844,1,821,12,76298381,75733264,565117,21.23454081190267
1747352040143245,75935404,1,822,12,76388525,75825824,562701,21.3257129452409
1747352040233572,76027964,1,823,12,76478852,75918384,560468,21.41067821891705
1747352040331437,76120524,1,824,12,76576717,76010944,565773,21.209919879527657
1747352040426003,76213084,1,825,12,76671283,76103504,567779,21.13498385815608
1747352040516169,76305644,1,826,12,76761449,76196064,565385,21.22447535749976
1747352040610007,76398204,1,827,12,76855287,76288624,566663,21.17660761334338
1747352040704587,76490772,1,828,12,76949867,76381192,568675,21.101683738514968
1747352040799025,76583324,1,829,12,77044305,76473744,570561,21.031931730349605
1747352040892611,76675884,1,830,12,77137891,76566304,571587,20.994179363771394
1747352040982337,76768444,1,831,12,77227617,76658864,568753,21.09878980858123
1747352041077589,76861004,1,832,12,77322869,76751424,571445,20.99939626735732
1747352041171150,76953564,1,833,12,77416430,76843984,572446,20.9626759554613
1747352041265144,77046124,1,834,12,77510424,76936544,573880,20.910294835157178
1747352041356371,77138684,1,835,12,77601651,77029104,572547,20.95897804023076
1747352041449968,77231244,1,836,12,77695248,77121664,573584,20.921085664872106
1747352041544304,77323804,1,837,12,77789584,77214224,575360,20.85650723025584
1747352041638820,77416364,1,838,12,77884100,77306784,577316,20.78584345488433
1747352041753409,77508924,1,839,12,77998689,77399344,599345,20.021857194103564
1747352041847012,77601484,1,840,12,78092292,77491904,600388,19.987075024817283
1747352041913146,77694044,1,841,12,78158426,77584464,573962,20.907307452409743
1747352042011033,77786604,1,842,12,78256313,77677024,579289,20.71504896519699
1747352042101450,77879164,1,843,12,78346730,77769584,577146,20.791965984343648
1747352042195017,77971724,1,844,12,78440297,77862144,578153,20.7557515052244
1747352042289932,78064284,1,845,12,78535212,77954704,580508,20.671549746084462
1747352042384250,78156844,1,846,12,78629530,78047264,582266,20.60913740455393
1747352042478222,78249404,1,847,12,78723502,78139824,583678,20.559280973413426
1747352042568653,78341964,1,848,12,78813933,78232384,581549,20.6345467019976
1747352042662850,78434524,1,849,12,78908130,78324944,583186,20.576625639161435
1747352042756960,78527084,1,850,12,79002240,78417504,584736,20.52208175997373
1747352042847292,78619644,1,851,12,79092572,78510064,582508,20.6005754427407
1747352042941161,78712204,1,852,12,79186441,78602624,583817,20.55438604905304
1747352043035669,78804764,1,853,12,79280949,78695184,585765,20.486031087552178
1747352043130364,78897324,1,854,12,79375644,78787744,587900,20.411634631740093
1747352043223406,78989884,1,855,12,79468686,78880304,588382,20.39491350857096
1747352043313725,79082444,1,856,12,79559005,78972864,586141,20.472889628945936
1747352043408143,79175004,1,857,12,79653423,79065424,587999,20.4081979731258
1747352043502674,79267564,1,858,12,79747954,79157984,589970,20.340017289014696
1747352043596055,79360124,1,859,12,79841335,79250544,590791,20.31175153311408
1747352043687089,79452684,1,860,12,79932369,79343104,589265,20.364352201471323
1747352043777106,79545244,1,861,12,80022386,79435664,586722,20.452616400953094
1747352043870080,79637804,1,862,12,80115360,79528224,587136,20.438194898626552
1747352043964884,79730364,1,863,12,80210164,79620784,589380,20.360378703043875
1747352044058870,79822924,1,864,12,80304150,79713344,590806,20.31123583714451
1747352044148881,79915484,1,865,12,80394161,79805904,588257,20.399247267775817
1747352044247630,80008044,1,866,12,80492910,79898464,594446,20.18686306241441
1747352044337044,80100604,1,867,12,80582324,79991024,591300,20.29426686960933
1747352044435787,80193164,1,868,12,80681067,80083584,597483,20.0842534431942
1747352044526068,80285732,1,869,12,80771348,80176152,595196,20.16142581603372
1747352044616407,80378284,1,870,12,80861687,80268704,592983,20.236667830275067
1747352044710220,80470844,1,871,12,80955500,80361264,594236,20.19399699782578
1747352044804819,80563404,1,872,12,81050099,80453824,596275,20.12494235042556
1747352044894831,80655964,1,873,12,81140111,80546384,593727,20.21130923808417
1747352044992338,80748524,1,874,12,81237618,80638944,598674,20.044297898355364
1747352045086576,80841084,1,875,12,81331856,80731504,600352,19.98827354618624
1747352045177015,80933644,1,876,12,81422295,80824064,598231,20.05914103414901
1747352045271635,81026204,1,877,12,81516915,80916624,600291,19.990304702219422
1747352045361450,81118764,1,878,12,81606730,81009184,597546,20.08213593597815
1747352045459443,81211324,1,879,12,81704723,81101744,602979,19.90119058872697
1747352045549636,81303884,1,880,12,81794916,81194304,600612,19.979620786797465
1747352045643928,81396444,1,881,12,81889208,81286864,602344,19.92217071972162
1747352045734140,81489004,1,882,12,81979420,81379424,599996,20.00013333422223
1747352045832764,81581564,1,883,12,82078044,81471984,606060,19.8000198000198
1747352045922442,81674124,1,884,12,82167722,81564544,603178,19.89462480395505
1747352046021127,81766684,1,885,12,82266407,81657104,609303,19.69463468914481
1747352046110863,81859244,1,886,12,82356143,81749664,606479,19.786340499835937
1747352046201344,81951804,1,887,12,82446624,81842224,604400,19.854401058901388
1747352046298898,82044364,1,888,12,82544178,81934784,609394,19.69169371539595
1747352046393524,82136924,1,889,12,82638804,82027344,611460,19.62515945442057
1747352046479310,82229484,1,890,12,82724590,82119904,604686,19.845010468243025
1747352046577621,82322044,1,891,12,82822901,82212464,610437,19.658048250679432
1747352046672020,82414612,1,892,12,82917300,82305032,612268,19.59926045457218
1747352046765868,82507164,1,893,12,83011148,82397584,613564,19.55786193453332
1747352046859910,82599724,1,894,12,83105190,82490144,615046,19.510735782364247
1747352046950199,82692284,1,895,12,83195479,82582704,612775,19.583044347435848
1747352047044170,82784844,1,896,12,83289450,82675264,614186,19.53805524710756
1747352047134379,82877404,1,897,12,83379659,82767824,611835,19.61313099119861
1747352047233310,82969964,1,898,12,83478590,82860384,618206,19.41100539302433
1747352047323543,83062524,1,899,12,83568823,82952944,615879,19.48434676291934
1747352047417007,83155084,1,900,12,83662287,83045504,616783,19.455789151127707
1747352047511823,83247644,1,901,12,83757103,83138064,619039,19.38488528186431
1747352047605675,83340204,1,902,12,83850955,83230624,620331,19.344511236742967
1747352047695614,83432764,1,903,12,83940894,83323184,617710,19.42659176636285
1747352047790179,83525324,1,904,12,84035459,83415744,619715,19.363739783610207
1747352047879879,83617884,1,905,12,84125159,83508304,616855,19.45351824983181
1747352047974530,83710444,1,906,12,84219810,83600864,618946,19.387797966219992
1747352048068514,83803004,1,907,12,84313794,83693424,620370,19.34329513032545
1747352048162720,83895564,1,908,12,84408000,83785984,622016,19.29210824158864
1747352048257012,83988124,1,909,12,84502292,83878544,623748,19.23853864060486
1747352048343207,84080684,1,910,12,84588487,83971104,617383,19.436881158049378
1747352048445327,84173244,1,911,12,84690607,84063664,626943,19.140496025954512
1747352048535348,84265804,1,912,12,84780628,84156224,624404,19.21832659624218
1747352048625964,84358364,1,913,12,84871244,84248784,622460,19.278347203033125
1747352048723827,84450924,1,914,12,84969107,84341344,627763,19.115494223138352
1747352048818352,84543484,1,915,12,85063632,84433904,629728,19.055846333655168
1747352048908465,84636044,1,916,12,85153745,84526464,627281,19.1301824859991
1747352049002694,84728604,1,917,12,85247974,84619024,628950,19.079418077748628
1747352049096660,84821164,1,918,12,85341940,84711584,630356,19.03686170989092
1747352049190304,84913724,1,919,12,85435584,84804144,631440,19.004180919802355
1747352049280545,85006284,1,920,12,85525825,84896704,629121,19.074232142942293
1747352049370579,85098844,1,921,12,85615859,84989264,626595,19.151126325617025
1747352049465728,85191404,1,922,12,85711008,85081824,629184,19.07232224595667
1747352049555758,85283964,1,923,12,85801038,85174384,626654,19.149323231001475
1747352049653290,85376524,1,924,12,85898570,85266944,631626,18.998584605446894
1747352049747491,85469084,1,925,12,85992771,85359504,633267,18.949353116457985
1747352049841760,85561644,1,926,12,86087040,85452064,634976,18.898352063700045
1747352049935925,85654204,1,927,12,86181205,85544624,636581,18.850703995249624
1747352050026641,85746764,1,928,12,86271921,85637184,634737,18.9054679339632
1747352050120977,85839324,1,929,12,86366257,85729744,636513,18.85271785493776
1747352050215143,85931884,1,930,12,86460423,85822304,638119,18.80526986345807
1747352050309235,86024444,1,931,12,86554515,85914864,639651,18.76023018802441
1747352050399359,86117004,1,932,12,86644639,86007424,637215,18.831948400461386
1747352050493063,86209572,1,933,12,86738343,86099992,638351,18.798435343564904
1747352050583043,86302124,1,934,12,86828323,86192544,635779,18.874483114415543
1747352050678085,86394684,1,935,12,86923365,86285104,638261,18.80108607607233
1747352050772213,86487244,1,936,12,87017493,86377664,639829,18.75501110452949
1747352050865643,86579804,1,937,12,87110923,86470224,640699,18.72954382635216
1747352050960921,86672364,1,938,12,87206201,86562784,643417,18.65042421944089
1747352051054020,86764924,1,939,12,87299300,86655344,643956,18.634813558690347
1747352051144523,86857484,1,940,12,87389803,86747904,641899,18.69452982478552
1747352051238296,86950044,1,941,12,87483576,86840464,643112,18.65926930301409
1747352051332364,87042604,1,942,12,87577644,86933024,644620,18.6156185039248
1747352051422732,87135164,1,943,12,87668012,87025584,642428,18.67913602769493
1747352051520735,87227724,1,944,12,87766015,87118144,647871,18.52220580948985
1747352051615222,87320284,1,945,12,87860502,87210704,649798,18.46727752316874
1747352051702061,87412844,1,946,12,87947341,87303264,644077,18.631312715715666
1747352051800342,87505404,1,947,12,88045622,87395824,649798,18.46727752316874
1747352051890073,87597964,1,948,12,88135353,87488384,646969,18.548029349165105
1747352051987746,87690524,1,949,12,88233026,87580944,652082,18.40259353884941
1747352052074027,87783084,1,950,12,88319307,87673504,645803,18.581517893227502
1747352052168395,87875644,1,951,12,88413675,87766064,647611,18.52964202275749
1747352052263102,87968204,1,952,12,88508382,87858624,649758,18.46841439428218
1747352052356715,88060764,1,953,12,88601995,87951184,650811,18.43853284594145
1747352052446858,88153324,1,954,12,88692138,88043744,648394,18.50726564403742
1747352052545585,88245884,1,955,12,88790865,88136304,654561,18.33289792700757
1747352052639620,88338452,1,956,12,88884900,88228872,656028,18.29190217490717
1747352052729131,88431004,1,957,12,88974411,88321424,652987,18.37708867098426
1747352052823382,88523564,1,958,12,89068662,88413984,654678,18.32962158496238
1747352052913436,88616124,1,959,12,89158716,88506544,652172,18.40005397349165
1747352053011986,88708684,1,960,12,89257266,88599104,658162,18.232593191341948
1747352053106229,88801244,1,961,12,89351509,88691664,659845,18.18608915730209
1747352053200704,88893804,1,962,12,89445984,88784224,661760,18.13346228239845
1747352053290797,88986364,1,963,12,89536077,88876784,659293,18.20131565176636
1747352053380321,89078924,1,964,12,89625601,88969344,656257,18.285519240175724
1747352053478650,89171484,1,965,12,89723930,89061904,662026,18.126176313317
1747352053569353,89264044,1,966,12,89814633,89154464,660169,18.177163726257973
1747352053659342,89356604,1,967,12,89904622,89247024,657598,18.248230681966795
1747352053757351,89449164,1,968,12,90002631,89339584,663047,18.098264527250706
1747352053847082,89541724,1,969,12,90092362,89432144,660218,18.17581465515936
1747352053946360,89634284,1,970,12,90191640,89524704,666936,17.992730936701573
1747352054036549,89726844,1,971,12,90281829,89617264,664565,18.056924454342315
1747352054130591,89819404,1,972,12,90375871,89709824,666047,18.01674656593304
1747352054220610,89911964,1,973,12,90465890,89802384,663506,18.0857445147444
1747352054314988,90004524,1,974,12,90560268,89894944,665324,18.036325158869964
1747352054408608,90097084,1,975,12,90653888,89987504,666384,18.007635237340633
1747352054502395,90189644,1,976,12,90747675,90080064,667611,17.974539065413843
1747352054593512,90282204,1,977,12,90838792,90172624,666168,18.013474078610802
1747352054691744,90374764,1,978,12,90937024,90265184,671840,17.861395570373897
1747352054785872,90467324,1,979,12,91031152,90357744,673408,17.81980612050941
1747352054871276,90559884,1,980,12,91116556,90450304,666252,18.011202968246252
1747352054970421,90652444,1,981,12,91215701,90542864,672837,17.834928816340362
1747352055059696,90745004,1,982,12,91304976,90635424,669552,17.92243171553516
1747352055154056,90837564,1,983,12,91399336,90727984,671352,17.87437886533443
1747352055243889,90930124,1,984,12,91489169,90820544,668625,17.9472798653954
1747352055342355,91022684,1,985,12,91587635,90913104,674531,17.79013862965527
1747352055436826,91115244,1,986,12,91682106,91005664,676442,17.739880137543203
1747352055531247,91207804,1,987,12,91776527,91098224,678303,17.691208796069013
1747352055621403,91300364,1,988,12,91866683,91190784,675899,17.754131904322982
1747352055715751,91392924,1,989,12,91961031,91283344,677687,17.70728964846603
1747352055809020,91485484,1,990,12,92054300,91375904,678396,17.688783542355793
1747352055902619,91578044,1,991,12,92147899,91468464,679435,17.6617336463385
1747352055993841,91670604,1,992,12,92239121,91561024,678097,17.696583232192445
1747352056088150,91763164,1,993,12,92333430,91653584,679846,17.651056268625542
1747352056180601,91855724,1,994,12,92425881,91746144,679737,17.653886723835836
1747352056272134,91948284,1,995,12,92517414,91838704,678710,17.68059996169203
1747352056371011,92040844,1,996,12,92616291,91931264,685027,17.517557702105172
1747352056460584,92133412,1,997,12,92705864,92023832,682032,17.594482370328667
1747352056554593,92225964,1,998,12,92799873,92116384,683489,17.556976044969268
1747352056649256,92318524,1,999,12,92894536,92208944,685592,17.503121389981214
1747352056739299,92411084,1,1000,12,92984579,92301504,683075,17.567617025948834
1747352056841527,92504684,1,1001,12,93086807,92395104,691703,17.348486272287385
1747352056935527,92598292,1,1002,12,93180807,92488712,692095,17.338660155036518
1747352057030553,92691884,1,1003,12,93275833,92582304,693529,17.30280925527267
1747352057123946,92785484,1,1004,12,93369226,92675904,693322,17.307975226518128
1747352057210121,92879084,1,1005,12,93455401,92769504,685897,17.49533822133644
1747352057311985,92972684,1,1006,12,93557265,92863104,694161,17.28705588472991
1747352057410713,93066284,1,1007,12,93655993,92956704,699289,17.160287091603042
1747352057500936,93159884,1,1008,12,93746216,93050304,695912,17.243559530515352
1747352057599408,93253484,1,1009,12,93844688,93143904,700784,17.12367862279961
1747352057689607,93347084,1,1010,12,93934887,93237504,697383,17.207187442194606
1747352057775485,93440684,1,1011,12,94020765,93331104,689661,17.399852971242392
1747352057873777,93534284,1,1012,12,94119057,93424704,694353,17.282275730068136
1747352057976160,93627884,1,1013,12,94221440,93518304,703136,17.066399672325126
1747352058070293,93721484,1,1014,12,94315573,93611904,703669,17.053472584411136
1747352058164357,93815084,1,1015,12,94409637,93705504,704133,17.042234918687235
1747352058258628,93908684,1,1016,12,94503908,93799104,704804,17.026010068047288
1747352058353480,94002284,1,1017,12,94598760,93892704,706056,16.995819028518984
1747352058446629,94095884,1,1018,12,94691909,93986304,705605,17.006682208884573
1747352058536713,94189484,1,1019,12,94781993,94079904,702089,17.091850178538618
1747352058635938,94283084,1,1020,12,94881218,94173504,707714,16.956002000808237
1747352058729835,94376684,1,1021,12,94975115,94267104,708011,16.94888921217326
1747352058815945,94470284,1,1022,12,95061225,94360704,700521,17.130107448598974
1747352058918037,94563884,1,1023,12,95163317,94454304,709013,16.924936496227854
1747352059012410,94657484,1,1024,12,95257690,94547904,709786,16.906504213946175
1747352059106496,94751084,1,1025,12,95351776,94641504,710272,16.89493602450892
1747352059200496,94844684,1,1026,12,95445776,94735104,710672,16.885426751018755
1747352059294991,94938284,1,1027,12,95540271,94828704,711567,16.864188474170387
1747352059388884,95031884,1,1028,12,95634164,94922304,711860,16.857247211530357
1747352059483013,95125484,1,1029,12,95728293,95015904,712389,16.844729494700225
1747352059573169,95219084,1,1030,12,95818449,95109504,708945,16.926559888284704
1747352059672083,95312684,1,1031,12,95917363,95203104,714259,16.800628343500048
1747352059766158,95406284,1,1032,12,96011438,95296704,714734,16.78946293306321
1747352059860433,95499884,1,1033,12,96105713,95390304,715409,16.77362180235362
1747352059954022,95593492,1,1034,12,96199302,95483912,715390,16.77406729196662
1747352060052722,95687084,1,1035,12,96298002,95577504,720498,16.65514685675741
1747352060142912,95780684,1,1036,12,96388192,95671104,717088,16.734347806684816
1747352060241010,95874284,1,1037,12,96486290,95764704,721586,16.630034396454477
1747352060347994,95967884,1,1038,12,96593274,95858304,734970,16.32719702845014
1747352060441831,96061484,1,1039,12,96687111,95951904,735207,16.321933822719316
1747352060519371,96155084,1,1040,12,96764651,96045504,719147,16.68643545756292
1747352060613748,96248684,1,1041,12,96859028,96139104,719924,16.66842611164512
1747352060707550,96342284,1,1042,12,96952830,96232704,720126,16.663750510327358
1747352060806670,96435884,1,1043,12,97051950,96326304,725646,16.53698911039267
1747352060904958,96529484,1,1044,12,97150238,96419904,730334,16.430838493073033
1747352061002621,96623084,1,1045,12,97247901,96513504,734397,16.339936029150447
1747352061084636,96716684,1,1046,12,97329916,96607104,722812,16.601827307792345
1747352061179051,96810284,1,1047,12,97424331,96700704,723627,16.583129153555628
1747352061273244,96903884,1,1048,12,97518524,96794304,724220,16.56955068901715
1747352061371164,96997484,1,1049,12,97616444,96887904,728540,16.471298761907377
1747352061462059,97091084,1,1050,12,97707339,96981504,725835,16.53268304780012
1747352061555233,97184684,1,1051,12,97800513,97075104,725409,16.5423919471636
1747352061662130,97278284,1,1052,12,97907410,97168704,738706,16.244622353141846
1747352061744149,97371884,1,1053,12,97989429,97262304,727125,16.503352243424445
1747352061842638,97465484,1,1054,12,98087918,97355904,732014,16.39312909315942
1747352061932165,97559084,1,1055,12,98177445,97449504,727941,16.48485248117636
1747352062026697,97652684,1,1056,12,98271977,97543104,728873,16.4637735243314
1747352062124778,97746284,1,1057,12,98370058,97636704,733354,16.36317521960745
1747352062227491,97839884,1,1058,12,98472771,97730304,742467,16.162334487593387
1747352062308901,97936604,1,1059,12,98554181,97827024,727157,16.502625980359124
1747352062407629,98030204,1,1060,12,98652909,97920624,732285,16.387062414223973
1747352062502364,98123812,1,1061,12,98747644,98014232,733412,16.361881180018873
1747352062608034,98217404,1,1062,12,98853314,98107824,745490,16.096795396316516
1747352062690545,98311004,1,1063,12,98935825,98201424,734401,16.339847031798705
1747352062784551,98404604,1,1064,12,99029831,98295024,734807,16.330818840865696
1747352062879145,98498204,1,1065,12,99124425,98388624,735801,16.308757395002182
1747352062989786,98591804,1,1066,12,99235066,98482224,752842,15.939599544127454
1747352063067374,98685404,1,1067,12,99312654,98575824,736830,16.285981841130248
1747352063165524,98779004,1,1068,12,99410804,98669424,741380,16.18603145485446
1747352063259764,98872604,1,1069,12,99505044,98763024,742020,16.17207083367025
1747352063353895,98966204,1,1070,12,99599175,98856624,742551,16.160506147052526
1747352063447458,99059804,1,1071,12,99692738,98950224,742514,16.161311436552037
1747352063550812,99153404,1,1072,12,99796092,99043824,752268,15.951761872098771
1747352063636213,99247004,1,1073,12,99881493,99137424,744069,16.127536559109437
1747352063730416,99340604,1,1074,12,99975696,99231024,744672,16.114477246358128
1747352063824604,99434204,1,1075,12,100069884,99324624,745260,16.101763143064165
1747352063927534,99527804,1,1076,12,100172814,99418224,754590,15.902675625173936
1747352064012804,99621404,1,1077,12,100258084,99511824,746260,16.08018653016375
1747352064107333,99715004,1,1078,12,100352613,99605424,747189,16.060193605633916
1747352064197512,99808604,1,1079,12,100442792,99699024,743768,16.13406331006443
1747352064295779,99902204,1,1080,12,100541059,99792624,748435,16.03345647918657
1747352064390507,99995804,1,1081,12,100635787,99886224,749563,16.009328101840673
1747352064492521,100089404,1,1082,12,100737801,99979824,757977,15.831614943461345
1747352064573833,100184044,1,1083,12,100819113,100074464,744649,16.11497497478678
1747352064664144,100278684,1,1084,12,100909424,100169104,740320,16.209206829479143
1747352064771075,100373324,1,1085,12,101016355,100263744,752611,15.94449190883471
1747352064860602,100467964,1,1086,12,101105882,100358384,747498,16.05355465834022
1747352064955596,100562604,1,1087,12,101200876,100453024,747852,16.045955616886765
1747352065049200,100657244,1,1088,12,101294480,100547664,746816,16.06821492844288
1747352065147213,100751884,1,1089,12,101392493,100642304,750189,15.995969015808017
1747352065241843,100846524,1,1090,12,101487123,100736944,750179,15.996182244504311
1747352065336212,100941164,1,1091,12,101581492,100831584,749908,16.00196290744998
1747352065430715,101035804,1,1092,12,101675995,100926224,749771,16.004886825444036
1747352065528394,101130444,1,1093,12,101773674,101020864,752810,15.94027709515017
1747352065622863,101225084,1,1094,12,101868143,101115504,752639,15.943898734984502
1747352065717278,101319724,1,1095,12,101962558,101210144,752414,15.948666558570148
1747352065814846,101414364,1,1096,12,102060126,101304784,755342,15.886843310712235
1747352065909875,101509004,1,1097,12,102155155,101399424,755731,15.878665821568784
1747352066004152,101603644,1,1098,12,102249432,101494064,755368,15.886296480655783
1747352066094166,101698284,1,1099,12,102339446,101588704,750742,15.984186311675648
1747352066188223,101792924,1,1100,12,102433503,101683344,750159,15.99660871895158
1747352066285953,101887564,1,1101,12,102531233,101777984,753249,15.930986964469918
1747352066384730,101982204,1,1102,12,102630010,101872624,757386,15.84396859725424
1747352066474811,102076844,1,1103,12,102720091,101967264,752827,15.939917138997403
1747352066572466,102171484,1,1104,12,102817746,102061904,755842,15.876333942808152
1747352066667460,102266124,1,1105,12,102912740,102156544,756196,15.868901713312422
1747352066761283,102360764,1,1106,12,103006563,102251184,755379,15.886065140810109
1747352066855216,102455404,1,1107,12,103100496,102345824,754672,15.90094769648271
1747352066949831,102550044,1,1108,12,103195111,102440464,754647,15.901474464219696
1747352067047649,102644684,1,1109,12,103292929,102535104,757825,15.834790353973544
1747352067142547,102739324,1,1110,12,103387827,102629744,758083,15.82940126608828
1747352067236678,102833964,1,1111,12,103481958,102724384,757574,15.840036748885256
1747352067334972,102928604,1,1112,12,103580252,102819024,761228,15.76400237510969
1747352067428464,103023244,1,1113,12,103673744,102913664,760080,15.787811809283234
1747352067527578,103117884,1,1114,12,103772858,103008304,764554,15.695425045189744
1747352067617734,103212524,1,1115,12,103863014,103102944,760070,15.78801952451748
1747352067715729,103307164,1,1116,12,103961009,103197584,763425,15.71863640829158
1747352067810243,103401804,1,1117,12,104055523,103292224,763299,15.72123112960976
1747352067903808,103496444,1,1118,12,104149088,103386864,762224,15.743403513927664
1747352068001997,103591084,1,1119,12,104247277,103481504,765773,15.670440195723796
1747352068096367,103685724,1,1120,12,104341647,103576144,765503,15.675967305157522
1747352068191162,103780372,1,1121,12,104436442,103670792,765650,15.67295761771044
1747352068284801,103875004,1,1122,12,104530081,103765424,764657,15.693310857024784
1747352068383099,103969644,1,1123,12,104628379,103860064,768315,15.618593936080904
1747352068489894,104064284,1,1124,12,104735174,103954704,780470,15.37535075018899
1747352068571466,104158924,1,1125,12,104816746,104049344,767402,15.637175821798744
1747352068674364,104253564,1,1126,12,104919644,104143984,775660,15.470695923471624
1747352068764371,104348204,1,1127,12,105009651,104238624,771027,15.563657303829826
1747352068862851,104442844,1,1128,12,105108131,104333264,774867,15.48652865588546
1747352068952894,104537484,1,1129,12,105198174,104427904,770270,15.578952834720292
1747352069055152,104632124,1,1130,12,105300432,104522544,777888,15.426385289398988
1747352069148268,104726764,1,1131,12,105393548,104617184,776364,15.456667233411132
1747352069243510,104821404,1,1132,12,105488790,104711824,776966,15.444691273492015
1747352069341756,104916044,1,1133,12,105587036,104806464,780572,15.373341600774816
1747352069431348,105010684,1,1134,12,105676628,104901104,775524,15.473408946725051
1747352069538023,105105324,1,1135,12,105783303,104995744,787559,15.236953675851586
1747352069632521,105199964,1,1136,12,105877801,105090384,787417,15.239701454248513
1747352069722511,105294604,1,1137,12,105967791,105185024,782767,15.330232367997118
1747352069816465,105389244,1,1138,12,106061745,105279664,782081,15.343679235271026
1747352069915196,105483884,1,1139,12,106160476,105374304,786172,15.263835394799102
1747352070000822,105578532,1,1140,12,106246102,105468952,777150,15.441034549314804
1747352070103932,105673164,1,1141,12,106349212,105563584,785628,15.274404680077597
1747352070201996,105767804,1,1142,12,106447276,105658224,789052,15.208123165520144
1747352070300495,105862444,1,1143,12,106545775,105752864,792911,15.134107106598345
1747352070381883,105957084,1,1144,12,106627163,105847504,779659,15.391344164564252
1747352070484694,106051724,1,1145,12,106729974,105942144,787830,15.23171242526941
1747352070574396,106146364,1,1146,12,106819676,106036784,782892,15.32778467528088
1747352070668403,106241004,1,1147,12,106913683,106131424,782259,15.340187840600109
1747352070762318,106335644,1,1148,12,107007598,106226064,781534,15.354418361837103
1747352070868242,106430284,1,1149,12,107113522,106320704,792818,15.135882384103288
1747352070955519,106524924,1,1150,12,107200799,106415344,785455,15.27776893647631
1747352071050032,106619564,1,1151,12,107295312,106509984,785328,15.280239594156836
1747352071156013,106714204,1,1152,12,107401293,106604624,796669,15.06271738953066
1747352071245957,106808844,1,1153,12,107491237,106699264,791973,15.152031698050312
1747352071340399,106903484,1,1154,12,107585679,106793904,791775,15.155820782419248
1747352071438691,106998124,1,1155,12,107683971,106888544,795427,15.08623670053946
1747352071533212,107092764,1,1156,12,107778492,106983184,795308,15.088494017412122
1747352071627602,107187404,1,1157,12,107872882,107077824,795058,15.093238480714614
1747352071725417,107282044,1,1158,12,107970697,107172464,798233,15.033204590639576
1747352071819229,107376684,1,1159,12,108064509,107267104,797405,15.048814592333882
1747352071914065,107471324,1,1160,12,108159345,107361744,797601,15.045116543234023
1747352072004238,107565964,1,1161,12,108249518,107456384,793134,15.129851954398626
1747352072098049,107660604,1,1162,12,108343329,107551024,792305,15.145682533872687
1747352072195824,107755244,1,1163,12,108441104,107645664,795440,15.085990143819773
1747352072294824,107849884,1,1164,12,108540104,107740304,799800,15.003750937734434
1747352072385208,107944524,1,1165,12,108630488,107834944,795544,15.084017980149431
1747352072479122,108039164,1,1166,12,108724402,107929584,794818,15.097795973417814
1747352072576992,108133804,1,1167,12,108822272,108024224,798048,15.036689522434742
1747352072671005,108228444,1,1168,12,108916285,108118864,797421,15.048512642631684
1747352072778079,108323084,1,1169,12,109023359,108213504,809855,14.817467324397578
1747352072863628,108417724,1,1170,12,109108908,108308144,800764,14.985688667322709
1747352072962421,108512364,1,1171,12,109207701,108402784,804917,14.90836943436404
1747352073056599,108607004,1,1172,12,109301879,108497424,804455,14.916931338608125
1747352073154795,108701644,1,1173,12,109400075,108592064,808011,14.851282965207156
1747352073249569,108796284,1,1174,12,109494849,108686704,808145,14.848820446825757
1747352073343502,108890924,1,1175,12,109588782,108781344,807438,14.861822208020923
1747352073441393,108985564,1,1176,12,109686673,108875984,810689,14.80222378742033
1747352073539665,109080204,1,1177,12,109784945,108970624,814321,14.736203536443249
1747352073630105,109174844,1,1178,12,109875385,109065264,810121,14.812602068086123
1747352073724169,109269484,1,1179,12,109969449,109159904,809545,14.823141394239975
1747352073822315,109364124,1,1180,12,110067595,109254544,813051,14.75922174623732
1747352073912099,109458764,1,1181,12,110157379,109349184,808195,14.847901805876058
1747352074010329,109553404,1,1182,12,110255609,109443824,811785,14.782239139673685
1747352074109239,109648044,1,1183,12,110354519,109538464,816055,14.704891214440204
1747352074203253,109742684,1,1184,12,110448533,109633104,815429,14.716180072084756
1747352074293503,109837332,1,1185,12,110538783,109727752,811031,14.795981904514132
1747352074392045,109931964,1,1186,12,110637325,109822384,814941,14.724992361410212
1747352074489775,110026604,1,1187,12,110735055,109917024,818031,14.66937072066951
1747352074588644,110121244,1,1188,12,110833924,110011664,822260,14.59392406294846
1747352074673813,110215884,1,1189,12,110919093,110106304,812789,14.763979335350257
1747352074776579,110310524,1,1190,12,111021859,110200944,820915,14.61783497682464
1747352074870802,110405164,1,1191,12,111116082,110295584,820498,14.62526416883405
1747352074965455,110499804,1,1192,12,111210735,110390224,820511,14.625032449290748
1747352075062825,110594444,1,1193,12,111308105,110484864,823241,14.576533481690053
1747352075149823,110689084,1,1194,12,111395103,110579504,815599,14.713112693860587
1747352075251978,110783724,1,1195,12,111497258,110674144,823114,14.578782525871263
1747352075345574,110878364,1,1196,12,111590854,110768784,822070,14.597297067159731
1747352075440428,110973004,1,1197,12,111685708,110863424,822284,14.593498110141994
1747352075538762,111067644,1,1198,12,111784042,110958064,825978,14.528231986808365
1747352075632624,111162284,1,1199,12,111877904,111052704,825200,14.54192922927775
1747352075726335,111256924,1,1200,12,111971615,111147344,824271,14.55831880534436
1747352075825272,111351564,1,1201,12,112070552,111241984,828568,14.482818549594
1747352075919143,111446204,1,1202,12,112164423,111336624,827799,14.496272645895925
1747352076013917,111540844,1,1203,12,112259197,111431264,827933,14.493926440907655
1747352076104039,111635492,1,1204,12,112349319,111525912,823407,14.573594832203272
1747352076205952,111730124,1,1205,12,112451232,111620544,830688,14.445856928232985
1747352076296287,111824764,1,1206,12,112541567,111715184,826383,14.52111188153677
1747352076394224,111919404,1,1207,12,112639504,111809824,829680,14.463407578825572
1747352076485054,112014044,1,1208,12,112730334,111904464,825870,14.530131860946636
1747352076587217,112108684,1,1209,12,112832497,111999104,833393,14.398969033817178
1747352076681521,112203324,1,1210,12,112926801,112093744,833057,14.404776623928496
1747352076775133,112297964,1,1211,12,113020413,112188384,832029,14.422574213158436
1747352076865604,112392604,1,1212,12,113110884,112283024,827860,14.495204503176865
1747352076959300,112487244,1,1213,12,113204580,112377664,826916,14.511752100576118
1747352077058339,112581884,1,1214,12,113303619,112472304,831315,14.43496147669656
1747352077152016,112676524,1,1215,12,113397296,112566944,830352,14.451702410543962
1747352077254862,112771164,1,1216,12,113500142,112661584,838558,14.310280266839026
1747352077344363,112865804,1,1217,12,113589643,112756224,833419,14.398519832161254
1747352077438987,112960444,1,1218,12,113684267,112850864,833403,14.398796260632611
1747352077532843,113055084,1,1219,12,113778123,112945504,832619,14.412354270080312
1747352077635672,113149724,1,1220,12,113880952,113040144,840808,14.27198599442441
1747352077729657,113244364,1,1221,12,113974937,113134784,840153,14.283112718754795
1747352077823650,113339004,1,1222,12,114068930,113229424,839506,14.294120589966004
1747352077922511,113433644,1,1223,12,114167791,113324064,843727,14.222609920033376
1747352078016739,113528284,1,1224,12,114262019,113418704,843315,14.229558350082709
1747352078109973,113622924,1,1225,12,114355253,113513344,841909,14.253321914838777
1747352078208929,113717564,1,1226,12,114454209,113607984,846225,14.1806257201099
1747352078302793,113812204,1,1227,12,114548073,113702624,845449,14.193641485175332
1747352078396977,113906844,1,1228,12,114642257,113797264,844993,14.2013010758669
1747352078491982,114001484,1,1229,12,114737262,113891904,845358,14.195169383858673
1747352078589622,114096124,1,1230,12,114834902,113986544,848358,14.144971816143658
1747352078683786,114190764,1,1231,12,114929066,114081184,847882,14.152912787392586
1747352078778205,114285404,1,1232,12,115023485,114175824,847661,14.156602698484418
1747352078872671,114380044,1,1233,12,115117951,114270464,847487,14.15950923141004
1747352078970206,114474684,1,1234,12,115215486,114365104,850382,14.11130527221884
1747352079065238,114569324,1,1235,12,115310518,114459744,850774,14.104803390794734
1747352079159253,114663964,1,1236,12,115404533,114554384,850149,14.11517275207052
1747352079248745,114758604,1,1237,12,115494025,114649024,845001,14.201166625838312
1747352079343842,114853244,1,1238,12,115589122,114743664,845458,14.193490392189794
1747352079445649,114947884,1,1239,12,115690929,114838304,852625,14.074182671162587
1747352079540092,115042524,1,1240,12,115785372,114932944,852428,14.077435278991306
1747352079634308,115137164,1,1241,12,115879588,115027584,852004,14.084440918117757
1747352079732850,115231804,1,1242,12,115978130,115122224,855906,14.020231193612384
1747352079822172,115326444,1,1243,12,116067452,115216864,850588,14.107887720024266
1747352079921144,115421084,1,1244,12,116166424,115311504,854920,14.03640106676648
1747352080018706,115515724,1,1245,12,116263986,115406144,857842,13.988589973444991
1747352080117071,115610364,1,1246,12,116362351,115500784,861567,13.928110059925697
1747352080208062,115705004,1,1247,12,116453342,115595424,857918,13.987350772451448
1747352080305579,115799644,1,1248,12,116550859,115690064,860795,13.940601420779627
1747352080400345,115894292,1,1249,12,116645625,115784712,860913,13.938690669092
1747352080494118,115988924,1,1250,12,116739398,115879344,860054,13.952612277833715
1747352080588415,116083564,1,1251,12,116833695,115973984,859711,13.958178969444385
1747352080691005,116178204,1,1252,12,116936285,116068624,867661,13.830286252349708
1747352080776467,116272844,1,1253,12,117021747,116163264,858483,13.978145170026664
1747352080875599,116367484,1,1254,12,117120879,116257904,862975,13.90538543990266
1747352080973354,116462124,1,1255,12,117218634,116352544,866090,13.855372998187256
1747352081067879,116556764,1,1256,12,117313159,116447184,865975,13.857212968041802
1747352081162222,116651404,1,1257,12,117407502,116541824,865678,13.861967151758506
1747352081256379,116746044,1,1258,12,117501659,116636464,865195,13.869705673287523
1747352081345898,116840684,1,1259,12,117591178,116731104,860074,13.952287826396333
1747352081448128,116935324,1,1260,12,117693408,116825744,867664,13.83023843331059
1747352081543263,117029964,1,1261,12,117788543,116920384,868159,13.822352817859402
1747352081636807,117124604,1,1262,12,117882087,117015024,867063,13.839824787818186
1747352081726849,117219244,1,1263,12,117972129,117109664,862465,13.913608088444168
1747352081829300,117313884,1,1264,12,118074580,117204304,870276,13.788729092839512
1747352081923691,117408524,1,1265,12,118168971,117298944,870027,13.792675399728974
1747352082022053,117503164,1,1266,12,118267333,117393584,873749,13.733921297764002
1747352082111654,117597804,1,1267,12,118356934,117488224,868710,13.813585661498085
1747352082210170,117692452,1,1268,12,118455450,117582872,872578,13.752352225245192
1747352082300793,117787084,1,1269,12,118546073,117677504,868569,13.815828103466735
1747352082402888,117881724,1,1270,12,118648168,117772144,876024,13.698254842333087
1747352082497196,117976364,1,1271,12,118742476,117866784,875692,13.703448244359889
1747352082591409,118071004,1,1272,12,118836689,117961424,875265,13.71013350242498
1747352082689748,118165644,1,1273,12,118935028,118056064,878964,13.652436277253676
1747352082783702,118260284,1,1274,12,119028982,118150704,878278,13.663099838547703
1747352082877637,118354924,1,1275,12,119122917,118245344,877573,13.674076116744702
1747352082972022,118449564,1,1276,12,119217302,118339984,877318,13.678050604227884
1747352083070380,118544204,1,1277,12,119315660,118434624,881036,13.620328794737103
1747352083156607,118638844,1,1278,12,119401887,118529264,872623,13.7516430348501
1747352083254802,118733484,1,1279,12,119500082,118623904,876178,13.695847190867608
1747352083353403,118828124,1,1280,12,119598683,118718544,880139,13.634210050912412
1747352083443554,118922764,1,1281,12,119688834,118813184,875650,13.704105521612515
1747352083541703,119017404,1,1282,12,119786983,118907824,879159,13.649408127540068
1747352083635231,119112044,1,1283,12,119880511,119002464,878047,13.666694379685826
1747352083730048,119206684,1,1284,12,119975328,119097104,878224,13.66393995153856
1747352083831870,119301324,1,1285,12,120077150,119191744,885406,13.553104451517155
1747352083926834,119395964,1,1286,12,120172114,119286384,885730,13.548146726429048
1747352084020395,119490604,1,1287,12,120265675,119381024,884651,13.56467126584382
1747352084119071,119585244,1,1288,12,120364351,119475664,888687,13.503066884066044
1747352084212971,119679884,1,1289,12,120458251,119570304,887947,13.514320111448091
1747352084303306,119774524,1,1290,12,120548586,119664944,883642,13.580160291158636
1747352084397320,119869164,1,1291,12,120642600,119759584,883016,13.589787727515697
1747352084495316,119963804,1,1292,12,120740596,119854224,886372,13.538333792132422
1747352084589861,120058444,1,1293,12,120835141,119948864,886277,13.539784965648437
1747352084688518,120153084,1,1294,12,120933798,120043504,890294,13.478693555162677
1747352084778598,120247724,1,1295,12,121023878,120138144,885734,13.548085542612116
1747352084873066,120342364,1,1296,12,121118346,120232784,885562,13.550716945849077
1747352084975384,120437004,1,1297,12,121220664,120327424,893240,13.434239398146074
1747352085065324,120531644,1,1298,12,121310604,120422064,888540,13.505300830576
1747352085167318,120626284,1,1299,12,121412598,120516704,895894,13.394441753153831
1747352085257418,120720924,1,1300,12,121502698,120611344,891354,13.462664665217186
1747352085351421,120815564,1,1301,12,121596701,120705984,890717,13.47229254634188
1747352085446454,120910204,1,1302,12,121691734,120800624,891110,13.46635095554982
1747352085539940,121004844,1,1303,12,121785220,120895264,889956,13.48381268287421
1747352085646490,121099484,1,1304,12,121891770,120989904,901866,13.305746086447432
1747352085736709,121194124,1,1305,12,121981989,121084544,897445,13.37129294831438
1747352085834875,121288764,1,1306,12,122080155,121179184,900971,13.31896365143828
1747352085920976,121383404,1,1307,12,122166256,121273824,892432,13.446402639080624
1747352086019347,121478044,1,1308,12,122264627,121368464,896163,13.390421162221603
1747352086118107,121572684,1,1309,12,122363387,121463104,900283,13.329142058663775
1747352086207613,121667324,1,1310,12,122452893,121557744,895149,13.405589460525569
1747352086313972,121761964,1,1311,12,122559252,121652384,906868,13.232355756295291
1747352086400489,121856604,1,1312,12,122645769,121747024,898745,13.351951888466695
1747352086502709,121951252,1,1313,12,122747989,121841672,906317,13.240400433843789
1747352086597194,122045884,1,1314,12,122842474,121936304,906170,13.24254830771268
1747352086690860,122140524,1,1315,12,122936140,122030944,905196,13.25679742287858
1747352086785258,122235164,1,1316,12,123030538,122125584,904954,13.260342514647151
1747352086874950,122329804,1,1317,12,123120230,122220224,900006,13.333244445037034
1747352086977477,122424444,1,1318,12,123222757,122314864,907893,13.217416589840434
1747352087071817,122519084,1,1319,12,123317097,122409504,907593,13.221785536027712
1747352087165931,122613724,1,1320,12,123411211,122504144,907067,13.229452730614168
1747352087264386,122708364,1,1321,12,123509666,122598784,910882,13.174044497530964
1747352087354766,122803004,1,1322,12,123600046,122693424,906622,13.23594618264282
1747352087452644,122897644,1,1323,12,123697924,122788064,909860,13.188842239465412
1747352087543009,122992284,1,1324,12,123788289,122882704,905585,13.251102878249972
1747352087645173,123086924,1,1325,12,123890453,122977344,913109,13.141914054072409
1747352087739858,123181564,1,1326,12,123985138,123071984,913154,13.141266423845266
1747352087829614,123276204,1,1327,12,124074894,123166624,908270,13.211930373126933
1747352087924103,123370844,1,1328,12,124169383,123261264,908119,13.214127223414552
1747352088022282,123465484,1,1329,12,124267562,123355904,911658,13.162830798391502
1747352088123972,123560124,1,1330,12,124369252,123450544,918708,13.061821601640563
1747352088210527,123654764,1,1331,12,124455807,123545184,910623,13.177791468038915
1747352088304991,123749412,1,1332,12,124550271,123639832,910439,13.180454703719851
1747352088402580,123844044,1,1333,12,124647860,123734464,913396,13.13778470674275
1747352088501136,123938684,1,1334,12,124746416,123829104,917312,13.081699574408708
1747352088603415,124033324,1,1335,12,124848695,123923744,924951,12.973660226325505
1747352088693943,124127964,1,1336,12,124939223,124018384,920839,13.031594013720095
1747352088792024,124222604,1,1337,12,125037304,124113024,924280,12.983078720733976
1747352088886315,124317244,1,1338,12,125131595,124207664,923931,12.987982868850596
1747352088981047,124411884,1,1339,12,125226327,124302304,924023,12.986689725255756
1747352089070410,124506524,1,1340,12,125315690,124396944,918746,13.061281355238554
1747352089165011,124601164,1,1341,12,125410291,124491584,918707,13.06183581925467
1747352089271764,124695804,1,1342,12,125517044,124586224,930820,12.891858791173377
1747352089361543,124790444,1,1343,12,125606823,124680864,925959,12.959537085335311
1747352089459760,124885084,1,1344,12,125705040,124775504,929536,12.909666758468742
1747352089549768,124979724,1,1345,12,125795048,124870144,924904,12.974319496942384
1747352089647747,125074364,1,1346,12,125893027,124964784,928243,12.92764933320262
1747352089742408,125169004,1,1347,12,125987688,125059424,928264,12.927356872613826
1747352089832636,125263644,1,1348,12,126077916,125154064,923852,12.989093491165251
1747352089938800,125358284,1,1349,12,126184080,125248704,935376,12.829065530866732
1747352090028866,125452924,1,1350,12,126274146,125343344,930802,12.892108096029016
1747352090127690,125547564,1,1351,12,126372970,125437984,934986,12.834416772015835
1747352090217114,125642204,1,1352,12,126462394,125532624,929770,12.906417716209384
1747352090315486,125736844,1,1353,12,126560766,125627264,933502,12.854819807563349
1747352090409677,125831484,1,1354,12,126654957,125721904,933053,12.861005752084822
1747352090500480,125926124,1,1355,12,126745760,125816544,929216,12.9141125421861
1747352090602015,126020764,1,1356,12,126847295,125911184,936111,12.818992619464998
1747352090696482,126115404,1,1357,12,126941762,126005824,935938,12.8213620987715
1747352090791184,126210044,1,1358,12,127036464,126100464,936000,12.82051282051282
1747352090884709,126304684,1,1359,12,127129989,126195104,934885,12.835803334099916
1747352090983208,126399324,1,1360,12,127228488,126289744,938744,12.783037761093546
1747352091081867,126493964,1,1361,12,127327147,126384384,942763,12.728543653070814
1747352091171640,126588604,1,1362,12,127416920,126479024,937896,12.79459556283426
1747352091269705,126683244,1,1363,12,127514985,126573664,941321,12.748042378742214
1747352091356069,126777884,1,1364,12,127601349,126668304,933045,12.861116023342923
1747352091458878,126872524,1,1365,12,127704158,126762944,941214,12.74949161402189
1747352091552946,126967164,1,1366,12,127798226,126857584,940642,12.757244520231929
1747352091650947,127061804,1,1367,12,127896227,126952224,944003,12.711824009033869
1747352091737387,127156444,1,1368,12,127982667,127046864,935803,12.823211722980156
1747352091835137,127251084,1,1369,12,128080417,127141504,938913,12.780736873384434
1747352091929757,127345724,1,1370,12,128175037,127236144,938893,12.781009124575432
1747352092023883,127440364,1,1371,12,128269163,127330784,938379,12.78800996185976
1747352092117452,127535004,1,1372,12,128362732,127425424,937308,12.802621976980886
1747352092216521,127629644,1,1373,12,128461801,127520064,941737,12.742411097790573
1747352092310312,127724284,1,1374,12,128555592,127614704,940888,12.753909073130917
1747352092404506,127818924,1,1375,12,128649786,127709344,940442,12.759957551874544
1747352092502945,127913564,1,1376,12,128748225,127803984,944241,12.708619939189251
1747352092596765,128008212,1,1377,12,128842045,127898632,943413,12.719773842421082
1747352092691210,128102844,1,1378,12,128936490,127993264,943226,12.722295611020051
1747352092785272,128197484,1,1379,12,129030552,128087904,942648,12.730096494131423
1747352092883954,128292124,1,1380,12,129129234,128182544,946690,12.675743907720584
1747352092978013,128386764,1,1381,12,129223293,128277184,946109,12.683528007872244
1747352093079969,128481404,1,1382,12,129325249,128371824,953425,12.5862023756457
1747352093170482,128576044,1,1383,12,129415762,128466464,949298,12.640919921879116
1747352093264783,128670684,1,1384,12,129510063,128561104,948959,12.645435682679652
1747352093366476,128765324,1,1385,12,129611756,128655744,956012,12.552143696941044
1747352093452810,128859964,1,1386,12,129698090,128750384,947706,12.662154718868509
1747352093551775,128954604,1,1387,12,129797055,128845024,952031,12.604631571871083
1747352093645853,129049244,1,1388,12,129891133,128939664,951469,12.612076694038375
1747352093747830,129143884,1,1389,12,129993110,129034304,958806,12.515566235505409
1747352093841844,129238524,1,1390,12,130087124,129128944,958180,12.52374292930347
1747352093932031,129333164,1,1391,12,130177311,129223584,953727,12.582216923710874
1747352094030460,129427804,1,1392,12,130275740,129318224,957516,12.532427656561351
1747352094121357,129522444,1,1393,12,130366637,129412864,953773,12.581610089612518
1747352094223044,129617084,1,1394,12,130468324,129507504,960820,12.489332028891988
1747352094317343,129711724,1,1395,12,130562623,129602144,960479,12.493766131274084
1747352094415351,129806372,1,1396,12,130660631,129696792,963839,12.450212120489002
1747352094501437,129901004,1,1397,12,130746717,129791424,955293,12.561591051122535
1747352094603834,129995644,1,1398,12,130849114,129886064,963050,12.460412231971342
1747352094698268,130090284,1,1399,12,130943548,129980704,962844,12.463078131036802
1747352094788605,130184924,1,1400,12,131033885,130075344,958541,12.519026311863552
1747352094890618,130279564,1,1401,12,131135898,130169984,965914,12.423466271324362
1747352094984738,130374204,1,1402,12,131230018,130264624,965394,12.4301580494596
1747352095074937,130468844,1,1403,12,131320217,130359264,960953,12.487603451989848
1747352095169653,130563484,1,1404,12,131414933,130453904,961029,12.486615908573
1747352095267901,130658124,1,1405,12,131513181,130548544,964637,12.43991263034696
1747352095361973,130752764,1,1406,12,131607253,130643184,964069,12.447241846797274
1747352095455386,130847404,1,1407,12,131700666,130737824,962842,12.463104019143328
1747352095550253,130942044,1,1408,12,131795533,130832464,963069,12.460166405522346
1747352095647966,131036684,1,1409,12,131893246,130927104,966142,12.420534455597624
1747352095742613,131131324,1,1410,12,131987893,131021744,966149,12.4204444656052
1747352095836885,131225964,1,1411,12,132082165,131116384,965781,12.425177136431552
1747352095935039,131320604,1,1412,12,132180319,131211024,969295,12.38013195157305
1747352096029524,131415244,1,1413,12,132274804,131305664,969140,12.382111975565966
1747352096123495,131509884,1,1414,12,132368775,131400304,968471,12.390665285795858
1747352096217219,131604524,1,1415,12,132462499,131494944,967555,12.402395729441736
1747352096315572,131699164,1,1416,12,132560852,131589584,971268,12.354983382547353
1747352096409975,131793804,1,1417,12,132655255,131684224,971031,12.357998869243104
1747352096504723,131888444,1,1418,12,132750003,131778864,971139,12.35662454087417
1747352096602253,131983084,1,1419,12,132847533,131873504,974029,12.319961725985571
1747352096697269,132077724,1,1420,12,132942549,131968144,974405,12.3152077421606
1747352096791408,132172364,1,1421,12,133036688,132062784,973904,12.321542985756295
1747352096885403,132267004,1,1422,12,133130683,132157424,973259,12.329708741455256
1747352096983759,132361644,1,1423,12,133229039,132252064,976975,12.282811740320888
1747352097077614,132456284,1,1424,12,133322894,132346704,976190,12.29268892326289
1747352097172330,132550924,1,1425,12,133417610,132441344,976266,12.29173196649274
1747352097265759,132645564,1,1426,12,133511039,132535984,975055,12.30699806677572
1747352097364241,132740204,1,1427,12,133609521,132630624,978897,12.258695245771516
1747352097458928,132834844,1,1428,12,133704208,132725264,978944,12.258106694560668
1747352097552420,132929484,1,1429,12,133797700,132819904,977796,12.27249855798142
1747352097650887,133024124,1,1430,12,133896167,132914544,981623,12.224652437850375
1747352097745406,133118764,1,1431,12,133990686,133009184,981502,12.22615949840143
1747352097839309,133213404,1,1432,12,134084589,133103824,980765,12.235346897574852
1747352097933826,133308044,1,1433,12,134179106,133198464,980642,12.236881553105006
1747352098032065,133402684,1,1434,12,134277345,133293104,984241,12.192135869162126
1747352098125710,133497324,1,1435,12,134370990,133387744,983246,12.204473753262157
1747352098220305,133591964,1,1436,12,134465585,133482384,983201,12.205032338250266
1747352098314858,133686604,1,1437,12,134560138,133577024,983114,12.20611241422663
1747352098412671,133781244,1,1438,12,134657951,133671664,986287,12.16684393082338
1747352098507417,133875884,1,1439,12,134752697,133766304,986393,12.165536454536884
1747352098600926,133970524,1,1440,12,134846206,133860944,985262,12.179501493003892
1747352098699575,134065172,1,1441,12,134944855,133955592,989263,12.130242412786084
1747352098793538,134159804,1,1442,12,135038818,134050224,988594,12.13845117409169
1747352098887982,134254444,1,1443,12,135133262,134144864,988398,12.140858237268793
1747352098982014,134349084,1,1444,12,135227294,134239504,987790,12.148331123011976
1747352099080116,134443724,1,1445,12,135325396,134334144,991252,12.10590243449698
1747352099174790,134538364,1,1446,12,135420070,134428784,991286,12.10548721559671
1747352099268560,134633004,1,1447,12,135513840,134523424,990416,12.11612090273178
1747352099367395,134727644,1,1448,12,135612675,134618064,994611,12.065018384071765
1747352099461401,134822284,1,1449,12,135706681,134712704,993977,12.07271395615794
1747352099555456,134916924,1,1450,12,135800736,134807344,993392,12.079823473512974
1747352099649863,135011564,1,1451,12,135895143,134901984,993159,12.082657459681682
1747352099748185,135106204,1,1452,12,135993465,134996624,996841,12.038028130865404
1747352099841946,135200844,1,1453,12,136087226,135091264,995962,12.04865245862794
1747352099936290,135295484,1,1454,12,136181570,135185904,995666,12.052234383819473
1747352100030967,135390124,1,1455,12,136276247,135280544,995703,12.051786526705252
1747352100129176,135484764,1,1456,12,136374456,135375184,999272,12.008742364441312
1747352100223604,135579404,1,1457,12,136468884,135469824,999060,12.011290613176389
1747352100317069,135674044,1,1458,12,136562349,135564464,997885,12.025433792471077
1747352100416057,135768684,1,1459,12,136661337,135659104,1002233,11.973263702153092
1747352100510086,135863332,1,1460,12,136755366,135753752,1001614,11.980663209579738
1747352100604304,135957964,1,1461,12,136849584,135848384,1001200,11.985617259288851
1747352100697815,136052604,1,1462,12,136943095,135943024,1000071,11.999148060487704
1747352100796799,136147244,1,1463,12,137042079,136037664,1004415,11.94725287854124
1747352100890599,136241884,1,1464,12,137135879,136132304,1003575,11.957252821164335
1747352100985197,136336524,1,1465,12,137230477,136226944,1003533,11.957753257740404
1747352101083722,136431164,1,1466,12,137329002,136321584,1007418,11.911639458496872
1747352101177934,136525804,1,1467,12,137423214,136416224,1006990,11.916702251263668
1747352101271930,136620444,1,1468,12,137517210,136510864,1006346,11.924328213159292
1747352101365598,136715084,1,1469,12,137610878,136605504,1005374,11.935856706061625
1747352101464141,136809724,1,1470,12,137709421,136700144,1009277,11.889699259965305
1747352101558653,136904364,1,1471,12,137803933,136794784,1009149,11.891207344009654
1747352101652950,136999004,1,1472,12,137898230,136889424,1008806,11.895250424759569
1747352101747304,137093644,1,1473,12,137992584,136984064,1008520,11.898623725855709
1747352101845527,137188284,1,1474,12,138090807,137078704,1012103,11.856500771166573
1747352101939791,137282924,1,1475,12,138185071,137173344,1011727,11.860907141946392
1747352102033359,137377564,1,1476,12,138278639,137267984,1010655,11.873487985514345
1747352102131608,137472204,1,1477,12,138376888,137362624,1014264,11.831239203994226
1747352102226282,137566844,1,1478,12,138471562,137457264,1014298,11.830842612328922
1747352102320135,137661484,1,1479,12,138565415,137551904,1013511,11.84002936327282
1747352102418608,137756124,1,1480,12,138663888,137646544,1017344,11.795420231504782
1747352102512390,137850764,1,1481,12,138757670,137741184,1016486,11.805376561998886
1747352102607529,137945404,1,1482,12,138852809,137835824,1016985,11.79958406466172
1747352102701507,138040044,1,1483,12,138946787,137930464,1016323,11.807269932885507
1747352102799757,138134684,1,1484,12,139045037,138025104,1019933,11.76547871281741
1747352102894238,138229324,1,1485,12,139139518,138119744,1019774,11.767313149776324
1747352102988287,138323964,1,1486,12,139233567,138214384,1019183,11.77413673501226
1747352103082762,138418604,1,1487,12,139328042,138309024,1019018,11.776043210227886
1747352103181269,138513244,1,1488,12,139426549,138403664,1022885,11.731524071620957
1747352103274793,138607884,1,1489,12,139520073,138498304,1021769,11.744337516601112
1747352103368966,138702524,1,1490,12,139614246,138592944,1021302,11.749707726020317
1747352103463530,138797164,1,1491,12,139708810,138687584,1021226,11.750582143423689
1747352103561259,138891804,1,1492,12,139806539,138782224,1024315,11.715146219668751
1747352103655236,138986444,1,1493,12,139900516,138876864,1023652,11.722733897848096
1747352103749809,139081084,1,1494,12,139995089,138971504,1023585,11.72350122364044
1747352103847739,139175724,1,1495,12,140093019,139066144,1026875,11.685940353012782
1747352103942170,139270364,1,1496,12,140187450,139160784,1026666,11.6883192781294
1747352104036465,139365004,1,1497,12,140281745,139255424,1026321,11.692248331662316
1747352104130770,139459644,1,1498,12,140376050,139350064,1025986,11.696066028191415
1747352104228538,139554284,1,1499,12,140473818,139444704,1029114,11.660515744611384
1747352104322932,139648924,1,1500,12,140568212,139539344,1028868,11.663303747419496
1747351654505185,109580,1,1,1,0,0,0,0.0
1747351654594431,197404,1,2,1,89246,87824,1422,703.2348804500702
1747351680708829,109580,1,1,1,26203644,0,26203644,0.0381626311210761
1747351680799226,200524,1,2,1,26294041,90944,26203097,0.0381634277810748
1747351680888812,292044,1,3,1,26383627,182464,26201163,0.0381662447579139
1747351680983215,383564,1,4,1,26478030,273984,26204046,0.0381620456627194
1747351681073754,475084,1,5,1,26568569,365504,26203065,0.0381634743874428
1747351681167930,566604,1,6,1,26662745,457024,26205721,0.0381596064462412
1747351681257372,658124,1,7,1,26752187,548544,26203643,0.0381626325774626
1747351681351721,749644,1,8,1,26846536,640064,26206472,0.0381585129047511
1747351681441819,841164,1,9,1,26936634,731584,26205050,0.0381605835516436
1747351681536383,932684,1,10,1,27031198,823104,26208094,0.0381561513019603
1747351681629969,1022124,1,11,1,27124784,912544,26212240,0.0381501161289534
1747351681724812,1115724,1,12,1,27219627,1006144,26213483,0.0381483071135567
1747351681818880,1209324,1,13,1,27313695,1099744,26213951,0.038147626048435
1747351681912730,1302924,1,14,1,27407545,1193344,26214201,0.0381472622415613
1747351682007079,1396524,1,15,1,27501894,1286944,26214950,0.0381461723177042
1747351682101336,1490124,1,16,1,27596151,1380544,26215607,0.0381452163209495
1747351682191746,1580604,1,17,1,27686561,1471024,26215537,0.0381453181752485
1747351682285587,1674204,1,18,1,27780402,1564624,26215778,0.0381449675077352
1747351682380559,1767804,1,19,1,27875374,1658224,26217150,0.0381429712993212
1747351682474444,1861404,1,20,1,27969259,1751824,26217435,0.0381425566612447
1747351682568972,1955004,1,21,1,28063787,1845424,26218363,0.0381412066039363
1747351682658522,2045484,1,22,1,28153337,1935904,26217433,0.0381425595709541
1747351682752760,2139084,1,23,1,28247575,2029504,26218071,0.0381416313961465
1747351682847012,2232684,1,24,1,28341827,2123104,26218723,0.0381406829005363
1747351682941123,2326284,1,25,1,28435938,2216704,26219234,0.0381399395573493
1747351683034927,2416764,1,26,1,28529742,2307184,26222558,0.0381351048970889
1747351683129997,2510364,1,27,1,28624812,2400784,26224028,0.0381329672161728
1747351683224426,2603964,1,28,1,28719241,2494384,26224857,0.0381317617861557
1747351683318309,2697564,1,29,1,28813124,2587984,26225140,0.0381313502997505
1747351683413621,2791164,1,30,1,28908436,2681584,26226852,0.038128861214453
1747351683506058,2884764,1,31,1,29000873,2775184,26225689,0.038130552070529
1747351683600356,2978364,1,32,1,29095171,2868784,26226387,0.0381295372481158
1747351683695121,3071964,1,33,1,29189936,2962384,26227552,0.0381278435745737
1747351683784701,3162444,1,34,1,29279516,3052864,26226652,0.0381291519786818
1747351683875028,3252924,1,35,1,29369843,3143344,26226499,0.0381293744163107
1747351683964912,3343404,1,36,1,29459727,3233824,26225903,0.0381302409301216
1747351684059616,3433884,1,37,1,29554431,3324304,26230127,0.0381241005809846
1747351684149751,3524364,1,38,1,29644566,3414784,26229782,0.0381246020268105
1747351684243773,3617964,1,39,1,29738588,3508384,26230204,0.0381239886658906
1747351684337751,3711564,1,40,1,29832566,3601984,26230582,0.0381234392740504
1747351684431985,3805164,1,41,1,29926800,3695584,26231216,0.0381225178428632
1747351684526170,3898764,1,42,1,30020985,3789184,26231801,0.0381216676658991
1747351684620525,3992364,1,43,1,30115340,3882784,26232556,0.038120570485011
1747351684714860,4085964,1,44,1,30209675,3976384,26233291,0.0381195024291843
1747351684808491,4179564,1,45,1,30303306,4069984,26233322,0.0381194573832471
1747351684902623,4273172,1,46,1,30397438,4163592,26233846,0.0381186959777075
1747351684997203,4366764,1,47,1,30492018,4257184,26234834,0.0381172604332087
1747351685091295,4460364,1,48,1,30586110,4350784,26235326,0.0381165456072472
1747351685185096,4553964,1,49,1,30679911,4444384,26235527,0.0381162535824037
1747351685279335,4647564,1,50,1,30774150,4537984,26236166,0.0381153252346398
1747351685373412,4741164,1,51,1,30868227,4631584,26236643,0.0381146322721241
1747351685467667,4834764,1,52,1,30962482,4725184,26237298,0.0381136807608771
1747351685562848,4928364,1,53,1,31057663,4818784,26238879,0.038111384255402
1747351685656547,5021964,1,54,1,31151362,4912384,26238978,0.0381112404606612
1747351685750657,5115564,1,55,1,31245472,5005984,26239488,0.0381104997170676
1747351685845275,5209164,1,56,1,31340090,5099584,26240506,0.038109021220856
1747351685939164,5302764,1,57,1,31433979,5193184,26240795,0.0381086015115014
1747351686033530,5396364,1,58,1,31528345,5286784,26241561,0.0381074891085938
1747351686127375,5489964,1,59,1,31622190,5380384,26241806,0.0381071333276375
1747351686222061,5583564,1,60,1,31716876,5473984,26242892,0.0381055563540786
1747351686315652,5677164,1,61,1,31810467,5567584,26242883,0.0381055694223839
1747351686409656,5770764,1,62,1,31904471,5661184,26243287,0.0381049828095085
1747351686504559,5864364,1,63,1,31999374,5754784,26244590,0.0381030909608418
1747351686597914,5957964,1,64,1,32092729,5848384,26244345,0.0381034466663199
1747351686697224,6051564,1,65,1,32192039,5941984,26250055,0.0380951582768112
1747351686791057,6145164,1,66,1,32285872,6035584,26250288,0.0380948201406399
1747351686885103,6238764,1,67,1,32379918,6129184,26250734,0.0380941729096032
1747351686979216,6332364,1,68,1,32474031,6222784,26251247,0.0380934284759882
1747351687072959,6425964,1,69,1,32567774,6316384,26251390,0.0380932209684896
1747351687167903,6519564,1,70,1,32662718,6409984,26252734,0.0380912707986909
1747351687261905,6613164,1,71,1,32756720,6503584,26253136,0.0380906875277681
1747351687356306,6706764,1,72,1,32851121,6597184,26253937,0.038089525391944
1747351687450407,6800364,1,73,1,32945222,6690784,26254438,0.03808879854903
1747351687544384,6893964,1,74,1,33039199,6784384,26254815,0.0380882516216549
1747351687638106,6987564,1,75,1,33132921,6877984,26254937,0.0380880746352581
1747351687733260,7081164,1,76,1,33228075,6971584,26256491,0.0380858203786637
1747351687827488,7174764,1,77,1,33322303,7065184,26257119,0.0380849094677904
1747351687921853,7268372,1,78,1,33416668,7158792,26257876,0.0380838115009759
1747351688012069,7358844,1,79,1,33506884,7249264,26257620,0.0380841828010307
1747351688105976,7452444,1,80,1,33600791,7342864,26257927,0.0380837375319079
1747351688200468,7546044,1,81,1,33695283,7436464,26258819,0.0380824438448659
1747351688293647,7639644,1,82,1,33788462,7530064,26258398,0.0380830544193899
1747351688388438,7733244,1,83,1,33883253,7623664,26259589,0.0380813271677633
1747351688482187,7826844,1,84,1,33977002,7717264,26259738,0.038081111091055
1747351688576367,7920444,1,85,1,34071182,7810864,26260318,0.0380802700104393
1747351688670493,8014044,1,86,1,34165308,7904464,26260844,0.038079507269454
1747351688765602,8107644,1,87,1,34260417,7998064,26262353,0.03807731927143
1747351688858889,8201252,1,88,1,34353704,8091672,26262032,0.0380777846893187
1747351688954035,8294844,1,89,1,34448850,8185264,26263586,0.0380755316505522
1747351689048118,8388444,1,90,1,34542933,8278864,26264069,0.0380748314360581
1747351689141664,8482044,1,91,1,34636479,8372464,26264015,0.0380749097196296
1747351689236240,8575644,1,92,1,34731055,8466064,26264991,0.038073494866227
1747351689330554,8669244,1,93,1,34825369,8559664,26265705,0.0380724598863803
1747351689425023,8762844,1,94,1,34919838,8653264,26266574,0.0380712003019503
1747351689518996,8853324,1,95,1,35013811,8743744,26270067,0.0380661381640176
1747351689612551,8946924,1,96,1,35107366,8837344,26270022,0.0380662033705186
1747351689706638,9040524,1,97,1,35201453,8930944,26270509,0.0380654977031469
1747351689800907,9134124,1,98,1,35295722,9024544,26271178,0.0380645283587968
1747351689895164,9227724,1,99,1,35389979,9118144,26271835,0.0380635764498368
1747351689989518,9321324,1,100,1,35484333,9211744,26272589,0.0380624840589558
1747351690083683,9415964,1,101,1,35578498,9306384,26272114,0.0380631722289268
1747351690182123,9510604,1,102,1,35676938,9401024,26275914,0.0380576675658171
1747351690276537,9605244,1,103,1,35771352,9495664,26275688,0.0380579949038822
1747351690371008,9699884,1,104,1,35865823,9590304,26275519,0.0380582396869116
1747351690464873,9794524,1,105,1,35959688,9684944,26274744,0.0380593622529681
1747351690562883,9889164,1,106,1,36057698,9779584,26278114,0.038054481383253
1747351690656877,9983804,1,107,1,36151692,9874224,26277468,0.0380554169069866
1747351690752006,10078444,1,108,1,36246821,9968864,26277957,0.0380547087431492
1747351690846124,10171004,1,109,1,36340939,10061424,26279515,0.0380524526422957
1747351690943906,10266684,1,110,1,36438721,10157104,26281617,0.0380494092125305
1747351691038289,10362364,1,111,1,36533104,10252784,26280320,0.038051287046733
1747351691136293,10458044,1,112,1,36631108,10348464,26282644,0.0380479224236343
1747351691230370,10550604,1,113,1,36725185,10441024,26284161,0.0380457264738258
1747351691325155,10646284,1,114,1,36819970,10536704,26283266,0.0380470220101261
1747351691418737,10738844,1,115,1,36913552,10629264,26284288,0.0380455426450965
1747351691513198,10834524,1,116,1,37008013,10724944,26283069,0.0380473071847127
1747351691611405,10930212,1,117,1,37106220,10820632,26285588,0.0380436610358497
1747351691706313,11025884,1,118,1,37201128,10916304,26284824,0.0380447668205805
1747351691804580,11121564,1,119,1,37299395,11011984,26287411,0.0380410227541997
1747351691902644,11217244,1,120,1,37397459,11107664,26289795,0.0380375731343663
1747351691997038,11312924,1,121,1,37491853,11203344,26288509,0.0380394338834507
1747351692093937,11408604,1,122,1,37588752,11299024,26289728,0.0380376700740304
1747351692188899,11504284,1,123,1,37683714,11394704,26289010,0.0380387089510027
1747351692287269,11599964,1,124,1,37782084,11490384,26291700,0.0380348170715472
1747351692381806,11695644,1,125,1,37876621,11586064,26290557,0.03803647066131
1747351692480110,11791324,1,126,1,37974925,11681744,26293181,0.0380326747075601
1747351692574493,11887004,1,127,1,38069308,11777424,26291884,0.0380345508903051
1747351692671951,11982684,1,128,1,38166766,11873104,26293662,0.0380319789613177
1747351692766489,12078364,1,129,1,38261304,11968784,26292520,0.0380336308577496
1747351692864710,12174044,1,130,1,38359525,12064464,26295061,0.0380299555114171
1747351692958760,12269724,1,131,1,38453575,12160144,26293431,0.038032313089912
1747351693057160,12365404,1,132,1,38551975,12255824,26296151,0.0380283791342695
1747351693151241,12461092,1,133,1,38646056,12351512,26294544,0.0380307032515947
1747351693249997,12556764,1,134,1,38744812,12447184,26297628,0.0380262432794318
1747351693348616,12652444,1,135,1,38843431,12542864,26300567,0.0380219939745025
1747351693442420,12748124,1,136,1,38937235,12638544,26298691,0.0380247062486874
1747351693541087,12843804,1,137,1,39035902,12734224,26301678,0.0380203879007263
1747351693635180,12939484,1,138,1,39129995,12829904,26300091,0.0380226821268413
1747351693733133,13035164,1,139,1,39227948,12925584,26302364,0.038019396279361
1747351693827753,13130844,1,140,1,39322568,13021264,26301304,0.0380209285440752
1747351693925886,13226524,1,141,1,39420701,13116944,26303757,0.0380173828400254
1747351694020215,13322204,1,142,1,39515030,13212624,26302406,0.0380193355695292
1747351694117904,13417884,1,143,1,39612719,13308304,26304415,0.0380164318423352
1747351694212877,13513564,1,144,1,39707692,13403984,26303708,0.0380174536609059
1747351694311115,13609244,1,145,1,39805930,13499664,26306266,0.0380137568745028
1747351694405350,13704924,1,146,1,39900165,13595344,26304821,0.0380158450802611
1747351694503406,13800604,1,147,1,39998221,13691024,26307197,0.0380124115845561
1747351694597798,13896284,1,148,1,40092613,13786704,26305909,0.0380142727628229
1747351694695898,13991972,1,149,1,40190713,13882392,26308321,0.0380107875375247
1747351694790160,14087644,1,150,1,40284975,13978064,26306911,0.0380128248428711
1747351694888610,14183324,1,151,1,40383425,14073744,26309681,0.038008822683939
1747351694986804,14279004,1,152,1,40481619,14169424,26312195,0.0380051911290563
1747351695080827,14374684,1,153,1,40575642,14265104,26310538,0.0380075846415607
1747351695174817,14467244,1,154,1,40669632,14357664,26311968,0.0380055190094484
1747351695268822,14559804,1,155,1,40763637,14450224,26313413,0.0380034319379245
1747351695358813,14652364,1,156,1,40853628,14542784,26310844,0.0380071426062957
1747351695453252,14744924,1,157,1,40948067,14635344,26312723,0.0380044285040358
1747351695547766,14837484,1,158,1,41042581,14727904,26314677,0.0380016064799123
1747351695641967,14930044,1,159,1,41136782,14820464,26316318,0.0379992368233276
1747351695736387,15025724,1,160,1,41231202,14916144,26315058,0.0380010562773602
1747351695834387,15121404,1,161,1,41329202,15011824,26317378,0.0379977063064565
1747351695928313,15217084,1,162,1,41423128,15107504,26315624,0.0380002389455024
1747351696027093,15312764,1,163,1,41521908,15203184,26318724,0.0379957630164745
1747351696121433,15408444,1,164,1,41616248,15298864,26317384,0.0379976976435043
1747351696219567,15504124,1,165,1,41714382,15394544,26319838,0.0379941548272447
1747351696313524,15599804,1,166,1,41808339,15490224,26318115,0.0379966422367255
1747351696412103,15695484,1,167,1,41906918,15585904,26321014,0.0379924572814709
1747351696506102,15791164,1,168,1,42000917,15681584,26319333,0.0379948838369118
1747351696604180,15886844,1,169,1,42098995,15777264,26321731,0.0379914223726395
1747351696702176,15982524,1,170,1,42196991,15872944,26324047,0.0379880798723691
1747351696796670,16078204,1,171,1,42291485,15968624,26322861,0.0379897914592186
1747351696894839,16173884,1,172,1,42389654,16064304,26325350,0.0379861996136803
1747351696989346,16269564,1,173,1,42484161,16159984,26324177,0.037987892271048
1747351697083268,16362124,1,174,1,42578083,16252544,26325539,0.037985926897831
1747351697177672,16457804,1,175,1,42672487,16348224,26324263,0.0379877681665769
1747351697271558,16550364,1,176,1,42766373,16440784,26325589,0.0379858547514359
1747351697365836,16642924,1,177,1,42860651,16533344,26327307,0.0379833759677736
1747351697459730,16735484,1,178,1,42954545,16625904,26328641,0.0379814514543306
1747351697550730,16828044,1,179,1,43045545,16718464,26327081,0.0379837020291007
1747351697644879,16920612,1,180,1,43139694,16811032,26328662,0.037981421159951
1747351697738947,17013164,1,181,1,43233762,16903584,26330178,0.0379792343219252
1747351697832924,17105724,1,182,1,43327739,16996144,26331595,0.037977190519602
1747351697927267,17198284,1,183,1,43422082,17088704,26333378,0.0379746191316586
1747351698017166,17290844,1,184,1,43511981,17181264,26330717,0.037978456872253
1747351698111421,17383404,1,185,1,43606236,17273824,26332412,0.0379760122240226
1747351698205484,17475964,1,186,1,43700299,17366384,26333915,0.0379738447549481
1747351698300285,17568524,1,187,1,43795100,17458944,26336156,0.0379706134790513
1747351698389799,17661084,1,188,1,43884614,17551504,26333110,0.037975005610807
1747351698483602,17753644,1,189,1,43978417,17644064,26334353,0.0379732131638092
1747351698578007,17846204,1,190,1,44072822,17736624,26336198,0.0379705529249134
1747351698672152,17938764,1,191,1,44166967,17829184,26337783,0.037968267868256
1747351698762987,18031324,1,192,1,44257802,17921744,26336058,0.0379707547727909
1747351698857408,18123884,1,193,1,44352223,18014304,26337919,0.0379680718131147
1747351698951253,18216444,1,194,1,44446068,18106864,26339204,0.0379662194802849
1747351699045678,18309004,1,195,1,44540493,18199424,26341069,0.0379635313965427
1747351699139149,18401564,1,196,1,44633964,18291984,26341980,0.0379622184816782
1747351699229388,18494124,1,197,1,44724203,18384544,26339659,0.0379655636392255
1747351699323462,18586684,1,198,1,44818277,18477104,26341173,0.0379633815092441
1747351699417873,18679244,1,199,1,44912688,18569664,26343024,0.0379607140015512
1747351699512484,18771804,1,200,1,45007299,18662224,26345075,0.0379577587082215
1747351699602310,18864364,1,201,1,45097125,18754784,26342341,0.0379616982408662
1747351699696740,18956924,1,202,1,45191555,18847344,26344211,0.0379590035928576
1747351699791004,19049492,1,203,1,45285819,18939912,26345907,0.0379565600075943
1747351699885002,19142044,1,204,1,45379817,19032464,26347353,0.0379544768690805
1747351699975096,19234604,1,205,1,45469911,19125024,26344887,0.0379580295789463
1747351700068906,19327164,1,206,1,45563721,19217584,26346137,0.0379562286493841
1747351700163884,19419724,1,207,1,45658699,19310144,26348555,0.0379527454162097
1747351700257793,19512284,1,208,1,45752608,19402704,26349904,0.0379508024014053
1747351700347830,19604844,1,209,1,45842645,19495264,26347381,0.0379544365339386
1747351700442090,19697404,1,210,1,45936905,19587824,26349081,0.0379519877752093
1747351700536611,19789964,1,211,1,46031426,19680384,26351042,0.0379491634524357
1747351700630533,19882524,1,212,1,46125348,19772944,26352404,0.0379472020844853
1747351700720923,19975084,1,213,1,46215738,19865504,26350234,0.0379503271204346
1747351700814833,20067644,1,214,1,46309648,19958064,26351584,0.0379483829131486
1747351700908579,20160204,1,215,1,46403394,20050624,26352770,0.0379466750554116
1747351701002854,20252764,1,216,1,46497669,20143184,26354485,0.0379442057016101
1747351701097264,20345324,1,217,1,46592079,20235744,26356335,0.0379415423274897
1747351701187817,20437884,1,218,1,46682632,20328304,26354328,0.0379444317457079
1747351701283920,20530444,1,219,1,46778735,20420864,26357871,0.0379393312912108
1747351701375433,20623004,1,220,1,46870248,20513424,26356824,0.0379408383953999
1747351701470344,20715564,1,221,1,46965159,20605984,26359175,0.0379374544157774
1747351701560473,20808124,1,222,1,47055288,20698544,26356744,0.0379409535563269
1747351701654581,20900684,1,223,1,47149396,20791104,26358292,0.0379387253164962
1747351701748363,20993244,1,224,1,47243178,20883664,26359514,0.0379369665161504
1747351701842325,21085804,1,225,1,47337140,20976224,26360916,0.0379349488462388
1747351701933320,21178364,1,226,1,47428135,21068784,26359351,0.0379372011093899
1747351702027473,21270924,1,227,1,47522288,21161344,26360944,0.037934908552592
1747351702121564,21363484,1,228,1,47616379,21253904,26362475,0.0379327054838364
1747351702214888,21456044,1,229,1,47709703,21346464,26363239,0.0379316062036231
1747351702309607,21548604,1,230,1,47804422,21439024,26365398,0.037928500074226
1747351702399426,21641164,1,231,1,47894241,21531584,26362657,0.0379324436076378
1747351702493402,21733724,1,232,1,47988217,21624144,26364073,0.0379304062767539
1747351702587564,21826284,1,233,1,48082379,21716704,26365675,0.0379281015942129
1747351702682596,21918844,1,234,1,48177411,21809264,26368147,0.0379245458545115
1747351702772314,22011404,1,235,1,48267129,21901824,26365305,0.0379286338618119
1747351702866395,22103964,1,236,1,48361210,21994384,26366826,0.0379264459059274
1747351702960499,22196524,1,237,1,48455314,22086944,26368370,0.0379242251227512
1747351703055164,22289084,1,238,1,48549979,22179504,26370475,0.0379211978547978
1747351703145135,22381644,1,239,1,48639950,22272064,26367886,0.0379249212470047
1747351703239384,22474204,1,240,1,48734199,22364624,26369575,0.0379224921144917
1747351703333492,22566764,1,241,1,48828307,22457184,26371123,0.0379202660425193
1747351703428062,22659324,1,242,1,48922877,22549744,26373133,0.037917375990179
1747351703517733,22751884,1,243,1,49012548,22642304,26370244,0.0379215300396917
1747351703612114,22844452,1,244,1,49106929,22734872,26372057,0.0379189230479821
1747351703706522,22937004,1,245,1,49201337,22827424,26373913,0.0379162545959714
1747351703800356,23029564,1,246,1,49295171,22919984,26375187,0.037914423128071
1747351703894244,23122124,1,247,1,49389059,23012544,26376515,0.0379125142195623
1747351703984834,23214684,1,248,1,49479649,23105104,26374545,0.0379153460277703
1747351704078532,23307244,1,249,1,49573347,23197664,26375683,0.0379137101397525
1747351704173087,23399804,1,250,1,49667902,23290224,26377678,0.0379108426450576
1747351704267321,23492364,1,251,1,49762136,23382784,26379352,0.0379084368713833
1747351704357018,23584924,1,252,1,49851833,23475344,26376489,0.0379125515909263
1747351704451299,23677484,1,253,1,49946114,23567904,26378210,0.0379100780530597
1747351704546073,23770044,1,254,1,50040888,23660464,26380424,0.0379068964168278
1747351704639989,23862604,1,255,1,50134804,23753024,26381780,0.0379049480361067
1747351704730586,23955164,1,256,1,50225401,23845584,26379817,0.0379077686551047
1747351704827867,24047724,1,257,1,50322682,23938144,26384538,0.0379009857970603
1747351704918191,24140284,1,258,1,50413006,24030704,26382302,0.0379041980491315
1747351705012896,24232844,1,259,1,50507711,24123264,26384447,0.0379011165176211
1747351705102535,24325404,1,260,1,50597350,24215824,26381526,0.0379053129830321
1747351705197216,24417964,1,261,1,50692031,24308384,26383647,0.0379022657481734
1747351705291552,24510524,1,262,1,50786367,24400944,26385423,0.0378997145507199
1747351705385172,24603084,1,263,1,50879987,24493504,26386483,0.0378981920402199
1747351705479285,24695644,1,264,1,50974100,24586064,26388036,0.0378959616395854
1747351705570264,24788204,1,265,1,51065079,24678624,26386455,0.0378982322559055
1747351705664048,24880764,1,266,1,51158863,24771184,26387679,0.037896474335617
1747351705758166,24973332,1,267,1,51252981,24863752,26389229,0.0378942484450758
1747351705851938,25065884,1,268,1,51346753,24956304,26390449,0.037892496637704
1747351705942418,25158444,1,269,1,51437233,25048864,26388369,0.0378954834230186
1747351706036865,25251004,1,270,1,51531680,25141424,26390256,0.0378927737571018
1747351706131349,25343564,1,271,1,51626164,25233984,26392180,0.0378900113594254
1747351706225113,25436124,1,272,1,51719928,25326544,26393384,0.0378882829121116
1747351706315276,25528684,1,273,1,51810091,25419104,26390987,0.0378917241708315
1747351706409043,25621244,1,274,1,51903858,25511664,26392194,0.0378899912602946
1747351706503393,25713804,1,275,1,51998208,25604224,26393984,0.0378874216185021
1747351706598161,25806364,1,276,1,52092976,25696784,26396192,0.0378842523951939
1747351706688358,25898924,1,277,1,52183173,25789344,26393829,0.0378876441155999
1747351706782161,25991484,1,278,1,52276976,25881904,26395072,0.0378858599059703
1747351706876178,26084044,1,279,1,52370993,25974464,26396529,0.0378837687333815
1747351706970757,26176604,1,280,1,52465572,26067024,26398548,0.0378808713267108
1747351707063729,26269164,1,281,1,52558544,26159584,26398960,0.0378802801322476
1747351707155054,26361724,1,282,1,52649869,26252144,26397725,0.0378820523359494
1747351707249008,26454284,1,283,1,52743823,26344704,26399119,0.0378800519820377
1747351707343323,26546844,1,284,1,52838138,26437264,26400874,0.0378775339028548
1747351707437381,26639404,1,285,1,52932196,26529824,26402372,0.0378753848328475
1747351707528066,26731964,1,286,1,53022881,26622384,26400497,0.0378780747953343
1747351707621168,26824524,1,287,1,53115983,26714944,26401039,0.0378772971775845
1747351707716175,26917084,1,288,1,53210990,26807504,26403486,0.0378737868173922
1747351707810424,27009644,1,289,1,53305239,26900064,26405175,0.0378713642306858
1747351707900497,27102204,1,290,1,53395312,26992624,26402688,0.0378749315221238
1747351707993872,27194764,1,291,1,53488687,27085184,26403503,0.0378737624322045
1747351708088973,27287324,1,292,1,53583788,27177744,26406044,0.0378701179169435
1747351708182255,27379884,1,293,1,53677070,27270304,26406766,0.0378690824919643
1747351708273268,27472444,1,294,1,53768083,27362864,26405219,0.0378713011242209
1747351708367287,27565004,1,295,1,53862102,27455424,26406678,0.0378692086903168
1747351708460905,27657564,1,296,1,53955720,27547984,26407736,0.0378676914976732
1747351708555903,27750124,1,297,1,54050718,27640544,26410174,0.0378641958208984
1747351708649740,27842684,1,298,1,54144555,27733104,26411451,0.0378623650779353
1747351708739824,27935244,1,299,1,54234639,27825664,26408975,0.0378659149020361
1747351708833830,28027804,1,300,1,54328645,27918224,26410421,0.0378638417009709
1747351708927801,28120364,1,301,1,54422616,28010784,26411832,0.0378618188999536
1747351709021968,28212924,1,302,1,54516783,28103344,26413439,0.037859515377759
1747351709113019,28305484,1,303,1,54607834,28195904,26411930,0.0378616784157765
1747351709206825,28398044,1,304,1,54701640,28288464,26413176,0.0378598923506964
1747351709300360,28490604,1,305,1,54795175,28381024,26414151,0.0378584948651198
1747351709395445,28583164,1,306,1,54890260,28473584,26416676,0.0378548762153118
1747351709484971,28675724,1,307,1,54979786,28566144,26413642,0.0378592244113856
1747351709579077,28768292,1,308,1,55073892,28658712,26415180,0.0378570200922348
1747351709673862,28860844,1,309,1,55168677,28751264,26417413,0.0378538201299271
1747351709767983,28953404,1,310,1,55262798,28843824,26418974,0.0378515834869287
1747351709858277,29045964,1,311,1,55353092,28936384,26416708,0.0378548303596345
1747351709952660,29138524,1,312,1,55447475,29028944,26418531,0.0378522182024428
1747351710046810,29231084,1,313,1,55541625,29121504,26420121,0.0378499402027719
1747351710139874,29323644,1,314,1,55634689,29214064,26420625,0.037849218177087
1747351710235118,29416204,1,315,1,55729933,29306624,26423309,0.0378453735677087
1747351710325051,29508764,1,316,1,55819866,29399184,26420682,0.0378491365211541
1747351710418547,29601324,1,317,1,55913362,29491744,26421618,0.0378477956951765
1747351710513175,29693884,1,318,1,56007990,29584304,26423686,0.0378448336087554
1747351710607496,29786444,1,319,1,56102311,29676864,26425447,0.0378423116172831
1747351710698022,29879004,1,320,1,56192837,29769424,26423413,0.0378452246119757
1747351710791393,29971564,1,321,1,56286208,29861984,26424224,0.0378440630839338
1747351710886220,30064124,1,322,1,56381035,29954544,26426491,0.0378408166260136
1747351710980694,30156684,1,323,1,56475509,30047104,26428405,0.0378380761154522
1747351711070948,30249244,1,324,1,56565763,30139664,26426099,0.037841377949882
1747351711164156,30341804,1,325,1,56658971,30232224,26426747,0.0378404500561495
1747351711258205,30434364,1,326,1,56753020,30324784,26428236,0.0378383180776802
1747351711352649,30526924,1,327,1,56847464,30417344,26430120,0.0378356208749714
1747351711443228,30619484,1,328,1,56938043,30509904,26428139,0.0378384569568065
1747351711537361,30712044,1,329,1,57032176,30602464,26429712,0.0378362049499442
1747351711631812,30804604,1,330,1,57126627,30695024,26431603,0.0378334980288558
1747351711725401,30897172,1,331,1,57220216,30787592,26432624,0.0378320366528877
1747351711819854,30989724,1,332,1,57314669,30880144,26434525,0.0378293160175944
1747351711910410,31082284,1,333,1,57405225,30972704,26432521,0.0378321840735509
1747351712004288,31174844,1,334,1,57499103,31065264,26433839,0.0378302977482763
1747351712098774,31267404,1,335,1,57593589,31157824,26435765,0.0378275415899634
1747351712192104,31359964,1,336,1,57686919,31250384,26436535,0.03782643981142
1747351712283145,31452524,1,337,1,57777960,31342944,26435016,0.0378286133815844
1747351712377017,31545084,1,338,1,57871832,31435504,26436328,0.0378267359975258
1747351712470879,31637644,1,339,1,57965694,31528064,26437630,0.0378248731070069
1747351712565033,31730204,1,340,1,58059848,31620624,26439224,0.0378225926751859
1747351712655537,31822764,1,341,1,58150352,31713184,26437168,0.0378255341116718
1747351712750025,31915324,1,342,1,58244840,31805744,26439096,0.0378227757862825
1747351712843949,32007884,1,343,1,58338764,31898304,26440460,0.0378208245998745
1747351712938140,32100444,1,344,1,58432955,31990864,26442091,0.0378184917372835
1747351713028273,32193004,1,345,1,58523088,32083424,26439664,0.0378219632443135
1747351713122494,32285564,1,346,1,58617309,32175984,26441325,0.0378195873315728
1747351713216950,32378124,1,347,1,58711765,32268544,26443221,0.0378168756370489
1747351713310884,32470684,1,348,1,58805699,32361104,26444595,0.0378149107596467
1747351713404845,32563244,1,349,1,58899660,32453664,26445996,0.0378129074813442
1747351713494963,32655804,1,350,1,58989778,32546224,26443554,0.0378163994143903
1747351713589948,32748364,1,351,1,59084763,32638784,26445979,0.0378129317882314
1747351713683122,32840924,1,352,1,59177937,32731344,26446593,0.0378120539004778
1747351713777421,32933484,1,353,1,59272236,32823904,26448332,0.0378095677262369
1747351713868035,33026044,1,354,1,59362850,32916464,26446386,0.0378123498613383
1747351713961565,33118604,1,355,1,59456380,33009024,26447356,0.0378109630316164
1747351714056298,33211164,1,356,1,59551113,33101584,26449529,0.0378078566162747
1747351714150121,33303724,1,357,1,59644936,33194144,26450792,0.0378060513273099
1747351714240774,33396284,1,358,1,59735589,33286704,26448885,0.0378087771941993
1747351714334204,33488844,1,359,1,59829019,33379264,26449755,0.037807533566946
1747351714428340,33581404,1,360,1,59923155,33471824,26451331,0.0378052809516466
1747351714522179,33673964,1,361,1,60016994,33564384,26452610,0.0378034530430078
1747351714617601,33766524,1,362,1,60112416,33656944,26455472,0.0377993633982413
1747351714707504,33859084,1,363,1,60202319,33749504,26452815,0.0378031600795605
1747351714801274,33951644,1,364,1,60296089,33842064,26454025,0.0378014309731694
1747351714895377,34044204,1,365,1,60390192,33934624,26455568,0.0377992262347192
1747351714989938,34136764,1,366,1,60484753,34027184,26457569,0.0377963674591569
1747351715079962,34229324,1,367,1,60574777,34119744,26455033,0.0377999906482823
1747351715174063,34321884,1,368,1,60668878,34212304,26456574,0.0377977889351811
1747351715268325,34414444,1,369,1,60763140,34304864,26458276,0.0377953574904124
1747351715362664,34507004,1,370,1,60857479,34397424,26460055,0.0377928163792554
1747351715453139,34599564,1,371,1,60947954,34489984,26457970,0.0377957946131165
1747351715547072,34692132,1,372,1,61041887,34582552,26459335,0.0377938447810574
1747351715641467,34784684,1,373,1,61136282,34675104,26461178,0.0377912124698303
1747351715735238,34877244,1,374,1,61230053,34767664,26462389,0.0377894830281574
1747351715825306,34969804,1,375,1,61320121,34860224,26459897,0.0377930420515242
1747351715919907,35062364,1,376,1,61414722,34952784,26461938,0.0377901270874415
1747351716013409,35154924,1,377,1,61508224,35045344,26462880,0.0377887818710586
1747351716107993,35247484,1,378,1,61602808,35137904,26464904,0.037785891836222
1747351716201901,35340044,1,379,1,61696716,35230464,26466252,0.0377839672954069
1747351716292704,35432604,1,380,1,61787519,35323024,26464495,0.0377864758046582
1747351716386504,35525164,1,381,1,61881319,35415584,26465735,0.0377847053935966
1747351716480209,35617724,1,382,1,61975024,35508144,26466880,0.0377830707661802
1747351716575209,35710284,1,383,1,62070024,35600704,26469320,0.0377795878398085
1747351716664863,35802844,1,384,1,62159678,35693264,26466414,0.0377837360210567
1747351716759152,35895404,1,385,1,62253967,35785824,26468143,0.0377812678433844
1747351716857659,35991084,1,386,1,62352474,35881504,26470970,0.0377772329461292
1747351716951795,36086764,1,387,1,62446610,35977184,26469426,0.0377794365469051
1747351717050458,36182444,1,388,1,62545273,36072864,26472409,0.0377751794330466
1747351717144257,36278124,1,389,1,62639072,36168544,26470528,0.0377778637434054
1747351717238333,36370684,1,390,1,62733148,36261104,26472044,0.0377757002821542
1747351717332363,36463244,1,391,1,62827178,36353664,26473514,0.0377736027034416
1747351717426650,36555812,1,392,1,62921465,36446232,26475233,0.0377711501160348
1747351717516996,36648364,1,393,1,63011811,36538784,26473027,0.0377742975897693
1747351717611441,36740924,1,394,1,63106256,36631344,26474912,0.0377716080793771
1747351717705542,36833484,1,395,1,63200357,36723904,26476453,0.037769409671303
1747351717799611,36926044,1,396,1,63294426,36816464,26477962,0.037767257162768
1747351717890071,37018604,1,397,1,63384886,36909024,26475862,0.0377702527683517
1747351717983672,37111164,1,398,1,63478487,37001584,26476903,0.0377687677444752
1747351718078545,37203724,1,399,1,63573360,37094144,26479216,0.0377654685848704
1747351718172252,37296284,1,400,1,63667067,37186704,26480363,0.0377638327692109
1747351718262667,37388844,1,401,1,63757482,37279264,26478218,0.0377668920166757
1747351718356577,37481404,1,402,1,63851392,37371824,26479568,0.0377649665583668
1747351718450723,37573964,1,403,1,63945538,37464384,26481154,0.0377627047522173
1747351718545299,37666524,1,404,1,64040114,37556944,26483170,0.0377598301109723
1747351718634691,37759084,1,405,1,64129506,37649504,26480002,0.03776434760088
1747351718728984,37851644,1,406,1,64223799,37742064,26481735,0.0377618762516881
1747351718823687,37944204,1,407,1,64318502,37834624,26483878,0.0377588206681816
1747351718917857,38036764,1,408,1,64412672,37927184,26485488,0.0377565253847692
1747351719011425,38129324,1,409,1,64506240,38019744,26486496,0.0377550884798049
1747351719101947,38221884,1,410,1,64596762,38112304,26484458,0.0377579937637387
1747351719196509,38314444,1,411,1,64691324,38204864,26486460,0.0377551397959561
1747351719290585,38407004,1,412,1,64785400,38297424,26487976,0.0377529789365559
1747351719384520,38499564,1,413,1,64879335,38389984,26489351,0.0377510192680824
1747351719474609,38592124,1,414,1,64969424,38482544,26486880,0.0377545411162054
1747351719569028,38684692,1,415,1,65063843,38575112,26488731,0.0377519028752264
1747351719663435,38777244,1,416,1,65158250,38667664,26490586,0.0377492593029085
1747351719757521,38869804,1,417,1,65252336,38760224,26492112,0.0377470848681298
1747351719847522,38962364,1,418,1,65342337,38852784,26489553,0.0377507313921076
1747351719941831,39054924,1,419,1,65436646,38945344,26491302,0.0377482390257753
1747351720035360,39147484,1,420,1,65530175,39037904,26492271,0.0377468583195453
1747351720129553,39240044,1,421,1,65624368,39130464,26493904,0.037744531723222
1747351720220522,39332604,1,422,1,65715337,39223024,26492313,0.037746798476977
1747351720314537,39425164,1,423,1,65809352,39315584,26493768,0.0377447254765724
1747351720408655,39517724,1,424,1,65903470,39408144,26495326,0.0377425059801113
1747351720502843,39610284,1,425,1,65997658,39500704,26496954,0.0377401870418765
1747351720596908,39702844,1,426,1,66091723,39593264,26498459,0.0377380435594386
1747351720686960,39795404,1,427,1,66181775,39685824,26495951,0.0377416156906389
1747351720781348,39887964,1,428,1,66276163,39778384,26497779,0.0377390120130445
1747351720875229,39980524,1,429,1,66370044,39870944,26499100,0.0377371306950047
1747351720969458,40073084,1,430,1,66464273,39963504,26500769,0.0377347540367602
1747351721059427,40165644,1,431,1,66554242,40056064,26498178,0.0377384437526232
1747351721153570,40258204,1,432,1,66648385,40148624,26499761,0.0377361893943119
1747351721248427,40350764,1,433,1,66743242,40241184,26502058,0.0377329187038983
1747351721342263,40443324,1,434,1,66837078,40333744,26503334,0.0377311020568204
1747351721432842,40535884,1,435,1,66927657,40426304,26501353,0.0377339224906743
1747351721527102,40628444,1,436,1,67021917,40518864,26503053,0.0377315021027954
1747351721621102,40721004,1,437,1,67115917,40611424,26504493,0.0377294521347757
1747351721714773,40813564,1,438,1,67209588,40703984,26505604,0.0377278706797249
1747351721805375,40906124,1,439,1,67300190,40796544,26503646,0.0377306578875978
1747351721899581,40998684,1,440,1,67394396,40889104,26505292,0.037728314783327
1747351721993812,41091244,1,441,1,67488627,40981664,26506963,0.037725936388865
1747351722087314,41183804,1,442,1,67582129,41074224,26507905,0.0377245957385164
1747351722181822,41276364,1,443,1,67676637,41166784,26509853,0.0377218236555291
1747351722272428,41368924,1,444,1,67767243,41259344,26507899,0.0377246042773891
1747351722365790,41461484,1,445,1,67860605,41351904,26508701,0.0377234629490143
1747351722460935,41554044,1,446,1,67955750,41444464,26511286,0.0377197846984865
1747351722554329,41646604,1,447,1,68049144,41537024,26512120,0.0377185981354942
1747351722645258,41739164,1,448,1,68140073,41629584,26510489,0.037720918689957
1747351722738786,41831724,1,449,1,68233601,41722144,26511457,0.0377195414043068
1747351722833299,41924284,1,450,1,68328114,41814704,26513410,0.0377167629512763
1747351722926976,42016844,1,451,1,68421791,41907264,26514527,0.0377151740251674
1747351723017393,42109404,1,452,1,68512208,41999824,26512384,0.0377182225483758
1747351723111915,42201964,1,453,1,68606730,42092384,26514346,0.0377154314875426
1747351723206275,42294524,1,454,1,68701090,42184944,26516146,0.0377128712445617
1747351723300511,42387084,1,455,1,68795326,42277504,26517822,0.0377104876863567
1747351723390647,42479652,1,456,1,68885462,42370072,26515390,0.0377139465042754
1747351723484265,42572204,1,457,1,68979080,42462624,26516456,0.0377124303489123
1747351723579054,42664764,1,458,1,69073869,42555184,26518685,0.0377092604704946
1747351723673222,42757324,1,459,1,69168037,42647744,26520293,0.0377069740519081
1747351723766749,42849884,1,460,1,69261564,42740304,26521260,0.0377055992060709
1747351723856435,42942444,1,461,1,69351250,42832864,26518386,0.0377096856497978
1747351723951491,43035004,1,462,1,69446306,42925424,26520882,0.0377061366209464
1747351724045804,43127564,1,463,1,69540619,43017984,26522635,0.0377036444531246
1747351724139389,43220124,1,464,1,69634204,43110544,26523660,0.0377021874055088
1747351724229610,43312684,1,465,1,69724425,43203104,26521321,0.0377055124818254
1747351724324216,43405244,1,466,1,69819031,43295664,26523367,0.0377026038964057
1747351724418569,43497804,1,467,1,69913384,43388224,26525160,0.0377000553436812
1747351724512512,43590364,1,468,1,70007327,43480784,26526543,0.0376980897963221
1747351724602709,43682924,1,469,1,70097524,43573344,26524180,0.0377014482634335
1747351724697047,43775484,1,470,1,70191862,43665904,26525958,0.037698921185052
1747351724790683,43868044,1,471,1,70285498,43758464,26527034,0.0376973920265642
1747351724884833,43960604,1,472,1,70379648,43851024,26528624,0.037695132623539
1747351724974990,44053164,1,473,1,70469805,43943584,26526221,0.0376985474108807
1747351725069917,44145724,1,474,1,70564732,44036144,26528588,0.0376951837768372
1747351725164014,44238284,1,475,1,70658829,44128704,26530125,0.0376929999387488
1747351725257930,44330844,1,476,1,70752745,44221264,26531481,0.0376910734836099
1747351725352223,44423404,1,477,1,70847038,44313824,26533214,0.0376886117151129
1747351725442698,44515964,1,478,1,70937513,44406384,26531129,0.0376915735474355
1747351725536329,44608532,1,479,1,71031144,44498952,26532192,0.0376900634519756
1747351725630254,44701084,1,480,1,71125069,44591504,26533565,0.0376881131502683
1747351725724708,44793644,1,481,1,71219523,44684064,26535459,0.0376854231162913
1747351725814636,44886204,1,482,1,71309451,44776624,26532827,0.0376891614301031
1747351725908964,44978764,1,483,1,71403779,44869184,26534595,0.0376866502013691
1747351726003592,45071324,1,484,1,71498407,44961744,26536663,0.0376837132837689
1747351726097618,45163884,1,485,1,71592433,45054304,26538129,0.0376816315875169
1747351726187314,45256444,1,486,1,71682129,45146864,26535265,0.037685698635382
1747351726282409,45349004,1,487,1,71777224,45239424,26537800,0.0376820987421715
1747351726375886,45441564,1,488,1,71870701,45331984,26538717,0.0376807967016642
1747351726470080,45534124,1,489,1,71964895,45424544,26540351,0.0376784768219531
1747351726560335,45626684,1,490,1,72055150,45517104,26538046,0.0376817494400303
1747351727039753,46101964,1,495,1,72534568,45992384,26542184,0.0376758747509247
1747351727133712,46194524,1,496,1,72628527,46084944,26543583,0.037673889014908
1747351727227445,46287084,1,497,1,72722260,46177504,26544756,0.037672224223873
1747351727322276,46379644,1,498,1,72817091,46270064,26547027,0.0376690015043869
1747351727411955,46472212,1,499,1,72906770,46362632,26544138,0.0376731013077162
1747351727506603,46564764,1,500,1,73001418,46455184,26546234,0.037670126768264
1747351727600967,46657324,1,501,1,73095782,46547744,26548038,0.037667566996853
1747351727694676,46749884,1,502,1,73189491,46640304,26549187,0.037665936813809
1747351727789346,46842444,1,503,1,73284161,46732864,26551297,0.0376629435465996
1747351727879227,46935004,1,504,1,73374042,46825424,26548618,0.0376667440843813
1747351727972853,47027564,1,505,1,73467668,46917984,26549684,0.0376652317217786
1747351728066958,47120124,1,506,1,73561773,47010544,26551229,0.0376630400046641
1747351728162084,47212684,1,507,1,73656899,47103104,26553795,0.0376594004736422
1747351728251768,47305244,1,508,1,73746583,47195664,26550919,0.0376634797462189
1747351728346244,47397804,1,509,1,73841059,47288224,26552835,0.0376607620240927
1747351728439841,47490364,1,510,1,73934656,47380784,26553872,0.0376592912702147
1747351728534087,47582924,1,511,1,74028902,47473344,26555558,0.0376569002993648
1747351728624222,47675484,1,512,1,74119037,47565904,26553133,0.0376603393656033
1747351728718552,47768044,1,513,1,74213367,47658464,26554903,0.0376578291398767
1747351728813244,47860604,1,514,1,74308059,47751024,26557035,0.0376548059676089
1747351728907115,47953164,1,515,1,74401930,47843584,26558346,0.0376529472129024
1747351728997603,48045724,1,516,1,74492418,47936144,26556274,0.037655885008567
1747351729091450,48138284,1,517,1,74586265,48028704,26557561,0.0376540601751794
1747351729185910,48230844,1,518,1,74680725,48121264,26559461,0.0376513664942221
1747351729279451,48323404,1,519,1,74774266,48213824,26560442,0.0376499758550704
1747351729373669,48415964,1,520,1,74868484,48306384,26562100,0.0376476257524819
1747351729463847,48508524,1,521,1,74958662,48398944,26559718,0.03765100216802
1747351729558253,48601084,1,522,1,75053068,48491504,26561564,0.0376483854640487
1747351729652737,48693644,1,523,1,75147552,48584064,26563488,0.0376456585821861
1747351729746940,48786204,1,524,1,75241755,48676624,26565131,0.0376433302738089
1747351729836666,48878764,1,525,1,75331481,48769184,26562297,0.0376473465378389
1747351729931090,48971324,1,526,1,75425905,48861744,26564161,0.0376447048337043
1747351730025331,49063884,1,527,1,75520146,48954304,26565842,0.03764232279933
1747351730118770,49156444,1,528,1,75613585,49046864,26566721,0.0376410773463537
1747351730209365,49249004,1,529,1,75704180,49139424,26564756,0.0376438616639279
1747351730304142,49341564,1,530,1,75798957,49231984,26566973,0.0376407203033631
1747351730397384,49434124,1,531,1,75892199,49324544,26567655,0.037639754054319
1747351730492321,49526684,1,532,1,75987136,49417104,26570032,0.0376363867382621
1747351730582570,49619244,1,533,1,76077385,49509664,26567721,0.0376396605489797
1747351730675816,49711804,1,534,1,76170631,49602224,26568407,0.0376386886876582
1747351730771088,49804364,1,535,1,76265903,49694784,26571119,0.0376348470683526
1747351730864401,49896924,1,536,1,76359216,49787344,26571872,0.0376337805631458
1747351730958400,49989484,1,537,1,76453215,49879904,26573311,0.0376317426157395
1747351731049466,50082044,1,538,1,76544281,49972464,26571817,0.0376338584598862
1747351731143109,50174604,1,539,1,76637924,50065024,26572900,0.0376323246615913
1747351731236920,50267172,1,540,1,76731735,50157592,26574143,0.0376305644174489
1747351731331506,50359724,1,541,1,76826321,50250144,26576177,0.0376276843731135
1747351731421564,50452284,1,542,1,76916379,50342704,26573675,0.0376312271449093
1747351731516478,50544844,1,543,1,77011293,50435264,26576029,0.0376278939189899
1747351731610296,50637404,1,544,1,77105111,50527824,26577287,0.03762611285343
1747351731704100,50729964,1,545,1,77198915,50620384,26578531,0.0376243517747463
1747351731794778,50822524,1,546,1,77289593,50712944,26576649,0.0376270161072601
1747351731888890,50915084,1,547,1,77383705,50805504,26578201,0.0376248189258558
1747351731983434,51007644,1,548,1,77478249,50898064,26580185,0.0376220105315294
1747351732077227,51100204,1,549,1,77572042,50990624,26581418,0.0376202654049531
1747351732167086,51192764,1,550,1,77661901,51083184,26578717,0.0376240884765054
1747351732261663,51285324,1,551,1,77756478,51175744,26580734,0.0376212334843725
1747351732356065,51377884,1,552,1,77850880,51268304,26582576,0.037618626577048
1747351732450209,51470444,1,553,1,77945024,51360864,26584160,0.0376163850954854
1747351732544362,51563004,1,554,1,78039177,51453424,26585753,0.0376141311476112
1747351732633829,51655564,1,555,1,78128644,51545984,26582660,0.0376185077038941
1747351732728806,51748124,1,556,1,78223621,51638544,26585077,0.0376150875921856
1747351732822019,51840684,1,557,1,78316834,51731104,26585730,0.0376141636885652
1747351732916355,51933244,1,558,1,78411170,51823664,26587506,0.0376116511266607
1747351733006432,52025804,1,559,1,78501247,51916224,26585023,0.0376151639966608
1747351733101515,52118364,1,560,1,78596330,52008784,26587546,0.0376115945412938
1747351733194903,52210924,1,561,1,78689718,52101344,26588374,0.0376104232624379
1747351733289388,52303484,1,562,1,78784203,52193904,26590299,0.0376077004624882
1747351733379477,52396052,1,563,1,78874292,52286472,26587820,0.0376112069361083
1747351733473477,52488604,1,564,1,78968292,52379024,26589268,0.0376091587026765
1747351733568467,52581164,1,565,1,79063282,52471584,26591698,0.0376057219061377
1747351733662378,52673724,1,566,1,79157193,52564144,26593049,0.0376038114320776
1747351733752015,52766284,1,567,1,79246830,52656704,26590126,0.0376079451447503
1747351733846407,52858844,1,568,1,79341222,52749264,26591958,0.0376053542202495
1747351733941127,52951404,1,569,1,79435942,52841824,26594118,0.0376022998769878
1747351734035287,53043964,1,570,1,79530102,52934384,26595718,0.0376000377203578
1747351734128627,53136524,1,571,1,79623442,53026944,26596498,0.0375989350176854
1747351734218890,53229084,1,572,1,79713705,53119504,26594201,0.0376021825209187
1747351734313621,53321644,1,573,1,79808436,53212064,26596372,0.0375991131421984
1747351734408058,53414204,1,574,1,79902873,53304624,26598249,0.0375964598271111
1747351734501363,53506764,1,575,1,79996178,53397184,26598994,0.0375954068037309
1747351734592364,53599324,1,576,1,80087179,53489744,26597435,0.0375976104462704
1747351734685737,53691884,1,577,1,80180552,53582304,26598248,0.037596461240605
1747351734796476,53784444,1,578,1,80291291,53674864,26616427,0.0375707828853211
1747351734874269,53877004,1,579,1,80369084,53767424,26601660,0.0375916390180161
1747351734965150,53969564,1,580,1,80459965,53859984,26599981,0.0375940118152716
1747351735059151,54062124,1,581,1,80553966,53952544,26601422,0.0375919753462803
1747351735153160,54154684,1,582,1,80647975,54045104,26602871,0.0375899277938836
1747351735246708,54247244,1,583,1,80741523,54137664,26603859,0.0375885317990897
1747351735337837,54339804,1,584,1,80832652,54230224,26602428,0.0375905537644909
1747351735431957,54432364,1,585,1,80926772,54322784,26603988,0.0375883495361672
1747351735526142,54524924,1,586,1,81020957,54415344,26605613,0.037586053739863
1747351735619837,54617484,1,587,1,81114652,54507904,26606748,0.0375844503807831
1747351735714341,54710044,1,588,1,81209156,54600464,26608692,0.0375817045046784
1747351735804301,54802604,1,589,1,81299116,54693024,26606092,0.037585377063268
1747351735898303,54895164,1,590,1,81393118,54785584,26607534,0.0375833401171262
1747351735992028,54987724,1,591,1,81486843,54878144,26608699,0.0375816946179894
1747351736087036,55080284,1,592,1,81581851,54970704,26611147,0.0375782374205816
1747351736176698,55172844,1,593,1,81671513,55063264,26608249,0.0375823302014349
1747351736270962,55265404,1,594,1,81765777,55155824,26609953,0.0375799235722062
1747351736364995,55357964,1,595,1,81859810,55248384,26611426,0.0375778434421364
1747351736459559,55450524,1,596,1,81954374,55340944,26613430,0.0375750138182113
1747351736549568,55543084,1,597,1,82044383,55433504,26610879,0.0375786158736056
1747351736643925,55635644,1,598,1,82138740,55526064,26612676,0.037576078407147
1747351736737565,55728204,1,599,1,82232380,55618624,26613756,0.037574553550427
1747351736832432,55820764,1,600,1,82327247,55711184,26616063,0.0375712967015444
1747351736922043,55913324,1,601,1,82416858,55803744,26613114,0.0375754599781145
1747351737016619,56005884,1,602,1,82511434,55896304,26615130,0.0375726137726924
1747351737110613,56098444,1,603,1,82605428,55988864,26616564,0.0375705895020859
1747351737205192,56191012,1,604,1,82700007,56081432,26618575,0.0375677510911083
1747351737299564,56283564,1,605,1,82794379,56173984,26620395,0.037565182635344
1747351737389201,56376124,1,606,1,82884016,56266544,26617472,0.0375693078591385
1747351737483776,56468684,1,607,1,82978591,56359104,26619487,0.0375664639968456
1747351737578121,56561244,1,608,1,83072936,56451664,26621272,0.0375639451037501
1747351737671722,56653804,1,609,1,83166537,56544224,26622313,0.0375624762581673
1747351737761891,56746364,1,610,1,83256706,56636784,26619922,0.0375658501178177
1747351737856270,56838924,1,611,1,83351085,56729344,26621741,0.0375632833329721
1747351737950535,56931484,1,612,1,83445350,56821904,26623446,0.0375608777316054
1747351738044575,57024044,1,613,1,83539390,56914464,26624926,0.0375587898347586
1747351738134733,57116604,1,614,1,83629548,57007024,26622524,0.0375621785522665
1747351738228989,57209164,1,615,1,83723804,57099584,26624220,0.0375597857890296
1747351738322559,57301724,1,616,1,83817374,57192144,26625230,0.037558360998196
1747351738417289,57394284,1,617,1,83912104,57284704,26627400,0.0375553001795143
1747351738511861,57486844,1,618,1,84006676,57377264,26629412,0.0375524626679702
1747351738601999,57579404,1,619,1,84096814,57469824,26626990,0.0375558784526527
1747351738695689,57671964,1,620,1,84190504,57562384,26628120,0.0375542847185606
1747351738789872,57764524,1,621,1,84284687,57654944,26629743,0.0375519959017253
1747351738884639,57857084,1,622,1,84379454,57747504,26631950,0.0375488839532967
1747351738974323,57949644,1,623,1,84469138,57840064,26629074,0.0375529393173791
1747351739068515,58042204,1,624,1,84563330,57932624,26630706,0.0375506379740739
1747351739162670,58134764,1,625,1,84657485,58025184,26632301,0.0375483890783601
1747351739257038,58227324,1,626,1,84751853,58117744,26634109,0.0375458401856056
1747351739347390,58319892,1,627,1,84842205,58210312,26631893,0.0375489643188338
1747351739441070,58412444,1,628,1,84935885,58302864,26633021,0.0375473739911067
1747351739535649,58505004,1,629,1,85030464,58395424,26635040,0.0375445278099826
1747351739629891,58597564,1,630,1,85124706,58487984,26636722,0.0375421570266791
1747351739719732,58690124,1,631,1,85214547,58580544,26634003,0.0375459896133525
1747351739813968,58782684,1,632,1,85308783,58673104,26635679,0.0375436271025792
1747351739908190,58875244,1,633,1,85403005,58765664,26637341,0.0375412846199626
1747351740002236,58967804,1,634,1,85497051,58858224,26638827,0.0375391904455853
1747351740096342,59060364,1,635,1,85591157,58950784,26640373,0.0375370119630081
1747351740186140,59152924,1,636,1,85680955,59043344,26637611,0.0375409040998458
1747351740281167,59245484,1,637,1,85775982,59135904,26640078,0.0375374276306548
1747351740375422,59338044,1,638,1,85870237,59228464,26641773,0.0375350394284944
1747351740469506,59430604,1,639,1,85964321,59321024,26643297,0.0375328924194329
1747351740559843,59523164,1,640,1,86054658,59413584,26641074,0.0375360242608837
1747351740653710,59615724,1,641,1,86148525,59506144,26642381,0.0375341828494983
1747351740747406,59708284,1,642,1,86242221,59598704,26643517,0.037532582504029
1747351740841539,59800844,1,643,1,86336354,59691264,26645090,0.037530366758003
1747351740932471,59893404,1,644,1,86427286,59783824,26643462,0.0375326599824001
1747351741026581,59985964,1,645,1,86521396,59876384,26645012,0.0375304766235421
1747351741119936,60078524,1,646,1,86614751,59968944,26645807,0.0375293568702948
1747351741214520,60171084,1,647,1,86709335,60061504,26647831,0.0375265063786992
1747351741304562,60263644,1,648,1,86799377,60154064,26645313,0.0375300526587921
1747351741399540,60356204,1,649,1,86894355,60246624,26647731,0.0375266472030958
1747351741492979,60448764,1,650,1,86987794,60339184,26648610,0.0375254093928351
1747351741587063,60541324,1,651,1,87081878,60431744,26650134,0.0375232634852792
1747351741681501,60633884,1,652,1,87176316,60524304,26652012,0.0375206194564222
1747351741771549,60726444,1,653,1,87266364,60616864,26649500,0.037524156175538
1747351741865635,60819004,1,654,1,87360450,60709424,26651026,0.0375220075955049
1747351741960299,60911564,1,655,1,87455114,60801984,26653130,0.0375190456055255
1747351742053988,61004124,1,656,1,87548803,60894544,26654259,0.0375174564034963
1747351742144606,61096684,1,657,1,87639421,60987104,26652317,0.0375201900832861
1747351742238411,61189244,1,658,1,87733226,61079664,26653562,0.0375184374981475
1747351742333254,61281804,1,659,1,87828069,61172224,26655845,0.0375152241468991
1747351742427064,61374364,1,660,1,87921879,61264784,26657095,0.0375134649893396
1747351742517477,61466924,1,661,1,88012292,61357344,26654948,0.0375164866200451
1747351742610751,61559484,1,662,1,88105566,61449904,26655662,0.0375154817014111
1747351742705736,61652044,1,663,1,88200551,61542464,26658087,0.0375120690393125
1747351742800604,61744604,1,664,1,88295419,61635024,26660395,0.0375088216059814
1747351742890670,61837164,1,665,1,88385485,61727584,26657901,0.0375123307720289
1747351742984661,61929724,1,666,1,88479476,61820144,26659332,0.0375103172127493
1747351743078056,62022284,1,667,1,88572871,61912704,26660167,0.0375091423845919
1747351743172498,62114852,1,668,1,88667313,62005272,26662041,0.0375065059722922
1747351743267170,62207404,1,669,1,88761985,62097824,26664161,0.0375035239248667
1747351743357002,62299964,1,670,1,88851817,62190384,26661433,0.0375073612884948
1747351743450949,62392524,1,671,1,88945764,62282944,26662820,0.0375054101554149
1747351743545353,62485084,1,672,1,89040168,62375504,26664664,0.0375028164615162
1747351743639318,62577644,1,673,1,89134133,62468064,26666069,0.0375008404875874
1747351743729062,62670204,1,674,1,89223877,62560624,26663253,0.0375048010833486
1747351743823678,62762764,1,675,1,89318493,62653184,26665309,0.037501909315958
1747351743917525,62855324,1,676,1,89412340,62745744,26666596,0.0375000993752633
1747351744012060,62947884,1,677,1,89506875,62838304,26668571,0.0374973222224767
1747351744102669,63040444,1,678,1,89597484,62930864,26666620,0.0375000656251148
1747351744195838,63133004,1,679,1,89690653,63023424,26667229,0.0374992092354252
1747351744290213,63225564,1,680,1,89785028,63115984,26669044,0.037496657173013
1747351744384312,63318124,1,681,1,89879127,63208544,26670583,0.0374944934649535
1747351744475236,63410684,1,682,1,89970051,63301104,26668947,0.037496793555441
1747351744569119,63503244,1,683,1,90063934,63393664,26670270,0.0374949334971112
1747351744663113,63595804,1,684,1,90157928,63486224,26671704,0.0374929175878676
1747351744757716,63688364,1,685,1,90252531,63578784,26673747,0.0374900459241815
1747351744851745,63780924,1,686,1,90346560,63671344,26675216,0.0374879813531781
1747351744942202,63873484,1,687,1,90437017,63763904,26673113,0.0374909370346085
1747351745036021,63966044,1,688,1,90530836,63856464,26674372,0.0374891675050494
1747351745130016,64058604,1,689,1,90624831,63949024,26675807,0.0374871508104703
1747351745224255,64151164,1,690,1,90719070,64041584,26677486,0.0374847914829755
1747351745314541,64243732,1,691,1,90809356,64134152,26675204,0.0374879982173707
1747351745408871,64336284,1,692,1,90903686,64226704,26676982,0.0374854996715895
1747351745502653,64428844,1,693,1,90997468,64319264,26678204,0.0374837826414401
1747351745596655,64521404,1,694,1,91091470,64411824,26679646,0.037481756691974
1747351745687773,64613964,1,695,1,91182588,64504384,26678204,0.0374837826414401
1747351745780842,64706524,1,696,1,91275657,64596944,26678713,0.0374830674927984
1747351745875857,64799084,1,697,1,91370672,64689504,26681168,0.0374796185834143
1747351745970151,64891644,1,698,1,91464966,64782064,26682902,0.0374771829540879
1747351746060273,64984204,1,699,1,91555088,64874624,26680464,0.037480607533662
1747351746154349,65076764,1,700,1,91649164,64967184,26681980,0.0374784779840176
1747351746248708,65169324,1,701,1,91743523,65059744,26683779,0.0374759512136568
1747351746342277,65261884,1,702,1,91837092,65152304,26684788,0.0374745341802977
1747351746436444,65354444,1,703,1,91931259,65244864,26686395,0.0374722775406719
1747351746526867,65447004,1,704,1,92021682,65337424,26684258,0.0374752784956583
1747351746621194,65539564,1,705,1,92116009,65429984,26686025,0.0374727970913614
1747351746715324,65632124,1,706,1,92210139,65522544,26687595,0.0374705926105368
1747351746809764,65724684,1,707,1,92304579,65615104,26689475,0.037467953191286
1747351746899359,65817244,1,708,1,92394174,65707664,26686510,0.0374721160616356
1747351746993459,65909804,1,709,1,92488274,65800224,26688050,0.037469953780812
1747351747087962,66002364,1,710,1,92582777,65892784,26689993,0.0374672260123859
1747351747181882,66094924,1,711,1,92676697,65985344,26691353,0.0374653169511489
1747351747272647,66187484,1,712,1,92767462,66077904,26689558,0.0374678366723045
1747351747366584,66280044,1,713,1,92861399,66170464,26690935,0.0374659036860267
1747351747460507,66372604,1,714,1,92955322,66263024,26692298,0.0374639905488841
1747351747554677,66465164,1,715,1,93049492,66355584,26693908,0.0374617309687288
1747351747644629,66557724,1,716,1,93139444,66448144,26691300,0.0374653913447452
1747351747739154,66650284,1,717,1,93233969,66540704,26693265,0.0374626333646333
1747351747833004,66742844,1,718,1,93327819,66633264,26694555,0.0374608230030431
1747351747927467,66835404,1,719,1,93422282,66725824,26696458,0.0374581526882704
1747351748021593,66927964,1,720,1,93516408,66818384,26698024,0.0374559555418783
1747351748111834,67020524,1,721,1,93606649,66910944,26695705,0.0374592092623139
1747351748206539,67113084,1,722,1,93701354,67003504,26697850,0.0374561996565266
1747351748300561,67205644,1,723,1,93795376,67096064,26699312,0.0374541486312456
1747351748394390,67298204,1,724,1,93889205,67188624,26700581,0.037452368545838
1747351748484642,67390764,1,725,1,93979457,67281184,26698273,0.0374556062109335
1747351748578633,67483324,1,726,1,94073448,67373744,26699704,0.0374535987365253
1747351748672732,67575884,1,727,1,94167547,67466304,26701243,0.0374514399947597
1747351748766896,67668444,1,728,1,94261711,67558864,26702847,0.0374491903428874
1747351748857583,67761004,1,729,1,94352398,67651424,26700974,0.0374518173007471
1747351748951447,67853564,1,730,1,94446262,67743984,26702278,0.0374499883493086
1747351749045648,67946124,1,731,1,94540463,67836544,26703919,0.0374476869855694
1747351749139808,68038692,1,732,1,94634623,67929112,26705511,0.0374454546104734
1747351749229947,68131244,1,733,1,94724762,68021664,26703098,0.03744883833329
1747351749324300,68223804,1,734,1,94819115,68114224,26704891,0.0374463239711407
1747351749418450,68316364,1,735,1,94913265,68206784,26706481,0.0374440945626644
1747351749512053,68408924,1,736,1,95006868,68299344,26707524,0.037442632270966
1747351749606123,68501484,1,737,1,95100938,68391904,26709034,0.0374405154450737
1747351749697385,68594044,1,738,1,95192200,68484464,26707736,0.0374423350597744
1747351749790878,68686604,1,739,1,95285693,68577024,26708669,0.0374410271062178
1747351749885615,68779164,1,740,1,95380430,68669584,26710846,0.0374379755699239
1747351749979768,68871724,1,741,1,95474583,68762144,26712439,0.0374357429510648
1747351750069316,68964284,1,742,1,95564131,68854704,26709427,0.0374399645488463
1747351750163590,69056844,1,743,1,95658405,68947264,26711141,0.0374375621018959
1747351750258111,69149404,1,744,1,95752926,69039824,26713102,0.0374348138228199
1747351750352495,69241964,1,745,1,95847310,69132384,26714926,0.0374322579070591
1747351750442468,69334524,1,746,1,95937283,69224944,26712339,0.0374358830950745
1747351750536822,69427084,1,747,1,96031637,69317504,26714133,0.0374333690709707
1747351750630734,69519644,1,748,1,96125549,69410064,26715485,0.0374314746672201
1747351750724982,69612204,1,749,1,96219797,69502624,26717173,0.0374291097340276
1747351750814864,69704764,1,750,1,96309679,69595184,26714495,0.037432861822767
1747351750909033,69797324,1,751,1,96403848,69687744,26716104,0.0374306073969468
1747351751003926,69889884,1,752,1,96498741,69780304,26718437,0.0374273390318453
1747351751097432,69982444,1,753,1,96592247,69872864,26719383,0.0374260139165638
1747351751191908,70075004,1,754,1,96686723,69965424,26721299,0.0374233303553094
1747351751281651,70167572,1,755,1,96776466,70057992,26718474,0.0374272872021059
1747351751376475,70260124,1,756,1,96871290,70150544,26720746,0.0374241048509648
1747351751490286,70352684,1,757,1,96985101,70243104,26741997,0.0373943651253868
1747351751564704,70445244,1,758,1,97059519,70335664,26723855,0.0374197510052348
1747351751655013,70537804,1,759,1,97149828,70428224,26721604,0.0374229032059602
1747351751748303,70630364,1,760,1,97243118,70520784,26722334,0.037421880888099
1747351751842558,70722924,1,761,1,97337373,70613344,26724029,0.03741950736545
1747351751937446,70815484,1,762,1,97432261,70705904,26726357,0.0374162479383179
1747351752027797,70908044,1,763,1,97522612,70798464,26724148,0.0374193407400677
1747351752121096,71000604,1,764,1,97615911,70891024,26724887,0.0374183060156624
1747351752215859,71093164,1,765,1,97710674,70983584,26727090,0.0374152217843394
1747351752309579,71185724,1,766,1,97804394,71076144,26728250,0.0374135979721829
1747351752404606,71278284,1,767,1,97899421,71168704,26730717,0.0374101450402546
1747351752493923,71370844,1,768,1,97988738,71261264,26727474,0.0374146842309153
1747351752588684,71463404,1,769,1,98083499,71353824,26729675,0.0374116033958512
1747351752682285,71555964,1,770,1,98177100,71446384,26730716,0.0374101464397736
1747351752776971,71648524,1,771,1,98271786,71538944,26732842,0.0374071712988839
1747351752867231,71741084,1,772,1,98362046,71631504,26730542,0.0374103899576746
1747351752961168,71833644,1,773,1,98455983,71724064,26731919,0.0374084628941154
1747351753054685,71926204,1,774,1,98549500,71816624,26732876,0.0374071237228646
1747351753149453,72018764,1,775,1,98644268,71909184,26735084,0.0374040343392973
1747351753239446,72111324,1,776,1,98734261,72001744,26732517,0.0374076260757638
1747351753333701,72203884,1,777,1,98828516,72094304,26734212,0.0374052543609663
1747351753428352,72296444,1,778,1,98923167,72186864,26736303,0.0374023289607392
1747351753522436,72389004,1,779,1,99017251,72279424,26737827,0.0374001971065187
1747351753611986,72481564,1,780,1,99106801,72371984,26734817,0.0374044078925245
1747351753706679,72574124,1,781,1,99201494,72464544,26736950,0.0374014238722068
1747351753800653,72666684,1,782,1,99295468,72557104,26738364,0.037399445979567
1747351753894963,72759244,1,783,1,99389778,72649664,26740114,0.0373969983822806
1747351753989301,72851804,1,784,1,99484116,72742224,26741892,0.0373945119515103
1747351754079493,72944364,1,785,1,99574308,72834784,26739524,0.0373978235364249
1747351754173560,73036924,1,786,1,99668375,72927344,26741031,0.0373957159692159
1747351754267360,73129484,1,787,1,99762175,73019904,26742271,0.0373939819845517
1747351754361789,73222044,1,788,1,99856604,73112464,26744140,0.0373913687260087
1747351754451989,73314604,1,789,1,99946804,73205024,26741780,0.037394668567313
1747351754546568,73407164,1,790,1,100041383,73297584,26743799,0.0373918454891169
1747351754640170,73499724,1,791,1,100134985,73390144,26744841,0.0373903886734641
1747351754734143,73592284,1,792,1,100228958,73482704,26746254,0.0373884133456595
1747351754824327,73684844,1,793,1,100319142,73575264,26743878,0.0373917350355845
1747351754918525,73777404,1,794,1,100413340,73667824,26745516,0.0373894450194941
1747351755012958,73869964,1,795,1,100507773,73760384,26747389,0.0373868268039172
1747351755106980,73962532,1,796,1,100601795,73852952,26748843,0.0373847945498053
1747351755197341,74055084,1,797,1,100692156,73945504,26746652,0.0373878569923443
1747351755291435,74147644,1,798,1,100786250,74038064,26748186,0.0373857128105808
1747351755385527,74240204,1,799,1,100880342,74130624,26749718,0.0373835716698022
1747351755480085,74332764,1,800,1,100974900,74223184,26751716,0.0373807796105491
1747351755574190,74425324,1,801,1,101069005,74315744,26753261,0.0373786208716761
1747351755664165,74517884,1,802,1,101158980,74408304,26750676,0.0373822328826381
1747351755758699,74610444,1,803,1,101253514,74500864,26752650,0.0373794745567261
1747351755852552,74703004,1,804,1,101347367,74593424,26753943,0.0373776680319607
1747351755947079,74795564,1,805,1,101441894,74685984,26755910,0.0373749201578268
1747351756037017,74888124,1,806,1,101531832,74778544,26753288,0.0373785831483591
1747351756130929,74980684,1,807,1,101625744,74871104,26754640,0.0373766942855519
1747351756225675,75073244,1,808,1,101720490,74963664,26756826,0.0373736406552855
1747351756319693,75165804,1,809,1,101814508,75056224,26758284,0.0373716042478658
1747351756410224,75258364,1,810,1,101905039,75148784,26756255,0.0373744382388342
1747351756503910,75350924,1,811,1,101998725,75241344,26757381,0.0373728654534612
1747351756597656,75443484,1,812,1,102092471,75333904,26758567,0.0373712090038304
1747351756692268,75536044,1,813,1,102187083,75426464,26760619,0.0373683433854799
1747351756782735,75628604,1,814,1,102277550,75519024,26758526,0.0373712662648159
1747351756876158,75721164,1,815,1,102370973,75611584,26759389,0.0373700610279255
1747351756970462,75813724,1,816,1,102465277,75704144,26761133,0.0373676256532187
1747351757065102,75906284,1,817,1,102559917,75796704,26763213,0.0373647214928939
1747351757159484,75998844,1,818,1,102654299,75889264,26765035,0.0373621779310208
1747351757249386,76091412,1,819,1,102744201,75981832,26762369,0.0373658998573706
1747351757343881,76183964,1,820,1,102838696,76074384,26764312,0.0373631872173661
1747351757438106,76276524,1,821,1,102932921,76166944,26765977,0.0373608630090356
1747351757532104,76369084,1,822,1,103026919,76259504,26767415,0.0373588559074531
1747351757622271,76461644,1,823,1,103117086,76352064,26765022,0.03736219607815
1747351757716349,76554204,1,824,1,103211164,76444624,26766540,0.0373600771709754
1747351757810509,76646764,1,825,1,103305324,76537184,26768140,0.0373578440638759
1747351757904392,76739324,1,826,1,103399207,76629744,26769463,0.0373559977650653
1747351757994510,76831884,1,827,1,103489325,76722304,26767021,0.0373594058150886
1747351758088600,76924444,1,828,1,103583415,76814864,26768551,0.0373572704775839
1747351758183409,77017004,1,829,1,103678224,76907424,26770800,0.0373541321140944
1747351758276852,77109564,1,830,1,103771667,76999984,26771683,0.0373529000772943
1747351758368032,77202124,1,831,1,103862847,77092544,26770303,0.0373548256065685
1747351758461799,77294684,1,832,1,103956614,77185104,26771510,0.0373531414552261
1747351758555759,77387244,1,833,1,104050574,77277664,26772910,0.0373511881973233
1747351758649606,77479804,1,834,1,104144421,77370224,26774197,0.0373493927754397
1747351758743881,77572364,1,835,1,104238696,77462784,26775912,0.037347000542876
1747351758834408,77664924,1,836,1,104329223,77555344,26773879,0.0373498363834392
1747351758928768,77757484,1,837,1,104423583,77647904,26775679,0.0373473255337427
1747351759022633,77850044,1,838,1,104517448,77740464,26776984,0.0373455053787984
1747351759117169,77942604,1,839,1,104611984,77833024,26778960,0.0373427496810929
1747351759206812,78035164,1,840,1,104701627,77925584,26776043,0.037346817825173
1747351759301435,78127724,1,841,1,104796250,78018144,26778106,0.0373439406058068
1747351759395452,78220284,1,842,1,104890267,78110704,26779563,0.0373419088280118
1747351759489474,78312844,1,843,1,104984289,78203264,26781025,0.0373398702999605
1747351759580078,78405404,1,844,1,105074893,78295824,26779069,0.0373425976832876
1747351759673859,78497964,1,845,1,105168674,78388384,26780290,0.0373408951135331
1747351759767879,78590524,1,846,1,105262694,78480944,26781750,0.037338859484537
1747351759861957,78683084,1,847,1,105356772,78573504,26783268,0.0373367432234184
1747351759952777,78775644,1,848,1,105447592,78666064,26781528,0.0373391689973775
1747351760046657,78868204,1,849,1,105541472,78758624,26782848,0.0373373287262056
1747351760140154,78960764,1,850,1,105634969,78851184,26783785,0.0373360225225822
1747351760235059,79053324,1,851,1,105729874,78943744,26786130,0.0373327539289923
1747351760329517,79145884,1,852,1,105824332,79036304,26788028,0.0373301088083079
1747351760419262,79238444,1,853,1,105914077,79128864,26785213,0.037334032027298
1747351760513726,79331004,1,854,1,106008541,79221424,26787117,0.0373313783637111
1747351760607489,79423564,1,855,1,106102304,79313984,26788320,0.0373297018999325
1747351760701505,79516124,1,856,1,106196320,79406544,26789776,0.0373276730645302
1747351760792544,79608684,1,857,1,106287359,79499104,26788255,0.0373297924780841
1747351760886402,79701244,1,858,1,106381217,79591664,26789553,0.037327983785321
1747351760980652,79793804,1,859,1,106475467,79684224,26791243,0.037325629124412
1747351761074468,79886372,1,860,1,106569283,79776792,26792491,0.0373238904885701
1747351761164903,79978924,1,861,1,106659718,79869344,26790374,0.0373268398567336
1747351761259277,80071484,1,862,1,106754092,79961904,26792188,0.0373243125944025
1747351761353059,80164044,1,863,1,106847874,80054464,26793410,0.0373226102985771
1747351761447220,80256604,1,864,1,106942035,80147024,26795011,0.0373203802752684
1747351761537279,80349164,1,865,1,107032094,80239584,26792510,0.0373238640202056
1747351761631378,80441724,1,866,1,107126193,80332144,26794049,0.037321720207349
1747351761726359,80534284,1,867,1,107221174,80424704,26796470,0.037318348274978
1747351761819965,80626844,1,868,1,107314780,80517264,26797516,0.0373168916104015
1747351761914211,80719404,1,869,1,107409026,80609824,26799202,0.037314543918136
1747351762004209,80811964,1,870,1,107499024,80702384,26796640,0.0373181115244299
1747351762098226,80904524,1,871,1,107593041,80794944,26798097,0.0373160825561606
1747351762192944,80997084,1,872,1,107687759,80887504,26800255,0.0373130778046701
1747351762286490,81089644,1,873,1,107781305,80980064,26801241,0.0373117050811191
1747351762376889,81182204,1,874,1,107871704,81072624,26799080,0.0373147137886823
1747351762472494,81274764,1,875,1,107967309,81165184,26802125,0.0373104744493207
1747351762565219,81367324,1,876,1,108060034,81257744,26802290,0.0373102447589366
1747351762659253,81459884,1,877,1,108154068,81350304,26803764,0.0373081929836421
1747351762749896,81552444,1,878,1,108244711,81442864,26801847,0.0373108614492128
1747351762843531,81645004,1,879,1,108338346,81535424,26802922,0.0373093650013233
1747351762938134,81737564,1,880,1,108432949,81627984,26804965,0.0373065213851239
1747351763032454,81830124,1,881,1,108527269,81720544,26806725,0.0373040720192414
1747351763122376,81922684,1,882,1,108617191,81813104,26804087,0.0373077434049516
1747351763217147,82015252,1,883,1,108711962,81905672,26806290,0.0373046773723629
1747351763310344,82107804,1,884,1,108805159,81998224,26806935,0.037303779786835
1747351763404845,82200364,1,885,1,108899660,82090784,26808876,0.0373010789411685
1747351763499098,82292924,1,886,1,108993913,82183344,26810569,0.0372987234996765
1747351763589240,82385484,1,887,1,109084055,82275904,26808151,0.0373020877120544
1747351763684138,82478044,1,888,1,109178953,82368464,26810489,0.0372988347955906
1747351763777323,82570604,1,889,1,109272138,82461024,26811114,0.0372979653139366
1747351763872084,82663164,1,890,1,109366899,82553584,26813315,0.0372949036700609
1747351763962326,82755724,1,891,1,109457141,82646144,26810997,0.0372981280778182
1747351764056338,82848284,1,892,1,109551153,82738704,26812449,0.0372961082368865
1747351764150611,82940844,1,893,1,109645426,82831264,26814162,0.0372937256066402
1747351764244616,83033404,1,894,1,109739431,82923824,26815607,0.0372917159771919
1747351764335271,83125964,1,895,1,109830086,83016384,26813702,0.0372943653957219
1747351764429010,83218524,1,896,1,109923825,83108944,26814881,0.0372927256324575
1747351764522931,83311084,1,897,1,110017746,83201504,26816242,0.0372908329213317
1747351764617591,83403644,1,898,1,110112406,83294064,26818342,0.0372879128769407
1747351764712068,83496204,1,899,1,110206883,83386624,26820259,0.0372852476927981
1747351764802057,83588764,1,900,1,110296872,83479184,26817688,0.0372888222131602
1747351764896468,83681324,1,901,1,110391283,83571744,26819539,0.0372862486562502
1747351764989856,83773884,1,902,1,110484671,83664304,26820367,0.0372850975529156
1747351765084065,83866444,1,903,1,110578880,83756864,26822016,0.0372828052895054
1747351765174960,83959004,1,904,1,110669775,83849424,26820351,0.0372851197957849
1747351765268957,84051564,1,905,1,110763772,83941984,26821788,0.0372831222139254
1747351765363049,84144124,1,906,1,110857864,84034544,26823320,0.0372809928077508
1747351765456814,84236684,1,907,1,110951629,84127104,26824525,0.0372793180867135
1747351765547293,84329244,1,908,1,111042108,84219664,26822444,0.0372822103757584
1747351765641639,84421804,1,909,1,111136454,84312224,26824230,0.0372797280667515
1747351765735395,84514364,1,910,1,111230210,84404784,26825426,0.0372780659662217
1747351765829882,84606924,1,911,1,111324697,84497344,26827353,0.0372753882949242
1747351765919670,84699484,1,912,1,111414485,84589904,26824581,0.0372792402610128
1747351766014685,84792044,1,913,1,111509500,84682464,26827036,0.0372758287572283
1747351766108785,84884604,1,914,1,111603600,84775024,26828576,0.0372736890694459
1747351766202181,84977164,1,915,1,111696996,84867584,26829412,0.0372725276275156
1747351766296223,85069724,1,916,1,111791038,84960144,26830894,0.0372704688856062
1747351766387318,85162284,1,917,1,111882133,85052704,26829429,0.0372725040104282
1747351766480752,85254844,1,918,1,111975567,85145264,26830303,0.0372712898546095
1747351766575369,85347404,1,919,1,112070184,85237824,26832360,0.0372684325940767
1747351766669428,85439964,1,920,1,112164243,85330384,26833859,0.0372663506952168
1747351766759513,85532524,1,921,1,112254328,85422944,26831384,0.0372697882449895
1747351766853659,85625084,1,922,1,112348474,85515504,26832970,0.0372675853623359
1747351766948283,85717644,1,923,1,112443098,85608064,26835034,0.037264718949117
1747351767042191,85810212,1,924,1,112537006,85700632,26836374,0.0372628582385981
1747351767132630,85902764,1,925,1,112627445,85793184,26834261,0.037265792413661
1747351767226191,85995324,1,926,1,112721006,85885744,26835262,0.0372644023374916
1747351767321005,86087884,1,927,1,112815820,85978304,26837516,0.0372612726155431
1747351767414796,86180444,1,928,1,112909611,86070864,26838747,0.0372595635705347
1747351767505322,86273004,1,929,1,113000137,86163424,26836713,0.0372623875360592
1747351767599103,86365564,1,930,1,113093918,86255984,26837934,0.0372606922723634
1747351767693100,86458124,1,931,1,113187915,86348544,26839371,0.037258697307027
1747351767787588,86550684,1,932,1,113282403,86441104,26841299,0.0372560210293846
1747351767882019,86643244,1,933,1,113376834,86533664,26843170,0.0372534242416227
1747351767972279,86735804,1,934,1,113467094,86626224,26840870,0.037256616495665
1747351768066440,86828364,1,935,1,113561255,86718784,26842471,0.0372543943513993
1747351768160549,86920924,1,936,1,113655364,86811344,26844020,0.0372522446340004
1747351768254335,87013484,1,937,1,113749150,86903904,26845246,0.0372505433550506
1747351768344663,87106044,1,938,1,113839478,86996464,26843014,0.0372536407424292
1747351768438636,87198604,1,939,1,113933451,87089024,26844427,0.0372516798365634
1747351768533466,87291164,1,940,1,114028281,87181584,26846697,0.0372485300519464
1747351768627385,87383724,1,941,1,114122200,87274144,26848056,0.0372466445987746
1747351768717168,87476284,1,942,1,114211983,87366704,26845279,0.0372504975642085
1747351768812067,87568844,1,943,1,114306882,87459264,26847618,0.0372472522515777
1747351768905451,87661404,1,944,1,114400266,87551824,26848442,0.0372461091038355
1747351769000182,87753964,1,945,1,114494997,87644384,26850613,0.0372430975784426
1747351769090475,87846524,1,946,1,114585290,87736944,26848346,0.0372462422824854
1747351769184760,87939092,1,947,1,114679575,87829512,26850063,0.0372438604706439
1747351769278278,88031644,1,948,1,114773093,87922064,26851029,0.0372425205752822
1747351769372575,88124204,1,949,1,114867390,88014624,26852766,0.0372401115028522
1747351769466787,88216764,1,950,1,114961602,88107184,26854418,0.037237820607395
1747351769556790,88309324,1,951,1,115051605,88199744,26851861,0.0372413666225964
1747351769650694,88401884,1,952,1,115145509,88292304,26853205,0.037239502696233
1747351769745051,88494444,1,953,1,115239866,88384864,26855002,0.0372370108183198
1747351769839779,88587004,1,954,1,115334594,88477424,26857170,0.0372340049230801
1747351769929493,88679564,1,955,1,115424308,88569984,26854324,0.0372379509534479
1747351770023697,88772124,1,956,1,115518512,88662544,26855968,0.0372356714157538
1747351770117822,88864684,1,957,1,115612637,88755104,26857533,0.0372335016771644
1747351770212547,88957244,1,958,1,115707362,88847664,26859698,0.0372305005067443
1747351770302260,89049804,1,959,1,115797075,88940224,26856851,0.0372344471807212
1747351770396717,89142364,1,960,1,115891532,89032784,26858748,0.0372318173579796
1747351770490311,89234924,1,961,1,115985126,89125344,26859782,0.0372303840738543
1747351770584962,89327484,1,962,1,116079777,89217904,26861873,0.0372274859612358
1747351770674824,89420044,1,963,1,116169639,89310464,26859175,0.037231225456478
1747351770769099,89512604,1,964,1,116263914,89403024,26860890,0.0372288483367453
1747351770863892,89605164,1,965,1,116358707,89495584,26863123,0.0372257536847074
1747351770957249,89697724,1,966,1,116452064,89588144,26863920,0.0372246492693545
1747351771051735,89790284,1,967,1,116546550,89680704,26865846,0.0372219806515677
1747351771141579,89882844,1,968,1,116636394,89773264,26863130,0.0372257439844128
1747351771235825,89975404,1,969,1,116730640,89865824,26864816,0.0372234077463996
1747351771330220,90067964,1,970,1,116825035,89958384,26866651,0.0372208653769314
1747351771424142,90160524,1,971,1,116918957,90050944,26868013,0.0372189785675628
1747351771514781,90253084,1,972,1,117009596,90143504,26866092,0.037221639827631
1747351771608860,90345644,1,973,1,117103675,90236064,26867611,0.0372195354473458
1747351771702893,90438204,1,974,1,117197708,90328624,26869084,0.0372174950214156
1747351771797006,90530764,1,975,1,117291821,90421184,26870637,0.0372153440203148
1747351771885615,90623324,1,976,1,117380430,90513744,26866686,0.0372208168882459
1747351771981756,90715884,1,977,1,117476571,90606304,26870267,0.0372158564706483
1747351772075659,90808444,1,978,1,117570474,90698864,26871610,0.0372139964817887
1747351772169731,90901004,1,979,1,117664546,90791424,26873122,0.0372119026587234
1747351772259796,90993564,1,980,1,117754611,90883984,26870627,0.0372153578701382
1747351772354941,91086124,1,981,1,117849756,90976544,26873212,0.0372117780338278
1747351772448777,91178684,1,982,1,117943592,91069104,26874488,0.0372100112195625
1747351772543011,91271244,1,983,1,118037826,91161664,26876162,0.0372076935687469
1747351772637196,91363804,1,984,1,118132011,91254224,26877787,0.0372054440345107
1747351772727424,91456364,1,985,1,118222239,91346784,26875455,0.0372086723741049
1747351772821544,91548924,1,986,1,118316359,91439344,26877015,0.0372065127023964
1747351772915737,91641484,1,987,1,118410552,91531904,26878648,0.0372042522376869
1747351773010311,91734052,1,988,1,118505126,91624472,26880654,0.0372014758271878
1747351773099727,91826604,1,989,1,118594542,91717024,26877518,0.0372058164001601
1747351773194524,91919164,1,990,1,118689339,91809584,26879755,0.0372027200396729
1747351773288636,92011724,1,991,1,118783451,91902144,26881307,0.0372005721299191
1747351773382102,92104284,1,992,1,118876917,91994704,26882213,0.0371993183745698
1747351773473255,92196844,1,993,1,118968070,92087264,26880806,0.0372012654680071
1747351773567560,92289404,1,994,1,119062375,92179824,26882551,0.0371988506596714
1747351773661267,92381964,1,995,1,119156082,92272384,26883698,0.0371972635609877
1747351773754861,92474524,1,996,1,119249676,92364944,26884732,0.0371958329359578
1747351773845621,92567084,1,997,1,119340436,92457504,26882932,0.0371983234566824
1747351773939297,92659644,1,998,1,119434112,92550064,26884048,0.0371967792945467
1747351774033533,92752204,1,999,1,119528348,92642624,26885724,0.0371944605248495
1747351774127563,92844764,1,1000,1,119622378,92735184,26887194,0.0371924269970306
1747351774221772,92938364,1,1001,1,119716587,92828784,26887803,0.0371915846006458
1747351774316461,93031964,1,1002,1,119811276,92922384,26888892,0.0371900783416438
1747351774410370,93125564,1,1003,1,119905185,93015984,26889201,0.0371896509680596
1747351774505010,93219164,1,1004,1,119999825,93109584,26890241,0.0371882126307458
1747351774598831,93312764,1,1005,1,120093646,93203184,26890462,0.0371879069983996
1747351774693463,93406364,1,1006,1,120188278,93296784,26891494,0.0371864798586497
1747351774787199,93499964,1,1007,1,120282014,93390384,26891630,0.0371862917941381
1747351774881114,93593564,1,1008,1,120375929,93483984,26891945,0.0371858562108467
1747351774975746,93687164,1,1009,1,120470561,93577584,26892977,0.0371844292284933
1747351775069649,93780764,1,1010,1,120564464,93671184,26893280,0.0371840102806351
1747351775164048,93874364,1,1011,1,120658863,93764784,26894079,0.0371829055756101
1747351775258257,93967964,1,1012,1,120753072,93858384,26894688,0.0371820636104795
1747351775351947,94061564,1,1013,1,120846762,93951984,26894778,0.0371819391853689
1747351775446630,94155164,1,1014,1,120941445,94045584,26895861,0.0371804420018381
1747351775540536,94248764,1,1015,1,121035351,94139184,26896167,0.0371800189967589
1747351775634737,94342364,1,1016,1,121129552,94232784,26896768,0.0371791882206813
1747351775728751,94435964,1,1017,1,121223566,94326384,26897182,0.0371786159605865
1747351775823405,94529572,1,1018,1,121318220,94419992,26898228,0.03717717018385
1747351775917329,94623164,1,1019,1,121412144,94513584,26898560,0.0371767113183754
1747351776011525,94716764,1,1020,1,121506340,94607184,26899156,0.0371758876003395
1747351776105889,94810364,1,1021,1,121600704,94700784,26899920,0.0371748317467115
1747351776204194,94903964,1,1022,1,121699009,94794384,26904625,0.0371683307238067
1747351776298210,94997564,1,1023,1,121793025,94887984,26905041,0.0371677560350121
1747351776392641,95091164,1,1024,1,121887456,94981584,26905872,0.0371666080920923
1747351776487087,95184764,1,1025,1,121981902,95075184,26906718,0.0371654395010197
1747351776581438,95278364,1,1026,1,122076253,95168784,26907469,0.0371644021962823
1747351776674839,95371964,1,1027,1,122169654,95262384,26907270,0.0371646770556804
1747351776769380,95465564,1,1028,1,122264195,95355984,26908211,0.037163377379492
1747351776863455,95559164,1,1029,1,122358270,95449584,26908686,0.0371627213606788
1747351776958032,95652764,1,1030,1,122452847,95543184,26909663,0.0371613721063693
1747351777051694,95746364,1,1031,1,122546509,95636784,26909725,0.0371612864865768
1747351777145793,95839964,1,1032,1,122640608,95730384,26910224,0.0371605973997094
1747351777240449,95933564,1,1033,1,122735264,95823984,26911280,0.0371591392159718
1747351777334978,96027164,1,1034,1,122829793,95917584,26912209,0.0371578564955407
1747351777428590,96120764,1,1035,1,122923405,96011184,26912221,0.0371578399270725
1747351777523386,96214364,1,1036,1,123018201,96104784,26913417,0.0371561886771939
1747351777617752,96307964,1,1037,1,123112567,96198384,26914183,0.0371551311812065
1747351777711100,96401564,1,1038,1,123205915,96291984,26913931,0.0371554790714147
1747351777805402,96495164,1,1039,1,123300217,96385584,26914633,0.0371545099648953
1747351777899665,96588764,1,1040,1,123394480,96479184,26915296,0.0371535947440444
1747351777994094,96682364,1,1041,1,123488909,96572784,26916125,0.037152450436309
1747351778112355,96775964,1,1042,1,123607170,96666384,26940786,0.0371184419044047
1747351778182307,96869564,1,1043,1,123677122,96759984,26917138,0.0371510522403979
1747351778276638,96963164,1,1044,1,123771453,96853584,26917869,0.037150043341098
1747351778371268,97056764,1,1045,1,123866083,96947184,26918899,0.0371486218659983
1747351778464866,97150364,1,1046,1,123959681,97040784,26918897,0.0371486246260387
1747351778559014,97243964,1,1047,1,124053829,97134384,26919445,0.0371478683903029
1747351778653666,97337564,1,1048,1,124148481,97227984,26920497,0.0371464167247729
1747351778747723,97431164,1,1049,1,124242538,97321584,26920954,0.0371457861411597
1747351778841845,97524772,1,1050,1,124336660,97415192,26921468,0.0371450769326546
1747351778936121,97618364,1,1051,1,124430936,97508784,26922152,0.0371441332030218
1747351779030669,97711964,1,1052,1,124525484,97602384,26923100,0.0371428253061497
1747351779124862,97805564,1,1053,1,124619677,97695984,26923693,0.0371420072276117
1747351779218631,97899164,1,1054,1,124713446,97789584,26923862,0.0371417740887247
1747351779312967,97992764,1,1055,1,124807782,97883184,26924598,0.0371407587961016
1747351779407262,98086364,1,1056,1,124902077,97976784,26925293,0.037139800112853
1747351779501552,98179964,1,1057,1,124996367,98070384,26925983,0.0371388483755634
1747351779595291,98273564,1,1058,1,125090106,98163984,26926122,0.037138656654679
1747351779690117,98367164,1,1059,1,125184932,98257584,26927348,0.037136965734613
1747351779784291,98460764,1,1060,1,125279106,98351184,26927922,0.037136174116963
1747351779878541,98554364,1,1061,1,125373356,98444784,26928572,0.0371352777265723
1747351779972536,98647964,1,1062,1,125467351,98538384,26928967,0.0371347330181659
1747351780066348,98741564,1,1063,1,125561163,98631984,26929179,0.0371344406749273
1747351780160858,98835164,1,1064,1,125655673,98725584,26930089,0.0371331858576479
1747351780254917,98928764,1,1065,1,125749732,98819184,26930548,0.0371325529655022
1747351780348743,99022364,1,1066,1,125843558,98912784,26930774,0.0371322413533305
1747351780443359,99115964,1,1067,1,125938174,99006384,26931790,0.0371308405419766
1747351780537068,99209564,1,1068,1,126031883,99099984,26931899,0.037130690264359
1747351780631229,99303164,1,1069,1,126126044,99193584,26932460,0.0371299168364122
1747351780729594,99396764,1,1070,1,126224409,99287184,26937225,0.0371233488230506
1747351780823813,99490364,1,1071,1,126318628,99380784,26937844,0.0371224957721189
1747351780917816,99583964,1,1072,1,126412631,99474384,26938247,0.0371219404143112
1747351781012569,99677564,1,1073,1,126507384,99567984,26939400,0.0371203516039704
1747351781106894,99771164,1,1074,1,126601709,99661584,26940125,0.0371193526384899
1747351781200395,99864764,1,1075,1,126695210,99755184,26940026,0.0371194890457789
1747351781295369,99958364,1,1076,1,126790184,99848784,26941400,0.0371175959675443
1747351781389115,100051964,1,1077,1,126883930,99942384,26941546,0.0371173948221085
1747351781483919,100146604,1,1078,1,126978734,100037024,26941710,0.0371171688805202
1747351781577503,100241244,1,1079,1,127072318,100131664,26940654,0.037118623772088
1747351781676123,100335884,1,1080,1,127170938,100226304,26944634,0.0371131409689959
1747351781770218,100430524,1,1081,1,127265033,100320944,26944089,0.0371138916591316
1747351781864596,100525164,1,1082,1,127359411,100415584,26943827,0.0371142525521708
1747351781963082,100619804,1,1083,1,127457897,100510224,26947673,0.0371089555673322
1747351782057412,100714444,1,1084,1,127552227,100604864,26947363,0.037109382465364
1747351782151667,100809084,1,1085,1,127646482,100699504,26946978,0.0371099126588517
1747351782245384,100903724,1,1086,1,127740199,100794144,26946055,0.0371111838077967
1747351782343556,100998364,1,1087,1,127838371,100888784,26949587,0.0371063200337726
1747351782437969,101093004,1,1088,1,127932784,100983424,26949360,0.0371066325879353
1747351782529054,101187644,1,1089,1,128023869,101078064,26945805,0.0371115281209821
1747351782630048,101282284,1,1090,1,128124863,101172704,26952159,0.037102779038963
1747351782724332,101376924,1,1091,1,128219147,101267344,26951803,0.0371032691208079
1747351782818822,101471564,1,1092,1,128313637,101361984,26951653,0.0371034756198441
1747351782913097,101566204,1,1093,1,128407912,101456624,26951288,0.0371039781104339
1747351783011218,101660844,1,1094,1,128506033,101551264,26954769,0.0370991864185517
1747351783105693,101755484,1,1095,1,128600508,101645904,26954604,0.0370994135176313
1747351783199336,101850132,1,1096,1,128694151,101740552,26953599,0.0371007968175233
1747351783293432,101944764,1,1097,1,128788247,101835184,26953063,0.037101534619646
1747351783391864,102039404,1,1098,1,128886679,101929824,26956855,0.0370963155753888
1747351783486510,102134044,1,1099,1,128981325,102024464,26956861,0.0370963073185709
1747351783580696,102228684,1,1100,1,129075511,102119104,26956407,0.0370969320948448
1747351783679126,102323324,1,1101,1,129173941,102213744,26960197,0.0370917170968743
1747351783773128,102417964,1,1102,1,129267943,102308384,26959559,0.0370925948751609
1747351783867568,102512604,1,1103,1,129362383,102403024,26959359,0.0370928700493212
1747351783961557,102607244,1,1104,1,129456372,102497664,26958708,0.0370937657694871
1747351784059742,102701884,1,1105,1,129554557,102592304,26962253,0.0370888886770701
1747351784153600,102796524,1,1106,1,129648415,102686944,26961471,0.037089964416259
1747351784248516,102891164,1,1107,1,129743331,102781584,26961747,0.0370895847364786
1747351784342410,102985804,1,1108,1,129837225,102876224,26961001,0.0370906109902966
1747351784440763,103080444,1,1109,1,129935578,102970864,26964714,0.0370855036697218
1747351784535515,103175084,1,1110,1,130030330,103065504,26964826,0.0370853496328884
1747351784629000,103269724,1,1111,1,130123815,103160144,26963671,0.0370869381991791
1747351784727139,103364364,1,1112,1,130221954,103254784,26967170,0.0370821261556181
1747351784821391,103459004,1,1113,1,130316206,103349424,26966782,0.0370826596959177
1747351784915678,103553644,1,1114,1,130410493,103444064,26966429,0.0370831451209205
1747351785010835,103648292,1,1115,1,130505650,103538712,26966938,0.0370824451778692
1747351785108556,103742924,1,1116,1,130603371,103633344,26970027,0.0370781979565685
1747351785202434,103837564,1,1117,1,130697249,103727984,26969265,0.0370792455782536
1747351785297161,103932204,1,1118,1,130791976,103822624,26969352,0.03707912596491
1747351785395272,104026844,1,1119,1,130890087,103917264,26972823,0.0370743544344616
1747351785489236,104121484,1,1120,1,130984051,104011904,26972147,0.0370752836249928
1747351785583352,104216124,1,1121,1,131078167,104106544,26971623,0.0370760039171539
1747351785677439,104310764,1,1122,1,131172254,104201184,26971070,0.0370767641031668
1747351785776042,104405404,1,1123,1,131270857,104295824,26975033,0.0370713170211877
1747351785870563,104500044,1,1124,1,131365378,104390464,26974914,0.037071480561532
1747351785963598,104594684,1,1125,1,131458413,104485104,26973309,0.037073686435728
1747351786058775,104689324,1,1126,1,131553590,104579744,26973846,0.0370729483663545
1747351786156859,104783964,1,1127,1,131651674,104674384,26977290,0.0370682155249841
1747351786251130,104878604,1,1128,1,131745945,104769024,26976921,0.0370687225573296
1747351786344708,104973244,1,1129,1,131839523,104863664,26975859,0.0370701818985634
1747351786443121,105067884,1,1130,1,131937936,104958304,26979632,0.0370649977731349
1747351786537818,105162524,1,1131,1,132032633,105052944,26979689,0.0370649194658989
1747351786631966,105257164,1,1132,1,132126781,105147584,26979197,0.0370655953918865
1747351786725866,105351804,1,1133,1,132220681,105242224,26978457,0.0370666120749604
1747351786824156,105446444,1,1134,1,132318971,105336864,26982107,0.0370615978952273
1747351786918159,105541084,1,1135,1,132412974,105431504,26981470,0.0370624728749026
1747351787013153,105635724,1,1136,1,132507968,105526144,26981824,0.0370619866173613
1747351787111207,105730364,1,1137,1,132606022,105620784,26985238,0.0370572977714704
1747351787205034,105825004,1,1138,1,132699849,105715424,26984425,0.0370584142519249
1747351787299667,105919644,1,1139,1,132794482,105810064,26984418,0.0370584238652099
1747351787393525,106014284,1,1140,1,132888340,105904704,26983636,0.0370594978378747
1747351787491855,106108924,1,1141,1,132986670,105999344,26987326,0.0370544306612667
1747351787586249,106203564,1,1142,1,133081064,106093984,26987080,0.0370547684299301
1747351787680503,106298204,1,1143,1,133175318,106188624,26986694,0.0370552984370742
1747351787774277,106392844,1,1144,1,133269092,106283264,26985828,0.0370564875756267
1747351787873239,106487484,1,1145,1,133368054,106377904,26990150,0.0370505536278975
1747351787966790,106582124,1,1146,1,133461605,106472544,26989061,0.0370520486059148
1747351788061142,106676764,1,1147,1,133555957,106567184,26988773,0.037052443992174
1747351788159623,106771404,1,1148,1,133654438,106661824,26992614,0.0370471714966175
1747351788253946,106866044,1,1149,1,133748761,106756464,26992297,0.0370476065819815
1747351788347564,106960684,1,1150,1,133842379,106851104,26991275,0.037049009355801
1747351788442700,107055324,1,1151,1,133937515,106945744,26991771,0.0370483285442811
1747351788540557,107149964,1,1152,1,134035372,107040384,26994988,0.0370439134849772
1747351788634831,107244604,1,1153,1,134129646,107135024,26994622,0.0370444157358454
1747351788728821,107339244,1,1154,1,134223636,107229664,26993972,0.0370453077450032
1747351788823223,107433884,1,1155,1,134318038,107324304,26993734,0.0370456343683315
1747351788921393,107528524,1,1156,1,134416208,107418944,26997264,0.037040790503808
1747351789015865,107623164,1,1157,1,134510680,107513584,26997096,0.0370410210046295
1747351789109515,107717804,1,1158,1,134604330,107608224,26996106,0.0370423793713063
1747351789207845,107812444,1,1159,1,134702660,107702864,26999796,0.0370373168745423
1747351789302305,107907092,1,1160,1,134797120,107797512,26999608,0.0370375747677521
1747351789396015,108001724,1,1161,1,134890830,107892144,26998686,0.0370388395938972
1747351789490465,108096364,1,1162,1,134985280,107986784,26998496,0.0370391002521029
1747351789589324,108191004,1,1163,1,135084139,108081424,27002715,0.037033313131661
1747351789683001,108285644,1,1164,1,135177816,108176064,27001752,0.0370346339007928
1747351789777262,108380284,1,1165,1,135272077,108270704,27001373,0.0370351537308862
1747351789875756,108474924,1,1166,1,135370571,108365344,27005227,0.0370298683288239
1747351789970074,108569564,1,1167,1,135464889,108459984,27004905,0.0370303098640783
1747351790064515,108664204,1,1168,1,135559330,108554624,27004706,0.0370305827436151
1747351790158182,108758844,1,1169,1,135652997,108649264,27003733,0.0370319170316192
1747351790256930,108853484,1,1170,1,135751745,108743904,27007841,0.0370262843297988
1747351790350282,108948124,1,1171,1,135845097,108838544,27006553,0.0370280501921144
1747351790445204,109042764,1,1172,1,135940019,108933184,27006835,0.0370276635525784
1747351790538749,109137404,1,1173,1,136033564,109027824,27005740,0.0370291649108671
1747351790637761,109232044,1,1174,1,136132576,109122464,27010112,0.0370231711738181
1747351790732201,109326684,1,1175,1,136227016,109217104,27009912,0.0370234453188888
1747351790825894,109421324,1,1176,1,136320709,109311744,27008965,0.0370247434509245
1747351790923687,109515964,1,1177,1,136418502,109406384,27012118,0.0370204217233169
1747351791018407,109610604,1,1178,1,136513222,109501024,27012198,0.0370203120827116
1747351791112993,109705252,1,1179,1,136607808,109595672,27012136,0.0370203970541241
1747351791207195,109799884,1,1180,1,136702010,109690304,27011706,0.0370209863827186
1747351791305064,109894524,1,1181,1,136799879,109784944,27014935,0.0370165613946507
1747351791399543,109989164,1,1182,1,136894358,109879584,27014774,0.0370167820023221
1747351791493729,110083804,1,1183,1,136988544,109974224,27014320,0.0370174041027129
1747351791591199,110178444,1,1184,1,137086014,110068864,27017150,0.0370135265932935
1747351791685522,110273084,1,1185,1,137180337,110163504,27016833,0.037013960888754
1747351791780058,110367724,1,1186,1,137274873,110258144,27016729,0.0370141033727658
1747351791873863,110462364,1,1187,1,137368678,110352784,27015894,0.0370152473947373
1747351791972105,110557004,1,1188,1,137466920,110447424,27019496,0.0370103128496549
1747351792066728,110651644,1,1189,1,137561543,110542064,27019479,0.0370103361356449
1747351792160818,110746284,1,1190,1,137655633,110636704,27018929,0.0370110895217201
1747351792255095,110840924,1,1191,1,137749910,110731344,27018566,0.037011586773332
1747351792352924,110935564,1,1192,1,137847739,110825984,27021755,0.0370072188131377
1747351792447831,111030204,1,1193,1,137942646,110920624,27022022,0.0370068531511076
1747351792541636,111124844,1,1194,1,138036451,111015264,27021187,0.0370079967249403
1747351792639030,111219484,1,1195,1,138133845,111109904,27023941,0.0370042252534521
1747351792734224,111314124,1,1196,1,138229039,111204544,27024495,0.0370034666697749
1747351792829076,111408764,1,1197,1,138323891,111299184,27024707,0.0370031763896644
1747351792923327,111503404,1,1198,1,138418142,111393824,27024318,0.0370037090297708
1747351793021608,111598044,1,1199,1,138516423,111488464,27027959,0.0369987241729943
1747351793115578,111692684,1,1200,1,138610393,111583104,27027289,0.0369996413624762
1747351793209706,111787324,1,1201,1,138704521,111677744,27026777,0.0370003422901665
1747351793307696,111881964,1,1202,1,138802511,111772384,27030127,0.036995756623711
1747351793401610,111976604,1,1203,1,138896425,111867024,27029401,0.0369967503164424
1747351793495500,112071244,1,1204,1,138990315,111961664,27028651,0.0369977769145785
1747351793590481,112165884,1,1205,1,139085296,112056304,27028992,0.036997310147563
1747351793688683,112260524,1,1206,1,139183498,112150944,27032554,0.0369924351210026
1747351793782663,112355164,1,1207,1,139277478,112245584,27031894,0.0369933383136231
1747351793877414,112449804,1,1208,1,139372229,112340224,27032005,0.036993186409961
1747351793971588,112544444,1,1209,1,139466403,112434864,27031539,0.0369938241400166
1747351794070052,112639084,1,1210,1,139564867,112529504,27035363,0.0369885915717129
1747351794163545,112733724,1,1211,1,139658360,112624144,27034216,0.0369901609131183
1747351794258122,112828364,1,1212,1,139752937,112718784,27034153,0.0369902471144555
1747351794356375,112923004,1,1213,1,139851190,112813424,27037766,0.0369853041852644
1747351794450790,113017644,1,1214,1,139945605,112908064,27037541,0.0369856119681889
1747351794545394,113112284,1,1215,1,140040209,113002704,27037505,0.0369856612139322
1747351794638643,113206924,1,1216,1,140133458,113097344,27036114,0.0369875641151683
1747351794736730,113301564,1,1217,1,140231545,113191984,27039561,0.0369828489449218
1747351794831746,113396204,1,1218,1,140326561,113286624,27039937,0.0369823346851732
1747351794925173,113490844,1,1219,1,140419988,113381264,27038724,0.0369839937713037
1747351795020277,113585484,1,1220,1,140515092,113475904,27039188,0.0369833591156657
1747351795118478,113680124,1,1221,1,140613293,113570544,27042749,0.0369784891321514
1747351795211987,113774764,1,1222,1,140706802,113665184,27041618,0.0369800357360273
1747351795306088,113869404,1,1223,1,140800903,113759824,27041079,0.0369807728456397
1747351795404655,113964052,1,1224,1,140899470,113854472,27044998,0.0369754140858135
1747351795499294,114058684,1,1225,1,140994109,113949104,27045005,0.0369754045155473
1747351795593413,114153324,1,1226,1,141088228,114043744,27044484,0.0369761168303303
1747351795687615,114247964,1,1227,1,141182430,114138384,27044046,0.0369767156881777
1747351795785747,114342604,1,1228,1,141280562,114233024,27047538,0.0369719417715579
1747351795880116,114437244,1,1229,1,141374931,114327664,27047267,0.0369723122118031
1747351795974355,114531884,1,1230,1,141469170,114422304,27046866,0.03697286036763
1747351796072664,114626524,1,1231,1,141567479,114516944,27050535,0.0369678455527774
1747351796166199,114721164,1,1232,1,141661014,114611584,27049430,0.0369693557313407
1747351796260823,114815804,1,1233,1,141755638,114706224,27049414,0.0369693775990858
1747351796355529,114910444,1,1234,1,141850344,114800864,27049480,0.0369692873948038
1747351796453656,115005084,1,1235,1,141948471,114895504,27052967,0.0369645222278207
1747351796547428,115099724,1,1236,1,142042243,114990144,27052099,0.0369657082801597
1747351796641459,115194364,1,1237,1,142136274,115084784,27051490,0.0369665404752196
1747351796736354,115289004,1,1238,1,142231169,115179424,27051745,0.0369661920146001
1747351796834223,115383644,1,1239,1,142329038,115274064,27054974,0.0369617801148136
1747351796928126,115478284,1,1240,1,142422941,115368704,27054237,0.0369627870118828
1747351797022744,115572924,1,1241,1,142517559,115463344,27054215,0.0369628170693549
1747351797120342,115667564,1,1242,1,142615157,115557984,27057173,0.03695877614413
1747351797214992,115762212,1,1243,1,142709807,115652632,27057175,0.0369587734122279
1747351797308993,115856844,1,1244,1,142803808,115747264,27056544,0.0369596353473673
1747351797403430,115951484,1,1245,1,142898245,115841904,27056341,0.0369599126504208
1747351797502144,116046124,1,1246,1,142996959,115936544,27060415,0.0369543482611039
1747351797595844,116140764,1,1247,1,143090659,116031184,27059475,0.036955631992121
1747351797689928,116235404,1,1248,1,143184743,116125824,27058919,0.0369563913473409
1747351797788865,116330044,1,1249,1,143283680,116220464,27063216,0.036950523544578
1747351797883044,116424684,1,1250,1,143377859,116315104,27062755,0.0369511529775885
1747351797976958,116519324,1,1251,1,143471773,116409744,27062029,0.0369521442756565
1747351798071747,116613964,1,1252,1,143566562,116504384,27062178,0.0369519408230926
1747351798169530,116708604,1,1253,1,143664345,116599024,27065321,0.0369476497249007
1747351798263573,116803244,1,1254,1,143758388,116693664,27064724,0.0369484647247834
1747351798357719,116897884,1,1255,1,143852534,116788304,27064230,0.0369491391404817
1747351798451725,116992524,1,1256,1,143946540,116882944,27063596,0.0369500047222106
1747351798550151,117087164,1,1257,1,144044966,116977584,27067382,0.0369448364086338
1747351798644867,117181804,1,1258,1,144139682,117072224,27067458,0.0369447326749338
1747351798738967,117276444,1,1259,1,144233782,117166864,27066918,0.0369454697428055
1747351798836969,117371084,1,1260,1,144331784,117261504,27070280,0.0369408812912167
1747351798931230,117465724,1,1261,1,144426045,117356144,27069901,0.0369413984927392
1747351799025918,117560364,1,1262,1,144520733,117450784,27069949,0.036941332988843
1747351799119516,117655004,1,1263,1,144614331,117545424,27068907,0.0369427550214716
1747351799217695,117749644,1,1264,1,144712510,117640064,27072446,0.0369379257419148
1747351799312030,117844284,1,1265,1,144806845,117734704,27072141,0.0369383418917624
1747351799406656,117938924,1,1266,1,144901471,117829344,27072127,0.0369383609939477
1747351799500157,118033564,1,1267,1,144994972,117923984,27070988,0.036939915159358
1747351799598515,118128204,1,1268,1,145093330,118018624,27074706,0.0369348424318993
1747351799693313,118222844,1,1269,1,145188128,118113264,27074864,0.0369346268923086
1747351799787387,118317484,1,1270,1,145282202,118207904,27074298,0.0369353990267817
1747351799886082,118412124,1,1271,1,145380897,118302544,27078353,0.0369298679280826
1747351799980091,118506764,1,1272,1,145474906,118397184,27077722,0.0369307285154932
1747351800074250,118601404,1,1273,1,145569065,118491824,27077241,0.0369313845528058
1747351800168023,118696044,1,1274,1,145662838,118586464,27076374,0.0369325671155229
1747351800266770,118790684,1,1275,1,145761585,118681104,27080481,0.0369269659575101
1747351800360479,118885324,1,1276,1,145855294,118775744,27079550,0.0369282355135148
1747351800454539,118979964,1,1277,1,145949354,118870384,27078970,0.0369290264733112
1747351800553313,119074604,1,1278,1,146048128,118965024,27083104,0.0369233895789788
1747351800647021,119169244,1,1279,1,146141836,119059664,27082172,0.0369246602525085
1747351800741772,119263884,1,1280,1,146236587,119154304,27082283,0.0369245089123394
1747351800836044,119358524,1,1281,1,146330859,119248944,27081915,0.0369250106574812
1747351800934088,119453164,1,1282,1,146428903,119343584,27085319,0.036920370035147
1747351801028366,119547804,1,1283,1,146523181,119438224,27084957,0.0369208634889101
1747351801122025,119642444,1,1284,1,146616840,119532864,27083976,0.0369222007876539
1747351801216115,119737084,1,1285,1,146710930,119627504,27083426,0.0369229505897813
1747351801315049,119831724,1,1286,1,146809864,119722144,27087720,0.0369170974891943
1747351801409150,119926364,1,1287,1,146903965,119816784,27087181,0.0369178320918666
1747351801503757,120021012,1,1288,1,146998572,119911432,27087140,0.0369178879719305
1747351801601222,120115644,1,1289,1,147096037,120006064,27089973,0.0369140271937517
1747351801695138,120210284,1,1290,1,147189953,120100704,27089249,0.0369150137753911
1747351801789745,120304924,1,1291,1,147284560,120195344,27089216,0.0369150587451478
1747351801884374,120399564,1,1292,1,147379189,120289984,27089205,0.0369150737350911
1747351801982773,120494204,1,1293,1,147477588,120384624,27092964,0.0369099519712941
1747351802080414,120591964,1,1294,1,147575229,120482384,27092845,0.0369101140910081
1747351802175086,120686612,1,1295,1,147669901,120577032,27092869,0.0369100813944805
1747351802272805,120784364,1,1296,1,147767620,120674784,27092836,0.0369101263522209
1747351802371596,120882124,1,1297,1,147866411,120772544,27093867,0.036908721815162
1747351802470503,120979884,1,1298,1,147965318,120870304,27095014,0.0369071593762601
1747351802564654,121074524,1,1299,1,148059469,120964944,27094525,0.0369078254739656
1747351802662845,121169164,1,1300,1,148157660,121059584,27098076,0.0369029889797342
1747351802756697,121263804,1,1301,1,148251512,121154224,27097288,0.0369040621334504
1747351802851316,121358444,1,1302,1,148346131,121248864,27097267,0.0369040907335784
1747351802949066,121453084,1,1303,1,148443881,121343504,27100377,0.0368998556735945
1747351803043790,121547724,1,1304,1,148538605,121438144,27100461,0.0368997412996037
1747351803138387,121642364,1,1305,1,148633202,121532784,27100418,0.0368997998481056
1747351803231523,121737004,1,1306,1,148726338,121627424,27098914,0.0369018478009856
1747351803330181,121831644,1,1307,1,148824996,121722064,27102932,0.0368963771152139
1747351803424582,121926284,1,1308,1,148919397,121816704,27102693,0.036896702478975
1747351803518547,122020924,1,1309,1,149013362,121911344,27102018,0.0368976214243529
1747351803613163,122115564,1,1310,1,149107978,122005984,27101994,0.0368976540988091
1747351803710525,122210204,1,1311,1,149205340,122100624,27104716,0.0368939486397865
1747351803804783,122304844,1,1312,1,149299598,122195264,27104334,0.0368944686115512
1747351803898969,122399484,1,1313,1,149393784,122289904,27103880,0.0368950866075263
1747351803997774,122494124,1,1314,1,149492589,122384544,27108045,0.0368894178831413
1747351804091712,122588764,1,1315,1,149586527,122479184,27107343,0.0368903732099453
1747351804186371,122683412,1,1316,1,149681186,122573832,27107354,0.0368903582400554
1747351804280527,122778044,1,1317,1,149775342,122668464,27106878,0.0368910060391314
1747351804378554,122872684,1,1318,1,149873369,122763104,27110265,0.0368863970898108
1747351804472570,122967324,1,1319,1,149967385,122857744,27109641,0.0368872461276783
1747351804566940,123061964,1,1320,1,150061755,122952384,27109371,0.0368876135119475
1747351804664893,123156604,1,1321,1,150159708,123047024,27112684,0.0368831060768458
1747351804760145,123251244,1,1322,1,150254960,123141664,27113296,0.0368822735531674
1747351804853651,123345884,1,1323,1,150348466,123236304,27112162,0.036883816200272
1747351804947445,123440524,1,1324,1,150442260,123330944,27111316,0.0368849671480351
1747351805046020,123535164,1,1325,1,150540835,123425584,27115251,0.0368796143542982
1747351805140172,123629804,1,1326,1,150634987,123520224,27114763,0.0368802780979498
1747351805234923,123724444,1,1327,1,150729738,123614864,27114874,0.0368801271213725
1747351805328488,123819084,1,1328,1,150823303,123709504,27113799,0.0368815893339033
1747351805427144,123913724,1,1329,1,150921959,123804144,27117815,0.0368761273723565
1747351805521746,124008364,1,1330,1,151016561,123898784,27117777,0.0368761790466821
1747351805615704,124103004,1,1331,1,151110519,123993424,27117095,0.0368771064894672
1747351805713912,124197644,1,1332,1,151208727,124088064,27120663,0.0368722549297559
1747351805807637,124292284,1,1333,1,151302452,124182704,27119748,0.0368734989720405
1747351805902545,124386924,1,1334,1,151397360,124277344,27120016,0.0368731345881211
1747351805996604,124481572,1,1335,1,151491419,124371992,27119427,0.036873935426438
1747351806095047,124576204,1,1336,1,151589862,124466624,27123238,0.0368687543869209
1747351806188506,124670844,1,1337,1,151683321,124561264,27122057,0.0368703597960877
1747351806282864,124765484,1,1338,1,151777679,124655904,27121775,0.0368707431574814
1747351806377113,124860124,1,1339,1,151871928,124750544,27121384,0.0368712747107596
1747351806475719,124954764,1,1340,1,151970534,124845184,27125350,0.0368658837581819
1747351806569897,125049404,1,1341,1,152064712,124939824,27124888,0.0368665116700205
1747351806664094,125144044,1,1342,1,152158909,125034464,27124445,0.0368671137787335
1747351806762061,125238684,1,1343,1,152256876,125129104,27127772,0.0368625923278918
1747351806855971,125333324,1,1344,1,152350786,125223744,27127042,0.0368635843156065
1747351806950665,125427964,1,1345,1,152445480,125318384,27127096,0.0368635109338647
1747351807045269,125522604,1,1346,1,152540084,125413024,27127060,0.0368635598549935
1747351807143098,125617244,1,1347,1,152637913,125507664,27130249,0.0368592267619806
1747351807237037,125711884,1,1348,1,152731852,125602304,27129548,0.03686017916701
1747351807331193,125806524,1,1349,1,152826008,125696944,27129064,0.0368608367763812
1747351807429763,125901164,1,1350,1,152924578,125791584,27132994,0.0368554977751441
1747351807523700,125995804,1,1351,1,153018515,125886224,27132291,0.0368564527042703
1747351807617925,126090444,1,1352,1,153112740,125980864,27131876,0.036857016448107
1747351807712123,126185084,1,1353,1,153206938,126075504,27131434,0.036857616888219
1747351807810667,126279724,1,1354,1,153305482,126170144,27135338,0.0368523141300101
1747351807904670,126374364,1,1355,1,153399485,126264784,27134701,0.0368531792555959
1747351807998870,126469004,1,1356,1,153493685,126359424,27134261,0.0368537768542876
1747351808093691,126563644,1,1357,1,153588506,126454064,27134442,0.0368535310215702
1747351808191896,126658284,1,1358,1,153686711,126548704,27138007,0.0368486897361328
1747351808285634,126752924,1,1359,1,153780449,126643344,27137105,0.0368499145358357
1747351808380053,126847564,1,1360,1,153874868,126737984,27136884,0.0368502146377601
1747351808477786,126942204,1,1361,1,153972601,126832624,27139977,0.0368460150132035
1747351808572976,127036844,1,1362,1,154067791,126927264,27140527,0.036845268332483
1747351808666836,127131484,1,1363,1,154161651,127021904,27139747,0.0368463272704789
1747351808760799,127226124,1,1364,1,154255614,127116544,27139070,0.0368472464236983
1747351808859460,127320764,1,1365,1,154354275,127211184,27143091,0.03684178784207
1747351808953020,127415404,1,1366,1,154447835,127305824,27142011,0.0368432538031172
1747351809048033,127510044,1,1367,1,154542848,127400464,27142384,0.0368427474904194
1747351809145750,127604684,1,1368,1,154640565,127495104,27145461,0.0368385712808487
1747351809240001,127699324,1,1369,1,154734816,127589744,27145072,0.0368390991926637
1747351809334099,127793964,1,1370,1,154828914,127684384,27144530,0.0368398347659731
1747351809428268,127888604,1,1371,1,154923083,127779024,27144059,0.0368404740057483
1747351809526277,127983244,1,1372,1,155021092,127873664,27147428,0.0368359020972447
1747351809620930,128077884,1,1373,1,155115745,127968304,27147441,0.0368358844577652
1747351809715216,128172524,1,1374,1,155210031,128062944,27147087,0.0368363648003927
1747351809809692,128267164,1,1375,1,155304507,128157584,27146923,0.0368365873362517
1747351809907695,128361804,1,1376,1,155402510,128252224,27150286,0.0368320245318962
1747351810001760,128456444,1,1377,1,155496575,128346864,27149711,0.0368328045922846
1747351810095983,128551084,1,1378,1,155590798,128441504,27149294,0.0368333703263149
1747351810194637,128645724,1,1379,1,155689452,128536144,27153308,0.0368279253489114
1747351810289040,128740372,1,1380,1,155783855,128630792,27153063,0.0368282576444506
1747351810382595,128835004,1,1381,1,155877410,128725424,27151986,0.0368297184596368
1747351810477509,128929644,1,1382,1,155972324,128820064,27152260,0.0368293468020709
1747351810575701,129024284,1,1383,1,156070516,128914704,27155812,0.036824529496669
1747351810669206,129118924,1,1384,1,156164021,129009344,27154677,0.0368260686731792
1747351810764168,129213564,1,1385,1,156258983,129103984,27154999,0.0368256319950518
1747351810857834,129308204,1,1386,1,156352649,129198624,27154025,0.0368269529102959
1747351810955971,129402844,1,1387,1,156450786,129293264,27157522,0.0368222108040637
1747351811050347,129497484,1,1388,1,156545162,129387904,27157258,0.0368225687585985
1747351811144538,129592124,1,1389,1,156639353,129482544,27156809,0.0368231775684691
1747351811242591,129686764,1,1390,1,156737406,129577184,27160222,0.0368185503049275
1747351811337618,129781404,1,1391,1,156832433,129671824,27160609,0.0368180256930174
1747351811430907,129876044,1,1392,1,156925722,129766464,27159258,0.0368198571551549
1747351811525555,129970684,1,1393,1,157020370,129861104,27159266,0.0368198463095431
1747351811624005,130065324,1,1394,1,157118820,129955744,27163076,0.0368146818129139
1747351811717829,130159964,1,1395,1,157212644,130050384,27162260,0.0368157877879086
1747351811812359,130254604,1,1396,1,157307174,130145024,27162150,0.0368159368827578
1747351811910279,130349244,1,1397,1,157405094,130239664,27165430,0.0368114916642217
1747351812004513,130443884,1,1398,1,157499328,130334304,27165024,0.0368120418373272
1747351812099338,130538532,1,1399,1,157594153,130428952,27165201,0.036811801981513
1747351812193287,130633164,1,1400,1,157688102,130523584,27164518,0.0368127275440705
1747351812290989,130727804,1,1401,1,157785804,130618224,27167580,0.0368085784600615
1747351812385257,130822444,1,1402,1,157880072,130712864,27167208,0.0368090824791417
1747351812479726,130917084,1,1403,1,157974541,130807504,27167037,0.0368093141699626
1747351812573804,131011724,1,1404,1,158068619,130902144,27166475,0.0368100756539079
1747351812671820,131106364,1,1405,1,158166635,130996784,27169851,0.0368055018041872
1747351812766453,131201004,1,1406,1,158261268,131091424,27169844,0.0368055112867044
1747351812861240,131295644,1,1407,1,158356055,131186064,27169991,0.0368053121548696
1747351812958662,131390284,1,1408,1,158453477,131280704,27172773,0.0368015439572545
1747351813053137,131484924,1,1409,1,158547952,131375344,27172608,0.0368017674269617
1747351813147155,131579564,1,1410,1,158641970,131469984,27171986,0.036802609864439
1747351813241782,131674204,1,1411,1,158736597,131564624,27171973,0.0368026274720646
1747351813339983,131768844,1,1412,1,158834798,131659264,27175534,0.0367978049667763
1747351813434597,131863484,1,1413,1,158929412,131753904,27175508,0.0367978401728497
1747351813528294,131958124,1,1414,1,159023109,131848544,27174565,0.0367991171155821
1747351813626310,132052764,1,1415,1,159121125,131943184,27177941,0.0367945459886015
1747351813720806,132147404,1,1416,1,159215621,132037824,27177797,0.0367947409423949
1747351813814720,132242044,1,1417,1,159309535,132132464,27177071,0.0367957238659015
1747351813909259,132336684,1,1418,1,159404074,132227104,27176970,0.0367958606128644
1747351814007430,132431324,1,1419,1,159502245,132321744,27180501,0.0367910804881779
1747351814101508,132525964,1,1420,1,159596323,132416384,27179939,0.0367918412178923
1747351814195380,132620604,1,1421,1,159690195,132511024,27179171,0.0367928808424657
1747351814290284,132715244,1,1422,1,159785099,132605664,27179435,0.0367925234648917
1747351814388704,132809884,1,1423,1,159883519,132700304,27183215,0.0367874072290566
1747351814483142,132904524,1,1424,1,159977957,132794944,27183013,0.0367876806003808
1747351814576566,132999164,1,1425,1,160071381,132889584,27181797,0.0367893263274683
1747351814675306,133093804,1,1426,1,160170121,132984224,27185897,0.0367837780007773
1747351814769379,133188444,1,1427,1,160264194,133078864,27185330,0.0367845451940439
1747351814863913,133283084,1,1428,1,160358728,133173504,27185224,0.0367846886234963
1747351814954028,133377724,1,1429,1,160448843,133268144,27180699,0.0367908124805767
1747351815056112,133472364,1,1430,1,160550927,133362784,27188143,0.0367807393097792
1747351815149956,133567004,1,1431,1,160644771,133457424,27187347,0.0367818161882437
1747351815243910,133661644,1,1432,1,160738725,133552064,27186661,0.0367827443024356
1747351815343277,133756284,1,1433,1,160838092,133646704,27191388,0.0367763499237332
1747351815437040,133850924,1,1434,1,160931855,133741344,27190511,0.0367775361044152
1747351815531385,133945564,1,1435,1,161026200,133835984,27190216,0.0367779351219571
1747351815625567,134040204,1,1436,1,161120382,133930624,27189758,0.0367785546307547
1747351815723151,134134844,1,1437,1,161217966,134025264,27192702,0.0367745728247233
1747351815817429,134229484,1,1438,1,161312244,134119904,27192340,0.0367750623888933
1747351815911949,134324124,1,1439,1,161406764,134214544,27192220,0.0367752246782351
1747351816006446,134418764,1,1440,1,161501261,134309184,27192077,0.0367754180749046
1747351816104555,134513404,1,1441,1,161599370,134403824,27195546,0.0367707270889137
1747351816198468,134608044,1,1442,1,161693283,134498464,27194819,0.0367717100819829
1747351816292914,134702684,1,1443,1,161787729,134593104,27194625,0.0367719724026347
1747351816390967,134797332,1,1444,1,161885782,134687752,27198030,0.0367673688131088
1747351816485659,134891964,1,1445,1,161980474,134782384,27198090,0.0367672877029232
1747351816579175,134986604,1,1446,1,162073990,134877024,27196966,0.0367688072265119
1747351816673894,135081244,1,1447,1,162168709,134971664,27197045,0.0367687004231525
1747351816771974,135175884,1,1448,1,162266789,135066304,27200485,0.0367640503468963
1747351816866763,135270524,1,1449,1,162361578,135160944,27200634,0.0367638489602852
1747351816960200,135365164,1,1450,1,162455015,135255584,27199431,0.0367654749836494
1747351817055256,135459804,1,1451,1,162550071,135350224,27199847,0.0367649126849867
1747351817153035,135554444,1,1452,1,162647850,135444864,27202986,0.0367606703175894
1747351817247320,135649084,1,1453,1,162742135,135539504,27202631,0.0367611500519931
1747351817341933,135743724,1,1454,1,162836748,135634144,27202604,0.0367611865393474
1747351817439706,135838364,1,1455,1,162934521,135728784,27205737,0.0367569531382296
1747351817533878,135933004,1,1456,1,163028693,135823424,27205269,0.0367575854515535
1747351817628389,136027644,1,1457,1,163123204,135918064,27205140,0.0367577597468713
1747351817722548,136122284,1,1458,1,163217363,136012704,27204659,0.0367584096532876
1747351817820935,136216924,1,1459,1,163315750,136107344,27208406,0.0367533474765114
1747351817914632,136311564,1,1460,1,163409447,136201984,27207463,0.0367546213331246
1747351818009397,136406204,1,1461,1,163504212,136296624,27207588,0.0367544524711268
1747351818107403,136500844,1,1462,1,163602218,136391264,27210954,0.0367499059386157
1747351818201476,136595492,1,1463,1,163696291,136485912,27210379,0.0367506825244881
1747351818295879,136690124,1,1464,1,163790694,136580544,27210150,0.0367509918173916
1747351818389774,136784764,1,1465,1,163884589,136675184,27209405,0.0367519980683149
1747351818488523,136879404,1,1466,1,163983338,136769824,27213514,0.0367464488415571
1747351818582598,136974044,1,1467,1,164077413,136864464,27212949,0.0367472117777459
1747351818676432,137068684,1,1468,1,164171247,136959104,27212143,0.0367483001981872
1747351818770343,137163324,1,1469,1,164265158,137053744,27211414,0.036749284693548
1747351818869321,137257964,1,1470,1,164364136,137148384,27215752,0.036743427115297
1747351818962877,137352604,1,1471,1,164457692,137243024,27214668,0.0367448906596986
1747351819057200,137447244,1,1472,1,164552015,137337664,27214351,0.0367453186739599
1747351819155545,137541884,1,1473,1,164650360,137432304,27218056,0.0367403167955859
1747351819249533,137636524,1,1474,1,164744348,137526944,27217404,0.0367411969194416
1747351819343945,137731164,1,1475,1,164838760,137621584,27217176,0.0367415047027656
1747351819438836,137825804,1,1476,1,164933651,137716224,27217427,0.0367411658714102
1747351819536454,137920444,1,1477,1,165031269,137810864,27220405,0.0367371462694989
1747351819630536,138015084,1,1478,1,165125351,137905504,27219847,0.0367378993717341
1747351819725219,138109724,1,1479,1,165220034,138000144,27219890,0.036737841335876
1747351819823492,138204364,1,1480,1,165318307,138094784,27223523,0.0367329386428053
1747351819917738,138299004,1,1481,1,165412553,138189424,27223129,0.0367334702781594
1747351820011515,138393644,1,1482,1,165506330,138284064,27222266,0.0367346348022607
1747351820106372,138488284,1,1483,1,165601187,138378704,27222483,0.0367343419775484
1747351820204213,138582924,1,1484,1,165699028,138473344,27225684,0.0367300230179708
1747351820298951,138677564,1,1485,1,165793766,138567984,27225782,0.0367298908071768
1747351820392515,138772204,1,1486,1,165887330,138662624,27224706,0.0367313424798783
1747351820486620,138866844,1,1487,1,165981435,138757264,27224171,0.0367320643115266
1747351820585063,138961484,1,1488,1,166079878,138851904,27227974,0.0367269338511929
1747351820681320,139056124,1,1489,1,166176135,138946544,27229591,0.0367247528616937
1747351820773313,139150764,1,1490,1,166268128,139041184,27226944,0.0367283232374518
1747351820871726,139245404,1,1491,1,166366541,139135824,27230717,0.0367232342798759
1747351820966114,139340044,1,1492,1,166460929,139230464,27230465,0.0367235741291968
1747351821060291,139434684,1,1493,1,166555106,139325104,27230002,0.0367241985512891
1747351821154798,139529324,1,1494,1,166649613,139419744,27229869,0.0367243779248442
1747351821253038,139623964,1,1495,1,166747853,139514384,27233469,0.0367195233188985
1747351821346619,139718604,1,1496,1,166841434,139609024,27232410,0.0367209512488979
1747351821441768,139813244,1,1497,1,166936583,139703664,27232919,0.0367202649117415
1747351821535283,139907884,1,1498,1,167030098,139798304,27231794,0.0367217818994958
1747351821634065,140002524,1,1499,1,167128880,139892944,27235936,0.0367161973063822
1747351821728048,140097164,1,1500,1,167222863,139987584,27235279,0.0367170830157458
1747352159869185,109580,1,1,25,0,0,0,0.0
1747352159959450,197404,1,2,25,90265,87824,2441,10241.704219582138
1747352160049394,285804,1,3,25,180209,176224,3985,6273.525721455459
1747352160135529,374204,1,4,25,266344,264624,1720,14534.883720930233
1747352160224771,462604,1,5,25,355586,353024,2562,9758.001561280247
1747352160315031,551004,1,6,25,445846,441424,4422,5653.550429669833
1747352160405537,639404,1,7,25,536352,529824,6528,3829.656862745098
1747352160491708,727804,1,8,25,622523,618224,4299,5815.305885089556
1747352160582034,816204,1,9,25,712849,706624,6225,4016.064257028113
1747352160671262,904604,1,10,25,802077,795024,7053,3544.590954203885
1747352160761497,994044,1,11,25,892312,884464,7848,3185.5249745158
1747352160852230,1083484,1,12,25,983045,973904,9141,2734.930532764468
1747352160946432,1173964,1,13,25,1077247,1064384,12863,1943.559045323797
1747352161036094,1264444,1,14,25,1166909,1154864,12045,2075.5500207555
1747352161125869,1354924,1,15,25,1256684,1245344,11340,2204.5855379188715
1747352161220810,1445404,1,16,25,1351625,1335824,15801,1582.1783431428391
1747352161310573,1535884,1,17,25,1441388,1426304,15084,1657.3853089366216
1747352161400703,1626364,1,18,25,1531518,1516784,14734,1696.755802904846
1747352161494525,1716844,1,19,25,1625340,1607264,18076,1383.0493472007083
1747352161580411,1807324,1,20,25,1711226,1697744,13482,1854.3242842308264
1747352161674747,1897804,1,21,25,1805562,1788224,17338,1441.9194832160572
1747352161765618,1988284,1,22,25,1896433,1878704,17729,1410.1190140447852
1747352161855245,2078764,1,23,25,1986060,1969184,16876,1481.3936951884334
1747352161945253,2169244,1,24,25,2076068,2059664,16404,1524.01853206535
1747352162039564,2259724,1,25,25,2170379,2150144,20235,1235.4830738818878
1747352162129624,2350204,1,26,25,2260439,2240624,19815,1261.6704516780217
1747352162219985,2440684,1,27,25,2350800,2331104,19696,1269.293257514216
1747352162310461,2531164,1,28,25,2441276,2421584,19692,1269.5510867357302
1747352162404117,2621644,1,29,25,2534932,2512064,22868,1093.2307154101802
1747352162494883,2712124,1,30,25,2625698,2602544,23154,1079.7270450030232
1747352162588018,2802604,1,31,25,2718833,2693024,25809,968.6543453833934
1747352162674957,2893084,1,32,25,2805772,2783504,22268,1122.6872642356743
1747352162769006,2983564,1,33,25,2899821,2873984,25837,967.60459805705
1747352162859143,3074044,1,34,25,2989958,2964464,25494,980.622891660783
1747352162949590,3164524,1,35,25,3080405,3054944,25461,981.8938769097836
1747352163039130,3255004,1,36,25,3169945,3145424,24521,1019.534276742384
1747352163133158,3345484,1,37,25,3263973,3235904,28069,890.6622964836653
1747352163223496,3435964,1,38,25,3354311,3326384,27927,895.1910337666058
1747352163313093,3526444,1,39,25,3443908,3416864,27044,924.419464576246
1747352163403929,3616924,1,40,25,3534744,3507344,27400,912.4087591240876
1747352163498283,3707404,1,41,25,3629098,3597824,31274,799.3860714970901
1747352163588157,3797884,1,42,25,3718972,3688304,30668,815.1819486109299
1747352163678469,3888364,1,43,25,3809284,3778784,30500,819.672131147541
1747352163768757,3978844,1,44,25,3899572,3869264,30308,824.8647221855615
1747352163864068,4069324,1,45,25,3994883,3959744,35139,711.4602009163608
1747352163952506,4159804,1,46,25,4083321,4050224,33097,755.3554702843157
1747352164046231,4250284,1,47,25,4177046,4140704,36342,687.909306037092
1747352164132393,4340772,1,48,25,4263208,4231192,32016,780.8595702148925
1747352164227135,4431244,1,49,25,4357950,4321664,36286,688.9709529846222
1747352164317068,4521724,1,50,25,4447883,4412144,35739,699.5159349729987
1747352164407083,4612204,1,51,25,4537898,4502624,35274,708.7373136020865
1747352164497144,4702684,1,52,25,4627959,4593104,34855,717.2572084349448
1747352164591685,4793164,1,53,25,4722500,4683584,38916,642.4092918079967
1747352164681016,4883644,1,54,25,4811831,4774064,37767,661.9535573384171
1747352164771300,4974124,1,55,25,4902115,4864544,37571,665.4068297357004
1747352164866026,5064604,1,56,25,4996841,4955024,41817,597.8429825190711
1747352164956001,5155084,1,57,25,5086816,5045504,41312,605.151045701007
1747352165045919,5245564,1,58,25,5176734,5135984,40750,613.4969325153374
1747352165136084,5336044,1,59,25,5266899,5226464,40435,618.2762458266353
1747352165226271,5426524,1,60,25,5357086,5316944,40142,622.7890986996164
1747352165320737,5517004,1,61,25,5451552,5407424,44128,566.5337200870196
1747352165410137,5607484,1,62,25,5540952,5497904,43048,580.7470730347519
1747352165500174,5697964,1,63,25,5630989,5588384,42605,586.7855885459453
1747352165590521,5788444,1,64,25,5721336,5678864,42472,588.6230928611791
1747352165684638,5878924,1,65,25,5815453,5769344,46109,542.1934980155718
1747352165774785,5969404,1,66,25,5905600,5859824,45776,546.1377140859839
1747352165865196,6059884,1,67,25,5996011,5950304,45707,546.9621720961778
1747352165955448,6150364,1,68,25,6086263,6040784,45479,549.7042591085996
1747352166049522,6240844,1,69,25,6180337,6131264,49073,509.44511238359183
1747352166139237,6331324,1,70,25,6270052,6221744,48308,517.5126273081064
1747352166229326,6421804,1,71,25,6360141,6312224,47917,521.735500970428
1747352166319307,6512284,1,72,25,6450122,6402704,47418,527.2259479522544
1747352166414211,6602772,1,73,25,6545026,6493192,51834,482.30890921017095
1747352166503840,6693244,1,74,25,6634655,6583664,50991,490.2825988900002
1747352166594329,6783724,1,75,25,6725144,6674144,51000,490.1960784313726
1747352166687746,6874204,1,76,25,6818561,6764624,53937,463.5037172998128
1747352166778110,6964684,1,77,25,6908925,6855104,53821,464.5027034057338
1747352166868732,7055164,1,78,25,6999547,6945584,53963,463.2803958267703
1747352166962581,7145644,1,79,25,7093396,7036064,57332,436.0566524802902
1747352167052784,7236124,1,80,25,7183599,7126544,57055,438.1736920515292
1747352167142670,7326604,1,81,25,7273485,7217024,56461,442.7835142841962
1747352167232547,7417084,1,82,25,7363362,7307504,55858,447.563464499266
1747352167327048,7507564,1,83,25,7457863,7397984,59879,417.5086424288983
1747352167417548,7598044,1,84,25,7548363,7488464,59899,417.3692382176664
1747352167507311,7688524,1,85,25,7638126,7578944,59182,422.4257375553378
1747352167601007,7779004,1,86,25,7731822,7669424,62398,400.65386711112535
1747352167687725,7869484,1,87,25,7818540,7759904,58636,426.3592332355549
1747352167782218,7959964,1,88,25,7913033,7850384,62649,399.0486679755463
1747352167876122,8050444,1,89,25,8006937,7940864,66073,378.36937932287015
1747352167966403,8140924,1,90,25,8097218,8031344,65874,379.51240246531256
1747352168055805,8231404,1,91,25,8186620,8121824,64796,385.8262855731835
1747352168146035,8321884,1,92,25,8276850,8212304,64546,387.3206705295448
1747352168236035,8412364,1,93,25,8366850,8302784,64066,390.2225829613212
1747352168326224,8502844,1,94,25,8457039,8393264,63775,392.0031360250882
1747352168416638,8593324,1,95,25,8547453,8483744,63709,392.40923574377246
1747352168511084,8683804,1,96,25,8641899,8574224,67675,369.4126339120798
1747352168600999,8774284,1,97,25,8731814,8664704,67110,372.52272388615705
1747352168695138,8864764,1,98,25,8825953,8755184,70769,353.26202150659185
1747352168784813,8955244,1,99,25,8915628,8845664,69964,357.3266251214911
1747352168875339,9045724,1,100,25,9006154,8936144,70010,357.09184402228254
1747352168969632,9137244,1,101,25,9100447,9027664,72783,343.4868032370196
1747352169059668,9228764,1,102,25,9190483,9119184,71299,350.63605380159606
1747352169150124,9320284,1,103,25,9280939,9210704,70235,355.9478892290168
1747352169244021,9411804,1,104,25,9374836,9302224,72612,344.29570869828683
1747352169333979,9503324,1,105,25,9464794,9393744,71050,351.8648838845883
1747352169428187,9594844,1,106,25,9559002,9485264,73738,339.0382163877512
1747352169518600,9686364,1,107,25,9649415,9576784,72631,344.20564221888725
1747352169612645,9777884,1,108,25,9743460,9668304,75156,332.6414391399223
1747352169703085,9869404,1,109,25,9833900,9759824,74076,337.49122522814406
1747352169797061,9960924,1,110,25,9927876,9851344,76532,326.6607432185229
1747352169891190,10052444,1,111,25,10022005,9942864,79141,315.8918891598539
1747352169981037,10145004,1,112,25,10111852,10035424,76428,327.10524938504216
1747352170075531,10237564,1,113,25,10206346,10127984,78362,319.0321839667185
1747352170169654,10330132,1,114,25,10300469,10220552,79917,312.82455547630667
1747352170263315,10422684,1,115,25,10394130,10313104,81026,308.54293683509
1747352170358148,10515244,1,116,25,10488963,10405664,83299,300.123650944189
1747352170447992,10607804,1,117,25,10578807,10498224,80583,310.2391323231947
1747352170542305,10700364,1,118,25,10673120,10590784,82336,303.6338904003109
1747352170636314,10792924,1,119,25,10767129,10683344,83785,298.38276541146985
1747352170730397,10885484,1,120,25,10861212,10775904,85308,293.0557509260562
1747352170820505,10978044,1,121,25,10951320,10868464,82856,301.7282997006855
1747352170915547,11070604,1,122,25,11046362,10961024,85338,292.9527291476247
1747352171009263,11163164,1,123,25,11140078,11053584,86494,289.03738987675445
1747352171103755,11255724,1,124,25,11234570,11146144,88426,282.72227625359056
1747352171197652,11348284,1,125,25,11328467,11238704,89763,278.5111905796375
1747352171287716,11440844,1,126,25,11418531,11331264,87267,286.4771333952124
1747352171386434,11533404,1,127,25,11517249,11423824,93425,267.5943270002676
1747352171480358,11625964,1,128,25,11611173,11516384,94789,263.743683338784
1747352171566576,11718524,1,129,25,11697391,11608944,88447,282.655149411512
1747352171663923,11811084,1,130,25,11794738,11701504,93234,268.1425231138855
1747352171754243,11903644,1,131,25,11885058,11794064,90994,274.7433896740444
1747352171848945,11996204,1,132,25,11979760,11886624,93136,268.4246693008074
1747352171942721,12088764,1,133,25,12073536,11979184,94352,264.9652365609632
1747352172033114,12181324,1,134,25,12163929,12071744,92185,271.1937950859684
1747352172127712,12273884,1,135,25,12258527,12164304,94223,265.3279984717107
1747352172221931,12366444,1,136,25,12352746,12256864,95882,260.7371560876911
1747352172315984,12459004,1,137,25,12446799,12349424,97375,256.73940949935815
1747352172405990,12551564,1,138,25,12536805,12441984,94821,263.654675652018
1747352172500707,12644124,1,139,25,12631522,12534544,96978,257.79042669471426
1747352172594065,12736684,1,140,25,12724880,12627104,97776,255.6864670266732
1747352172688518,12829244,1,141,25,12819333,12719664,99669,250.83024812128147
1747352172778681,12921804,1,142,25,12909496,12812224,97272,257.0112673739617
1747352172873207,13014364,1,143,25,13004022,12904784,99238,251.91962756202253
1747352172967299,13106924,1,144,25,13098114,12997344,100770,248.0897092388608
1747352173060942,13199484,1,145,25,13191757,13089904,101853,245.45177854358727
1747352173155401,13292044,1,146,25,13286216,13182464,103752,240.9592104248593
1747352173245306,13384604,1,147,25,13376121,13275024,101097,247.28725877127903
1747352173339320,13477164,1,148,25,13470135,13367584,102551,243.78114304102348
1747352173434309,13569724,1,149,25,13565124,13460144,104980,238.14059820918268
1747352173527765,13662284,1,150,25,13658580,13552704,105876,236.1252786278288
1747352173618266,13754844,1,151,25,13749081,13645264,103817,240.80834545402004
1747352173712270,13847404,1,152,25,13843085,13737824,105261,237.50486884981143
1747352173806429,13939964,1,153,25,13937244,13830384,106860,233.9509638779712
1747352173901205,14032524,1,154,25,14032020,13922944,109076,229.19799039202024
1747352173991348,14125092,1,155,25,14122163,14015512,106651,234.40942888486748
1747352174085618,14217644,1,156,25,14216433,14108064,108369,230.6932794433833
1747352174179118,14310204,1,157,25,14309933,14200624,109309,228.7094383811031
1747352174273587,14402764,1,158,25,14404402,14293184,111218,224.78375802478016
1747352174363630,14495324,1,159,25,14494445,14385744,108701,229.9886845567198
1747352174457420,14587884,1,160,25,14588235,14478304,109931,227.41537873757176
1747352174552075,14680444,1,161,25,14682890,14570864,112026,223.16248013853928
1747352174645967,14773004,1,162,25,14776782,14663424,113358,220.5402353605392
1747352174740561,14865564,1,163,25,14871376,14755984,115392,216.65280088740988
1747352174830645,14958124,1,164,25,14961460,14848544,112916,221.4035212016012
1747352174924559,15050684,1,165,25,15055374,14941104,114270,218.78008226131087
1747352175018564,15143244,1,166,25,15149379,15033664,115715,216.04804908611675
1747352175113070,15235804,1,167,25,15243885,15126224,117661,212.47482173362457
1747352175203240,15328364,1,168,25,15334055,15218784,115271,216.88022139133
1747352175297623,15420924,1,169,25,15428438,15311344,117094,213.50368080345703
1747352175391624,15513484,1,170,25,15522439,15403904,118535,210.9081705825284
1747352175485636,15606044,1,171,25,15616451,15496464,119987,208.35590522306583
1747352175580101,15698604,1,172,25,15710916,15589024,121892,205.09959636399435
1747352175670269,15791164,1,173,25,15801084,15681584,119500,209.2050209205021
1747352175764679,15883724,1,174,25,15895494,15774144,121350,206.01565718994644
1747352175858140,15976284,1,175,25,15988955,15866704,122251,204.4973047255237
1747352175948149,16068844,1,176,25,16078964,15959264,119700,208.85547201336675
1747352176042485,16161404,1,177,25,16173300,16051824,121476,205.8019691132405
1747352176137384,16253972,1,178,25,16268199,16144392,123807,201.9271931312446
1747352176231492,16346524,1,179,25,16362307,16236944,125363,199.4208817593708
1747352176324927,16439084,1,180,25,16455742,16329504,126238,198.03862545350847
1747352176419508,16531644,1,181,25,16550323,16422064,128259,194.91809541630604
1747352176509666,16624204,1,182,25,16640481,16514624,125857,198.63813693318608
1747352176603752,16716764,1,183,25,16734567,16607184,127383,196.25852743301687
1747352176698156,16809324,1,184,25,16828971,16699744,129227,193.4580234780657
1747352176792715,16901884,1,185,25,16923530,16792304,131226,190.5110267782299
1747352176882114,16994444,1,186,25,17012929,16884864,128065,195.2133682114551
1747352176976683,17087004,1,187,25,17107498,16977424,130074,192.1982871288651
1747352177070482,17179564,1,188,25,17201297,17069984,131313,190.38480576942115
1747352177160759,17272124,1,189,25,17291574,17162544,129030,193.7533906843369
1747352177255529,17364684,1,190,25,17386344,17255104,131240,190.4907040536422
1747352177349077,17457244,1,191,25,17479892,17347664,132228,189.06736848473847
1747352177443686,17549804,1,192,25,17574501,17440224,134277,186.18229480849288
1747352177533552,17642364,1,193,25,17664367,17532784,131583,189.99414818023604
1747352177627339,17734924,1,194,25,17758154,17625344,132810,188.23883743694
1747352177722457,17827484,1,195,25,17853272,17717904,135368,184.6817563973761
1747352177816020,17920044,1,196,25,17946835,17810464,136371,183.32343386790447
1747352177910190,18012604,1,197,25,18041005,17903024,137981,181.18436596342977
1747352178000754,18105164,1,198,25,18131569,17995584,135985,183.8438063021657
1747352178094075,18197724,1,199,25,18224890,18088144,136746,182.82070407909555
1747352178189100,18290284,1,200,25,18319915,18180704,139211,179.58350992378476
1747352178282750,18382844,1,201,25,18413565,18273264,140301,178.1883236755262
1747352178372870,18475404,1,202,25,18503685,18365824,137861,181.34207643931205
1747352178467446,18567964,1,203,25,18598261,18458384,139877,178.72845428483595
1747352178561822,18660524,1,204,25,18692637,18550944,141693,176.43779156345053
1747352178655838,18753084,1,205,25,18786653,18643504,143149,174.6432039343621
1747352178745840,18845644,1,206,25,18876655,18736064,140591,177.82077088860598
1747352178840012,18938204,1,207,25,18970827,18828624,142203,175.8050111460377
1747352178934781,19030764,1,208,25,19065596,18921184,144412,173.11580755061905
1747352179029021,19123324,1,209,25,19159836,19013744,146092,171.12504449251156
1747352179119158,19215884,1,210,25,19249973,19106304,143669,174.01109494741385
1747352179216621,19308444,1,211,25,19347436,19198864,148572,168.26858358237084
1747352179307241,19401004,1,212,25,19438056,19291424,146632,170.49484423591028
1747352179401363,19493564,1,213,25,19532178,19383984,148194,168.6977880346033
1747352179495808,19586124,1,214,25,19626623,19476544,150079,166.57893509418375
1747352179585709,19678684,1,215,25,19716524,19569104,147420,169.58350291683627
1747352179679816,19771244,1,216,25,19810631,19661664,148967,167.82240361959362
1747352179773636,19863804,1,217,25,19904451,19754224,150227,166.41482556397983
1747352179868077,19956364,1,218,25,19998892,19846784,152108,164.35690430483604
1747352179958876,20048932,1,219,25,20089691,19939352,150339,166.2908493471421
1747352180052694,20141484,1,220,25,20183509,20031904,151605,164.9022129876983
1747352180146740,20234044,1,221,25,20277555,20124464,153091,163.30156573541225
1747352180240352,20326604,1,222,25,20371167,20217024,154143,162.18706006759956
1747352180331659,20419164,1,223,25,20462474,20309584,152890,163.51625351559946
1747352180425508,20511724,1,224,25,20556323,20402144,154179,162.149190226944
1747352180519627,20604284,1,225,25,20650442,20494704,155738,160.52601163492534
1747352180613502,20696844,1,226,25,20744317,20587264,157053,159.18193221396598
1747352180703598,20789404,1,227,25,20834413,20679824,154589,161.71913913667854
1747352180797623,20881964,1,228,25,20928438,20772384,156054,160.20095607930588
1747352180892332,20974524,1,229,25,21023147,20864944,158203,158.02481621713872
1747352180986683,21067084,1,230,25,21117498,20957504,159994,156.2558595947348
1747352181080341,21159644,1,231,25,21211156,21050064,161092,155.1908226355126
1747352181171161,21252204,1,232,25,21301976,21142624,159352,156.8853858125408
1747352181265234,21344764,1,233,25,21396049,21235184,160865,155.40981568395858
1747352181358638,21437324,1,234,25,21489453,21327744,161709,154.59869271345443
1747352181453643,21529884,1,235,25,21584458,21420304,164154,152.29601471788686
1747352181543836,21622444,1,236,25,21674651,21512864,161787,154.52415830690973
1747352181637555,21715004,1,237,25,21768370,21605424,162946,153.4250610631743
1747352181732176,21807564,1,238,25,21862991,21697984,165007,151.5087238723206
1747352181825532,21900124,1,239,25,21956347,21790544,165803,150.78134895026025
1747352181916464,21992684,1,240,25,22047279,21883104,164175,152.27653418608193
1747352182013928,22085244,1,241,25,22144743,21975664,169079,147.85987615256772
1747352182104479,22177812,1,242,25,22235294,22068232,167062,149.64504196046977
1747352182198921,22270364,1,243,25,22329736,22160784,168952,147.9710213551778
1747352182292360,22362924,1,244,25,22423175,22253344,169831,147.205162779469
1747352182382672,22455484,1,245,25,22513487,22345904,167583,149.1798094078755
1747352182477537,22548044,1,246,25,22608352,22438464,169888,147.15577321529477
1747352182571846,22640604,1,247,25,22702661,22531024,171637,145.6562396219929
1747352182665367,22733164,1,248,25,22796182,22623584,172598,144.84524733774435
1747352182756162,22825724,1,249,25,22886977,22716144,170833,146.34174895951014
1747352182849388,22918284,1,250,25,22980203,22808704,171499,145.77344474311803
1747352182943914,23010844,1,251,25,23074729,22901264,173465,144.12129247975096
1747352183037895,23103404,1,252,25,23168710,22993824,174886,142.9502647438903
1747352183128585,23195964,1,253,25,23259400,23086384,173016,144.49530679243537
1747352183222600,23288524,1,254,25,23353415,23178944,174471,143.29028893053862
1747352183316439,23381084,1,255,25,23447254,23271504,175750,142.2475106685633
1747352183410639,23473644,1,256,25,23541454,23364064,177390,140.9324088167315
1747352183501059,23566204,1,257,25,23631874,23456624,175250,142.65335235378032
1747352183595726,23658764,1,258,25,23726541,23549184,177357,140.9586314608389
1747352183689873,23751324,1,259,25,23820688,23641744,178944,139.7085121602289
1747352183783604,23843884,1,260,25,23914419,23734304,180115,138.8002109763207
1747352183877604,23936444,1,261,25,24008419,23826864,181555,137.69931976536037
1747352183967924,24029004,1,262,25,24098739,23919424,179315,139.41945737947188
1747352184061919,24121564,1,263,25,24192734,24011984,180750,138.31258644536652
1747352184156455,24214124,1,264,25,24287270,24104544,182726,136.8168733513567
1747352184250541,24306684,1,265,25,24381356,24197104,184252,135.6837374899594
1747352184340735,24399244,1,266,25,24471550,24289664,181886,137.44873162310458
1747352184435116,24491804,1,267,25,24565931,24382224,183707,136.08626780688817
1747352184529188,24584364,1,268,25,24660003,24474784,185219,134.9753535004508
1747352184622838,24676924,1,269,25,24753653,24567344,186309,134.18568077763285
1747352184713424,24769484,1,270,25,24844239,24659904,184335,135.6226435565682
1747352184807578,24862044,1,271,25,24938393,24752464,185929,134.45992825218227
1747352184902017,24954604,1,272,25,25032832,24845024,187808,133.1146703015846
1747352184996336,25047164,1,273,25,25127151,24937584,189567,131.879493793751
1747352185085393,25139724,1,274,25,25216208,25030144,186064,134.3623699372259
1747352185180146,25232284,1,275,25,25310961,25122704,188257,132.79718682439432
1747352185274402,25324844,1,276,25,25405217,25215264,189953,131.61150389833273
1747352185368983,25417404,1,277,25,25499798,25307824,191974,130.22596809984685
1747352185462882,25509964,1,278,25,25593697,25400384,193313,129.3239461391629
1747352185553053,25602524,1,279,25,25683868,25492944,190924,130.94215499361002
1747352185646844,25695084,1,280,25,25777659,25585504,192155,130.10330202180532
1747352185741267,25787644,1,281,25,25872082,25678064,194018,128.8540238534569
1747352185835916,25880204,1,282,25,25966731,25770624,196107,127.48142595623816
1747352185925428,25972772,1,283,25,26056243,25863192,193051,129.49945869226266
1747352186019991,26065324,1,284,25,26150806,25955744,195062,128.16437850529573
1747352186114303,26157884,1,285,25,26245118,26048304,196814,127.02348410174072
1747352186208253,26250444,1,286,25,26339068,26140864,198204,126.13267138907388
1747352186298174,26343004,1,287,25,26428989,26233424,195565,127.8347352542633
1747352186393071,26435564,1,288,25,26523886,26325984,197902,126.3251508322301
1747352186486457,26528124,1,289,25,26617272,26418544,198728,125.80008856326236
1747352186581508,26620684,1,290,25,26712323,26511104,201219,124.24274049667278
1747352186670721,26713244,1,291,25,26801536,26603664,197872,126.34430338804884
1747352186765760,26805804,1,292,25,26896575,26696224,200351,124.78100932862826
1747352186859738,26898364,1,293,25,26990553,26788784,201769,123.90406851399372
1747352186953801,26990924,1,294,25,27084616,26881344,203272,122.9879176669684
1747352187048186,27083484,1,295,25,27179001,26973904,205097,121.89354305523727
1747352187137754,27176044,1,296,25,27268569,27066464,202105,123.69807773187205
1747352187232374,27268604,1,297,25,27363189,27159024,204165,122.44997918350352
1747352187325776,27361164,1,298,25,27456591,27251584,205007,121.94705546639872
1747352187420040,27453724,1,299,25,27550855,27344144,206711,120.94179796914533
1747352187510899,27546284,1,300,25,27641714,27436704,205010,121.94527096239209
1747352187604758,27638844,1,301,25,27735573,27529264,206309,121.17745711529793
1747352187699549,27731404,1,302,25,27830364,27621824,208540,119.88107797065312
1747352187793107,27823964,1,303,25,27923922,27714384,209538,119.31010127041397
1747352187883094,27916524,1,304,25,28013909,27806944,206965,120.7933708598072
1747352187977209,28009084,1,305,25,28108024,27899504,208520,119.89257625167848
1747352188072059,28101652,1,306,25,28202874,27992072,210802,118.59470024003568
1747352188165590,28194204,1,307,25,28296405,28084624,211781,118.0464725353077
1747352188255792,28286764,1,308,25,28386607,28177184,209423,119.37561776882195
1747352188350791,28379324,1,309,25,28481606,28269744,211862,118.00134049522804
1747352188444802,28471884,1,310,25,28575617,28362304,213313,117.19867049828188
1747352188539109,28564444,1,311,25,28669924,28454864,215060,116.24662884776342
1747352188633160,28657004,1,312,25,28763975,28547424,216551,115.4462459189752
1747352188723191,28749564,1,313,25,28854006,28639984,214022,116.81042135855192
1747352188817636,28842124,1,314,25,28948451,28732544,215907,115.79059502470972
1747352188911862,28934684,1,315,25,29042677,28825104,217573,114.90396326750104
1747352189005910,29027244,1,316,25,29136725,28917664,219061,114.12346332756628
1747352189096173,29119804,1,317,25,29226988,29010224,216764,115.33280434020408
1747352189189684,29212364,1,318,25,29320499,29102784,217715,114.82901958983076
1747352189284012,29304924,1,319,25,29414827,29195344,219483,113.90403812595964
1747352189378633,29397484,1,320,25,29509448,29287904,221544,112.84440111219442
1747352189468047,29490044,1,321,25,29598862,29380464,218398,114.46991272813852
1747352189566783,29582604,1,322,25,29697598,29473024,224574,111.32188053826356
1747352189657169,29675164,1,323,25,29787984,29565584,222400,112.41007194244604
1747352189751068,29767724,1,324,25,29881883,29658144,223739,111.7373368076196
1747352189841456,29860284,1,325,25,29972271,29750704,221567,112.83268717814477
1747352189935702,29952844,1,326,25,30066517,29843264,223253,111.98057808853632
1747352190029785,30045404,1,327,25,30160600,29935824,224776,111.22183863045876
1747352190123466,30137964,1,328,25,30254281,30028384,225897,110.669907081546
1747352190217838,30230524,1,329,25,30348653,30120944,227709,109.78924855846716
1747352190307984,30323084,1,330,25,30438799,30213504,225295,110.96562285004106
1747352190401952,30415644,1,331,25,30532767,30306064,226703,110.27644098225431
1747352190496160,30508204,1,332,25,30626975,30398624,228351,109.48058033466025
1747352190590383,30600764,1,333,25,30721198,30491184,230014,108.68903631952838
1747352190681372,30693324,1,334,25,30812187,30583744,228443,109.4364896276095
1747352190774469,30785884,1,335,25,30905284,30676304,228980,109.17984103415148
1747352190869161,30878444,1,336,25,30999976,30768864,231112,108.17266087438124
1747352190963059,30971004,1,337,25,31093874,30861424,232450,107.55001075500108
1747352191053226,31063564,1,338,25,31184041,30953984,230057,108.66872122995603
1747352191147469,31156124,1,339,25,31278284,31046544,231740,107.87952015189435
1747352191241986,31248684,1,340,25,31372801,31139104,233697,106.9761272074524
1747352191335972,31341244,1,341,25,31466787,31231664,235123,106.3273265482322
1747352191429795,31433804,1,342,25,31560610,31324224,236386,105.75922431954514
1747352191520640,31526364,1,343,25,31651455,31416784,234671,106.53212369657948
1747352191614292,31618924,1,344,25,31745107,31509344,235763,106.0386913977172
1747352191708565,31711484,1,345,25,31839380,31601904,237476,105.27379608886793
1747352191803456,31804044,1,346,25,31934271,31694464,239807,104.25050144491196
1747352191893626,31896612,1,347,25,32024441,31787032,237409,105.3035057643139
1747352191987138,31989164,1,348,25,32117953,31879584,238369,104.87940965477894
1747352192081454,32081724,1,349,25,32212269,31972144,240125,104.1124414367517
1747352192175465,32174284,1,350,25,32306280,32064704,241576,103.48710136768553
1747352192266013,32266844,1,351,25,32396828,32157264,239564,104.35624718238132
1747352192360477,32359404,1,352,25,32491292,32249824,241468,103.53338744678383
1747352192454660,32451964,1,353,25,32585475,32342384,243091,102.842145533977
1747352192549109,32544524,1,354,25,32679924,32434944,244980,102.04914686913216
1747352192638558,32637084,1,355,25,32769373,32527504,241869,103.36173713869904
1747352192733410,32729644,1,356,25,32864225,32620064,244161,102.39145481874664
1747352192827700,32822204,1,357,25,32958515,32712624,245891,101.67106563477311
1747352192921892,32914764,1,358,25,33052707,32805184,247523,101.0007150850628
1747352193015778,33007324,1,359,25,33146593,32897744,248849,100.4625294857524
1747352193106017,33099884,1,360,25,33236832,32990304,246528,101.40835929387332
1747352193199886,33192444,1,361,25,33330701,33082864,247837,100.87275104201552
1747352193294381,33285004,1,362,25,33425196,33175424,249772,100.0912832503243
1747352193388554,33377564,1,363,25,33519369,33267984,251385,99.44905225053203
1747352193478737,33470124,1,364,25,33609552,33360544,249008,100.39838077491486
1747352193572780,33562684,1,365,25,33703595,33453104,250491,99.80398497351202
1747352193667374,33655244,1,366,25,33798189,33545664,252525,99.000099000099
1747352193760889,33747804,1,367,25,33891704,33638224,253480,98.62711062016729
1747352193850673,33840364,1,368,25,33981488,33730784,250704,99.71919075882316
1747352193945456,33932924,1,369,25,34076271,33823344,252927,98.842749093612
1747352194038923,34025492,1,370,25,34169738,33915912,253826,98.49266820577876
1747352194133711,34118044,1,371,25,34264526,34008464,256062,97.63260460357256
1747352194224112,34210604,1,372,25,34354927,34101024,253903,98.46279878536292
1747352194318080,34303164,1,373,25,34448895,34193584,255311,97.91979194002607
1747352194412282,34395724,1,374,25,34543097,34286144,256953,97.29405766813386
1747352194506496,34488284,1,375,25,34637311,34378704,258607,96.67178382642388
1747352194600446,34580844,1,376,25,34731261,34471264,259997,96.15495563410347
1747352194690862,34673404,1,377,25,34821677,34563824,257853,96.95446630444478
1747352194784253,34765964,1,378,25,34915068,34656384,258684,96.64300845819608
1747352194878826,34858524,1,379,25,35009641,34748944,260697,95.8967690460573
1747352194973577,34951084,1,380,25,35104392,34841504,262888,95.0975320288488
1747352195063773,35043644,1,381,25,35194588,34934064,260524,95.96044894136432
1747352195157321,35136204,1,382,25,35288136,35026624,261512,95.59790755299947
1747352195251417,35228764,1,383,25,35382232,35119184,263048,95.03968857394848
1747352195345841,35321324,1,384,25,35476656,35211744,264912,94.37096092287253
1747352195436365,35413884,1,385,25,35567180,35304304,262876,95.1018731264931
1747352195530373,35506444,1,386,25,35661188,35396864,264324,94.58089314629017
1747352195624085,35599004,1,387,25,35754900,35489424,265476,94.17047115370129
1747352195718244,35691564,1,388,25,35849059,35581984,267075,93.60666479453336
1747352195808234,35784124,1,389,25,35939049,35674544,264505,94.51617171698078
1747352195902696,35876684,1,390,25,36033511,35767104,266407,93.84137804186828
1747352195997505,35969244,1,391,25,36128320,35859664,268656,93.05580370436545
1747352196091574,36061804,1,392,25,36222389,35952224,270165,92.5360427886662
1747352196185817,36154364,1,393,25,36316632,36044784,271848,91.96315588122776
1747352196275503,36246924,1,394,25,36406318,36137344,268974,92.94578658160268
1747352196369700,36339484,1,395,25,36500515,36229904,270611,92.38353208110536
1747352196464298,36432044,1,396,25,36595113,36322464,272649,91.69298255265927
1747352196557538,36524604,1,397,25,36688353,36415024,273329,91.46486468687918
1747352196647922,36617164,1,398,25,36778737,36507584,271153,92.19886927306725
1747352196742690,36709724,1,399,25,36873505,36600144,273361,91.45415768891684
1747352196836725,36802284,1,400,25,36967540,36692704,274836,90.96333813619758
1747352196930439,36894844,1,401,25,37061254,36785264,275990,90.58299213739627
1747352197021347,36987404,1,402,25,37152162,36877824,274338,91.12846197027024
1747352197115630,37079964,1,403,25,37246445,36970384,276061,90.55969513984228
1747352197209842,37172524,1,404,25,37340657,37062944,277713,90.02099289554324
1747352197303988,37265084,1,405,25,37434803,37155504,279299,89.50980848481376
1747352197393617,37357644,1,406,25,37524432,37248064,276368,90.45909801424187
1747352197488424,37450204,1,407,25,37619239,37340624,278615,89.72955512086571
1747352197582548,37542764,1,408,25,37713363,37433184,280179,89.22867167061057
1747352197676347,37635324,1,409,25,37807162,37525744,281418,88.83582428984641
1747352197770154,37727884,1,410,25,37900969,37618304,282665,88.44391771177897
1747352197860259,37820452,1,411,25,37991074,37710872,280202,89.22134745647783
1747352197954863,37913004,1,412,25,38085678,37803424,282254,88.57270401836644
1747352198049194,38005564,1,413,25,38180009,37895984,284025,88.02042073761112
1747352198142925,38098124,1,414,25,38273740,37988544,285196,87.65901345039902
1747352198232988,38190684,1,415,25,38363803,38081104,282699,88.43328062709809
1747352198327463,38283244,1,416,25,38458278,38173664,284614,87.83826515912781
1747352198421647,38375804,1,417,25,38552462,38266224,286238,87.33990595238927
1747352198516256,38468364,1,418,25,38647071,38358784,288287,86.71913752614581
1747352198605736,38560924,1,419,25,38736551,38451344,285207,87.65563257563805
1747352198700107,38653484,1,420,25,38830922,38543904,287018,87.10255105951543
1747352198794010,38746044,1,421,25,38924825,38636464,288361,86.69688342043482
1747352198888660,38838604,1,422,25,39019475,38729024,290451,86.07303813724174
1747352198982073,38931164,1,423,25,39112888,38821584,291304,85.82099799522149
1747352199072518,39023724,1,424,25,39203333,38914144,289189,86.44865468603578
1747352199167209,39116284,1,425,25,39298024,39006704,291320,85.81628449814636
1747352199261817,39208844,1,426,25,39392632,39099264,293368,85.21720160344687
1747352199355250,39301404,1,427,25,39486065,39191824,294241,84.9643659449227
1747352199445811,39393964,1,428,25,39576626,39284384,292242,85.54554102421966
1747352199539752,39486524,1,429,25,39670567,39376944,293623,85.14319382337214
1747352199633843,39579084,1,430,25,39764658,39469504,295154,84.70154563380471
1747352199727841,39671644,1,431,25,39858656,39562064,296592,84.29087770405135
1747352199818314,39764204,1,432,25,39949129,39654624,294505,84.888202237653
1747352199912397,39856764,1,433,25,40043212,39747184,296028,84.45147080681556
1747352200006885,39949332,1,434,25,40137700,39839752,297948,83.9072589847893
1747352200100556,40041884,1,435,25,40231371,39932304,299067,83.59330852283935
1747352200191010,40134444,1,436,25,40321825,40024864,296961,84.186138920599
1747352200285225,40227004,1,437,25,40416040,40117424,298616,83.71955956814102
1747352200379634,40319564,1,438,25,40510449,40209984,300465,83.20436656515734
1747352200473831,40412124,1,439,25,40604646,40302544,302102,82.75350709363063
1747352200567747,40504684,1,440,25,40698562,40395104,303458,82.38372361249333
1747352200658096,40597244,1,441,25,40788911,40487664,301247,82.98837830750182
1747352200752651,40689804,1,442,25,40883466,40580224,303242,82.44240573535328
1747352200846027,40782364,1,443,25,40976842,40672784,304058,82.22115517434173
1747352200940306,40874924,1,444,25,41071121,40765344,305777,81.75892889262435
1747352201031096,40967484,1,445,25,41161911,40857904,304007,82.23494853736919
1747352201124760,41060044,1,446,25,41255575,40950464,305111,81.93739327654525
1747352201219169,41152604,1,447,25,41349984,41043024,306960,81.44383633046651
1747352201313367,41245164,1,448,25,41444182,41135584,308598,81.0115425245789
1747352201403861,41337724,1,449,25,41534676,41228144,306532,81.55755353437813
1747352201498021,41430284,1,450,25,41628836,41320704,308132,81.13405942907585
1747352201592000,41522844,1,451,25,41722815,41413264,309551,80.76213612619568
1747352201685573,41615404,1,452,25,41816388,41505824,310564,80.49870558081426
1747352201776047,41707964,1,453,25,41906862,41598384,308478,81.0430565550866
1747352201870262,41800524,1,454,25,42001077,41690944,310133,80.61057675255455
1747352201964920,41893084,1,455,25,42095735,41783504,312231,80.06892332920178
1747352202058870,41985644,1,456,25,42189685,41876064,313621,79.71404976069843
1747352202153358,42078204,1,457,25,42284173,41968624,315549,79.2269980256632
1747352202242843,42170764,1,458,25,42373658,42061184,312474,80.00665655382528
1747352202337589,42263324,1,459,25,42468404,42153744,314660,79.45083582279285
1747352202431285,42355884,1,460,25,42562100,42246304,315796,79.16503058936782
1747352202525117,42448444,1,461,25,42655932,42338864,317068,78.84743966593916
1747352202615962,42541004,1,462,25,42746777,42431424,315353,79.27623964255929
1747352202710049,42633564,1,463,25,42840864,42523984,316880,78.89421863165867
1747352202804271,42726124,1,464,25,42935086,42616544,318542,78.48258628375537
1747352202898350,42818684,1,465,25,43029165,42709104,320061,78.11011026023165
1747352202988949,42911244,1,466,25,43119764,42801664,318100,78.59163784973279
1747352203079918,43003804,1,467,25,43210733,42894224,316509,78.98669548101319
1747352203177166,43096364,1,468,25,43307981,42986784,321197,77.83385274457731
1747352203271134,43188924,1,469,25,43401949,43079344,322605,77.49414919173603
1747352203360788,43281484,1,470,25,43491603,43171904,319699,78.1985555162825
1747352203459792,43374044,1,471,25,43590607,43264464,326143,76.65349248642467
1747352203549739,43466604,1,472,25,43680554,43357024,323530,77.27258677711495
1747352203643262,43559164,1,473,25,43774077,43449584,324493,77.0432644155652
1747352203738303,43651724,1,474,25,43869118,43542144,326974,76.45867867169866
1747352203827951,43744292,1,475,25,43958766,43634712,324054,77.14763588784585
1747352203922698,43836844,1,476,25,44053513,43727264,326249,76.62858736731759
1747352204016503,43929404,1,477,25,44147318,43819824,327494,76.3372764081174
1747352204110285,44021964,1,478,25,44241100,43912384,328716,76.05349298482581
1747352204200269,44114524,1,479,25,44331084,44004944,326140,76.6541975838597
1747352204295265,44207084,1,480,25,44426080,44097504,328576,76.08589793533308
1747352204389282,44299644,1,481,25,44520097,44190064,330033,75.7500007575
1747352204483574,44392204,1,482,25,44614389,44282624,331765,75.35454312540503
1747352204573292,44484764,1,483,25,44704107,44375184,328923,76.00563049710722
1747352204668076,44577324,1,484,25,44798891,44467744,331147,75.49517283864868
1747352204761634,44669884,1,485,25,44892449,44560304,332145,75.2683316021617
1747352204856491,44762444,1,486,25,44987306,44652864,334442,74.75137692036287
1747352204946262,44855004,1,487,25,45077077,44745424,331653,75.3799905322732
1747352205040072,44947564,1,488,25,45170887,44837984,332903,75.09695016266
1747352205134593,45040124,1,489,25,45265408,44930544,334864,74.65717425581728
1747352205228218,45132684,1,490,25,45359033,45023104,335929,74.42048766257156
1747352205322716,45225244,1,491,25,45453531,45115664,337867,73.99361287133695
1747352205413114,45317804,1,492,25,45543929,45208224,335705,74.47014491890202
1747352205507663,45410364,1,493,25,45638478,45300784,337694,74.03151965981036
1747352205601144,45502924,1,494,25,45731959,45393344,338615,73.83016109741152
1747352205695812,45595484,1,495,25,45826627,45485904,340723,73.37338541865387
1747352205785668,45688044,1,496,25,45916483,45578464,338019,73.96033950754247
1747352205880256,45780604,1,497,25,46011071,45671024,340047,73.51924880972336
1747352205974393,45873172,1,498,25,46105208,45763592,341616,73.18158400074938
1747352206067886,45965724,1,499,25,46198701,45856144,342557,72.98055506090957
1747352206158666,46058284,1,500,25,46289481,45948704,340777,73.36175856938702
1747352206253024,46150844,1,501,25,46383839,46041264,342575,72.97672042618404
1747352206346723,46243404,1,502,25,46477538,46133824,343714,72.73489005394019
1747352206440920,46335964,1,503,25,46571735,46226384,345351,72.39011903831174
1747352206530729,46428524,1,504,25,46661544,46318944,342600,72.97139521307648
1747352206624960,46521084,1,505,25,46755775,46411504,344271,72.61721144098689
1747352206719660,46613644,1,506,25,46850475,46504064,346411,72.16860896449593
1747352206813994,46706204,1,507,25,46944809,46596624,348185,71.80091043554432
1747352206908000,46798764,1,508,25,47038815,46689184,349631,71.50395702898197
1747352206998469,46891324,1,509,25,47129284,46781744,347540,71.93416585141279
1747352207092117,46983884,1,510,25,47222932,46874304,348628,71.70967334809596
1747352207186012,47076444,1,511,25,47316827,46966864,349963,71.43612324731471
1747352207281085,47169004,1,512,25,47411900,47059424,352476,70.92681487533903
1747352207371105,47261564,1,513,25,47501920,47151984,349936,71.44163504183622
1747352207464943,47354124,1,514,25,47595758,47244544,351214,71.1816727123634
1747352207559610,47446684,1,515,25,47690425,47337104,353321,70.75718680746404
1747352207653448,47539244,1,516,25,47784263,47429664,354599,70.50217287696807
1747352207744139,47631804,1,517,25,47874954,47522224,352730,70.8757406514898
1747352207837916,47724364,1,518,25,47968731,47614784,353947,70.63204378056601
1747352207932222,47816924,1,519,25,48063037,47707344,355693,70.28533032699548
1747352208026458,47909484,1,520,25,48157273,47799904,357369,69.95570404819668
1747352208120279,48002044,1,521,25,48251094,47892464,358630,69.70972868973594
1747352208210429,48094604,1,522,25,48341244,47985024,356220,70.18134860479479
1747352208304324,48187164,1,523,25,48435139,48077584,357555,69.91931311266798
1747352208399209,48279724,1,524,25,48530024,48170144,359880,69.46760031121485
1747352208493189,48372284,1,525,25,48624004,48262704,361300,69.1945751453086
1747352208583590,48464844,1,526,25,48714405,48355264,359141,69.61054293439068
1747352208676885,48557404,1,527,25,48807700,48447824,359876,69.4683724393958
1747352208771560,48649964,1,528,25,48902375,48540384,361991,69.06249050390755
1747352208866056,48742524,1,529,25,48996871,48632944,363927,68.69509544496562
1747352208955789,48835084,1,530,25,49086604,48725504,361100,69.23289947382997
1747352209050490,48927644,1,531,25,49181305,48818064,363241,68.82482979619591
1747352209144344,49020204,1,532,25,49275159,48910624,364535,68.58052038898872
1747352209238438,49112764,1,533,25,49369253,49003184,366069,68.29313599348757
1747352209328802,49205324,1,534,25,49459617,49095744,363873,68.70529003251134
1747352209422474,49297884,1,535,25,49553289,49188304,364985,68.49596558762688
1747352209516757,49390444,1,536,25,49647572,49280864,366708,68.17413309772353
1747352209611432,49483004,1,537,25,49742247,49373424,368823,67.78319139533055
1747352209704798,49575564,1,538,25,49835613,49465984,369629,67.6353857516591
1747352209795783,49668132,1,539,25,49926598,49558552,368046,67.92629182221788
1747352209889436,49760684,1,540,25,50020251,49651104,369147,67.72369814735052
1747352209983929,49853244,1,541,25,50114744,49743664,371080,67.37091732241026
1747352210077622,49945804,1,542,25,50208437,49836224,372213,67.16584321342887
1747352210168611,50038364,1,543,25,50299426,49928784,370642,67.45053177999255
1747352210262347,50130924,1,544,25,50393162,50021344,371818,67.23719669300571
1747352210356567,50223484,1,545,25,50487382,50113904,373478,66.93834710478262
1747352210451060,50316044,1,546,25,50581875,50206464,375411,66.5936799933939
1747352210541203,50408604,1,547,25,50672018,50299024,372994,67.02520683978831
1747352210635433,50501164,1,548,25,50766248,50391584,374664,66.72645356906455
1747352210728888,50593724,1,549,25,50859703,50484144,375559,66.56743680753225
1747352210823198,50686284,1,550,25,50954013,50576704,377309,66.25868982717083
1747352210913347,50778844,1,551,25,51044162,50669264,374898,66.6848049336086
1747352211007854,50871404,1,552,25,51138669,50761824,376845,66.34027252583954
1747352211102179,50963964,1,553,25,51232994,50854384,378610,66.03100816143261
1747352211196455,51056524,1,554,25,51327270,50946944,380326,65.73308161945279
1747352211290168,51149084,1,555,25,51420983,51039504,381479,65.53440687429715
1747352211380747,51241644,1,556,25,51511562,51132064,379498,65.87650000790518
1747352211474858,51334204,1,557,25,51605673,51224624,381049,65.60836007967478
1747352211569214,51426764,1,558,25,51700029,51317184,382845,65.30057856312607
1747352211662907,51519324,1,559,25,51793722,51409744,383978,65.10789680658787
1747352211752974,51611884,1,560,25,51883789,51502304,381485,65.53337614847241
1747352211847695,51704444,1,561,25,51978510,51594864,383646,65.16423995037091
1747352211942046,51797012,1,562,25,52072861,51687432,385429,64.86278925560867
1747352212035052,51889564,1,563,25,52165867,51779984,385883,64.7864767299933
1747352212126126,51982124,1,564,25,52256941,51872544,384397,65.03692796770007
1747352212220081,52074684,1,565,25,52350896,51965104,385792,64.80175846051758
1747352212313827,52167244,1,566,25,52444642,52057664,386978,64.60315573495134
1747352212408178,52259804,1,567,25,52538993,52150224,388769,64.30553876466489
1747352212499094,52352364,1,568,25,52629909,52242784,387125,64.57862447529868
1747352212593319,52444924,1,569,25,52724134,52335344,388790,64.30206538234007
1747352212687400,52537484,1,570,25,52818215,52427904,390311,64.05148714742859
1747352212781230,52630044,1,571,25,52912045,52520464,391581,63.84375135667971
1747352212875475,52722604,1,572,25,53006290,52613024,393266,63.57020439092116
1747352212965485,52815164,1,573,25,53096300,52705584,390716,63.98509403249419
1747352213059401,52907724,1,574,25,53190216,52798144,392072,63.763798485992375
1747352213154392,53000284,1,575,25,53285207,52890704,394503,63.370874239232656
1747352213248398,53092844,1,576,25,53379213,52983264,395949,63.139444726467296
1747352213338118,53185404,1,577,25,53468933,53075824,393109,63.59559307978195
1747352213432130,53277964,1,578,25,53562945,53168384,394561,63.36155879572487
1747352213526668,53370524,1,579,25,53657483,53260944,396539,63.04550119912544
1747352213620628,53463084,1,580,25,53751443,53353504,397939,62.82369910966254
1747352213711160,53555644,1,581,25,53841975,53446064,395911,63.14550492408648
1747352213805151,53648204,1,582,25,53935966,53538624,397342,62.91809071278647
1747352213899501,53740764,1,583,25,54030316,53631184,399132,62.63591994628344
1747352213993776,53833324,1,584,25,54124591,53723744,400847,62.36793589574077
1747352214084166,53925884,1,585,25,54214981,53816304,398677,62.707404741181456
1747352214178321,54018444,1,586,25,54309136,53908864,400272,62.45752888036135
1747352214272173,54111004,1,587,25,54402988,54001424,401564,62.256576784771546
1747352214366438,54203564,1,588,25,54497253,54093984,403269,61.993359271354855
1747352214460488,54296124,1,589,25,54591303,54186544,404759,61.76514913812911
1747352214550731,54388684,1,590,25,54681546,54279104,402442,62.12075280413078
1747352214644729,54481244,1,591,25,54775544,54371664,403880,61.89957413092998
1747352214738955,54573804,1,592,25,54869770,54464224,405546,61.64528808076026
1747352214833108,54666364,1,593,25,54963923,54556784,407139,61.404090494892415
1747352214923863,54758924,1,594,25,55054678,54649344,405334,61.67753013564122
1747352215017697,54851484,1,595,25,55148512,54741904,406608,61.48427969936646
1747352215111648,54944044,1,596,25,55242463,54834464,407999,61.27465998691173
1747352215205808,55036604,1,597,25,55336623,54927024,409599,61.035305261975736
1747352215296191,55129164,1,598,25,55427006,55019584,407422,61.36143850847524
1747352215390617,55221724,1,599,25,55521432,55112144,409288,61.08168331346143
1747352215484172,55314284,1,600,25,55614987,55204704,410283,60.93355074424239
1747352215578301,55406844,1,601,25,55709116,55297264,411852,60.701417013878775
1747352215668244,55499404,1,602,25,55799059,55389824,409235,61.089593998558286
1747352215762795,55591972,1,603,25,55893610,55482392,411218,60.79500410974228
1747352215857463,55684524,1,604,25,55988278,55574944,413334,60.48377341326869
1747352215951249,55777084,1,605,25,56082064,55667504,414560,60.30490158240062
1747352216045919,55869644,1,606,25,56176734,55760064,416670,59.99952000383997
1747352216136089,55962204,1,607,25,56266904,55852624,414280,60.34565994013711
1747352216230256,56054764,1,608,25,56361071,55945184,415887,60.11248247721136
1747352216324138,56147324,1,609,25,56454953,56037744,417209,59.92200551761827
1747352216418639,56239884,1,610,25,56549454,56130304,419150,59.64451866873434
1747352216508762,56332444,1,611,25,56639577,56222864,416713,59.993328741843904
1747352216602574,56425004,1,612,25,56733389,56315424,417965,59.81362075771895
1747352216696589,56517564,1,613,25,56827404,56407984,419420,59.60612274092794
1747352216790590,56610124,1,614,25,56921405,56500544,420861,59.40203535133928
1747352216881587,56702684,1,615,25,57012402,56593104,419298,59.6234658882227
1747352216974954,56795244,1,616,25,57105769,56685664,420105,59.50893229073684
1747352217069317,56887804,1,617,25,57200132,56778224,421908,59.254624230874974
1747352217162952,56980364,1,618,25,57293767,56870784,422983,59.1040301856103
1747352217253656,57072924,1,619,25,57384471,56963344,421127,59.3645147425836
1747352217347669,57165484,1,620,25,57478484,57055904,422580,59.1603956647262
1747352217441605,57258044,1,621,25,57572420,57148464,423956,58.96838351149648
1747352217536167,57350604,1,622,25,57666982,57241024,425958,58.69123246892886
1747352217630344,57443164,1,623,25,57761159,57333584,427575,58.46927439630475
1747352217720662,57535724,1,624,25,57851477,57426144,425333,58.77747553093693
1747352217814556,57628284,1,625,25,57945371,57518704,426667,58.593704223668574
1747352217909378,57720852,1,626,25,58040193,57611272,428921,58.2857915560208
1747352218002946,57813404,1,627,25,58133761,57703824,429937,58.14805424980869
1747352218093479,57905964,1,628,25,58224294,57796384,427910,58.4235002687481
1747352218187439,57998524,1,629,25,58318254,57888944,429310,58.232978500384334
1747352218281633,58091084,1,630,25,58412448,57981504,430944,58.01217791638821
1747352218375695,58183644,1,631,25,58506510,58074064,432446,57.8106861897208
1747352218466323,58276204,1,632,25,58597138,58166624,430514,58.070120832307424
1747352218560349,58368764,1,633,25,58691164,58259184,431980,57.87304967822585
1747352218654440,58461324,1,634,25,58785255,58351744,433511,57.66866354025619
1747352218748968,58553884,1,635,25,58879783,58444304,435479,57.408049527072485
1747352218842587,58646444,1,636,25,58973402,58536864,436538,57.26878301545341
1747352218932742,58739004,1,637,25,59063557,58629424,434133,57.586039301320106
1747352219026756,58831564,1,638,25,59157571,58721984,435587,57.39381570157053
1747352219121343,58924124,1,639,25,59252158,58814544,437614,57.127971225783455
1747352219214964,59016684,1,640,25,59345779,58907104,438675,56.989798826010144
1747352219305899,59109244,1,641,25,59436714,58999664,437050,57.20169317011784
1747352219399423,59201804,1,642,25,59530238,59092224,438014,57.07580123009767
1747352219494211,59294364,1,643,25,59625026,59184784,440242,56.78694899623389
1747352219588112,59386924,1,644,25,59718927,59277344,441583,56.61449829363902
1747352219678588,59479484,1,645,25,59809403,59369904,439499,56.88295081445009
1747352219772794,59572044,1,646,25,59903609,59462464,441145,56.67070917725464
1747352219866884,59664604,1,647,25,59997699,59555024,442675,56.474840458575706
1747352219961263,59757164,1,648,25,60092078,59647584,444494,56.2437288242361
1747352220051374,59849724,1,649,25,60182189,59740144,442045,56.55532807745818
1747352220145343,59942284,1,650,25,60276158,59832704,443454,56.37563309835969
1747352220239763,60034844,1,651,25,60370578,59925264,445314,56.14016177349017
1747352220333218,60127404,1,652,25,60464033,60017824,446209,56.02755659343491
1747352220427741,60219964,1,653,25,60558556,60110384,448172,55.782155065465936
1747352220518084,60312524,1,654,25,60648899,60202944,445955,56.05946788353085
1747352220612770,60405084,1,655,25,60743585,60295504,448081,55.79348376744383
1747352220706580,60497644,1,656,25,60837395,60388064,449331,55.63827111861857
1747352220800657,60590204,1,657,25,60931472,60480624,450848,55.45106111150543
1747352220891195,60682764,1,658,25,61022010,60573184,448826,55.70087294408078
1747352220985431,60775324,1,659,25,61116246,60665744,450502,55.49364930677333
1747352221078848,60867884,1,660,25,61209663,60758304,451359,55.38828294107351
1747352221172835,60960444,1,661,25,61303650,60850864,452786,55.213721272300816
1747352221262970,61053004,1,662,25,61393785,60943424,450361,55.5110233790226
1747352221357863,61145564,1,663,25,61488678,61035984,452694,55.224942234710426
1747352221451664,61238124,1,664,25,61582479,61128544,453935,55.0739643341007
1747352221546456,61330684,1,665,25,61677271,61221104,456167,54.80449046073039
1747352221635730,61423244,1,666,25,61766545,61313664,452881,55.20213919329802
1747352221730407,61515812,1,667,25,61861222,61406232,454990,54.94626255522099
1747352221824906,61608364,1,668,25,61955721,61498784,456937,54.71213755944474
1747352221918995,61700924,1,669,25,62049810,61591344,458466,54.52967068441281
1747352222012917,61793484,1,670,25,62143732,61683904,459828,54.368155049279295
1747352222103424,61886044,1,671,25,62234239,61776464,457775,54.61198186882202
1747352222196983,61978604,1,672,25,62327798,61869024,458774,54.49306194335337
1747352222291714,62071164,1,673,25,62422529,61961584,460945,54.2364056449251
1747352222385657,62163724,1,674,25,62516472,62054144,462328,54.07416379713104
1747352222476554,62256284,1,675,25,62607369,62146704,460665,54.26937145213984
1747352222569982,62348844,1,676,25,62700797,62239264,461533,54.167307646473816
1747352222664419,62441404,1,677,25,62795234,62331824,463410,53.94790790013163
1747352222759025,62533964,1,678,25,62889840,62424384,465456,53.71076965384484
1747352222848761,62626524,1,679,25,62979576,62516944,462632,54.03863113662696
1747352222942409,62719084,1,680,25,63073224,62609504,463720,53.91184335374795
1747352223037483,62811644,1,681,25,63168298,62702064,466234,53.62114303118177
1747352223130907,62904204,1,682,25,63261722,62794624,467098,53.52195898933415
1747352223221170,62996764,1,683,25,63351985,62887184,464801,53.78645915133573
1747352223315771,63089324,1,684,25,63446586,62979744,466842,53.55130857977646
1747352223409657,63181884,1,685,25,63540472,63072304,468168,53.39963431930418
1747352223504146,63274444,1,686,25,63634961,63164864,470097,53.18051380885222
1747352223598363,63367004,1,687,25,63729178,63257424,471754,52.99372130389991
1747352223688712,63459564,1,688,25,63819527,63349984,469543,53.24325993572474
1747352223786412,63552124,1,689,25,63917227,63442544,474683,52.66672705784703
1747352223876408,63644692,1,690,25,64007223,63535112,472111,52.95364861229668
1747352223970306,63737244,1,691,25,64101121,63627664,473457,52.80310566746294
1747352224060935,63829804,1,692,25,64191750,63720224,471526,53.0193456988586
1747352224155186,63922364,1,693,25,64286001,63812784,473217,52.829885654995486
1747352224249224,64014924,1,694,25,64380039,63905344,474695,52.66539567511771
1747352224343195,64107484,1,695,25,64474010,63997904,476106,52.50931515250806
1747352224433388,64200044,1,696,25,64564203,64090464,473739,52.77167385416865
1747352224527761,64292604,1,697,25,64658576,64183024,475552,52.570486508310346
1747352224621461,64385164,1,698,25,64752276,64275584,476692,52.44476517331946
1747352224716464,64477724,1,699,25,64847279,64368144,479135,52.177361286485024
1747352224806572,64570284,1,700,25,64937387,64460704,476683,52.44575535523608
1747352224899962,64662844,1,701,25,65030777,64553264,477513,52.354595581690965
1747352224994958,64755404,1,702,25,65125773,64645824,479949,52.08886777553448
1747352225088299,64847964,1,703,25,65219114,64738384,480730,52.00424354627338
1747352225183485,64940524,1,704,25,65314300,64830944,483356,51.72171236107548
1747352225273528,65033084,1,705,25,65404343,64923504,480839,51.99245485495145
1747352225367283,65125644,1,706,25,65498098,65016064,482034,51.863561491513046
1747352225461287,65218204,1,707,25,65592102,65108624,483478,51.70866099388183
1747352225555287,65310764,1,708,25,65686102,65201184,484918,51.55510828634944
1747352225645857,65403324,1,709,25,65776672,65293744,482928,51.76755127058278
1747352225739755,65495884,1,710,25,65870570,65386304,484266,51.62452040820541
1747352225834740,65588444,1,711,25,65965555,65478864,486691,51.36729464896619
1747352225928167,65681004,1,712,25,66058982,65571424,487558,51.27595075867897
1747352226018423,65773564,1,713,25,66149238,65663984,485254,51.5194104530823
1747352226112781,65866124,1,714,25,66243596,65756544,487052,51.329221520494734
1747352226206824,65958684,1,715,25,66337639,65849104,488535,51.17340620426377
1747352226301569,66051244,1,716,25,66432384,65941664,490720,50.94554939680469
1747352226395632,66143804,1,717,25,66526447,66034224,492223,50.78998746503109
1747352226485101,66236364,1,718,25,66615916,66126784,489132,51.11094755607893
1747352226579875,66328924,1,719,25,66710690,66219344,491346,50.8806421544085
1747352226674244,66421484,1,720,25,66805059,66311904,493155,50.694000871936815
1747352226768557,66514044,1,721,25,66899372,66404464,494908,50.51443904725727
1747352226858086,66606604,1,722,25,66988901,66497024,491877,50.82571455872098
1747352226952203,66699164,1,723,25,67083018,66589584,493434,50.665337208218325
1747352227046486,66791724,1,724,25,67177301,66682144,495157,50.48903681054696
1747352227140953,66884284,1,725,25,67271768,66774704,497064,50.29533420243671
1747352227230648,66976844,1,726,25,67361463,66867264,494199,50.5869093219533
1747352227325594,67069404,1,727,25,67456409,66959824,496585,50.3438484851536
1747352227418919,67161964,1,728,25,67549734,67052384,497350,50.26641198351262
1747352227513282,67254524,1,729,25,67644097,67144944,499153,50.08484372527061
1747352227603957,67347084,1,730,25,67734772,67237504,497268,50.274700966078655
1747352227698066,67439652,1,731,25,67828881,67330072,498809,50.119384373577866
1747352227791962,67532204,1,732,25,67922777,67422624,500153,49.98470468036781
1747352227886301,67624764,1,733,25,68017116,67515184,501932,49.80754365133125
1747352227980693,67717324,1,734,25,68111508,67607744,503764,49.626412367695984
1747352228070766,67809884,1,735,25,68201581,67700304,501277,49.87262531494563
1747352228164888,67902444,1,736,25,68295703,67792864,502839,49.71770288303015
1747352228259028,67995004,1,737,25,68389843,67885424,504419,49.56197129767119
1747352228353329,68087564,1,738,25,68484144,67977984,506160,49.39149675991781
1747352228443778,68180124,1,739,25,68574593,68070544,504049,49.598352541122
1747352228537816,68272684,1,740,25,68668631,68163104,505527,49.4533427492498
1747352228631905,68365244,1,741,25,68762720,68255664,507056,49.30421886339971
1747352228725440,68457804,1,742,25,68856255,68348224,508031,49.20959547744133
1747352228815916,68550364,1,743,25,68946731,68440784,505947,49.41229022012187
1747352228910531,68642924,1,744,25,69041346,68533344,508002,49.21240467557215
1747352229004140,68735484,1,745,25,69134955,68625904,509051,49.11099280818621
1747352229098227,68828044,1,746,25,69229042,68718464,510578,48.964115179267424
1747352229188376,68920604,1,747,25,69319191,68811024,508167,49.19642558450273
1747352229282692,69013164,1,748,25,69413507,68903584,509923,49.02700996032734
1747352229376682,69105724,1,749,25,69507497,68996144,511353,48.88990579892951
1747352229471310,69198284,1,750,25,69602125,69088704,513421,48.692982951612805
1747352229565791,69290844,1,751,25,69696606,69181264,515342,48.51147393381483
1747352229655199,69383404,1,752,25,69786014,69273824,512190,48.8100119096429
1747352229749395,69475964,1,753,25,69880210,69366384,513826,48.65460292005465
1747352229843456,69568532,1,754,25,69974271,69458952,515319,48.51363912450346
1747352229937676,69661084,1,755,25,70068491,69551504,516987,48.35711536266869
1747352230028662,69753644,1,756,25,70159477,69644064,515413,48.50479130328494
1747352230122749,69846204,1,757,25,70253564,69736624,516940,48.36151197431037
1747352230216085,69938764,1,758,25,70346900,69829184,517716,48.28902332552983
1747352230310967,70031324,1,759,25,70441782,69921744,520038,48.073410020037
1747352230400656,70123884,1,760,25,70531471,70014304,517167,48.34028466626834
1747352230494654,70216444,1,761,25,70625469,70106864,518605,48.20624560118009
1747352230589014,70309004,1,762,25,70719829,70199424,520405,48.03950769112518
1747352230683159,70401564,1,763,25,70813974,70291984,521990,47.89363780915344
1747352230774251,70494124,1,764,25,70905066,70384544,520522,48.02870964147529
1747352230867530,70586684,1,765,25,70998345,70477104,521241,47.9624588242291
1747352230961917,70679244,1,766,25,71092732,70569664,523068,47.794932972386
1747352231056289,70771804,1,767,25,71187104,70662224,524880,47.62993446121018
1747352231150523,70864364,1,768,25,71281338,70754784,526554,47.4785112258192
1747352231240219,70956924,1,769,25,71371034,70847344,523690,47.73816570872081
1747352231334692,71049484,1,770,25,71465507,70939904,525603,47.56441648925139
1747352231428525,71142044,1,771,25,71559340,71032464,526876,47.44949475777982
1747352231523089,71234604,1,772,25,71653904,71125024,528880,47.26970201179852
1747352231613182,71327164,1,773,25,71743997,71217584,526413,47.491228370120034
1747352231707354,71419724,1,774,25,71838169,71310144,528025,47.34624307561195
1747352231801958,71512284,1,775,25,71932773,71402704,530069,47.163671144700025
1747352231896050,71604844,1,776,25,72026865,71495264,531601,47.02775201702028
1747352231986186,71697404,1,777,25,72117001,71587824,529177,47.24317194435888
1747352232080206,71789964,1,778,25,72211021,71680384,530637,47.113186604024975
1747352232174324,71882524,1,779,25,72305139,71772944,532195,46.97526282659552
1747352232268254,71975084,1,780,25,72399069,71865504,533565,46.85464751248677
1747352232358961,72067644,1,781,25,72489776,71958064,531712,47.01793452094367
1747352232453349,72160204,1,782,25,72584164,72050624,533540,46.856842973347824
1747352232546757,72252764,1,783,25,72677572,72143184,534388,46.78248763071027
1747352232641682,72345324,1,784,25,72772497,72235744,536753,46.57635821318185
1747352232735491,72437884,1,785,25,72866306,72328304,538002,46.46822874264408
1747352232825999,72530444,1,786,25,72956814,72420864,535950,46.64614236402649
1747352232920167,72623004,1,787,25,73050982,72513424,537558,46.50660951934489
1747352233014151,72715564,1,788,25,73144966,72605984,538982,46.383738232445616
1747352233108327,72808124,1,789,25,73239142,72698544,540598,46.24508414755511
1747352233198609,72900684,1,790,25,73329424,72791104,538320,46.44077871897756
1747352233292824,72993244,1,791,25,73423639,72883664,539975,46.29843974258068
1747352233386597,73085804,1,792,25,73517412,72976224,541188,46.19466802663769
1747352233480619,73178364,1,793,25,73611434,73068784,542650,46.07021100156639
1747352233571303,73270924,1,794,25,73702118,73161344,540774,46.23003324863991
1747352233665527,73363492,1,795,25,73796342,73253912,542430,46.0888962631123
1747352233759253,73456044,1,796,25,73890068,73346464,543604,45.98935990169315
1747352233853180,73548604,1,797,25,73983995,73439024,544971,45.87400063489617
1747352233943958,73641164,1,798,25,74074773,73531584,543189,46.02449607779244
1747352234037478,73733724,1,799,25,74168293,73624144,544149,45.9432986185769
1747352234131634,73826284,1,800,25,74262449,73716704,545745,45.80894007274459
1747352234226300,73918844,1,801,25,74357115,73809264,547851,45.63284542695003
1747352234320906,74011404,1,802,25,74451721,73901824,549897,45.46305944567801
1747352234411098,74103964,1,803,25,74541913,73994384,547529,45.659681952919385
1747352234505315,74196524,1,804,25,74636130,74086944,549186,45.52191789302714
1747352234598897,74289084,1,805,25,74729712,74179504,550208,45.43736187041991
1747352234693091,74381644,1,806,25,74823906,74272064,551842,45.30282218461081
1747352234783466,74474204,1,807,25,74914281,74364624,549657,45.48291025130218
1747352234877398,74566764,1,808,25,75008213,74457184,551029,45.36966293970009
1747352234972057,74659324,1,809,25,75102872,74549744,553128,45.19749497403856
1747352235066143,74751884,1,810,25,75196958,74642304,554654,45.07314469921789
1747352235156320,74844444,1,811,25,75287135,74734864,552271,45.26763128971104
1747352235250596,74937004,1,812,25,75381411,74827424,553987,45.12741273712199
1747352235344841,75029564,1,813,25,75475656,74919984,555672,44.99056997653292
1747352235439035,75122124,1,814,25,75569850,75012544,557306,44.85865933616362
1747352235532558,75214684,1,815,25,75663373,75105104,558269,44.78127927576133
1747352235622698,75307244,1,816,25,75753513,75197664,555849,44.97624354815786
1747352235716754,75399804,1,817,25,75847569,75290224,557345,44.8555203688918
1747352235811020,75492372,1,818,25,75941835,75382792,559043,44.7192791967702
1747352235905409,75584924,1,819,25,76036224,75475344,560880,44.57281414919412
1747352235995740,75677484,1,820,25,76126555,75567904,558651,44.75065828218333
1747352236090086,75770044,1,821,25,76220901,75660464,560437,44.608046934802665
1747352236184383,75862604,1,822,25,76315198,75753024,562174,44.47021740599886
1747352236278425,75955164,1,823,25,76409240,75845584,563656,44.353293498162
1747352236368489,76047724,1,824,25,76499304,75938144,561160,44.55057381139069
1747352236463021,76140284,1,825,25,76593836,76030704,563132,44.39456468465653
1747352236556813,76232844,1,826,25,76687628,76123264,564364,44.29765187006967
1747352236650524,76325404,1,827,25,76781339,76215824,565515,44.2074922857926
1747352236740725,76417964,1,828,25,76871540,76308384,563156,44.39267272301103
1747352236835380,76510524,1,829,25,76966195,76400944,565251,44.22813935755974
1747352236929179,76603084,1,830,25,77059994,76493504,566490,44.13140567353351
1747352237023642,76695644,1,831,25,77154457,76586064,568393,43.98365215616659
1747352237117501,76788204,1,832,25,77248316,76678624,569692,43.88336153570702
1747352237207707,76880764,1,833,25,77338522,76771184,567338,44.06544246992093
1747352237302548,76973324,1,834,25,77433363,76863744,569619,43.88898544465687
1747352237396321,77065884,1,835,25,77527136,76956304,570832,43.795722734534856
1747352237490887,77158444,1,836,25,77621702,77048864,572838,43.64235612860879
1747352237580542,77251004,1,837,25,77711357,77141424,569933,43.86480516130843
1747352237674819,77343564,1,838,25,77805634,77233984,571650,43.733053441791306
1747352237769636,77436124,1,839,25,77900451,77326544,573907,43.56106477181844
1747352237863501,77528684,1,840,25,77994316,77419104,575212,43.462236531922144
1747352237953709,77621244,1,841,25,78084524,77511664,572860,43.64068009635862
1747352238047130,77713804,1,842,25,78177945,77604224,573721,43.57518724257958
1747352238141762,77806364,1,843,25,78272577,77696784,575793,43.41838125854257
1747352238235788,77898924,1,844,25,78366603,77789344,577259,43.30811646072214
1747352238325826,77991484,1,845,25,78456641,77881904,574737,43.498156548125486
1747352238420492,78084044,1,846,25,78551307,77974464,576843,43.33934883495162
1747352238514752,78176604,1,847,25,78645567,78067024,578543,43.21199979949632
1747352238609068,78269164,1,848,25,78739883,78159584,580299,43.08123915429804
1747352238703153,78361724,1,849,25,78833968,78252144,581824,42.968320316796834
1747352238792672,78454284,1,850,25,78923487,78344704,578783,43.19408137419378
1747352238887320,78546844,1,851,25,79018135,78437264,580871,43.0388158472363
1747352238981576,78639404,1,852,25,79112391,78529824,582567,42.91351896005095
1747352239076107,78731964,1,853,25,79206922,78622384,584538,42.768819135796136
1747352239165465,78824524,1,854,25,79296280,78714944,581336,43.00438988811978
1747352239260392,78917084,1,855,25,79391207,78807504,583703,42.83000087373202
1747352239354484,79009644,1,856,25,79485299,78900064,585235,42.71788255999727
1747352239447605,79102204,1,857,25,79578420,78992624,585796,42.67697287110189
1747352239538379,79194764,1,858,25,79669194,79085184,584010,42.80748617318197
1747352239632377,79287332,1,859,25,79763192,79177752,585440,42.70292429625581
1747352239727285,79379884,1,860,25,79858100,79270304,587796,42.5317627203996
1747352239821210,79472444,1,861,25,79952025,79362864,589161,42.43322283722106
1747352239911216,79565004,1,862,25,80042031,79455424,586607,42.61797080498528
1747352240005477,79657564,1,863,25,80136292,79547984,588308,42.49474764919056
1747352240100039,79750124,1,864,25,80230854,79640544,590310,42.35062933035185
1747352240193590,79842684,1,865,25,80324405,79733104,591301,42.2796511421425
1747352240287548,79935244,1,866,25,80418363,79825664,592699,42.17992606702559
1747352240378291,80027804,1,867,25,80509106,79918224,590882,42.30963204159206
1747352240472061,80120364,1,868,25,80602876,80010784,592092,42.2231680211859
1747352240566470,80212924,1,869,25,80697285,80103344,593941,42.09172291523905
1747352240660906,80305484,1,870,25,80791721,80195904,595817,41.95919216806502
1747352240751262,80398044,1,871,25,80882077,80288464,593613,42.11498063553191
1747352240845157,80490604,1,872,25,80975972,80381024,594948,42.02047910069451
1747352240939442,80583164,1,873,25,81070257,80473584,596673,41.89899660282936
1747352241033508,80675724,1,874,25,81164323,80566144,598179,41.793509969423866
1747352241123386,80768284,1,875,25,81254201,80658704,595497,41.98173962253378
1747352241217855,80860844,1,876,25,81348670,80751264,597406,41.84758773765245
1747352241311306,80953404,1,877,25,81442121,80843824,598297,41.78526718335542
1747352241406008,81045964,1,878,25,81536823,80936384,600439,41.63620284491847
1747352241496739,81138524,1,879,25,81627554,81028944,598610,41.76341858639181
1747352241590273,81231084,1,880,25,81721088,81121504,599584,41.69557559908203
1747352241688592,81323644,1,881,25,81819407,81214064,605343,41.2988999625006
1747352241778592,81416212,1,882,25,81909407,81306632,602775,41.474845506200495
1747352241873370,81508764,1,883,25,82004185,81399184,605001,41.322245748354135
1747352241966868,81601324,1,884,25,82097683,81491744,605939,41.25827847357572
1747352242057085,81693884,1,885,25,82187900,81584304,603596,41.41843219636976
1747352242151726,81786444,1,886,25,82282541,81676864,605677,41.27612572377687
1747352242245230,81879004,1,887,25,82376045,81769424,606621,41.21189342274666
1747352242335968,81971564,1,888,25,82466783,81861984,604799,41.3360471826177
1747352242429627,82064124,1,889,25,82560442,81954544,605898,41.26107034517361
1747352242524321,82156684,1,890,25,82655136,82047104,608032,41.1162570391032
1747352242617782,82249244,1,891,25,82748597,82139664,608933,41.055419890201385
1747352242708535,82341804,1,892,25,82839350,82232224,607126,41.1776138725734
1747352242802521,82434364,1,893,25,82933336,82324784,608552,41.0811237166257
1747352242896883,82526924,1,894,25,83027698,82417344,610354,40.95983642279727
1747352242991338,82619484,1,895,25,83122153,82509904,612249,40.83305975183299
1747352243085414,82712044,1,896,25,83216229,82602464,613765,40.732202064308
1747352243174967,82804604,1,897,25,83305782,82695024,610758,40.932742591992245
1747352243269594,82897164,1,898,25,83400409,82787584,612825,40.79468037367928
1747352243363737,82989724,1,899,25,83494552,82880144,614408,40.68957435450059
1747352243457805,83082284,1,900,25,83588620,82972704,615916,40.58995057767618
1747352243548163,83174844,1,901,25,83678978,83065264,613714,40.73558693463079
1747352243642565,83267404,1,902,25,83773380,83157824,615556,40.61368908758911
1747352243736928,83359964,1,903,25,83867743,83250384,617359,40.495076608585926
1747352243830730,83452524,1,904,25,83961545,83342944,618601,40.41377236700232
1747352243920867,83545084,1,905,25,84051682,83435504,616178,40.57269165728085
1747352244014865,83637644,1,906,25,84145680,83528064,617616,40.47822595269552
1747352244109139,83730204,1,907,25,84239954,83620624,619330,40.36620218623351
1747352244203414,83822764,1,908,25,84334229,83713184,621045,40.25473194373999
1747352244293439,83915324,1,909,25,84424254,83805744,618510,40.4197183554025
1747352244387350,84007884,1,910,25,84518165,83898304,619861,40.331622734774406
1747352244481802,84100444,1,911,25,84612617,83990864,621753,40.20889324217173
1747352244576259,84193004,1,912,25,84707074,84083424,623650,40.08658702798044
1747352244670413,84285564,1,913,25,84801228,84175984,625244,39.98439009410726
1747352244760692,84378124,1,914,25,84891507,84268544,622963,40.1307942847328
1747352244854830,84470684,1,915,25,84985645,84361104,624541,40.02939758958979
1747352244949109,84563244,1,916,25,85079924,84453664,626260,39.91952224315779
1747352245043212,84655804,1,917,25,85174027,84546224,627803,39.82140894516274
1747352245133200,84748364,1,918,25,85264015,84638784,625231,39.98522146214759
1747352245227381,84840924,1,919,25,85358196,84731344,626852,39.88182218450288
1747352245321476,84933484,1,920,25,85452291,84823904,628387,39.78440037747439
1747352245416173,85026044,1,921,25,85546988,84916464,630524,39.64956131725359
1747352245506083,85118604,1,922,25,85636898,85009024,627874,39.81690593972676
1747352245600442,85211172,1,923,25,85731257,85101592,629665,39.70365194190561
1747352245694651,85303724,1,924,25,85825466,85194144,631322,39.5994437070148
1747352245788810,85396284,1,925,25,85919625,85286704,632921,39.49940039910194
1747352245878914,85488844,1,926,25,86009729,85379264,630465,39.65327179145551
1747352245973102,85581404,1,927,25,86103917,85471824,632093,39.551141999674094
1747352246066877,85673964,1,928,25,86197692,85564384,633308,39.47526322105516
1747352246160956,85766524,1,929,25,86291771,85656944,634827,39.38080768461329
1747352246255175,85859084,1,930,25,86385990,85749504,636486,39.278161656344366
1747352246345597,85951644,1,931,25,86476412,85842064,634348,39.41054436996727
1747352246439638,86044204,1,932,25,86570453,85934624,635829,39.31874765070483
1747352246533538,86136764,1,933,25,86664353,86027184,637169,39.236058251421525
1747352246628236,86229324,1,934,25,86759051,86119744,639307,39.104843213041626
1747352246718389,86321884,1,935,25,86849204,86212304,636900,39.25262992620505
1747352246812370,86414444,1,936,25,86943185,86304864,638321,39.16524757919605
1747352246906233,86507004,1,937,25,87037048,86397424,639624,39.08546270934174
1747352247000298,86599564,1,938,25,87131113,86489984,641129,38.99371265377171
1747352247090957,86692124,1,939,25,87221772,86582544,639228,39.109676046731366
1747352247185371,86784684,1,940,25,87316186,86675104,641082,38.99657142144063
1747352247279170,86877244,1,941,25,87409985,86767664,642321,38.92134929420025
1747352247373285,86969804,1,942,25,87504100,86860224,643876,38.82735185035628
1747352247463598,87062364,1,943,25,87594413,86952784,641629,38.96332615888621
1747352247557463,87154924,1,944,25,87688278,87045344,642934,38.884240061965926
1747352247651821,87247484,1,945,25,87782636,87137904,644732,38.77580141826371
1747352247745771,87340052,1,946,25,87876586,87230472,646114,38.69286225031496
1747352247840306,87432604,1,947,25,87971121,87323024,648097,38.57447264838442
1747352247930345,87525164,1,948,25,88061160,87415584,645576,38.72510750089842
1747352248024321,87617724,1,949,25,88155136,87508144,646992,38.64035413111754
1747352248118694,87710284,1,950,25,88249509,87600704,648805,38.53237875787024
1747352248213057,87802844,1,951,25,88343872,87693264,650608,38.425595750436514
1747352248303176,87895404,1,952,25,88433991,87785824,648167,38.57030672650721
1747352248397650,87987964,1,953,25,88528465,87878384,650081,38.45674615932476
1747352248491582,88080524,1,954,25,88622397,87970944,651453,38.37575389168521
1747352248585636,88173084,1,955,25,88716451,88063504,652947,38.28794680119519
1747352248676306,88265644,1,956,25,88807121,88156064,651057,38.39909562449985
1747352248770127,88358204,1,957,25,88900942,88248624,652318,38.32486609291787
1747352248864563,88450764,1,958,25,88995378,88341184,654194,38.21496375692837
1747352248958446,88543324,1,959,25,89089261,88433744,655517,38.13783624223323
1747352249048840,88635884,1,960,25,89179655,88526304,653351,38.264271425313495
1747352249146511,88728444,1,961,25,89277326,88618864,658462,37.96726310705857
1747352249236684,88821004,1,962,25,89367499,88711424,656075,38.10539953511413
1747352249331584,88913564,1,963,25,89462399,88803984,658415,37.96997334507872
1747352249425474,89006124,1,964,25,89556289,88896544,659745,37.89342852162578
1747352249515315,89098684,1,965,25,89646130,88989104,657026,38.050244586972205
1747352249609447,89191244,1,966,25,89740262,89081664,658598,37.95942289530184
1747352249703582,89283804,1,967,25,89834397,89174224,660173,37.86886164687135
1747352249798607,89376364,1,968,25,89929422,89266784,662638,37.72799024505085
1747352249888565,89468924,1,969,25,90019380,89359344,660036,37.87672187577648
1747352249982774,89561484,1,970,25,90113589,89451904,661685,37.78232844933768
1747352250077124,89654044,1,971,25,90207939,89544464,663475,37.68039489053845
1747352250170696,89746604,1,972,25,90301511,89637024,664487,37.62300842604896
1747352250265402,89839164,1,973,25,90396217,89729584,666633,37.5018938456392
1747352250355183,89931724,1,974,25,90485998,89822144,663854,37.658882826645616
1747352250449724,90024284,1,975,25,90580539,89914704,665835,37.54683968250393
1747352250543723,90116844,1,976,25,90674538,90007264,667274,37.46586859371113
1747352250634374,90209404,1,977,25,90765189,90099824,665365,37.57336198928408
1747352250728030,90301964,1,978,25,90858845,90192384,666461,37.51157232006074
1747352250822235,90394524,1,979,25,90953050,90284944,668106,37.41921192146157
1747352250916249,90487084,1,980,25,91047064,90377504,669560,37.33795328275285
1747352251010628,90579644,1,981,25,91141443,90470064,671379,37.23679173760276
1747352251100390,90672204,1,982,25,91231205,90562624,668581,37.39262707136458
1747352251194770,90764764,1,983,25,91325585,90655184,670401,37.2911138259042
1747352251289078,90857324,1,984,25,91419893,90747744,672149,37.194134038732486
1747352251382818,90949884,1,985,25,91513633,90840304,673329,37.128951819986966
1747352251473339,91042444,1,986,25,91604154,90932864,671290,37.241728612075256
1747352251567953,91135012,1,987,25,91698768,91025432,673336,37.12856582746207
1747352251661282,91227564,1,988,25,91792097,91117984,674113,37.08577048655048
1747352251755679,91320124,1,989,25,91886494,91210544,675950,36.984984096456834
1747352251845963,91412684,1,990,25,91976778,91303104,673674,37.10993744748944
1747352251940210,91505244,1,991,25,92071025,91395664,675361,37.01723966885858
1747352252034254,91597804,1,992,25,92165069,91488224,676845,36.9360784226817
1747352252128778,91690364,1,993,25,92259593,91580784,678809,36.82921116249195
1747352252223160,91782924,1,994,25,92353975,91673344,680631,36.73062202573788
1747352252312554,91875484,1,995,25,92443369,91765904,677465,36.902275394300815
1747352252406936,91968044,1,996,25,92537751,91858464,679287,36.803295219840805
1747352252501753,92060604,1,997,25,92632568,91951024,681544,36.68141748735224
1747352252595882,92153164,1,998,25,92726697,92043584,683113,36.59716620822616
1747352252685715,92245724,1,999,25,92816530,92136144,680386,36.74384834491009
1747352252780249,92338284,1,1000,25,92911064,92228704,682360,36.63755202532388
1747352252874509,92431884,1,1001,25,93005324,92322304,683020,36.602149278205616
1747352252968565,92525484,1,1002,25,93099380,92415904,683476,36.57772913752641
1747352253063049,92619084,1,1003,25,93193864,92509504,684360,36.53048103337425
1747352253160547,92712684,1,1004,25,93291362,92603104,688258,36.32358795684176
1747352253255026,92806284,1,1005,25,93385841,92696704,689137,36.27725691698458
1747352253345862,92899884,1,1006,25,93476677,92790304,686373,36.42334415835121
1747352253443958,92993484,1,1007,25,93574773,92883904,690869,36.18631028458362
1747352253537651,93087084,1,1008,25,93668466,92977504,690962,36.18143978974242
1747352253632495,93180684,1,1009,25,93763310,93071104,692206,36.116416211359045
1747352253726392,93274284,1,1010,25,93857207,93164704,692503,36.10092663858496
1747352253820575,93367884,1,1011,25,93951390,93258304,693086,36.07055978623144
1747352253914568,93461484,1,1012,25,94045383,93351904,693479,36.05011831648832
1747352254008239,93555084,1,1013,25,94139054,93445504,693550,36.04642779900512
1747352254102763,93648684,1,1014,25,94233578,93539104,694474,35.99846790520595
1747352254201440,93742284,1,1015,25,94332255,93632704,699551,35.737208580932624
1747352254290444,93835884,1,1016,25,94421259,93726304,694955,35.97355224438993
1747352254385443,93929492,1,1017,25,94516258,93819912,696346,35.901692549393545
1747352254479351,94023084,1,1018,25,94610166,93913504,696662,35.88540784483724
1747352254574200,94116684,1,1019,25,94705015,94007104,697911,35.821186369035594
1747352254668439,94210284,1,1020,25,94799254,94100704,698550,35.78841886765443
1747352254762582,94303884,1,1021,25,94893397,94194304,699093,35.76062126212106
1747352254856690,94397484,1,1022,25,94987505,94287904,699601,35.73465446733209
1747352254950910,94491084,1,1023,25,95081725,94381504,700221,35.703013762797745
1747352255045112,94584684,1,1024,25,95175927,94475104,700823,35.67234522839576
1747352255139266,94678284,1,1025,25,95270081,94568704,701377,35.64416854273807
1747352255233443,94771884,1,1026,25,95364258,94662304,701954,35.61486935041328
1747352255327664,94865484,1,1027,25,95458479,94755904,702575,35.58338967370032
1747352255421305,94959084,1,1028,25,95552120,94849504,702616,35.581313263574984
1747352255515477,95052684,1,1029,25,95646292,94943104,703188,35.55237006319789
1747352255610001,95146284,1,1030,25,95740816,95036704,704112,35.505714999886386
1747352255703990,95239884,1,1031,25,95834805,95130304,704501,35.4861100268133
1747352255798074,95333484,1,1032,25,95928889,95223904,704985,35.46174741306553
1747352255892991,95427084,1,1033,25,96023806,95317504,706302,35.39562396821756
1747352255991311,95520684,1,1034,25,96122126,95411104,711022,35.16065606971373
1747352256080988,95614284,1,1035,25,96211803,95504704,707099,35.35572812293611
1747352256174969,95707884,1,1036,25,96305784,95598304,707480,35.33668796291061
1747352256273733,95801484,1,1037,25,96404548,95691904,712644,35.080629318425466
1747352256363825,95895084,1,1038,25,96494640,95785504,709136,35.25416845287787
1747352256457998,95988684,1,1039,25,96588813,95879104,709709,35.225705183392066
1747352256552183,96082284,1,1040,25,96682998,95972704,710294,35.19669320028045
1747352256650374,96175884,1,1041,25,96781189,96066304,714885,34.97065961658169
1747352256740316,96269484,1,1042,25,96871131,96159904,711227,35.15052156343896
1747352256834586,96363084,1,1043,25,96965401,96253504,711897,35.117439741985145
1747352256933275,96456684,1,1044,25,97064090,96347104,716986,34.86818431601175
1747352257022734,96550284,1,1045,25,97153549,96440704,712845,35.07073767789632
1747352257117655,96643884,1,1046,25,97248470,96534304,714166,35.005866983306404
1747352257210863,96737484,1,1047,25,97341678,96627904,713774,35.02509197589153
1747352257309610,96831084,1,1048,25,97440425,96721504,718921,34.77433542767564
1747352257399572,96924692,1,1049,25,97530387,96815112,715275,34.95159204501765
1747352257498053,97018284,1,1050,25,97628868,96908704,720164,34.71431507267789
1747352257588717,97111884,1,1051,25,97719532,97002304,717228,34.85641943705488
1747352257682073,97205484,1,1052,25,97812888,97095904,716984,34.868281579505265
1747352257776957,97299084,1,1053,25,97907772,97189504,718268,34.805949868294284
1747352257874681,97392684,1,1054,25,98005496,97283104,722392,34.60724924971483
1747352257969537,97486284,1,1055,25,98100352,97376704,723648,34.5471831608738
1747352258063222,97579884,1,1056,25,98194037,97470304,723733,34.543125710724816
1747352258157340,97673484,1,1057,25,98288155,97563904,724251,34.51841971913052
1747352258251325,97767084,1,1058,25,98382140,97657504,724636,34.50008004018569
1747352258346366,97860684,1,1059,25,98477181,97751104,726077,34.43160987057847
1747352258439875,97954284,1,1060,25,98570690,97844704,725986,34.435925761653806
1747352258534357,98047884,1,1061,25,98665172,97938304,726868,34.39414033909871
1747352258628614,98141484,1,1062,25,98759429,98031904,727525,34.363080306518675
1747352258722456,98235084,1,1063,25,98853271,98125504,727767,34.351653757315184
1747352258817266,98328684,1,1064,25,98948081,98219104,728977,34.29463481015176
1747352258911273,98422284,1,1065,25,99042088,98312704,729384,34.27549822864225
1747352259005676,98515884,1,1066,25,99136491,98406304,730187,34.23780483629536
1747352259099842,98609484,1,1067,25,99230657,98499904,730753,34.21128616646117
1747352259193968,98703084,1,1068,25,99324783,98593504,731279,34.18667840865114
1747352259288056,98796684,1,1069,25,99418871,98687104,731767,34.16388003285199
1747352259382248,98890284,1,1070,25,99513063,98780704,732359,34.13626377227562
1747352259476175,98983884,1,1071,25,99606990,98874304,732686,34.12102865347502
1747352259570592,99077484,1,1072,25,99701407,98967904,733503,34.08302351864955
1747352259664703,99171084,1,1073,25,99795518,99061504,734014,34.059295871740865
1747352259758451,99264684,1,1074,25,99889266,99155104,734162,34.05242984518404
1747352259852671,99358284,1,1075,25,99983486,99248704,734782,34.02369682436423
1747352259946651,99451884,1,1076,25,100077466,99342304,735162,34.00611021788395
1747352260041797,99545484,1,1077,25,100172612,99435904,736708,33.93474755262601
1747352260135403,99639084,1,1078,25,100266218,99529504,736714,33.93447117877494
1747352260230063,99732684,1,1079,25,100360878,99623104,737774,33.88571567986944
1747352260323779,99826284,1,1080,25,100454594,99716704,737890,33.880388675818885
1747352260417939,99919892,1,1081,25,100548754,99810312,738442,33.85506241519307
1747352260512544,100013484,1,1082,25,100643359,99903904,739455,33.80868342225017
1747352260610291,100108124,1,1083,25,100741106,99998544,742562,33.667222400284416
1747352260704517,100202764,1,1084,25,100835332,100093184,742148,33.686003330872005
1747352260799413,100297404,1,1085,25,100930228,100187824,742404,33.6743875302396
1747352260893543,100392044,1,1086,25,101024358,100282464,741894,33.69753630572561
1747352260991216,100486684,1,1087,25,101122031,100377104,744927,33.560335442264815
1747352261089696,100581324,1,1088,25,101220511,100471744,748767,33.38822357288716
1747352261180111,100675964,1,1089,25,101310926,100566384,744542,33.577689371452514
1747352261277952,100770604,1,1090,25,101408767,100661024,747743,33.43394722518298
1747352261372531,100865244,1,1091,25,101503346,100755664,747682,33.43667495004561
1747352261466892,100959884,1,1092,25,101597707,100850304,747403,33.44915661296516
1747352261561221,101054524,1,1093,25,101692036,100944944,747092,33.46308085215743
1747352261658689,101149164,1,1094,25,101789504,101039584,749920,33.33688926818861
1747352261753910,101243804,1,1095,25,101884725,101134224,750501,33.31108153087072
1747352261847418,101338444,1,1096,25,101978233,101228864,749369,33.36140139237145
1747352261945856,101433084,1,1097,25,102076671,101323504,753167,33.19316964232368
1747352262040109,101527724,1,1098,25,102170924,101418144,752780,33.21023406572969
1747352262134394,101622364,1,1099,25,102265209,101512784,752425,33.22590291391168
1747352262228595,101717012,1,1100,25,102359410,101607432,751978,33.24565346326621
1747352262327288,101811644,1,1101,25,102458103,101702064,756039,33.06707722749752
1747352262420854,101906284,1,1102,25,102551669,101796704,754965,33.11411787301398
1747352262515208,102000924,1,1103,25,102646023,101891344,754679,33.12666709952178
1747352262610092,102095564,1,1104,25,102740907,101985984,754923,33.11596017077238
1747352262707663,102190204,1,1105,25,102838478,102080624,757854,32.98788420988739
1747352262802152,102284844,1,1106,25,102932967,102175264,757703,32.9944582507922
1747352262896426,102379484,1,1107,25,103027241,102269904,757337,33.01040355878558
1747352262994858,102474124,1,1108,25,103125673,102364544,761129,32.84594332892322
1747352263088299,102568764,1,1109,25,103219114,102459184,759930,32.897766899582855
1747352263183466,102663404,1,1110,25,103314281,102553824,760457,32.874968604404984
1747352263277544,102758044,1,1111,25,103408359,102648464,759895,32.899282137663754
1747352263375109,102852684,1,1112,25,103505924,102743104,762820,32.773131276054634
1747352263469910,102947324,1,1113,25,103600725,102837744,762981,32.76621567247415
1747352263564042,103041964,1,1114,25,103694857,102932384,762473,32.7880462652448
1747352263658141,103136604,1,1115,25,103788956,103027024,761932,32.81132699505992
1747352263756419,103231244,1,1116,25,103887234,103121664,765570,32.65540708230469
1747352263850947,103325884,1,1117,25,103981762,103216304,765458,32.66018514405754
1747352263944944,103420524,1,1118,25,104075759,103310944,764815,32.68764341703549
1747352264042724,103515172,1,1119,25,104173539,103405592,767947,32.5543299212055
1747352264136784,103609804,1,1120,25,104267599,103500224,767375,32.57859586251833
1747352264231123,103704444,1,1121,25,104361938,103594864,767074,32.59137971043211
1747352264325366,103799084,1,1122,25,104456181,103689504,766677,32.60825614959103
1747352264424145,103893724,1,1123,25,104554960,103784144,770816,32.43316174028562
1747352264522288,103988364,1,1124,25,104653103,103878784,774319,32.28643491894168
1747352264616474,104083004,1,1125,25,104747289,103973424,773865,32.30537626071731
1747352264710939,104177644,1,1126,25,104841754,104068064,773690,32.31268337447815
1747352264804363,104272284,1,1127,25,104935178,104162704,772474,32.36354880552614
1747352264899576,104366924,1,1128,25,105030391,104257344,773047,32.33956020785282
1747352264993005,104461564,1,1129,25,105123820,104351984,771836,32.39030053016444
1747352265091688,104556204,1,1130,25,105222503,104446624,775879,32.221519077072585
1747352265185675,104650844,1,1131,25,105316490,104541264,775226,32.24866039064737
1747352265284447,104745484,1,1132,25,105415262,104635904,779358,32.07768445310114
1747352265374599,104840124,1,1133,25,105505414,104730544,774870,32.26347645411489
1747352265472824,104934764,1,1134,25,105603639,104825184,778455,32.11489424565325
1747352265570636,105029404,1,1135,25,105701451,104919824,781627,31.98456552805878
1747352265661035,105124044,1,1136,25,105791850,105014464,777386,32.15905611883929
1747352265759068,105218684,1,1137,25,105889883,105109104,780779,32.01930379787366
1747352265853010,105313324,1,1138,25,105983825,105203744,780081,32.04795399452108
1747352265947526,105407964,1,1139,25,106078341,105298384,779957,32.053049078346625
1747352266041441,105502604,1,1140,25,106172256,105393024,779232,32.082871339986035
1747352266140117,105597244,1,1141,25,106270932,105487664,783268,31.91755567698413
1747352266234092,105691884,1,1142,25,106364907,105582304,782603,31.944676930704325
1747352266332909,105786524,1,1143,25,106463724,105676944,786780,31.775083250718115
1747352266427052,105881164,1,1144,25,106557867,105771584,786283,31.7951678975636
1747352266520685,105975804,1,1145,25,106651500,105866224,785276,31.83594048461942
1747352266614875,106070444,1,1146,25,106745690,105960864,784826,31.854194432906148
1747352266709825,106165084,1,1147,25,106840640,106055504,785136,31.84161724847669
1747352266807826,106259724,1,1148,25,106938641,106150144,788497,31.705891081386486
1747352266902068,106354364,1,1149,25,107032883,106244784,788099,31.72190295889222
1747352266996149,106449004,1,1150,25,107126964,106339424,787540,31.744419331081595
1747352267090181,106543644,1,1151,25,107220996,106434064,786932,31.76894572847464
1747352267188057,106638284,1,1152,25,107318872,106528704,790168,31.63884136031832
1747352267282529,106732924,1,1153,25,107413344,106623344,790000,31.645569620253163
1747352267377017,106827564,1,1154,25,107507832,106717984,789848,31.65165955981404
1747352267475111,106922204,1,1155,25,107605926,106812624,793302,31.513849706669088
1747352267569482,107016844,1,1156,25,107700297,106907264,793033,31.524539331906745
1747352267664166,107111484,1,1157,25,107794981,107001904,793077,31.52279034696505
1747352267758180,107206124,1,1158,25,107888995,107096544,792451,31.547691907764644
1747352267856159,107300764,1,1159,25,107986974,107191184,795790,31.4153231380138
1747352267950462,107395404,1,1160,25,108081277,107285824,795453,31.428632489914552
1747352268044055,107490044,1,1161,25,108174870,107380464,794406,31.470054355077885
1747352268142597,107584684,1,1162,25,108273412,107475104,798308,31.31623383456009
1747352268236671,107679324,1,1163,25,108367486,107569744,797742,31.338452782979964
1747352268330960,107773972,1,1164,25,108461775,107664392,797383,31.35256206866713
1747352268425522,107868604,1,1165,25,108556337,107759024,797313,31.35531466312477
1747352268523444,107963244,1,1166,25,108654259,107853664,800595,31.226775086029768
1747352268617964,108057884,1,1167,25,108748779,107948304,800475,31.23145632280833
1747352268712454,108152524,1,1168,25,108843269,108042944,800325,31.23730984287633
1747352268806449,108247164,1,1169,25,108937264,108137584,799680,31.262505002000804
1747352268904709,108341804,1,1170,25,109035524,108232224,803300,31.12162330387153
1747352268998750,108436444,1,1171,25,109129565,108326864,802701,31.14484720960856
1747352269093159,108531084,1,1172,25,109223974,108421504,802470,31.153812603586427
1747352269191558,108625724,1,1173,25,109322373,108516144,806229,31.008559602792754
1747352269285496,108720364,1,1174,25,109416311,108610784,805527,31.035582916525456
1747352269380158,108815004,1,1175,25,109510973,108705424,805549,31.03473531715637
1747352269473680,108909644,1,1176,25,109604495,108800064,804431,31.07786746159708
1747352269571722,109004284,1,1177,25,109702537,108894704,807833,30.94699028140717
1747352269666149,109098924,1,1178,25,109796964,108989344,807620,30.95515217552809
1747352269760803,109193564,1,1179,25,109891618,109083984,807634,30.954615580820025
1747352269859276,109288204,1,1180,25,109990091,109178624,811467,30.80840009513634
1747352269952634,109382844,1,1181,25,110083449,109273264,810185,30.85714991020569
1747352270047308,109477484,1,1182,25,110178123,109367904,810219,30.85585502191383
1747352270141457,109572132,1,1183,25,110272272,109462552,809720,30.874870325544634
1747352270239827,109666764,1,1184,25,110370642,109557184,813458,30.73299420498661
1747352270333807,109761404,1,1185,25,110464622,109651824,812798,30.75794969967938
1747352270428205,109856044,1,1186,25,110559020,109746464,812556,30.767110205327388
1747352270522768,109950684,1,1187,25,110653583,109841104,812479,30.770026056058065
1747352270620418,110045324,1,1188,25,110751233,109935744,815489,30.6564527541144
1747352270714412,110139964,1,1189,25,110845227,110030384,814843,30.680756906545188
1747352270809413,110234604,1,1190,25,110940228,110125024,815204,30.667170426052863
1747352270907704,110329244,1,1191,25,111038519,110219664,818855,30.530435791440485
1747352271001448,110423884,1,1192,25,111132263,110314304,817959,30.56387911863553
1747352271096405,110518524,1,1193,25,111227220,110408944,818276,30.5520386764368
1747352271194489,110613164,1,1194,25,111325304,110503584,821720,30.4239887066154
1747352271287997,110707804,1,1195,25,111418812,110598224,820588,30.465958556547257
1747352271382682,110802444,1,1196,25,111513497,110692864,820633,30.464287933826693
1747352271476361,110897084,1,1197,25,111607176,110787504,819672,30.500004880000784
1747352271574773,110991724,1,1198,25,111705588,110882144,823444,30.360291653105737
1747352271669332,111086364,1,1199,25,111800147,110976784,823363,30.363278408186915
1747352271763945,111181004,1,1200,25,111894760,111071424,823336,30.364274123808507
1747352271857210,111275644,1,1201,25,111988025,111166064,821961,30.41506835482462
1747352271956406,111370284,1,1202,25,112087221,111260704,826517,30.24741172897836
1747352272050503,111464924,1,1203,25,112181318,111355344,825974,30.26729654928605
1747352272143883,111559564,1,1204,25,112274698,111449984,824714,30.31353899654911
1747352272238861,111654204,1,1205,25,112369676,111544624,825052,30.30112041422844
1747352272336955,111748844,1,1206,25,112467770,111639264,828506,30.174796561521585
1747352272430891,111843484,1,1207,25,112561706,111733904,827802,30.20045856376283
1747352272525026,111938124,1,1208,25,112655841,111828544,827297,30.21889357751812
1747352272623108,112032764,1,1209,25,112753923,111923184,830739,30.093687668449416
1747352272717829,112127404,1,1210,25,112848644,112017824,830820,30.090753713199007
1747352272811564,112222044,1,1211,25,112942379,112112464,829915,30.1235668713061
1747352272906486,112316684,1,1212,25,113037301,112207104,830197,30.11333454589694
1747352273004396,112411324,1,1213,25,113135211,112301744,833467,29.99518877172102
1747352273098234,112505964,1,1214,25,113229049,112396384,832665,30.02407931160791
1747352273193036,112600604,1,1215,25,113323851,112491024,832827,30.018239082066263
1747352273287223,112695244,1,1216,25,113418038,112585664,832374,30.03457580366518
1747352273384946,112789884,1,1217,25,113515761,112680304,835457,29.9237423350334
1747352273479539,112884524,1,1218,25,113610354,112774944,835410,29.925425838809687
1747352273573289,112979164,1,1219,25,113704104,112869584,834520,29.957340746776588
1747352273671737,113073804,1,1220,25,113802552,112964224,838328,29.82126327642641
1747352273766073,113168444,1,1221,25,113896888,113058864,838024,29.83208118144588
1747352273860848,113263084,1,1222,25,113991663,113153504,838159,29.827276208929334
1747352273954473,113357724,1,1223,25,114085288,113248144,837144,29.86344045946695
1747352274053368,113452364,1,1224,25,114184183,113342784,841399,29.712419434774706
1747352274147082,113547004,1,1225,25,114277897,113437424,840473,29.74515540653893
1747352274241235,113641644,1,1226,25,114372050,113532064,839986,29.76240080191813
1747352274339642,113736284,1,1227,25,114470457,113626704,843753,29.629524280209967
1747352274433385,113830932,1,1228,25,114564200,113721352,842848,29.661338699267244
1747352274528025,113925564,1,1229,25,114658840,113815984,842856,29.66105716753514
1747352274622262,114020204,1,1230,25,114753077,113910624,842453,29.67524597811392
1747352274720191,114114844,1,1231,25,114851006,114005264,845742,29.559842126795168
1747352274815253,114209484,1,1232,25,114946068,114099904,846164,29.545100004254493
1747352274909066,114304124,1,1233,25,115039881,114194544,845337,29.57400421370412
1747352275003534,114398764,1,1234,25,115134349,114289184,845165,29.580022835777623
1747352275101263,114493404,1,1235,25,115232078,114383824,848254,29.47230428621616
1747352275196061,114588044,1,1236,25,115326876,114478464,848412,29.466815650886595
1747352275290053,114682684,1,1237,25,115420868,114573104,847764,29.4893390141596
1747352275388385,114777324,1,1238,25,115519200,114667744,851456,29.36147023451593
1747352275482065,114871964,1,1239,25,115612880,114762384,850496,29.39461208518324
1747352275576641,114966604,1,1240,25,115707456,114857024,850432,29.39682420228777
1747352275670807,115061244,1,1241,25,115801622,114951664,849958,29.41321806489261
1747352275769221,115155884,1,1242,25,115900036,115046304,853732,29.283194257682737
1747352275863349,115250524,1,1243,25,115994164,115140944,853220,29.30076650805185
1747352275957528,115345164,1,1244,25,116088343,115235584,852759,29.316606450357018
1747352276052134,115439804,1,1245,25,116182949,115330224,852725,29.317775367205137
1747352276149802,115534444,1,1246,25,116280617,115424864,855753,29.21403722803192
1747352276244377,115629092,1,1247,25,116375192,115519512,855680,29.216529543754675
1747352276338826,115723724,1,1248,25,116469641,115614144,855497,29.222779273334684
1747352276436771,115818364,1,1249,25,116567586,115708784,858802,29.110318792923167
1747352276531134,115913004,1,1250,25,116661949,115803424,858525,29.119711132465568
1747352276625548,116007644,1,1251,25,116756363,115898064,858299,29.127378687380503
1747352276719294,116102284,1,1252,25,116850109,115992704,857405,29.157749255019507
1747352276817130,116196924,1,1253,25,116947945,116087344,860601,29.049466593694408
1747352276911608,116291564,1,1254,25,117042423,116181984,860439,29.05493591062237
1747352277006400,116386204,1,1255,25,117137215,116276624,860591,29.049804146220445
1747352277104368,116480844,1,1256,25,117235183,116371264,863919,28.93789811313329
1747352277198389,116575484,1,1257,25,117329204,116465904,863300,28.95864705200973
1747352277292782,116670124,1,1258,25,117423597,116560544,863053,28.96693482323797
1747352277387138,116764764,1,1259,25,117517953,116655184,862769,28.97646994734396
1747352277484468,116859404,1,1260,25,117615283,116749824,865459,28.88640594181816
1747352277578892,116954044,1,1261,25,117709707,116844464,865243,28.89361716881848
1747352277673390,117048684,1,1262,25,117804205,116939104,865101,28.898359844688656
1747352277768048,117143324,1,1263,25,117898863,117033744,865119,28.89775857425395
1747352277866280,117237964,1,1264,25,117997095,117128384,868711,28.77827033386247
1747352277960170,117332604,1,1265,25,118090985,117223024,867961,28.80313746815813
1747352278054846,117427244,1,1266,25,118185661,117317664,867997,28.801942863857825
1747352278152357,117521884,1,1267,25,118283172,117412304,870868,28.70699118580543
1747352278246716,117616524,1,1268,25,118377531,117506944,870587,28.7162569622565
1747352278340699,117711164,1,1269,25,118471514,117601584,869930,28.737944432310645
1747352278435367,117805804,1,1270,25,118566182,117696224,869958,28.737019488297136
1747352278533818,117900444,1,1271,25,118664633,117790864,873769,28.61168111938052
1747352278627649,117995084,1,1272,25,118758464,117885504,872960,28.63819648093842
1747352278722008,118089724,1,1273,25,118852823,117980144,872679,28.647417893635577
1747352278820634,118184364,1,1274,25,118951449,118074784,876665,28.517164481301293
1747352278914734,118279004,1,1275,25,119045549,118169424,876125,28.534741047225
1747352279008447,118373644,1,1276,25,119139262,118264064,875198,28.56496472798156
1747352279103258,118468284,1,1277,25,119234073,118358704,875369,28.559384670921634
1747352279201403,118562924,1,1278,25,119332218,118453344,878874,28.44548820422495
1747352279295320,118657564,1,1279,25,119426135,118547984,878151,28.46890796685308
1747352279389329,118752204,1,1280,25,119520144,118642624,877520,28.48937915944936
1747352279483416,118846844,1,1281,25,119614231,118737264,876967,28.507344061977246
1747352279581838,118941484,1,1282,25,119712653,118831904,880749,28.384931461744493
1747352279675866,119036124,1,1283,25,119806681,118926544,880137,28.40466881860437
1747352279770938,119130764,1,1284,25,119901753,119021184,880569,28.390733718765933
1747352279869061,119225404,1,1285,25,119999876,119115824,884052,28.278879522924
1747352279963416,119320044,1,1286,25,120094231,119210464,883767,28.28799898615812
1747352280057323,119414684,1,1287,25,120188138,119305104,883034,28.311480645139373
1747352280151127,119509324,1,1288,25,120281942,119399744,882198,28.33830954048864
1747352280249307,119603964,1,1289,25,120380122,119494384,885738,28.225050748641245
1747352280343515,119698604,1,1290,25,120474330,119589024,885306,28.2388236383804
1747352280438044,119793244,1,1291,25,120568859,119683664,885195,28.24236467670965
1747352280536291,119887892,1,1292,25,120667106,119778312,888794,28.128002664284413
1747352280630440,119982524,1,1293,25,120761255,119872944,888311,28.14329666074157
1747352280724368,120077164,1,1294,25,120855183,119967584,887599,28.165872201298107
1747352280818926,120171804,1,1295,25,120949741,120062224,887517,28.16847451936132
1747352280917718,120266444,1,1296,25,121048533,120156864,891669,28.03730980890891
1747352281011320,120361084,1,1297,25,121142135,120251504,890631,28.06998633553065
1747352281105798,120455724,1,1298,25,121236613,120346144,890469,28.07509301278316
1747352281200119,120550364,1,1299,25,121330934,120440784,890150,28.08515418749649
1747352281298245,120645004,1,1300,25,121429060,120535424,893636,27.975596327811324
1747352281392282,120739644,1,1301,25,121523097,120630064,893033,27.994486205996868
1747352281486449,120834284,1,1302,25,121617264,120724704,892560,28.00932150219593
1747352281584773,120928924,1,1303,25,121715588,120819344,896244,27.8941895287444
1747352281679294,121023564,1,1304,25,121810109,120913984,896125,27.89789370902497
1747352281773035,121118204,1,1305,25,121903850,121008624,895226,27.92590921175212
1747352281867595,121212844,1,1306,25,121998410,121103264,895146,27.92840497527777
1747352281966136,121307484,1,1307,25,122096951,121197904,899047,27.807222536752803
1747352282059761,121402124,1,1308,25,122190576,121292544,898032,27.8386516293406
1747352282154237,121496764,1,1309,25,122285052,121387184,897868,27.8437364957878
1747352282252355,121591404,1,1310,25,122383170,121481824,901346,27.736296605299188
1747352282347289,121686052,1,1311,25,122478104,121576472,901632,27.72749858035208
1747352282445187,121780684,1,1312,25,122576002,121671104,904898,27.627423201288984
1747352282535646,121875324,1,1313,25,122666461,121765744,900717,27.755665764052416
1747352282633823,121969964,1,1314,25,122764638,121860384,904254,27.64709915576818
1747352282727985,122064604,1,1315,25,122858800,121955024,903776,27.661721488510427
1747352282822569,122159244,1,1316,25,122953384,122049664,903720,27.66343557739123
1747352282916171,122253884,1,1317,25,123046986,122144304,902682,27.69524594486209
1747352283013944,122348524,1,1318,25,123144759,122238944,905815,27.59945463477641
1747352283108651,122443164,1,1319,25,123239466,122333584,905882,27.597413349641567
1747352283203266,122537804,1,1320,25,123334081,122428224,905857,27.5981749878844
1747352283300842,122632444,1,1321,25,123431657,122522864,908793,27.50901470411854
1747352283395475,122727084,1,1322,25,123526290,122617504,908786,27.50922659459983
1747352283489388,122821724,1,1323,25,123620203,122712144,908059,27.531250722695333
1747352283584573,122916364,1,1324,25,123715388,122806784,908604,27.51473689307993
1747352283682518,123011004,1,1325,25,123813333,122901424,911909,27.415016191308563
1747352283776406,123105644,1,1326,25,123907221,122996064,911157,27.43764246995853
1747352283870463,123200284,1,1327,25,124001278,123090704,910574,27.45520957110569
1747352283964968,123294924,1,1328,25,124095783,123185344,910439,27.459280632749696
1747352284062593,123389564,1,1329,25,124193408,123279984,913424,27.36954579691359
1747352284156709,123484204,1,1330,25,124287524,123374624,912900,27.38525577828897
1747352284251314,123578844,1,1331,25,124382129,123469264,912865,27.386305751671934
1747352284349334,123673484,1,1332,25,124480149,123563904,916245,27.28527850083766
1747352284444684,123768124,1,1333,25,124575499,123658544,916955,27.26415145781418
1747352284538298,123862764,1,1334,25,124669113,123753184,915929,27.294692055825287
1747352284632507,123957404,1,1335,25,124763322,123847824,915498,27.30754190615381
1747352284730430,124052044,1,1336,25,124861245,123942464,918781,27.209966248757866
1747352284824801,124146684,1,1337,25,124955616,124037104,918512,27.21793509502325
1747352284923134,124241324,1,1338,25,125053949,124131744,922205,27.108939986228656
1747352285017104,124335964,1,1339,25,125147919,124226384,921535,27.128649481571507
1747352285111007,124430604,1,1340,25,125241822,124321024,920798,27.15036305465477
1747352285205902,124525244,1,1341,25,125336717,124415664,921053,27.14284628571863
1747352285299672,124619884,1,1342,25,125430487,124510304,920183,27.16850887269163
1747352285397827,124714524,1,1343,25,125528642,124604944,923698,27.06512301639713
1747352285492453,124809164,1,1344,25,125623268,124699584,923684,27.06553323430957
1747352285586521,124903804,1,1345,25,125717336,124794224,923112,27.082304205773514
1747352285684784,124998444,1,1346,25,125815599,124888864,926735,26.97642799721603
1747352285778792,125093084,1,1347,25,125909607,124983504,926103,26.994837507275108
1747352285873118,125187724,1,1348,25,126003933,125078144,925789,27.00399335053668
1747352285971199,125282364,1,1349,25,126102014,125172784,929230,26.90399578145346
1747352286065688,125377004,1,1350,25,126196503,125267424,929079,26.90836839493735
1747352286159519,125471644,1,1351,25,126290334,125362064,928270,26.93181940599179
1747352286254186,125566284,1,1352,25,126385001,125456704,928297,26.93103608004765
1747352286450243,125758684,1,1354,25,126581058,125649104,931954,26.825358333136617
1747352286544980,125853324,1,1355,25,126675795,125743744,932051,26.822566576292505
1747352286639311,125947964,1,1356,25,126770126,125838384,931742,26.83146192830204
1747352286733139,126042604,1,1357,25,126863954,125933024,930930,26.854865564542983
1747352286831926,126137244,1,1358,25,126962741,126027664,935077,26.735766145461817
1747352286925930,126231884,1,1359,25,127056745,126122304,934441,26.75396306454876
1747352287020063,126326524,1,1360,25,127150878,126216944,933934,26.76848685239
1747352287114529,126421164,1,1361,25,127245344,126311584,933760,26.77347498286497
1747352287212749,126515804,1,1362,25,127343564,126406224,937340,26.671218554633324
1747352287305467,126610452,1,1363,25,127436282,126500872,935410,26.72624838306197
1747352287405140,126705084,1,1364,25,127535955,126595504,940451,26.582990501365835
1747352287495156,126799724,1,1365,25,127625971,126690144,935827,26.71433929561768
1747352287593204,126894364,1,1366,25,127724019,126784784,939235,26.617406719298152
1747352287691271,126989004,1,1367,25,127822086,126879424,942662,26.520640484075948
1747352287781748,127083644,1,1368,25,127912563,126974064,938499,26.63828091452415
1747352287879644,127178284,1,1369,25,128010459,127068704,941755,26.54618239350999
1747352287974036,127272924,1,1370,25,128104851,127163344,941507,26.553174856904945
1747352288068043,127367564,1,1371,25,128198858,127257984,940874,26.57103926774468
1747352288162893,127462204,1,1372,25,128293708,127352624,941084,26.565110022059667
1747352288261071,127556844,1,1373,25,128391886,127447264,944622,26.465612700106497
1747352288355005,127651484,1,1374,25,128485820,127541904,943916,26.4854075998288
1747352288449097,127746124,1,1375,25,128579912,127636544,943368,26.50079290372368
1747352288547886,127840764,1,1376,25,128678701,127731184,947517,26.384750880459137
1747352288641966,127935404,1,1377,25,128772781,127825824,946957,26.400353975946107
1747352288736190,128030044,1,1378,25,128867005,127920464,946541,26.411956798490504
1747352288830186,128124684,1,1379,25,128961001,128015104,945897,26.42993898912884
1747352288928048,128219324,1,1380,25,129058863,128109744,949119,26.340216558724457
1747352289022273,128313964,1,1381,25,129153088,128204384,948704,26.35173879313253
1747352289121423,128408612,1,1382,25,129252238,128299032,953206,26.227279307935536
1747352289210998,128503244,1,1383,25,129341813,128393664,948149,26.367163810751265
1747352289309452,128597884,1,1384,25,129440267,128488304,951963,26.261524870189284
1747352289403705,128692524,1,1385,25,129534520,128582944,951576,26.272205267892424
1747352289497938,128787164,1,1386,25,129628753,128677584,951169,26.28344700048046
1747352289595738,128881804,1,1387,25,129726553,128772224,954329,26.19641653978869
1747352289689931,128976444,1,1388,25,129820746,128866864,953882,26.208692479782613
1747352289784064,129071084,1,1389,25,129914879,128961504,953375,26.22263012980202
1747352289879140,129165724,1,1390,25,130009955,129056144,953811,26.210643408390133
1747352289977092,129260364,1,1391,25,130107907,129150784,957123,26.11994487646833
1747352290070877,129355004,1,1392,25,130201692,129245424,956268,26.14329874052044
1747352290165150,129449644,1,1393,25,130295965,129340064,955901,26.153335962615376
1747352290263571,129544284,1,1394,25,130394386,129434704,959682,26.050295827159413
1747352290358072,129638924,1,1395,25,130488887,129529344,959543,26.054069489329816
1747352290455780,129733564,1,1396,25,130586595,129623984,962611,25.97103087332266
1747352290546049,129828204,1,1397,25,130676864,129718624,958240,26.08949741192185
1747352290644968,129922844,1,1398,25,130775783,129813264,962519,25.97351325012805
1747352290738676,130017484,1,1399,25,130869491,129907904,961587,25.998687586250647
1747352290836861,130112124,1,1400,25,130967676,130002544,965132,25.903192516671297
1747352290931498,130206764,1,1401,25,131062313,130097184,965129,25.90327303396748
1747352291025950,130301404,1,1402,25,131156765,130191824,964941,25.908319783282085
1747352291120072,130396044,1,1403,25,131250887,130286464,964423,25.9222353676758
1747352291218143,130490684,1,1404,25,131348958,130381104,967854,25.830342179708925
1747352291311940,130585324,1,1405,25,131442755,130475744,967011,25.8528599984902
1747352291406930,130679964,1,1406,25,131537745,130570384,967361,25.843506198823395
1747352291500120,130774604,1,1407,25,131630935,130665024,965911,25.88230178556824
1747352291595343,130869244,1,1408,25,131726158,130759664,966494,25.866689291397567
1747352291692849,130963884,1,1409,25,131823664,130854304,969360,25.7902120987043
1747352291787409,131058524,1,1410,25,131918224,130948944,969280,25.7923407065038
1747352291885594,131153164,1,1411,25,132016409,131043584,972825,25.698352735589648
1747352291980119,131247804,1,1412,25,132110934,131138224,972710,25.70139095927872
1747352292074269,131342444,1,1413,25,132205084,131232864,972220,25.714344489930262
1747352292172822,131437084,1,1414,25,132303637,131327504,976133,25.611264038814383
1747352292262298,131531724,1,1415,25,132393113,131422144,970969,25.747474945132133
1747352292360519,131626364,1,1416,25,132491334,131516784,974550,25.65286542506798
1747352292459003,131721004,1,1417,25,132589818,131611424,978394,25.55207820162429
1747352292557429,131815644,1,1418,25,132688244,131706064,982180,25.45358284632145
1747352292647848,131910284,1,1419,25,132778663,131800704,977959,25.56344386625615
1747352292745886,132004924,1,1420,25,132876701,131895344,981357,25.474929103272306
1747352292835967,132099564,1,1421,25,132966782,131989984,976798,25.59382799719082
1747352292930096,132194204,1,1422,25,133060911,132084624,976287,25.607224105206768
1747352293028648,132288844,1,1423,25,133159463,132179264,980199,25.505025000025505
1747352293122649,132383484,1,1424,25,133253464,132273904,979560,25.521662787373923
1747352293221170,132478124,1,1425,25,133351985,132368544,983441,25.42094543546588
1747352293315493,132572764,1,1426,25,133446308,132463184,983124,25.429142203831866
1747352293409405,132667412,1,1427,25,133540220,132557832,982388,25.44819358542653
1747352293503646,132762044,1,1428,25,133634461,132652464,981997,25.458326247432527
1747352293597439,132856684,1,1429,25,133728254,132747104,981150,25.48030372522041
1747352293691617,132951324,1,1430,25,133822432,132841744,980688,25.49230744130651
1747352293790470,133045964,1,1431,25,133921285,132936384,984901,25.38326187099008
1747352293888650,133140604,1,1432,25,134019465,133031024,988441,25.292354323626803
1747352293982489,133235244,1,1433,25,134113304,133125664,987640,25.31286703657203
1747352294080511,133329884,1,1434,25,134211326,133220304,991022,25.226483367674987
1747352294171249,133424524,1,1435,25,134302064,133314944,987120,25.326201474997973
1747352294264907,133519164,1,1436,25,134395722,133409584,986138,25.35142140349525
1747352294359641,133613804,1,1437,25,134490456,133504224,986232,25.349005102247748
1747352294457406,133708444,1,1438,25,134588221,133598864,989357,25.2689372996805
1747352294551667,133803084,1,1439,25,134682482,133693504,988978,25.278620960223584
1747352294650696,133897724,1,1440,25,134781511,133788144,993367,25.1669322616918
1747352294744527,133992364,1,1441,25,134875342,133882784,992558,25.18744496543275
1747352294838959,134087004,1,1442,25,134969774,133977424,992350,25.19272434121026
1747352294937262,134181644,1,1443,25,135068077,134072064,996013,25.100073995018136
1747352295030928,134276284,1,1444,25,135161743,134166704,995039,25.124643355687567
1747352295125053,134370924,1,1445,25,135255868,134261344,994524,25.137653792165903
1747352295220034,134465572,1,1446,25,135350849,134355992,994857,25.129239679672555
1747352295317902,134560204,1,1447,25,135448717,134450624,998093,25.047766089933504
1747352295412390,134654844,1,1448,25,135543205,134545264,997941,25.051581205702544
1747352295518569,134752604,1,1449,25,135649384,134643024,1006360,24.84200484915935
1747352295604934,134847244,1,1450,25,135735749,134737664,998085,25.04796685653025
1747352295703135,134941884,1,1451,25,135833950,134832304,1001646,24.958917621594853
1747352295797120,135036524,1,1452,25,135927935,134926944,1000991,24.97524952771803
1747352295890518,135131172,1,1453,25,136021333,135021592,999741,25.006476677459464
1747352295989743,135225804,1,1454,25,136120558,135116224,1004334,24.89211756248419
1747352296083344,135320444,1,1455,25,136214159,135210864,1003295,24.91789553421476
1747352296177578,135415084,1,1456,25,136308393,135305504,1002889,24.92798305694848
1747352296276445,135509724,1,1457,25,136407260,135400144,1007116,24.82335699164744
1747352296366102,135604364,1,1458,25,136496917,135494784,1002133,24.946788500129227
1747352296464214,135699004,1,1459,25,136595029,135589424,1005605,24.860656022991133
1747352296558641,135793644,1,1460,25,136689456,135684064,1005392,24.86592294348871
1747352296652680,135888284,1,1461,25,136783495,135778704,1004791,24.88079610585684
1747352296747364,135982924,1,1462,25,136878179,135873344,1004835,24.87970661849956
1747352296841512,136077564,1,1463,25,136972327,135967984,1004343,24.891894502177045
1747352296943747,136172204,1,1464,25,137074562,136062624,1011938,24.705070864025267
1747352297038444,136266844,1,1465,25,137169259,136157264,1011995,24.70367936600477
1747352297132550,136361484,1,1466,25,137263365,136251904,1011461,24.71672165313344
1747352297226145,136456124,1,1467,25,137356960,136346544,1010416,24.742284366043293
1747352297320138,136550764,1,1468,25,137450953,136441184,1009769,24.75813775229781
1747352297414789,136645404,1,1469,25,137545604,136535824,1009780,24.75786805046644
1747352297513021,136740044,1,1470,25,137643836,136630464,1013372,24.67011127206988
1747352297607257,136834684,1,1471,25,137738072,136725104,1012968,24.679950403171667
1747352297704735,136929324,1,1472,25,137835550,136819744,1015806,24.610998556811044
1747352297799800,137023964,1,1473,25,137930615,136914384,1016231,24.600705941857704
1747352297890509,137118604,1,1474,25,138021324,137009024,1012300,24.696236293588857
1747352297987925,137213244,1,1475,25,138118740,137103664,1015076,24.628697752680587
1747352298082731,137307884,1,1476,25,138213546,137198304,1015242,24.62467076815183
1747352298176515,137402524,1,1477,25,138307330,137292944,1014386,24.645450548410565
1747352298275002,137497164,1,1478,25,138405817,137387584,1018233,24.55233723519077
1747352298368837,137591804,1,1479,25,138499652,137482224,1017428,24.57176330904988
1747352298467082,137686444,1,1480,25,138597897,137576864,1021033,24.48500685090492
1747352298558034,137781084,1,1481,25,138688849,137671504,1017345,24.57376799414161
1747352298655383,137875724,1,1482,25,138786198,137766144,1020054,24.508506412405616
1747352298749489,137970364,1,1483,25,138880304,137860784,1019520,24.52134337727558
1747352298844439,138065004,1,1484,25,138975254,137955424,1019830,24.513889569830265
1747352298937932,138159644,1,1485,25,139068747,138050064,1018683,24.5414913177112
1747352299037217,138254284,1,1486,25,139168032,138144704,1023328,24.43009474967948
1747352299130579,138348924,1,1487,25,139261394,138239344,1022050,24.460642825693466
1747352299228754,138443564,1,1488,25,139359569,138333984,1025585,24.376331557111307
1747352299322953,138538204,1,1489,25,139453768,138428624,1025144,24.386817851931045
1747352299417359,138632844,1,1490,25,139548174,138523264,1024910,24.392385672888352
1747352299516197,138727484,1,1491,25,139647012,138617904,1029108,24.292882768378053
1747352299606212,138822124,1,1492,25,139737027,138712544,1024483,24.40255231175139
1747352299704584,138916764,1,1493,25,139835399,138807184,1028215,24.313981025369205
1747352299798457,139011404,1,1494,25,139929272,138901824,1027448,24.332131650458223
1747352299896991,139106044,1,1495,25,140027806,138996464,1031342,24.24026171725771
1747352400409688,109580,1,1,50,0,0,0,0.0
1747352400589891,288924,1,3,50,180203,179344,859,58207.217694994186
1747352400671489,377324,1,4,50,261801,267744,-5943,0.0
1747352400761928,465724,1,5,50,352240,356144,-3904,0.0
1747352400851490,554124,1,6,50,441802,444544,-2742,0.0
1747352400941624,642524,1,7,50,531936,532944,-1008,0.0
1747352401031542,730924,1,8,50,621854,621344,510,98039.2156862745
1747352401118375,819324,1,9,50,708687,709744,-1057,0.0
1747352401228589,907724,1,10,50,818901,798144,20757,2408.8259382377028
1747352401679229,1370524,1,15,50,1269541,1260944,8597,5815.982319413749
1747352401769466,1461004,1,16,50,1359778,1351424,8354,5985.156811108451
1747352401858946,1551484,1,17,50,1449258,1441904,7354,6799.020940984498
1747352401949840,1641964,1,18,50,1540152,1532384,7768,6436.663233779609
1747352402039263,1732444,1,19,50,1629575,1622864,6711,7450.454477723141
1747352402133515,1822924,1,20,50,1723827,1713344,10483,4769.627015167414
1747352402223528,1913404,1,21,50,1813840,1803824,10016,4992.012779552715
1747352402314275,2003884,1,22,50,1904587,1894304,10283,4862.3942429252165
1747352402408072,2094364,1,23,50,1998384,1984784,13600,3676.470588235294
1747352402498343,2184844,1,24,50,2088655,2075264,13391,3733.8510940183705
1747352402588859,2275324,1,25,50,2179171,2165744,13427,3723.840023832576
1747352402682801,2365804,1,26,50,2273113,2256224,16889,2960.506838770797
1747352402773017,2456284,1,27,50,2363329,2346704,16625,3007.518796992481
1747352402863271,2546764,1,28,50,2453583,2437184,16399,3048.966400390268
1747352402952976,2637244,1,29,50,2543288,2527664,15624,3200.2048131080387
1747352403047217,2727724,1,30,50,2637529,2618144,19385,2579.3139025019345
1747352403133159,2818204,1,31,50,2723471,2708624,14847,3367.6837071462246
1747352403227071,2908684,1,32,50,2817383,2799104,18279,2735.379397122381
1747352403317969,2999164,1,33,50,2908281,2889584,18697,2674.225811627534
1747352403416206,3089644,1,34,50,3006518,2980064,26454,1890.073334845392
1747352403497172,3180124,1,35,50,3087484,3070544,16940,2951.59386068477
1747352403592018,3270604,1,36,50,3182330,3161024,21306,2346.7567821271005
1747352403689833,3361084,1,37,50,3280145,3251504,28641,1745.7491009392131
1747352403776575,3451564,1,38,50,3366887,3341984,24903,2007.79022607718
1747352403866253,3542052,1,39,50,3456565,3432472,24093,2075.291578466775
1747352403960169,3632524,1,40,50,3550481,3522944,27537,1815.7388241275376
1747352404046427,3723004,1,41,50,3636739,3613424,23315,2144.542140253056
1747352404140062,3813484,1,42,50,3730374,3703904,26470,1888.930865130336
1747352404230718,3903964,1,43,50,3821030,3794384,26646,1876.4542520453351
1747352404320899,3994444,1,44,50,3911211,3884864,26347,1897.7492693665315
1747352404419107,4084924,1,45,50,4009419,3975344,34075,1467.3514306676448
1747352404505256,4175404,1,46,50,4095568,4065824,29744,1681.0112963959118
1747352404591437,4265884,1,47,50,4181749,4156304,25445,1965.0225977598743
1747352404685190,4356364,1,48,50,4275502,4246784,28718,1741.068319520858
1747352404783807,4446844,1,49,50,4374119,4337264,36855,1356.66802333469
1747352404869843,4537324,1,50,50,4460155,4427744,32411,1542.686125080991
1747352404955100,4627804,1,51,50,4545412,4518224,27188,1839.0466382227453
1747352405057607,4718284,1,52,50,4647919,4608704,39215,1275.0223128904756
1747352405156019,4808764,1,53,50,4746331,4699184,47147,1060.5128640210403
1747352405238803,4899244,1,54,50,4829115,4789664,39451,1267.3949963245543
1747352405328587,4989724,1,55,50,4918899,4880144,38755,1290.1561088891756
1747352405426573,5080204,1,56,50,5016885,4970624,46261,1080.8240202330255
1747352405521068,5170684,1,57,50,5111380,5061104,50276,994.5103031267404
1747352405615067,5261164,1,58,50,5205379,5151584,53795,929.4544102611768
1747352405693060,5351644,1,59,50,5283372,5242064,41308,1210.4192892417934
1747352405782871,5442124,1,60,50,5373183,5332544,40639,1230.3452348729054
1747352405869050,5532604,1,61,50,5459362,5423024,36338,1375.9700588915184
1747352405959083,5623084,1,62,50,5549395,5513504,35891,1393.106907024045
1747352406052819,5713564,1,63,50,5643131,5603984,39147,1277.2370807469283
1747352406143843,5804052,1,64,50,5734155,5694472,39683,1259.9853841695435
1747352406237643,5894524,1,65,50,5827955,5784944,43011,1162.493315663435
1747352406331685,5985004,1,66,50,5921997,5875424,46573,1073.583406694866
1747352406418179,6075484,1,67,50,6008491,5965904,42587,1174.0672036067344
1747352406516221,6165964,1,68,50,6106533,6056384,50149,997.0288540150352
1747352406601720,6256444,1,69,50,6192032,6146864,45168,1106.9783917817924
1747352406704854,6346924,1,70,50,6295166,6237344,57822,864.7227698799765
1747352406786050,6437404,1,71,50,6376362,6327824,48538,1030.1207301495735
1747352406880828,6527884,1,72,50,6471140,6418304,52836,946.3244757362404
1747352407159473,6805564,1,75,50,6749785,6695984,53801,929.3507555621644
1747352407253131,6896044,1,76,50,6843443,6786464,56979,877.5162779269555
1747352407360163,6986524,1,77,50,6950475,6876944,73531,679.9853123172539
1747352407445534,7077004,1,78,50,7035846,6967424,68422,730.7591125661337
1747352407531941,7167484,1,79,50,7122253,7057904,64349,777.0128517925687
1747352407609456,7257964,1,80,50,7199768,7148384,51384,973.065545695158
1747352407699899,7348444,1,81,50,7290211,7238864,51347,973.7667244434924
1747352407793598,7438924,1,82,50,7383910,7329344,54566,916.3215188945496
1747352407884199,7529404,1,83,50,7474511,7419824,54687,914.2940735458152
1747352407973757,7619884,1,84,50,7564069,7510304,53765,929.9730307821072
1747352408064193,7710364,1,85,50,7654505,7600784,53721,930.7347219895386
1747352408157870,7800852,1,86,50,7748182,7691272,56910,878.5802143735723
1747352408265419,7891324,1,87,50,7855731,7781744,73987,675.7943963128658
1747352408338791,7981804,1,88,50,7929103,7872224,56879,879.0590551873275
1747352408429237,8072284,1,89,50,8019549,7962704,56845,879.5848359574281
1747352408522886,8162764,1,90,50,8113198,8053184,60014,833.1389342486754
1747352408613389,8253244,1,91,50,8203701,8143664,60037,832.8197611472925
1747352408703360,8343724,1,92,50,8293672,8234144,59528,839.9408681628813
1747352408813208,8434204,1,93,50,8403520,8324624,78896,633.7456905293044
1747352408891286,8524684,1,94,50,8481598,8415104,66494,751.9475441393208
1747352408977187,8615164,1,95,50,8567499,8505584,61915,807.5587498990552
1747352409067623,8705644,1,96,50,8657935,8596064,61871,808.1330510255208
1747352409161854,8796124,1,97,50,8752166,8686544,65622,761.9395934290329
1747352409248005,8886604,1,98,50,8838317,8777024,61293,815.7538381218084
1747352409354317,8977084,1,99,50,8944629,8867504,77125,648.2982171799027
1747352409432384,9067564,1,100,50,9022696,8957984,64712,772.6542217826677
1747352409530371,9159084,1,101,50,9120683,9049504,71179,702.4543755883054
1747352409620815,9250604,1,102,50,9211127,9141024,70103,713.2362381067858
1747352409714547,9342124,1,103,50,9304859,9232544,72315,691.4194842010647
1747352409813564,9433644,1,104,50,9403876,9324064,79812,626.472209692778
1747352409895066,9525164,1,105,50,9485378,9415584,69794,716.3939593661347
1747352409992911,9616684,1,106,50,9583223,9507104,76119,656.8662226251001
1747352410091860,9708204,1,107,50,9682172,9598624,83548,598.4583712356969
1747352410178057,9799724,1,108,50,9768369,9690144,78225,639.1818472355385
1747352410271861,9891244,1,109,50,9862173,9781664,80509,621.048578419804
1747352410362158,9982764,1,110,50,9952470,9873184,79286,630.6283580960069
1747352410464475,10074284,1,111,50,10054787,9964704,90083,555.0436819377685
1747352410558257,10166844,1,112,50,10148569,10057264,91305,547.6151360823613
1747352410636500,10259404,1,113,50,10226812,10149824,76988,649.451862627942
1747352410746731,10351964,1,114,50,10337043,10242384,94659,528.2117918000401
1747352410836968,10444524,1,115,50,10427280,10334944,92336,541.5006064806793
1747352410914495,10537084,1,116,50,10504807,10427504,77303,646.8054279911518
1747352411021801,10629644,1,117,50,10612113,10520064,92049,543.1889537094373
1747352411123289,10722204,1,118,50,10713601,10612624,100977,495.1622646741337
1747352411201800,10814764,1,119,50,10792112,10705184,86928,575.188661881097
1747352411287549,10907324,1,120,50,10877861,10797744,80117,624.0872723641675
1747352411385850,10999884,1,121,50,10976162,10890304,85858,582.3569149060075
1747352411479655,11092444,1,122,50,11069967,10982864,87103,574.0330413418596
1747352411570146,11185004,1,123,50,11160458,11075424,85034,588.0000940800151
1747352411660264,11277564,1,124,50,11250576,11167984,82592,605.3855094924448
1747352411766446,11370124,1,125,50,11356758,11260544,96214,519.6748913879477
1747352411857264,11462692,1,126,50,11447576,11353112,94464,529.3021680216801
1747352411942572,11555244,1,127,50,11532884,11445664,87220,573.2630130703967
1747352412040513,11647804,1,128,50,11630825,11538224,92601,539.9509724517013
1747352412127161,11740364,1,129,50,11717473,11630784,86689,576.7744465849185
1747352412221844,11832924,1,130,50,11812156,11723344,88812,562.9869837409359
1747352412339957,11925484,1,131,50,11930269,11815904,114365,437.1966947929874
1747352412409634,12018044,1,132,50,11999946,11908464,91482,546.5556065674122
1747352412500066,12110604,1,133,50,12090378,12001024,89354,559.57203930434
1747352412594223,12203164,1,134,50,12184535,12093584,90951,549.7465668326901
1747352412700121,12295724,1,135,50,12290433,12186144,104289,479.43694924680455
1747352412782829,12388284,1,136,50,12373141,12278704,94437,529.453498099262
1747352412892891,12480844,1,137,50,12483203,12371264,111939,446.6718480601042
1747352412970931,12573404,1,138,50,12561243,12463824,97419,513.2469025549431
1747352413057270,12665964,1,139,50,12647582,12556384,91198,548.2576372288866
1747352413159259,12758524,1,140,50,12749571,12648944,100627,496.8845339719956
1747352413269995,12851084,1,141,50,12860307,12741504,118803,420.8647929766083
1747352413343402,12943644,1,142,50,12933714,12834064,99650,501.7561465127948
1747352413528067,13131884,1,144,50,13118379,13022304,96075,520.4267499349467
1747352413630709,13224444,1,145,50,13221021,13114864,106157,471.0004992605292
1747352413729066,13317004,1,146,50,13319378,13207424,111954,446.6120013577005
1747352413811030,13409564,1,147,50,13401342,13299984,101358,493.3009727895183
1747352413909257,13502124,1,148,50,13499569,13392544,107025,467.1805652884841
1747352414007468,13594684,1,149,50,13597780,13485104,112676,443.7502218751109
1747352414100939,13687244,1,150,50,13691251,13577664,113587,440.1912190655621
1747352414183688,13779804,1,151,50,13774000,13670224,103776,481.8069688559976
1747352414281951,13872364,1,152,50,13872263,13762784,109479,456.70859251545954
1747352414372175,13964924,1,153,50,13962487,13855344,107143,466.66604444527405
1747352414465624,14057492,1,154,50,14055936,13947912,108024,462.8601051618159
1747352414568536,14150044,1,155,50,14158848,14040464,118384,422.3543722124612
1747352414761119,14338284,1,157,50,14351431,14228704,122727,407.4083127592135
1747352414850330,14430844,1,158,50,14440642,14321264,119378,418.8376417765418
1747352415047826,14619084,1,160,50,14638138,14509504,128634,388.6997216909993
1747352415232001,14807324,1,162,50,14822313,14697744,124569,401.3839719352327
1747352415318219,14899884,1,163,50,14908531,14790304,118227,422.915239327734
1747352415600474,15183804,1,166,50,15190786,15074224,116562,428.9562636193614
1747352415887834,15467724,1,169,50,15478146,15358144,120002,416.65972233796106
1747352416173604,15751644,1,172,50,15763916,15642064,121852,410.3338476184224
1747352416288248,15844204,1,173,50,15878560,15734624,143936,347.3766118274789
1747352416550920,16128124,1,176,50,16141232,16018544,122688,407.5378195096505
1747352416849558,16412044,1,179,50,16439870,16302464,137406,363.88512874255855
1747352426753414,26263964,1,282,50,26343726,26154384,189342,264.07241922024696
1747352426847250,26356524,1,283,50,26437562,26246944,190618,262.3047141403225
1747352426941602,26449084,1,284,50,26531914,26339504,192410,259.8617535471129
1747352427035687,26541644,1,285,50,26625999,26432064,193935,257.81834119679274
1747352427125423,26634204,1,286,50,26715735,26524624,191111,261.62805908608084
1747352427219906,26726764,1,287,50,26810218,26617184,193034,259.0217267424391
1747352427314478,26819324,1,288,50,26904790,26709744,195046,256.3497841534817
1747352427408053,26911884,1,289,50,26998365,26802304,196061,255.0226715154977
1747352427498234,27004444,1,290,50,27088546,26894864,193682,258.155120248655
1747352427592314,27097004,1,291,50,27182626,26987424,195202,256.1449165479862
1747352427686738,27189564,1,292,50,27277050,27079984,197066,253.7221032547472
1747352427780742,27282124,1,293,50,27371054,27172544,198510,251.87647977431868
1747352427874627,27374684,1,294,50,27464939,27265104,199835,250.2064202967448
1747352427964888,27467244,1,295,50,27555200,27357664,197536,253.1184189211081
1747352428059486,27559804,1,296,50,27649798,27450224,199574,250.5336366460561
1747352428153165,27652364,1,297,50,27743477,27542784,200693,249.1367411917705
1747352428247274,27744924,1,298,50,27837586,27635344,202242,247.22856775546128
1747352428338179,27837484,1,299,50,27928491,27727904,200587,249.26839725405927
1747352428432564,27930044,1,300,50,28022876,27820464,202412,247.0209276129873
1747352428526293,28022604,1,301,50,28116605,27913024,203581,245.602487461993
1747352428620914,28115164,1,302,50,28211226,28005584,205642,243.1409925987882
1747352428710252,28207724,1,303,50,28300564,28098144,202420,247.0111649046537
1747352428804365,28300284,1,304,50,28394677,28190704,203973,245.1304829560776
1747352428899119,28392844,1,305,50,28489431,28283264,206167,242.52183909161025
1747352428993147,28485404,1,306,50,28583459,28375824,207635,240.8071856864209
1747352429083014,28577964,1,307,50,28673326,28468384,204942,243.9714650974421
1747352429177546,28670524,1,308,50,28767858,28560944,206914,241.6462878297264
1747352429271661,28763084,1,309,50,28861973,28653504,208469,239.84381370851304
1747352435243575,34692132,1,371,50,34833887,34582552,251335,198.93767282710328
1747352435337091,34784684,1,372,50,34927403,34675104,252299,198.17755916591028
1747352435431371,34877244,1,373,50,35021683,34767664,254019,196.83566977273355
1747352435526086,34969804,1,374,50,35116398,34860224,256174,195.17983870338128
1747352435906871,35349404,1,378,50,35497183,35239824,257359,194.28114035258145
1747352436001287,35441964,1,379,50,35591599,35332384,259215,192.8900719479969
1747352436090990,35534524,1,380,50,35681302,35424944,256358,195.0397491008668
1747352436185089,35627084,1,381,50,35775401,35517504,257897,193.8758496609112
1747352436280014,35719644,1,382,50,35870326,35610064,260262,192.11410040651344
1747352436372984,35812204,1,383,50,35963296,35702624,260672,191.8119322366805
1747352436463858,35904764,1,384,50,36054170,35795184,258986,193.0606287598557
1747352436557675,35997324,1,385,50,36147987,35887744,260243,192.1281264049369
1747352436652116,36089892,1,386,50,36242428,35980312,262116,190.75523813883927
1747352436746424,36182444,1,387,50,36336736,36072864,263872,189.4858113024497
1747352436840995,36275004,1,388,50,36431307,36165424,265883,188.0526396949034
1747352436931000,36367564,1,389,50,36521312,36257984,263328,189.87726333697896
1747352437024551,36460124,1,390,50,36614863,36350544,264319,189.16536457840712
1747352437119853,36552684,1,391,50,36710165,36443104,267061,187.22314377614103
1747352437212776,36645244,1,392,50,36803088,36535664,267424,186.96900801723103
1747352437303214,36737804,1,393,50,36893526,36628224,265302,188.4644669094089
1747352437397603,36830364,1,394,50,36987915,36720784,267131,187.1740831277538
1747352437492312,36922924,1,395,50,37082624,36813344,269280,185.68033273915623
1747352437586546,37015484,1,396,50,37176858,36905904,270954,184.5331679916148
1747352437676445,37108044,1,397,50,37266757,36998464,268293,186.3634161159628
1747352437770421,37200604,1,398,50,37360733,37091024,269709,185.38498900667017
1747352437863971,37293164,1,399,50,37454283,37183584,270699,184.70699928703087
1747352437958579,37385724,1,400,50,37548891,37276144,272747,183.3200731813732
1747352438048662,37478284,1,401,50,37638974,37368704,270270,185.00018500018496
1747352438142929,37570844,1,402,50,37733241,37461264,271977,183.83907462763395
1747352438236989,37663404,1,403,50,37827301,37553824,273477,182.8307316520219
1747352438332218,37755964,1,404,50,37922530,37646384,276146,181.06364024827445
1747352438425500,37848524,1,405,50,38015812,37738944,276868,180.5914731930017
1747352438515676,37941084,1,406,50,38105988,37831504,274484,182.15998018099413
1747352438610328,38033644,1,407,50,38200640,37924064,276576,180.7821358324656
1747352438704086,38126204,1,408,50,38294398,38016624,277774,180.00244803329323
1747352438799036,38218772,1,409,50,38389348,38109192,280156,178.4719941746741
1747352438888162,38311324,1,410,50,38478474,38201744,276730,180.6815307339284
1747352438982768,38403884,1,411,50,38573080,38294304,278776,179.35546818951414
1747352439076891,38496444,1,412,50,38667203,38386864,280339,178.35549103050235
1747352439171264,38589004,1,413,50,38761576,38479424,282152,177.20944739005924
1747352439260845,38681564,1,414,50,38851157,38571984,279173,179.100414438359
1747352439355131,38774124,1,415,50,38945443,38664544,280899,177.99992168003445
1747352439449692,38866684,1,416,50,39040004,38757104,282900,176.74089784376105
1747352439543431,38959244,1,417,50,39133743,38849664,284079,176.00737822929537
1747352439638152,39051804,1,418,50,39228464,38942224,286240,174.678591391839
1747352439728145,39144364,1,419,50,39318457,39034784,283673,176.2592844578088
1747352439822159,39236924,1,420,50,39412471,39127344,285127,175.36045341198832
1747352439917021,39329484,1,421,50,39507333,39219904,287429,173.95600304770915
1747352440010883,39422044,1,422,50,39601195,39312464,288731,173.1715679992796
1747352440100813,39514604,1,423,50,39691125,39405024,286101,174.76345766005713
1747352440195049,39607164,1,424,50,39785361,39497584,287777,173.74564332799355
1747352440288863,39699724,1,425,50,39879175,39590144,289031,172.99182440637856
1747352440383803,39792284,1,426,50,39974115,39682704,291411,171.57897265374336
1747352440473554,39884844,1,427,50,40063866,39775264,288602,173.24897263359227
1747352440567925,39977404,1,428,50,40158237,39867824,290413,172.1686012678496
1747352440661639,40069964,1,429,50,40251951,39960384,291567,171.48717104473414
1747352440756127,40162524,1,430,50,40346439,40052944,293495,170.36065350346684
1747352440846524,40255084,1,431,50,40436836,40145504,291332,171.62549943020335
1747352440939951,40347644,1,432,50,40530263,40238064,292199,171.1162598092396
1747352441035221,40440204,1,433,50,40625533,40330624,294909,169.54382538342338
1747352441129172,40532764,1,434,50,40719484,40423184,296300,168.74789065136684
1747352441223465,40625324,1,435,50,40813777,40515744,298033,167.76665671251172
1747352441312790,40717884,1,436,50,40903102,40608304,294798,169.60766355266995
1747352441407670,40810444,1,437,50,40997982,40700864,297118,168.28330831521484
1747352441501416,40903004,1,438,50,41091728,40793424,298304,167.61424586998498
1747352441595841,40995564,1,439,50,41186153,40885984,300169,166.57283063874016
1747352441685504,41088124,1,440,50,41275816,40978544,297272,168.19613014343767
1747352441779930,41180684,1,441,50,41370242,41071104,299138,167.146935528084
1747352441874352,41273244,1,442,50,41464664,41163664,301000,166.11295681063123
1747352441968423,41365804,1,443,50,41558735,41256224,302511,165.28324589849626
1747352442059063,41458364,1,444,50,41649375,41348784,300591,166.33897887827646
1747352442152490,41550924,1,445,50,41742802,41441344,301458,165.86058422732188
1747352442246637,41643484,1,446,50,41836949,41533904,303045,164.99199788810242
1747352442341102,41736044,1,447,50,41931414,41626464,304950,163.96130513198884
1747352442431106,41828604,1,448,50,42021418,41719024,302394,165.34719604224952
1747352442525917,41921164,1,449,50,42116229,41811584,304645,164.12545749971278
1747352442620026,42013732,1,450,50,42210338,41904152,306186,163.29943237117308
1747352442713393,42106284,1,451,50,42303705,41996704,307001,162.86591900352116
1747352442808169,42198844,1,452,50,42398481,42089264,309217,161.69874230718233
1747352442898643,42291404,1,453,50,42488955,42181824,307131,162.79698239513434
1747352442992790,42383964,1,454,50,42583102,42274384,308718,161.96010598669335
1747352443086517,42476524,1,455,50,42676829,42366944,309885,161.350178291947
1747352443180816,42569084,1,456,50,42771128,42459504,311624,160.4497728031217
1747352443271336,42661644,1,457,50,42861648,42552064,309584,161.50705462814614
1747352443365494,42754204,1,458,50,42955806,42644624,311182,160.677674158531
1747352443458908,42846764,1,459,50,43049220,42737184,312036,160.237921265495
1747352443552961,42939324,1,460,50,43143273,42829744,313529,159.47488111147612
1747352443643175,43031884,1,461,50,43233487,42922304,311183,160.67715781389086
1747352443738301,43124444,1,462,50,43328613,43014864,313749,159.3630577308613
1747352443831832,43217004,1,463,50,43422144,43107424,314720,158.8713777325877
1747352443925913,43309564,1,464,50,43516225,43199984,316241,158.10726629374432
1747352444016101,43402124,1,465,50,43606413,43292544,313869,159.30212923225932
1747352444110705,43494684,1,466,50,43701017,43385104,315913,158.27142282843695
1747352444204702,43587244,1,467,50,43795014,43477664,317350,157.5547502757208
1747352444299234,43679804,1,468,50,43889546,43570224,319322,156.5817575989127
1747352444393125,43772364,1,469,50,43983437,43662784,320653,155.9318016672228
1747352444483717,43864924,1,470,50,44074029,43755344,318685,156.89473931939062
1747352444577782,43957484,1,471,50,44168094,43847904,320190,156.15728161404166
1747352444671976,44050044,1,472,50,44262288,43940464,321824,155.36442279009646
1747352444765510,44142612,1,473,50,44355822,44033032,322790,154.89947024381175
1747352444856336,44235164,1,474,50,44446648,44125584,321064,155.73219046669823
1747352444949635,44327724,1,475,50,44539947,44218144,321803,155.3745614553003
1747352445043987,44420284,1,476,50,44634299,44310704,323595,154.5141303172175
1747352445138483,44512844,1,477,50,44728795,44403264,325531,153.59520291462258
1747352445228344,44605404,1,478,50,44818656,44495824,322832,154.87931803538683
1747352445322905,44697964,1,479,50,44913217,44588384,324833,153.92524774268625
1747352445417520,44790524,1,480,50,45007832,44680944,326888,152.95758792002152
1747352445511509,44883084,1,481,50,45101821,44773504,328317,152.29183989863455
1747352445601217,44975644,1,482,50,45191529,44866064,325465,153.62634999155054
1747352445695258,45068204,1,483,50,45285570,44958624,326946,152.9304533470359
1747352445789423,45160764,1,484,50,45379735,45051184,328551,152.18337487939468
1747352445883969,45253324,1,485,50,45474281,45143744,330537,151.26899560412298
1747352445978154,45345884,1,486,50,45568466,45236304,332162,150.52895876108644
1747352446067714,45438444,1,487,50,45658026,45328864,329162,151.90088770878776
1747352446162942,45531004,1,488,50,45753254,45421424,331830,150.6795648374167
1747352446257035,45623564,1,489,50,45847347,45513984,333363,149.98665118804425
1747352446350513,45716124,1,490,50,45940825,45606544,334281,149.57475896027594
1747352446441364,45808684,1,491,50,46031676,45699104,332572,150.34338428971773
1747352446535346,45901244,1,492,50,46125658,45791664,333994,149.70328808301946
1747352446629348,45993804,1,493,50,46219660,45884224,335436,149.05973121549266
1747352446723438,46086364,1,494,50,46313750,45976784,336966,148.38292290616857
1747352446813922,46178924,1,495,50,46404234,46069344,334890,149.30275612887812
1747352446907390,46271484,1,496,50,46497702,46161904,335798,148.89904049458306
1747352447002052,46364044,1,497,50,46592364,46254464,337900,147.9727730097662
1747352447096617,46456604,1,498,50,46686929,46347024,339905,147.09992497903826
1747352447186415,46549164,1,499,50,46776727,46439584,337143,148.3050219046517
1747352447280971,46641724,1,500,50,46871283,46532144,339139,147.43217382843022
1747352447375151,46734284,1,501,50,46965463,46624704,340759,146.7312675527279
1747352447469427,46826844,1,502,50,47059739,46717264,342475,145.99605810643115
1747352447563654,46919404,1,503,50,47153966,46809824,344142,145.28886331804895
1747352447653751,47011964,1,504,50,47244063,46902384,341679,146.33618103541627
1747352447747518,47104524,1,505,50,47337830,46994944,342886,145.8210600607782
1747352447841676,47197084,1,506,50,47431988,47087504,344484,145.1446221014619
1747352447935473,47289644,1,507,50,47525785,47180064,345721,144.62529033527034
1747352448026210,47382204,1,508,50,47616522,47272624,343898,145.39194761237346
1747352448120154,47474764,1,509,50,47710466,47365184,345282,144.80917047514785
1747352448214516,47567324,1,510,50,47804828,47457744,347084,144.05734634843438
1747352448308224,47659884,1,511,50,47898536,47550304,348232,143.58243929334466
1747352448399034,47752444,1,512,50,47989346,47642864,346482,144.30764080096512
1747352448492747,47845004,1,513,50,48083059,47735424,347635,143.8290160657011
1747352448587349,47937572,1,514,50,48177661,47827992,349669,142.99237278683557
1747352448681750,48030124,1,515,50,48272062,47920544,351518,142.24022667402522
1747352448771494,48122684,1,516,50,48361806,48013104,348702,143.38891087518854
1747352448865530,48215244,1,517,50,48455842,48105664,350178,142.7845267264077
1747352448959845,48307804,1,518,50,48550157,48198224,351933,142.07249675364346
1747352449054383,48400364,1,519,50,48644695,48290784,353911,141.2784570132039
1747352449148655,48492924,1,520,50,48738967,48383344,355623,140.5983302542299
1747352449238647,48585484,1,521,50,48828959,48475904,353055,141.62099389613516
1747352449332177,48678044,1,522,50,48922489,48568464,354025,141.2329637737448
1747352449426534,48770604,1,523,50,49016846,48661024,355822,140.51969805127283
1747352449520788,48863164,1,524,50,49111100,48753584,357516,139.85388066548072
1747352449610899,48955724,1,525,50,49201211,48846144,355067,140.81849341110268
1747352449705179,49048284,1,526,50,49295491,48938704,356787,140.13963513244596
1747352449799901,49140844,1,527,50,49390213,49031264,358949,139.29555452167298
1747352449893229,49233404,1,528,50,49483541,49123824,359717,138.9981568844397
1747352449983425,49325964,1,529,50,49573737,49216384,357353,139.91767244153542
1747352450078366,49418524,1,530,50,49668678,49308944,359734,138.99158822908038
1747352450172022,49511084,1,531,50,49762334,49401504,360830,138.56940941717707
1747352450266698,49603644,1,532,50,49857010,49494064,362946,137.76154028422962
1747352450360719,49696204,1,533,50,49951031,49586624,364407,137.20921936186738
1747352450450941,49788764,1,534,50,50041253,49679184,362069,138.09522494331193
1747352450545127,49881324,1,535,50,50135439,49771744,363695,137.47783169963844
1747352450639126,49973884,1,536,50,50229438,49864304,365134,136.93602896470884
1747352450733530,50066452,1,537,50,50323842,49956872,366970,136.2509196937079
1747352450823339,50159004,1,538,50,50413651,50049424,364227,137.27702778761596
1747352450917665,50251564,1,539,50,50507977,50141984,365993,136.61463470612824
1747352451011924,50344124,1,540,50,50602236,50234544,367692,135.9833773919476
1747352451105877,50436684,1,541,50,50696189,50327104,369085,135.4701491526342
1747352451195920,50529244,1,542,50,50786232,50419664,366568,136.40034045524976
1747352451289946,50621804,1,543,50,50880258,50512224,368034,135.85701321073597
1747352451384227,50714364,1,544,50,50974539,50604784,369755,135.22467579883977
1747352451478778,50806924,1,545,50,51069090,50697344,371746,134.50043847142942
1747352451569175,50899484,1,546,50,51159487,50789904,369583,135.28760792568923
1747352451663249,50992044,1,547,50,51253561,50882464,371097,134.73566210451713
1747352451757558,51084604,1,548,50,51347870,50975024,372846,134.10362455276442
1747352451851324,51177164,1,549,50,51441636,51067584,374052,133.671254264113
1747352451945787,51269724,1,550,50,51536099,51160144,375955,132.99464031599527
1747352452035846,51362284,1,551,50,51626158,51252704,373454,133.88529778767935
1747352452129532,51454844,1,552,50,51719844,51345264,374580,133.48283410753376
1747352452224094,51547404,1,553,50,51814406,51437824,376582,132.77320742892653
1747352452317824,51639964,1,554,50,51908136,51530384,377752,132.3619729346238
1747352452408501,51732524,1,555,50,51998813,51622944,375869,133.02506990467424
1747352452502912,51825084,1,556,50,52093224,51715504,377720,132.37318648734512
1747352452596862,51917644,1,557,50,52187174,51808064,379110,131.8878425786711
1747352452691074,52010204,1,558,50,52281386,51900624,380762,131.31562498358556
1747352452781104,52102764,1,559,50,52371416,51993184,378232,132.193997334969
1747352452874943,52195324,1,560,50,52465255,52085744,379511,131.7484868686283
1747352452969083,52287884,1,561,50,52559395,52178304,381091,131.20225877808713
1747352453064102,52380444,1,562,50,52654414,52270864,383550,130.3611002476861
1747352453153939,52473004,1,563,50,52744251,52363424,380827,131.29321187835944
1747352453248465,52565564,1,564,50,52838777,52455984,382793,130.61889846470547
1747352453341904,52658124,1,565,50,52932216,52548544,383672,130.3196480326946
1747352453435980,52750684,1,566,50,53026292,52641104,385188,129.80674371994974
1747352453530049,52843244,1,567,50,53120361,52733664,386697,129.30020144971385
1747352453621058,52935804,1,568,50,53211370,52826224,385146,129.82089908761873
1747352453714979,53028364,1,569,50,53305291,52918784,386507,129.36376314012423
1747352453808791,53120924,1,570,50,53399103,53011344,387759,128.9460721736955
1747352453903316,53213484,1,571,50,53493628,53103904,389724,128.29592224240744
1747352453993495,53306044,1,572,50,53583807,53196464,387343,129.08455813064907
1747352454088129,53398604,1,573,50,53678441,53289024,389417,128.3970653566742
1747352454181929,53491164,1,574,50,53772241,53381584,390657,127.9895150989231
1747352454275948,53583724,1,575,50,53866260,53474144,392116,127.51328688449335
1747352454366598,53676284,1,576,50,53956910,53566704,390206,128.13744534937956
1747352454459969,53768844,1,577,50,54050281,53659264,391017,127.8716782134792
1747352454554512,53861412,1,578,50,54144824,53751832,392992,127.22905300871264
1747352454648284,53953964,1,579,50,54238596,53844384,394212,126.83530689070857
1747352454739263,54046524,1,580,50,54329575,53936944,392631,127.34603227967226
1747352454833697,54139084,1,581,50,54424009,54029504,394505,126.74110594289046
1747352454927374,54231644,1,582,50,54517686,54122064,395622,126.3832648336038
1747352455021120,54324204,1,583,50,54611432,54214624,396808,126.00552408217575
1747352455115357,54416764,1,584,50,54705669,54307184,398485,125.4752374618869
1747352455205801,54509324,1,585,50,54796113,54399744,396369,126.14508198168878
1747352455299732,54601884,1,586,50,54890044,54492304,397740,125.71026298587016
1747352455393998,54694444,1,587,50,54984310,54584864,399446,125.17336511067828
1747352455488314,54787004,1,588,50,55078626,54677424,401202,124.625500371384
1747352455578169,54879564,1,589,50,55168481,54769984,398497,125.47145900721964
1747352455673066,54972124,1,590,50,55263378,54862544,400834,124.73991727248686
1747352455766754,55064684,1,591,50,55357066,54955104,401962,124.38986769893673
1747352455860859,55157244,1,592,50,55451171,55047664,403507,123.91358762053694
1747352455951530,55249804,1,593,50,55541842,55140224,401618,124.4964120134058
1747352456045583,55342364,1,594,50,55635895,55232784,403111,124.03531533498216
1747352456139777,55434924,1,595,50,55730089,55325344,404745,123.53457114973624
1747352456233759,55527484,1,596,50,55824071,55417904,406167,123.10207377753486
1747352456323663,55620044,1,597,50,55913975,55510464,403511,123.91235926653796
1747352456418134,55712604,1,598,50,56008446,55603024,405422,123.32828509553008
1747352456512619,55805164,1,599,50,56102931,55695584,407347,122.7454725332456
1747352456606650,55897724,1,600,50,56196962,55788144,408818,122.30381245444184
1747352456700974,55990292,1,601,50,56291286,55880712,410574,121.780726495102
1747352456790491,56082844,1,602,50,56380803,55973264,407539,122.6876446180611
1747352456885317,56175404,1,603,50,56475629,56065824,409805,122.00924830102124
1747352456979338,56267964,1,604,50,56569650,56158384,411266,121.5758171110668
1747352457073482,56360524,1,605,50,56663794,56250944,412850,121.10936175366356
1747352457163571,56453084,1,606,50,56753883,56343504,410379,121.83859310539768
1747352457257861,56545644,1,607,50,56848173,56436064,412109,121.32712461994278
1747352457352079,56638204,1,608,50,56942391,56528624,413767,120.8409563836652
1747352457446086,56730764,1,609,50,57036398,56621184,415214,120.4198317012432
1747352457535970,56823324,1,610,50,57126282,56713744,412538,121.20095603314118
1747352457629881,56915884,1,611,50,57220193,56806304,413889,120.80533669655392
1747352457724717,57008444,1,612,50,57315029,56898864,416165,120.14465416361298
1747352457818698,57101004,1,613,50,57409010,56991424,417586,119.73581489800902
1747352457909419,57193564,1,614,50,57499731,57083984,415747,120.26544990102154
1747352458002628,57286124,1,615,50,57592940,57176544,416396,120.0780026705348
1747352458097037,57378684,1,616,50,57687349,57269104,418245,119.54715537543784
1747352458191709,57471244,1,617,50,57782021,57361664,420357,118.94651451028533
1747352458285642,57563804,1,618,50,57875954,57454224,421730,118.5592677779622
1747352458375781,57656364,1,619,50,57966093,57546784,419309,119.24380349575137
1747352458470424,57748924,1,620,50,58060736,57639344,421392,118.6543645821468
1747352458564203,57841484,1,621,50,58154515,57731904,422611,118.3121120841625
1747352458658525,57934044,1,622,50,58248837,57824464,424373,117.82087927365784
1747352458748888,58026604,1,623,50,58339200,57917024,422176,118.43401803986964
1747352458843099,58119164,1,624,50,58433411,58009584,423827,117.97266337444287
1747352458936786,58211724,1,625,50,58527098,58102144,424954,117.65979376591348
1747352459031356,58304284,1,626,50,58621668,58194704,426964,117.10589183162983
1747352459121322,58396844,1,627,50,58711634,58287264,424370,117.82171218512148
1747352459215500,58489404,1,628,50,58805812,58379824,425988,117.37419833422538
1747352459309790,58581964,1,629,50,58900102,58472384,427718,116.89945244296476
1747352459403636,58674524,1,630,50,58993948,58564944,429004,116.54902984587557
1747352459493659,58767084,1,631,50,59083971,58657504,426467,117.24236576335332
1747352459588047,58859644,1,632,50,59178359,58750064,428295,116.74196523424276
1747352459682628,58952204,1,633,50,59272940,58842624,430316,116.1936809228567
1747352459776845,59044764,1,634,50,59367157,58935184,431973,115.74797498917756
1747352459870732,59137324,1,635,50,59461044,59027744,433300,115.39349180706208
1747352459960829,59229884,1,636,50,59551141,59120304,430837,116.05317092078906
1747352460054755,59322444,1,637,50,59645067,59212864,432203,115.68637885438092
1747352460148774,59415004,1,638,50,59739086,59305424,433662,115.2971669180145
1747352460243655,59507564,1,639,50,59833967,59397984,435983,114.68337068188438
1747352460333779,59600124,1,640,50,59924091,59490544,433547,115.32774993253328
1747352460427681,59692684,1,641,50,60017993,59583104,434889,114.97186638429577
1747352460522061,59785252,1,642,50,60112373,59675672,436701,114.49481452984996
1747352460616216,59877804,1,643,50,60206528,59768224,438304,114.07607505293127
1747352460706089,59970364,1,644,50,60296401,59860784,435617,114.779726227397
1747352460800986,60062924,1,645,50,60391298,59953344,437954,114.16724130844791
1747352460894468,60155484,1,646,50,60484780,60045904,438876,113.9273963488548
1747352460988631,60248044,1,647,50,60578943,60138464,440479,113.5127894859914
1747352461083303,60340604,1,648,50,60673615,60231024,442591,112.9711178040222
1747352461172859,60433164,1,649,50,60763171,60323584,439587,113.7431270715467
1747352461267654,60525724,1,650,50,60857966,60416144,441822,113.16774628696623
1747352461361665,60618284,1,651,50,60951977,60508704,443273,112.79730549796628
1747352461455538,60710844,1,652,50,61045850,60601264,444586,112.46418015861948
1747352461546528,60803404,1,653,50,61136840,60693824,443016,112.86274084908896
1747352461640140,60895964,1,654,50,61230452,60786384,444068,112.59536827693056
1747352461734129,60988524,1,655,50,61324441,60878944,445497,112.2342013526466
1747352461828808,61081084,1,656,50,61419120,60971504,447616,111.70288818987704
1747352461918962,61173644,1,657,50,61509274,61064064,445210,112.3065519642416
1747352462012938,61266204,1,658,50,61603250,61156624,446626,111.95049101485358
1747352462106912,61358764,1,659,50,61697224,61249184,448040,111.59717882331935
1747352462201124,61451324,1,660,50,61791436,61341744,449692,111.18721258105548
1747352462291825,61543884,1,661,50,61882137,61434304,447833,111.648761926879
1747352462386005,61636444,1,662,50,61976317,61526864,449453,111.24633721434722
1747352462480332,61729004,1,663,50,62070644,61619424,451220,110.81069101546916
1747352462574211,61821564,1,664,50,62164523,61711984,452539,110.4877148709835
1747352462668654,61914132,1,665,50,62258966,61804552,454414,110.03182120269182
1747352462758848,62006684,1,666,50,62349160,61897104,452056,110.60576565735218
1747352462852602,62099244,1,667,50,62442914,61989664,453250,110.31439602868174
1747352462947241,62191804,1,668,50,62537553,62082224,455329,109.81070830103069
1747352463041083,62284364,1,669,50,62631395,62174784,456611,109.50239919756642
1747352463131581,62376924,1,670,50,62721893,62267344,454549,109.99914200669237
1747352463225062,62469484,1,671,50,62815374,62359904,455470,109.77671416339166
1747352463319108,62562044,1,672,50,62909420,62452464,456956,109.41972531272158
1747352463413328,62654604,1,673,50,63003640,62545024,458616,109.02367121949516
1747352463504045,62747164,1,674,50,63094357,62637584,456773,109.46356286382952
1747352463598376,62839724,1,675,50,63188688,62730144,458544,109.04078997871524
1747352463692652,62932284,1,676,50,63282964,62822704,460260,108.63425020640508
1747352463786560,63024844,1,677,50,63376872,62915264,461608,108.31701356995544
1747352463876069,63117404,1,678,50,63466381,63007824,458557,109.03769869394644
1747352463970354,63209964,1,679,50,63560666,63100384,460282,108.62905783845557
1747352464063890,63302524,1,680,50,63654202,63192944,461258,108.39920391624644
1747352464159305,63395084,1,681,50,63749617,63285504,464113,107.73238413920748
1747352464252818,63487644,1,682,50,63843130,63378064,465066,107.5116220063389
1747352464342832,63580204,1,683,50,63933144,63470624,462520,108.10343336504368
1747352464437396,63672764,1,684,50,64027708,63563184,464524,107.63706503862018
1747352464531615,63765324,1,685,50,64121927,63655744,466183,107.25401827179456
1747352464625610,63857884,1,686,50,64215922,63748304,467618,106.92488313110276
1747352464716083,63950444,1,687,50,64306395,63840864,465531,107.40423301563162
1747352464810734,64043004,1,688,50,64401046,63933424,467622,106.92396850447584
1747352464904728,64135564,1,689,50,64495040,64025984,469056,106.59708009278212
1747352464998902,64228124,1,690,50,64589214,64118544,470670,106.23154226953068
1747352465089069,64320684,1,691,50,64679381,64211104,468277,106.7744091638069
1747352465182385,64413244,1,692,50,64772697,64303664,469033,106.60230730033922
1747352465277415,64505804,1,693,50,64867727,64396224,471503,106.0438639838983
1747352465371399,64598364,1,694,50,64961711,64488784,472927,105.7245621417259
1747352465461104,64690924,1,695,50,65051416,64581344,470072,106.36668425262512
1747352465555812,64783484,1,696,50,65146124,64673904,472220,105.88285121341748
1747352465649994,64876044,1,697,50,65240306,64766464,473842,105.52040553602257
1747352465743667,64968604,1,698,50,65333979,64859024,474955,105.27313113873946
1747352465838211,65061164,1,699,50,65428523,64951584,476939,104.8352095341333
1747352465928213,65153724,1,700,50,65518525,65044144,474381,105.40051140328131
1747352466022754,65246284,1,701,50,65613066,65136704,476362,104.96219261821892
1747352466116574,65338844,1,702,50,65706886,65229264,477622,104.68529506597268
1747352466210252,65431404,1,703,50,65800564,65321824,478740,104.44082382921836
1747352466300747,65523964,1,704,50,65891059,65414384,476675,104.89327109665916
1747352466395118,65616524,1,705,50,65985430,65506944,478486,104.49626530347804
1747352466489128,65709092,1,706,50,66079440,65599512,479928,104.18229401076827
1747352466583245,65801644,1,707,50,66173557,65692064,481493,103.84366958605835
1747352466673978,65894204,1,708,50,66264290,65784624,479666,104.23919977651116
1747352466768202,65986764,1,709,50,66358514,65877184,481330,103.8788357260092
1747352466861883,66079324,1,710,50,66452195,65969744,482451,103.6374678464756
1747352466956254,66171884,1,711,50,66546566,66062304,484262,103.24989365260952
1747352467046833,66264444,1,712,50,66637145,66154864,482281,103.67399918304888
1747352467140829,66357004,1,713,50,66731141,66247424,483717,103.3662244659584
1747352467235345,66449564,1,714,50,66825657,66339984,485673,102.94992721440146
1747352467328803,66542124,1,715,50,66919115,66432544,486571,102.75992609506116
1747352467423534,66634684,1,716,50,67013846,66525104,488742,102.30346481374632
1747352467513281,66727244,1,717,50,67103593,66617664,485929,102.89569052268952
1747352467607803,66819804,1,718,50,67198115,66710224,487891,102.48190681935104
1747352467701808,66912364,1,719,50,67292120,66802784,489336,102.17927967695
1747352467795703,67004924,1,720,50,67386015,66895344,490671,101.90127396972716
1747352467885614,67097484,1,721,50,67475926,66987904,488022,102.45439754765154
1747352467980270,67190044,1,722,50,67570582,67080464,490118,102.01624914816432
1747352468074889,67282604,1,723,50,67665201,67173024,492177,101.58946882930329
1747352468168270,67375164,1,724,50,67758582,67265584,492998,101.42028973748371
1747352468258967,67467724,1,725,50,67849279,67358144,491135,101.80500269783258
1747352468353418,67560284,1,726,50,67943730,67450704,493026,101.41452986252246
1747352468447226,67652844,1,727,50,68037538,67543264,494274,101.158466761351
1747352468541686,67745404,1,728,50,68131998,67635824,496174,100.77110046072546
1747352468631707,67837972,1,729,50,68222019,67728392,493627,101.291055797191
1747352468726194,67930524,1,730,50,68316506,67820944,495562,100.89554889196508
1747352468819805,68023084,1,731,50,68410117,67913504,496613,100.68202000350372
1747352468914422,68115644,1,732,50,68504734,68006064,498670,100.26670944712936
1747352469008006,68208204,1,733,50,68598318,68098624,499694,100.06123747733612
1747352469098029,68300764,1,734,50,68688341,68191184,497157,100.57185154790136
1747352469192481,68393324,1,735,50,68782793,68283744,499049,100.19056244977948
1747352469286511,68485884,1,736,50,68876823,68376304,500519,99.89630763267728
1747352469380907,68578444,1,737,50,68971219,68468864,502355,99.53120801027164
1747352469471526,68671004,1,738,50,69061838,68561424,500414,99.9172685016806
1747352469565162,68763564,1,739,50,69155474,68653984,501490,99.70288540150352
1747352469659463,68856124,1,740,50,69249775,68746544,503231,99.35794893398857
1747352470257381,69430204,1,746,50,69847693,69320624,527069,94.86423978644162
1747352470335067,69525884,1,747,50,69925379,69416304,509075,98.21735500662966
1747352470425321,69618444,1,748,50,70015633,69508864,506769,98.66428293759088
1747352470519646,69711004,1,749,50,70109958,69601424,508534,98.32184278730624
1747352470613896,69803564,1,750,50,70204208,69693984,510224,97.99617422935808
1747352470707968,69896124,1,751,50,70298280,69786544,511736,97.706629981084
1747352470798242,69988684,1,752,50,70388554,69879104,509450,98.14505839630976
1747352470892795,70081244,1,753,50,70483107,69971664,511443,97.76260502147844
1747352470987015,70173804,1,754,50,70577327,70064224,513103,97.44632169369504
1747352471080796,70266364,1,755,50,70671108,70156784,514324,97.21498510666429
1747352471174804,70358924,1,756,50,70765116,70249344,515772,96.94205966977655
1747352471264792,70451484,1,757,50,70855104,70341904,513200,97.42790335151987
1747352471358692,70544044,1,758,50,70949004,70434464,514540,97.17417499125432
1747352471555674,70732284,1,760,50,71145986,70622704,523282,95.550773770166
1747352471646283,70827964,1,761,50,71236595,70718384,518211,96.485794396491
1747352471740596,70923644,1,762,50,71330908,70814064,516844,96.74098954423386
1747352471834381,71016204,1,763,50,71424693,70906624,518069,96.51224064748132
1747352471928408,71108764,1,764,50,71518720,70999184,519536,96.23972159773336
1747352472023125,71201324,1,765,50,71613437,71091744,521693,95.84180734646624
1747352472113309,71293884,1,766,50,71703621,71184304,519317,96.28030663352057
1747352472207016,71386444,1,767,50,71797328,71276864,520464,96.06812382796888
1747352472301480,71479004,1,768,50,71891792,71369424,522368,95.717961283999
1747352472395268,71571564,1,769,50,71985580,71461984,523596,95.49347206624957
1747352472489267,71664124,1,770,50,72079579,71554544,525035,95.23174645499824
1747352472579631,71756684,1,771,50,72169943,71647104,522839,95.631733669447
1747352472673429,71849244,1,772,50,72263741,71739664,524077,95.40582776958348
1747352472767647,71941804,1,773,50,72357959,71832224,525735,95.1049483104606
1747352472862743,72034364,1,774,50,72453055,71924784,528271,94.64839069341303
1747352472952652,72126924,1,775,50,72542964,72017344,525620,95.1257562497622
1747352473047100,72219484,1,776,50,72637412,72109904,527508,94.78529235575574
1747352473140902,72312044,1,777,50,72731214,72202464,528750,94.5626477541371
1747352473234842,72404604,1,778,50,72825154,72295024,530130,94.31648840850356
1747352473325026,72497172,1,779,50,72915338,72387592,527746,94.74254660385868
1747352473419026,72589724,1,780,50,73009338,72480144,529194,94.48330857870648
1747352473513204,72682284,1,781,50,73103516,72572704,530812,94.1953083200832
1747352473607222,72774844,1,782,50,73197534,72665264,532270,93.9372874668871
1747352473698179,72867404,1,783,50,73288491,72757824,530667,94.22104634356386
1747352473792079,72959964,1,784,50,73382391,72850384,532007,93.98372577804427
1747352473886547,73052524,1,785,50,73476859,72942944,533915,93.64786529691057
1747352473980271,73145084,1,786,50,73570583,73035504,535079,93.44414563083208
1747352474074670,73237644,1,787,50,73664982,73128064,536918,93.12408971202306
1747352474165100,73330204,1,788,50,73755412,73220624,534788,93.4949924082066
1747352474259037,73422764,1,789,50,73849349,73313184,536165,93.25487489858531
1747352474353300,73515324,1,790,50,73943612,73405744,537868,92.9596109082526
1747352474447221,73607884,1,791,50,74037533,73498304,539229,92.72498326314052
1747352474537752,73700444,1,792,50,74128064,73590864,537200,93.07520476545048
1747352474631863,73793004,1,793,50,74222175,73683424,538751,92.80725232992609
1747352474725489,73885564,1,794,50,74315801,73775984,539817,92.62398183087971
1747352474819651,73978124,1,795,50,74409963,73868544,541419,92.34991753152364
1747352474909683,74070684,1,796,50,74499995,73961104,538891,92.78314167429036
1747352475004362,74163244,1,797,50,74594674,74053664,541010,92.4197334614887
1747352475098798,74255804,1,798,50,74689110,74146224,542886,92.10036729626478
1747352475192423,74348364,1,799,50,74782735,74238784,543951,91.92004426869332
1747352475287042,74440924,1,800,50,74877354,74331344,546010,91.57341440632956
1747352475377068,74533484,1,801,50,74967380,74423904,543476,92.00038272159212
1747352475471126,74626044,1,802,50,75061438,74516464,544974,91.74749621082842
1747352475565438,74718604,1,803,50,75155750,74609024,546726,91.45348858477554
1747352475660146,74811164,1,804,50,75250458,74701584,548874,91.09558842284386
1747352475750179,74903724,1,805,50,75340491,74794144,546347,91.51692971682832
1747352475844363,74996284,1,806,50,75434675,74886704,547971,91.24570460845555
1747352475937988,75088844,1,807,50,75528300,74979264,549036,91.06870951995862
1747352476032705,75181404,1,808,50,75623017,75071824,551193,90.71232762389944
1747352476122711,75273964,1,809,50,75713023,75164384,548639,91.13460763817372
1747352476216889,75366524,1,810,50,75807201,75256944,550257,90.86663141041367
1747352476311100,75459084,1,811,50,75901412,75349504,551908,90.5948092798075
1747352476404847,75551644,1,812,50,75995159,75442064,553095,90.40038329762518
1747352476495625,75644204,1,813,50,76085937,75534624,551313,90.6925829791788
1747352476589365,75736764,1,814,50,76179677,75627184,552493,90.49888414875844
1747352476683713,75829324,1,815,50,76274025,75719744,554281,90.20695279109331
1747352476777549,75921884,1,816,50,76367861,75812304,555557,89.9997660006084
1747352476872258,76014444,1,817,50,76462570,75904864,557706,89.65297127877412
1747352476961597,76107004,1,818,50,76551909,75997424,554485,90.17376484485604
1747352477056602,76199564,1,819,50,76646914,76089984,556930,89.7778895013736
1747352477150953,76292132,1,820,50,76741265,76182552,558713,89.49138466439835
1747352477244302,76384684,1,821,50,76834614,76275104,559510,89.36390770495613
1747352477334467,76477244,1,822,50,76924779,76367664,557115,89.7480771474471
1747352477428540,76569804,1,823,50,77018852,76460224,558628,89.50500153948603
1747352477523058,76662364,1,824,50,77113370,76552784,560586,89.19238083005997
1747352477617733,76754924,1,825,50,77208045,76645344,562701,88.85713727183709
1747352477707656,76847484,1,826,50,77297968,76737904,560064,89.27551137012912
1747352477801396,76940044,1,827,50,77391708,76830464,561244,89.08781207460571
1747352477896719,77032604,1,828,50,77487031,76923024,564007,88.65138198639379
1747352477989957,77125164,1,829,50,77580269,77015584,564685,88.54494098479684
1747352478080094,77217724,1,830,50,77670406,77108144,562262,88.92651468532463
1747352478174854,77310284,1,831,50,77765166,77200704,564462,88.57992212053247
1747352478269042,77402844,1,832,50,77859354,77293264,566090,88.32517797523363
1747352478363012,77495404,1,833,50,77953324,77385824,567500,88.10572687224669
1747352478457202,77587964,1,834,50,78047514,77478384,569130,87.85339026233022
1747352478547113,77680524,1,835,50,78137425,77570944,566481,88.26421362764152
1747352478641716,77773084,1,836,50,78232028,77663504,568524,87.94703477777543
1747352478735097,77865644,1,837,50,78325409,77756064,569345,87.82021445696371
1747352478829417,77958204,1,838,50,78419729,77848624,571105,87.54957494681364
1747352478919856,78050764,1,839,50,78510168,77941184,568984,87.87593324241102
1747352479013911,78143324,1,840,50,78604223,78033744,570479,87.6456451508294
1747352479108564,78235884,1,841,50,78698876,78126304,572572,87.32526215043698
1747352479202601,78328444,1,842,50,78792913,78218864,574049,87.10057852204254
1747352479293001,78421012,1,843,50,78883313,78311432,571881,87.43077668256159
1747352479386721,78513564,1,844,50,78977033,78403984,573049,87.25257351465581
1747352479480663,78606124,1,845,50,79070975,78496544,574431,87.04265612406016
1747352479575159,78698684,1,846,50,79165471,78589104,576367,86.75028237216912
1747352479664853,78791244,1,847,50,79255165,78681664,573501,87.18380613111398
1747352479759844,78883804,1,848,50,79350156,78774224,575932,86.81580464360376
1747352479853948,78976364,1,849,50,79444260,78866784,577476,86.58368486309388
1747352479947532,79068924,1,850,50,79537844,78959344,578500,86.4304235090752
1747352480042032,79161484,1,851,50,79632344,79051904,580440,86.14154779133072
1747352480132587,79254044,1,852,50,79722899,79144464,578435,86.4401358838936
1747352480226266,79346604,1,853,50,79816578,79237024,579554,86.27323769657357
1747352480320943,79439164,1,854,50,79911255,79329584,581671,85.95924500275929
1747352480415058,79531724,1,855,50,80005370,79422144,583226,85.73006004533406
1747352480505121,79624284,1,856,50,80095433,79514704,580729,86.09867941845508
1747352480598755,79716844,1,857,50,80189067,79607264,581803,85.93974249015561
1747352480693240,79809404,1,858,50,80283552,79699824,583728,85.65633308664309
1747352480788141,79901964,1,859,50,80378453,79792384,586069,85.31418655482547
1747352480877823,79994524,1,860,50,80468135,79884944,583191,85.73520510433117
1747352480971438,80087084,1,861,50,80561750,79977504,584246,85.58038908268092
1747352481065774,80179644,1,862,50,80656086,80070064,586022,85.32102890335175
1747352481159871,80272204,1,863,50,80750183,80162624,587559,85.09783698317955
1747352481250735,80364764,1,864,50,80841047,80255184,585863,85.34418456191976
1747352481344695,80457324,1,865,50,80935007,80347744,587263,85.14072911114782
1747352481438419,80549884,1,866,50,81028731,80440304,588427,84.97230752497761
1747352481532887,80642444,1,867,50,81123199,80532864,590335,84.69767166100603
1747352481627072,80735004,1,868,50,81217384,80625424,591960,84.46516656530846
1747352481717293,80827564,1,869,50,81307605,80717984,589621,84.80023608385727
1747352481811225,80920124,1,870,50,81401537,80810544,590993,84.6033709367116
1747352481905329,81012684,1,871,50,81495641,80903104,592537,84.38291617232342
1747352481999318,81105244,1,872,50,81589630,80995664,593966,84.1799025533448
1747352482089310,81197804,1,873,50,81679622,81088224,591398,84.54543302479887
1747352482184178,81290364,1,874,50,81774490,81180784,593706,84.21676722148673
1747352482278851,81382924,1,875,50,81869163,81273344,595819,83.91810264526643
1747352482372540,81475484,1,876,50,81962852,81365904,596948,83.75938942755482
1747352482462786,81568044,1,877,50,82053098,81458464,594634,84.08533652633385
1747352482557099,81660604,1,878,50,82147411,81551024,596387,83.83817890061319
1747352482651187,81753164,1,879,50,82241499,81643584,597915,83.62392647784384
1747352482745215,81845724,1,880,50,82335527,81736144,599383,83.41911599094402
1747352482835179,81938284,1,881,50,82425491,81828704,596787,83.78198586765463
1747352482929347,82030844,1,882,50,82519659,81921264,598395,83.55684790146977
1747352483023631,82123404,1,883,50,82613943,82013824,600119,83.31680883291482
1747352483117629,82215972,1,884,50,82707941,82106392,601549,83.11874843113362
1747352483212089,82308524,1,885,50,82802401,82198944,603457,82.85594499690947
1747352483302369,82401084,1,886,50,82892681,82291504,601177,83.17018116128861
1747352483396568,82493644,1,887,50,82986880,82384064,602816,82.94404926212974
1747352483490610,82586204,1,888,50,83080922,82476624,604298,82.74063458757104
1747352483585240,82678764,1,889,50,83175552,82569184,606368,82.45817721251781
1747352483675328,82771324,1,890,50,83265640,82661744,603896,82.79571316915495
1747352483768978,82863884,1,891,50,83359290,82754304,604986,82.64654058110435
1747352483863165,82956444,1,892,50,83453477,82846864,606613,82.42487384873058
1747352483957828,83049004,1,893,50,83548140,82939424,608716,82.14011131627885
1747352484047587,83141564,1,894,50,83637899,83031984,605915,82.51982538804948
1747352484142236,83234124,1,895,50,83732548,83124544,608004,82.2363010769666
1747352484236240,83326684,1,896,50,83826552,83217104,609448,82.04145390582954
1747352484330726,83419244,1,897,50,83921038,83309664,611374,81.78300025843429
1747352484424751,83511804,1,898,50,84015063,83402224,612839,81.58749687927825
1747352484515006,83604364,1,899,50,84105318,83494784,610534,81.8955209701671
1747352484609291,83696924,1,900,50,84199603,83587344,612259,81.6647856544371
1747352484703361,83789484,1,901,50,84293673,83679904,613769,81.46387321614483
1747352484797543,83882044,1,902,50,84387855,83772464,615391,81.24915703999571
1747352484886940,83974604,1,903,50,84477252,83865024,612228,81.66892072887879
1747352484981594,84067164,1,904,50,84571906,83957584,614322,81.39054111687355
1747352485075963,84159724,1,905,50,84666275,84050144,616131,81.1515732855513
1747352485170089,84252284,1,906,50,84760401,84142704,617697,80.94583590336362
1747352485260473,84344852,1,907,50,84850785,84235272,615513,81.23305275436913
1747352485354585,84437404,1,908,50,84944897,84327824,617073,81.0276904029183
1747352485448645,84529964,1,909,50,85038957,84420384,618573,80.83120343112292
1747352485542775,84622524,1,910,50,85133087,84512944,620143,80.62656516319623
1747352485632682,84715084,1,911,50,85222994,84605504,617490,80.97297122220603
1747352485726576,84807644,1,912,50,85316888,84698064,618824,80.79841764378885
1747352485821497,84900204,1,913,50,85411809,84790624,621185,80.49131901124464
1747352485915740,84992764,1,914,50,85506052,84883184,622868,80.27383008920029
1747352486009410,85085324,1,915,50,85599722,84975744,623978,80.13103026068227
1747352486099998,85177884,1,916,50,85690310,85068304,622006,80.38507667128614
1747352486194225,85270444,1,917,50,85784537,85160864,623673,80.17021740559555
1747352486288388,85363004,1,918,50,85878700,85253424,625276,79.9646875939585
1747352486381982,85455564,1,919,50,85972294,85345984,626310,79.83267072216634
1747352486472334,85548124,1,920,50,86062646,85438544,624102,80.11510938917036
1747352486566808,85640684,1,921,50,86157120,85531104,626016,79.8701630629249
1747352486660479,85733244,1,922,50,86250791,85623664,627127,79.72866739910737
1747352486754444,85825804,1,923,50,86344756,85716224,628532,79.55044452788403
1747352486845654,85918364,1,924,50,86435966,85808784,627182,79.72167568584557
1747352486939639,86010924,1,925,50,86529951,85901344,628607,79.54095325060014
1747352487033249,86103484,1,926,50,86623561,85993904,629657,79.40831277981503
1747352487127438,86196044,1,927,50,86717750,86086464,631286,79.20340384548366
1747352487217559,86288604,1,928,50,86807871,86179024,628847,79.51059637717918
1747352487311553,86381164,1,929,50,86901865,86271584,630281,79.32969580234848
1747352487406201,86473724,1,930,50,86996513,86364144,632369,79.06775948852648
1747352487500160,86566284,1,931,50,87090472,86456704,633768,78.89322275659232
1747352487594827,86658844,1,932,50,87185139,86549264,635875,78.63180656575585
1747352487684545,86751404,1,933,50,87274857,86641824,633033,78.98482385594433
1747352487778518,86843964,1,934,50,87368830,86734384,634446,78.8089136033642
1747352487872721,86936524,1,935,50,87463033,86826944,636089,78.60535239565532
1747352487966860,87029084,1,936,50,87557172,86919504,637668,78.41070902099526
1747352488057298,87121644,1,937,50,87647610,87012064,635546,78.67251150978842
1747352488151336,87214204,1,938,50,87741648,87104624,637024,78.48997839955794
1747352488246122,87306764,1,939,50,87836434,87197184,639250,78.21666014861165
1747352488340384,87399324,1,940,50,87930696,87289744,640952,78.0089616695166
1747352488429957,87491884,1,941,50,88020269,87382304,637965,78.37420548149193
1747352488524696,87584444,1,942,50,88115008,87474864,640144,78.10742582918843
1747352488618289,87677004,1,943,50,88208601,87567424,641177,77.98158698768047
1747352488712646,87769564,1,944,50,88302958,87659984,642974,77.76364207572934
1747352488802503,87862124,1,945,50,88392815,87752544,640271,78.0919329471427
1747352488896579,87954684,1,946,50,88486891,87845104,641787,77.90746774241298
1747352488991396,88047244,1,947,50,88581708,87937664,644044,77.63444733589631
1747352489085473,88139812,1,948,50,88675785,88030232,645553,77.4529744265769
1747352489179433,88232364,1,949,50,88769745,88122784,646961,77.28441127054026
1747352489270130,88324924,1,950,50,88860442,88215344,645098,77.50760349590296
1747352489364275,88417484,1,951,50,88954587,88307904,646683,77.31763476077151
1747352489457828,88510044,1,952,50,89048140,88400464,647676,77.19909337384742
1747352489552003,88602604,1,953,50,89142315,88493024,649291,77.00707386980568
1747352489642607,88695164,1,954,50,89232919,88585584,647335,77.23975993882611
1747352489736889,88787724,1,955,50,89327201,88678144,649057,77.0348366938497
1747352489831132,88880284,1,956,50,89421444,88770704,650740,76.83560254479515
1747352489924815,88972844,1,957,50,89515127,88863264,651863,76.70323365492443
1747352490014952,89065404,1,958,50,89605264,88955824,649440,76.98940625769895
1747352490108950,89157964,1,959,50,89699262,89048384,650878,76.81931176042208
1747352490203768,89250524,1,960,50,89794080,89140944,653136,76.5537345973886
1747352490297337,89343084,1,961,50,89887649,89233504,654145,76.43565264582011
1747352490388021,89435644,1,962,50,89978333,89326064,652269,76.65549029618148
1747352490772970,89815244,1,966,50,90363282,89705664,657618,76.03198209294757
1747352490866638,89907804,1,967,50,90456950,89798224,658726,75.90409365957925
1747352490956940,90000364,1,968,50,90547252,89890784,656468,76.16517484477536
1747352491051286,90092924,1,969,50,90641598,89983344,658254,75.95852057108654
1747352491145489,90185484,1,970,50,90735801,90075904,659897,75.76940037611931
1747352491239858,90278044,1,971,50,90830170,90168464,661706,75.56225876748888
1747352491330247,90370604,1,972,50,90920559,90261024,659535,75.81098804460719
1747352491424445,90463164,1,973,50,91014757,90353584,661173,75.6231727550883
1747352491518100,90555724,1,974,50,91108412,90446144,662268,75.4981367059861
1747352491612472,90648284,1,975,50,91202784,90538704,664080,75.29213347789423
1747352491702769,90740844,1,976,50,91293081,90631264,661817,75.54958545942459
1747352491797028,90833404,1,977,50,91387340,90723824,663516,75.35613308495952
1747352491894754,90925964,1,978,50,91485066,90816384,668682,74.77395832398659
1747352491985616,91018524,1,979,50,91575928,90908944,666984,74.96431698511508
1747352492083622,91114204,1,980,50,91673934,91004624,669310,74.70379943523928
1747352492177722,91206764,1,981,50,91768034,91097184,670850,74.53230975627935
1747352492267853,91299324,1,982,50,91858165,91189744,668421,74.80315549631145
1747352492362199,91391884,1,983,50,91952511,91282304,670207,74.60381643283344
1747352492460647,91487564,1,984,50,92050959,91377984,672975,74.29696496898102
1747352493418067,92444364,1,994,50,93008379,92334784,673595,74.22857948767434
1747352493513120,92536924,1,995,50,93103432,92427344,676088,73.95486978026528
1747352493607331,92629484,1,996,50,93197643,92519904,677739,73.77471268438146
1747352493700799,92722044,1,997,50,93291111,92612464,678647,73.67600534593095
1747352493794973,92814604,1,998,50,93385285,92705024,680261,73.50120027460048
1747352493886127,92907164,1,999,50,93476439,92797584,678855,73.6534311450899
1747352493979684,92999724,1,1000,50,93569996,92890144,679852,73.54541870877779
1747352494074530,93093324,1,1001,50,93664842,92983744,681098,73.41087479334838
1747352494168408,93186924,1,1002,50,93758720,93077344,681376,73.38092330812944
1747352494262120,93280524,1,1003,50,93852432,93170944,681488,73.36886342826286
1747352494356438,93374124,1,1004,50,93946750,93264544,682206,73.29164504563138
1747352494451227,93467724,1,1005,50,94041539,93358144,683395,73.16412909078937
1747352494545183,93561324,1,1006,50,94135495,93451744,683751,73.12603564747985
1747352494638873,93654924,1,1007,50,94229185,93545344,683841,73.11641156350672
1747352494737006,93748524,1,1008,50,94327318,93638944,688374,72.63493391673711
1747352494831503,93842124,1,1009,50,94421815,93732544,689271,72.54040863462993
1747352494924921,93935724,1,1010,50,94515233,93826144,689089,72.55956777716668
1747352495019765,94029324,1,1011,50,94610077,93919744,690333,72.42881334080799
1747352495113969,94122924,1,1012,50,94704281,94013344,690937,72.36549786738877
1747352495208693,94216524,1,1013,50,94799005,94106944,692061,72.24796658098057
1747352495302686,94310124,1,1014,50,94892998,94200544,692454,72.20696248415057
1747352495397323,94403724,1,1015,50,94987635,94294144,693491,72.09898902797585
1747352495491501,94497324,1,1016,50,95081813,94387744,694069,72.0389471363798
1747352495585551,94590924,1,1017,50,95175863,94481344,694519,71.99227090979512
1747352495679885,94684524,1,1018,50,95270197,94574944,695253,71.91626645264385
1747352495774036,94778124,1,1019,50,95364348,94668544,695804,71.85931670412933
1747352495867399,94871724,1,1020,50,95457711,94762144,695567,71.88380127291835
1747352495962148,94965324,1,1021,50,95552460,94855744,696716,71.76525298686983
1747352496056634,95058924,1,1022,50,95646946,94949344,697602,71.67410643891502
1747352496150665,95152524,1,1023,50,95740977,95042944,698033,71.62985131075465
1747352496244333,95246124,1,1024,50,95834645,95136544,698101,71.62287405404089
1747352496338449,95339724,1,1025,50,95928761,95230144,698617,71.56997324714399
1747352496432716,95433324,1,1026,50,96023028,95323744,699284,71.50170746077416
1747352496527800,95526932,1,1027,50,96118112,95417352,700760,71.35110451509789
1747352496621225,95620524,1,1028,50,96211537,95510944,700593,71.36811244188851
1747352496715288,95714124,1,1029,50,96305600,95604544,701056,71.32097863794047
1747352496809790,95807724,1,1030,50,96400102,95698144,701958,71.22933280908545
1747352496904445,95901324,1,1031,50,96494757,95791744,703013,71.12244012557377
1747352496997945,95994924,1,1032,50,96588257,95885344,702913,71.13255836782076
1747352497092960,96088524,1,1033,50,96683272,95978944,704328,70.98965254824458
1747352497187093,96182124,1,1034,50,96777405,96072544,704861,70.93597177315812
1747352497281127,96275724,1,1035,50,96871439,96166144,705295,70.8923216526418
1747352497375040,96369324,1,1036,50,96965352,96259744,705608,70.86087459325857
1747352497468963,96462924,1,1037,50,97059275,96353344,705931,70.82845207251134
1747352497563337,96556524,1,1038,50,97153649,96446944,706705,70.75087907967256
1747352497657228,96650124,1,1039,50,97247540,96540544,706996,70.721757973171
1747352497751898,96743724,1,1040,50,97342210,96634144,708066,70.61488618292645
1747352505099140,104037244,1,1115,50,104689452,103927664,761788,65.63505857272627
1747352505197651,104131884,1,1116,50,104787963,104022304,765659,65.30322245281516
1747352505783287,104715324,1,1122,50,105373599,104605744,767855,65.11646079012314
1747352508936995,107840532,1,1154,50,108527307,107730952,796355,62.78606902700429
1747352509036171,107935164,1,1155,50,108626483,107825584,800899,62.4298444622855
1747352509122125,108029804,1,1156,50,108712437,107920224,792213,63.11433919918002
1747352509219480,108124444,1,1157,50,108809792,108014864,794928,62.8987782541312
1747352509314604,108219084,1,1158,50,108904916,108109504,795412,62.86050499615293
1747352509412086,108313724,1,1159,50,109002398,108204144,798254,62.636704607806536
1747352509507097,108408364,1,1160,50,109097409,108298784,798625,62.60760682422914
1747352509600668,108503004,1,1161,50,109190980,108393424,797556,62.691522601547724
1747352509694705,108597644,1,1162,50,109285017,108488064,796953,62.7389570024832
1747352509793337,108692284,1,1163,50,109383649,108582704,800945,62.42625898157801
1747352509883575,108786924,1,1164,50,109473887,108677344,796543,62.77125026520853
1747352509981476,108881564,1,1165,50,109571788,108771984,799804,62.51531625248186
1747352510080711,108976204,1,1166,50,109671023,108866624,804399,62.158207556200345
1747352510174058,109070844,1,1167,50,109764370,108961264,803106,62.25828221928363
1747352510268102,109165484,1,1168,50,109858414,109055904,802510,62.3045195698496
1747352510367389,109260124,1,1169,50,109957701,109150544,807157,61.945817232583
1747352510460924,109354764,1,1170,50,110051236,109245184,806052,62.03073747103165
1747352510554693,109449404,1,1171,50,110145005,109339824,805181,62.09783887101161
1747352510649093,109544044,1,1172,50,110239405,109434464,804941,62.11635386941403
1747352510743576,109638692,1,1173,50,110333888,109529112,804776,62.12908933666014
1747352510837907,109733324,1,1174,50,110428219,109623744,804475,62.15233537400167
1747352510935624,109827964,1,1175,50,110525936,109718384,807552,61.91551751466159
1747352511034759,109922604,1,1176,50,110625071,109813024,812047,61.572790737481945
1747352511124347,110017244,1,1177,50,110714659,109907664,806995,61.95825252944566
1747352511222740,110111884,1,1178,50,110813052,110002304,810748,61.67144414787332
1747352511317313,110206524,1,1179,50,110907625,110096944,810681,61.67654108089372
1747352511419102,110301164,1,1180,50,111009414,110191584,817830,61.13740019319419
1747352511722771,110591324,1,1183,50,111313083,110481744,831339,60.14393646875703
1747352511808544,110685964,1,1184,50,111398856,110576384,822472,60.79234308280404
1747352511923107,110780604,1,1185,50,111513419,110671024,842395,59.35457831539836
1747352512008952,110875244,1,1186,50,111599264,110765664,833600,59.98080614203455
1747352512107753,110969892,1,1187,50,111698065,110860312,837753,59.68346278676412
1747352512193099,111064524,1,1188,50,111783411,110954944,828467,60.352434074018646
1747352512377857,111256924,1,1190,50,111968169,111147344,820825,60.91432400328937
1747352512574756,111449324,1,1192,50,112165068,111339744,825324,60.58226829705667
1747352512672450,111543964,1,1193,50,112262762,111434384,828378,60.35891827161031
1747352512766952,111638604,1,1194,50,112357264,111529024,828240,60.36897517627741
1747352512865209,111733244,1,1195,50,112455521,111623664,831857,60.10648464820276
1747352512971521,111827884,1,1196,50,112561833,111718304,843529,59.274784862168346
1747352513045276,111922524,1,1197,50,112635588,111812944,822644,60.77963250203004
1747352513344077,112212684,1,1200,50,112934389,112103104,831285,60.14784339907492
1747352513438248,112307324,1,1201,50,113028560,112197744,830816,60.1817971728999
1747352513548714,112401964,1,1202,50,113139026,112292384,846642,59.05683866380359
1747352513622646,112496604,1,1203,50,113212958,112387024,825934,60.53752479011641
1747352513721440,112591244,1,1204,50,113311752,112481664,830088,60.23457753876697
1747352513810902,112685884,1,1205,50,113401214,112576304,824910,60.61267289764944
1747352513925464,112780524,1,1206,50,113515776,112670944,844832,59.18336426650505
1747352514004043,112875164,1,1207,50,113594355,112765584,828771,60.33029630621728
1747352514101939,112969804,1,1208,50,113692251,112860224,832027,60.09420367367886
1747352514208612,113064444,1,1209,50,113798924,112954864,844060,59.237494964812925
1747352514296247,113159084,1,1210,50,113886559,113049504,837055,59.73323138861843
1747352514389068,113253724,1,1211,50,113979380,113144144,835236,59.86332006762161
1747352514482981,113348364,1,1212,50,114073293,113238784,834509,59.91547125315605
1747352514581633,113443004,1,1213,50,114171945,113333424,838521,59.62879880169966
1747352514675623,113537644,1,1214,50,114265935,113428064,837871,59.67505737756767
1747352514769802,113632292,1,1215,50,114360114,113522712,837402,59.70847932056528
1747352514863360,113726924,1,1216,50,114453672,113617344,836328,59.78515606317139
1747352514957897,113821564,1,1217,50,114548209,113711984,836225,59.792519955753534
1747352515052445,113916204,1,1218,50,114642757,113806624,836133,59.799098947177065
1747352515150889,114010844,1,1219,50,114741201,113901264,839937,59.52827414437035
1747352515249161,114105484,1,1220,50,114839473,113995904,843569,59.27197419535332
1747352515343208,114200124,1,1221,50,114933520,114090544,842976,59.31366966556581
1747352515437543,114294764,1,1222,50,115027855,114185184,842671,59.335137912661054
1747352515531691,114389404,1,1223,50,115122003,114279824,842179,59.36980143176213
1747352515629707,114484044,1,1224,50,115220019,114374464,845555,59.13275895713467
1747352515719701,114578684,1,1225,50,115310013,114469104,840909,59.45946588750982
1747352515817813,114673324,1,1226,50,115408125,114563744,844381,59.214975230375856
1747352515912309,114767964,1,1227,50,115502621,114658384,844237,59.22507542313355
1747352516010922,114862604,1,1228,50,115601234,114753024,848210,58.94766626189269
1747352516109251,114957244,1,1229,50,115699563,114847664,851899,58.69240367696171
1747352516198916,115051884,1,1230,50,115789228,114942304,846924,59.03717452805682
1747352516309100,115146524,1,1231,50,115899412,115036944,862468,57.97316538120835
1747352516387513,115241164,1,1232,50,115977825,115131584,846241,59.08482335410362
1747352516498169,115335804,1,1233,50,116088481,115226224,862257,57.98735179882564
1747352516583892,115430444,1,1234,50,116174204,115320864,853340,58.59329223990438
1747352516678622,115525084,1,1235,50,116268934,115415504,853430,58.587113178585234
1747352516768191,115619724,1,1236,50,116358503,115510144,848359,58.93731309504585
1747352516866455,115714364,1,1237,50,116456767,115604784,851983,58.68661698648916
1747352516973618,115809004,1,1238,50,116563930,115699424,864506,57.83649853210967
1747352517062858,115903644,1,1239,50,116653170,115794064,859106,58.20003585122208
1747352517152933,115998284,1,1240,50,116743245,115888704,854541,58.510943301725725
1747352517243058,116092924,1,1241,50,116833370,115983344,850026,58.8217301588422
1747352517349560,116187564,1,1242,50,116939872,116077984,861888,58.01217791638821
1747352517562344,116379964,1,1244,50,117152656,116270384,882272,56.67186536578289
1747352517632226,116474604,1,1245,50,117222538,116365024,857514,58.308085932124726
1747352517735000,116569244,1,1246,50,117325312,116459664,865648,57.7601981405837
1747352517923650,116761644,1,1248,50,117513962,116652064,861898,58.01150484164019
1747352518017712,116856284,1,1249,50,117608024,116746704,861320,58.05043421724795
1747352518127828,116950924,1,1250,50,117718140,116841344,876796,57.02580759948722
1747352518218449,117045564,1,1251,50,117808761,116935984,872777,57.28840242123704
1747352518300457,117140204,1,1252,50,117890769,117030624,860145,58.12973394020775
1747352518402731,117234844,1,1253,50,117993043,117125264,867779,57.618356747512905
1747352518590889,117427244,1,1255,50,118181201,117317664,863537,57.90139855038058
1747352518705560,117521884,1,1256,50,118295872,117412304,883568,56.5887401988302
1747352518787265,117616524,1,1257,50,118377577,117506944,870633,57.42947947068397
1747352518872979,117711164,1,1258,50,118463291,117601584,861707,58.02436326964966
1747352518971362,117805804,1,1259,50,118561674,117696224,865450,57.77341267548674
1747352519073884,117900444,1,1260,50,118664196,117790864,873332,57.25199580457375
1747352519160172,117995084,1,1261,50,118750484,117885504,864980,57.80480473536961
1747352519258432,118089724,1,1262,50,118848744,117980144,868600,57.56389592447616
1747352519352155,118184364,1,1263,50,118942467,118074784,867683,57.62473161281252
1747352519451043,118279004,1,1264,50,119041355,118169424,871931,57.34398708154659
1747352519540590,118373644,1,1265,50,119130902,118264064,866838,57.68090462116336
1747352519639600,118468284,1,1266,50,119229912,118358704,871208,57.391575834932645
1747352519733779,118562924,1,1267,50,119324091,118453344,870747,57.42196068433196
1747352519831668,118657564,1,1268,50,119421980,118547984,873996,57.20849981006778
1747352519929927,118752204,1,1269,50,119520239,118642624,877615,56.97259048671684
1747352520023880,118846844,1,1270,50,119614192,118737264,876928,57.01722376295431
1747352520118250,118941484,1,1271,50,119708562,118831904,876658,57.03478437429419
1747352520212241,119036124,1,1272,50,119802553,118926544,876009,57.07703916283965
1747352520315029,119130764,1,1273,50,119905341,119021184,884157,56.55104240536466
1747352520405616,119225404,1,1274,50,119995928,119115824,880104,56.81146773563125
1747352520495748,119320044,1,1275,50,120086060,119210464,875596,57.10396118757966
1747352520593558,119414684,1,1276,50,120183870,119305104,878766,56.89796828734839
1747352520687575,119509324,1,1277,50,120277887,119399744,878143,56.938334644812976
1747352520786476,119603964,1,1278,50,120376788,119494384,882404,56.66338774529581
1747352520884237,119698604,1,1279,50,120474549,119589024,885525,56.46367973800852
1747352520974501,119793244,1,1280,50,120564813,119683664,881149,56.74409208885217
1747352521072634,119887892,1,1281,50,120662946,119778312,884634,56.520549741475
1747352521162675,119982524,1,1282,50,120752987,119872944,880043,56.81540561086219
1747352521273600,120077164,1,1283,50,120863912,119967584,896328,55.78315081086388
1747352521355620,120171804,1,1284,50,120945932,120062224,883708,56.579775219869006
1747352521453539,120266444,1,1285,50,121043851,120156864,886987,56.37061197063768
1747352521547689,120361084,1,1286,50,121138001,120251504,886497,56.40177011315323
1747352521642282,120455724,1,1287,50,121232594,120346144,886450,56.40476056179142
1747352521740072,120550364,1,1288,50,121330384,120440784,889600,56.20503597122303
1747352521834501,120645004,1,1289,50,121424813,120535424,889389,56.218370139500266
1747352521925107,120739644,1,1290,50,121515419,120630064,885355,56.47452151961642
1747352522023300,120834284,1,1291,50,121613612,120724704,888908,56.248790651001
1747352522121109,120928924,1,1292,50,121711421,120819344,892077,56.04897335095513
1747352522211811,121023564,1,1293,50,121802123,120913984,888139,56.29749397335327
1747352522318836,121118204,1,1294,50,121909148,121008624,900524,55.52322869795808
1747352522403586,121212844,1,1295,50,121993898,121103264,890634,56.13978356990638
1747352522498358,121307484,1,1296,50,122088670,121197904,890766,56.13146438009534
1747352522596691,121402124,1,1297,50,122187003,121292544,894459,55.89971144568952
1747352522690769,121496764,1,1298,50,122281081,121387184,893897,55.93485602927407
1747352522793248,121591404,1,1299,50,122383560,121481824,901736,55.44860136447918
1747352522887390,121686052,1,1300,50,122477702,121576472,901230,55.47973325344252
1747352522977884,121780684,1,1301,50,122568196,121671104,897092,55.73564361291818
1747352523071490,121875324,1,1302,50,122661802,121765744,896058,55.79995937762957
1747352523166578,121969964,1,1303,50,122756890,121860384,896506,55.77207514506316
1747352523268629,122064604,1,1304,50,122858941,121955024,903917,55.31481319634435
1747352523354960,122159244,1,1305,50,122945272,122049664,895608,55.82799617689882
1747352523452695,122253884,1,1306,50,123043007,122144304,898703,55.63573282830924
1747352523550755,122348524,1,1307,50,123141067,122238944,902123,55.424814576282834
1747352523645107,122443164,1,1308,50,123235419,122333584,901835,55.44251442891438
1747352523739036,122537804,1,1309,50,123329348,122428224,901124,55.48625938272646
1747352523845794,122632444,1,1310,50,123436106,122522864,913242,54.75000054750001
1747352523931851,122727084,1,1311,50,123522163,122617504,904659,55.26944406676992
1747352524025628,122821724,1,1312,50,123615940,122712144,903796,55.322218730775525
1747352524120303,122916364,1,1313,50,123710615,122806784,903831,55.32007643021759
1747352524214247,123011004,1,1314,50,123804559,122901424,903135,55.36270878661552
1747352524317152,123105644,1,1315,50,123907464,122996064,911400,54.86065393899495
1747352524406531,123200284,1,1316,50,123996843,123090704,906139,55.17917229034398
1747352524501392,123294924,1,1317,50,124091704,123185344,906360,55.16571781632023
1747352524598834,123389564,1,1318,50,124189146,123279984,909162,54.9956993363119
1747352524688913,123484204,1,1319,50,124279225,123374624,904601,55.27298775924413
1747352524787645,123578844,1,1320,50,124377957,123469264,908693,55.024084041585006
1747352524886043,123673484,1,1321,50,124476355,123563904,912451,54.79746309664848
1747352524980232,123768124,1,1322,50,124570544,123658544,912000,54.82456140350877
1747352525078867,123862764,1,1323,50,124669179,123753184,915995,54.58545079394538
1747352525192708,123957404,1,1324,50,124783020,123847824,935196,53.46472824947925
1747352525271210,124052044,1,1325,50,124861522,123942464,919058,54.403530571519966
1747352525357060,124146684,1,1326,50,124947372,124037104,910268,54.92887808865082
1747352525455319,124241324,1,1327,50,125045631,124131744,913887,54.71135928183681
1747352525549874,124335964,1,1328,50,125140186,124226384,913802,54.716448420992734
1747352525664449,124430604,1,1329,50,125254761,124321024,933737,53.54826894510981
1747352525746479,124525244,1,1330,50,125336791,124415664,921127,54.28133145592302
1747352525844518,124619884,1,1331,50,125434830,124510304,924526,54.08176730562472
1747352525938213,124714524,1,1332,50,125528525,124604944,923581,54.13710329684132
1747352526024869,124809164,1,1333,50,125615181,124699584,915597,54.60917849228427
1747352526127368,124903804,1,1334,50,125717680,124794224,923456,54.14443135352415
1747352526225165,124998444,1,1335,50,125815477,124888864,926613,53.95995955161432
1747352526315073,125093084,1,1336,50,125905385,124983504,921881,54.2369351358798
1747352526421349,125187724,1,1337,50,126011661,125078144,933517,53.56088855371675
1747352526503505,125282364,1,1338,50,126093817,125172784,921033,54.28687137160124
1747352526597842,125377004,1,1339,50,126188154,125267424,920730,54.30473645911396
1747352526692121,125471644,1,1340,50,126282433,125362064,920369,54.32603662226781
1747352526786014,125566284,1,1341,50,126376326,125456704,919622,54.37016513306554
1747352526896880,125660924,1,1342,50,126487192,125551344,935848,53.42747967618673
1747352526983148,125755564,1,1343,50,126573460,125645984,927476,53.90975076444027
1747352527094060,125850204,1,1344,50,126684372,125740624,943748,52.98024472634644
1747352527188061,125944852,1,1345,50,126778373,125835272,943101,53.016591011991295
1747352527269908,126039484,1,1346,50,126860220,125929904,930316,53.74517905743855
1747352527363588,126134124,1,1347,50,126953900,126024544,929356,53.80069639621416
1747352527462381,126228764,1,1348,50,127052693,126119184,933509,53.56134756065555
1747352527573075,126323404,1,1349,50,127163387,126213824,949563,52.65580061565162
1747352527670615,126418044,1,1350,50,127260927,126308464,952463,52.49547751461212
1747352527753274,126512684,1,1351,50,127343586,126403104,940482,53.16422855514512
1747352527838487,126607324,1,1352,50,127428799,126497744,931055,53.70252025927577
1747352527953685,126701964,1,1353,50,127543997,126592384,951613,52.54236753806432
1747352528035289,126796604,1,1354,50,127625601,126687024,938577,53.27213430544324
1747352528130123,126891244,1,1355,50,127720435,126781664,938771,53.26112545018966
1747352528220350,126985884,1,1356,50,127810662,126876304,934358,53.51267929423197
1747352528322452,127080524,1,1357,50,127912764,126970944,941820,53.08870060096409
1747352528429092,127175164,1,1358,50,128019404,127065584,953820,52.42079218301147
1747352528527328,127269804,1,1359,50,128117640,127160224,957416,52.22390267135707
1747352528605104,127364444,1,1360,50,128195416,127254864,940552,53.16027184036608
1747352528703142,127459084,1,1361,50,128293454,127349504,943950,52.968907251443405
1747352528801041,127553724,1,1362,50,128391353,127444144,947209,52.78666059971981
1747352529091741,127843884,1,1365,50,128682053,127734304,947749,52.75658428550175
1747352529178102,127938524,1,1366,50,128768414,127828944,939470,53.22149722715999
1747352529281062,128033164,1,1367,50,128871374,127923584,947790,52.75430211333734
1747352529370722,128127804,1,1368,50,128961034,128018224,942810,53.03295467803693
1747352529567310,128320204,1,1370,50,129157622,128210624,946998,52.79842196076444
1747352529665739,128414844,1,1371,50,129256051,128305264,950787,52.58801392951312
1747352529762971,128509484,1,1372,50,129353283,128399904,953379,52.44504022010135
1747352529948498,128701884,1,1374,50,129538810,128592304,946506,52.82586692530212
1747352530042921,128796524,1,1375,50,129633233,128686944,946289,52.83798078599666
1747352530153287,128891164,1,1376,50,129743599,128781584,962015,51.97424156587995
1747352530247728,128985804,1,1377,50,129838040,128876224,961816,51.98499505102847
1747352530350062,129080444,1,1378,50,129940374,128970864,969510,51.57244381182247
1747352530530145,129272852,1,1380,50,130120457,129163272,957185,52.23650600458637
1747352530619609,129367484,1,1381,50,130209921,129257904,952017,52.52007054495876
1747352530717937,129462124,1,1382,50,130308249,129352544,955705,52.317399197451095
1747352530808443,129556764,1,1383,50,130398755,129447184,951571,52.54468662874342
1747352622474565,7109244,1,76,75,0,0,0,0.0
1747352622564533,7199724,1,77,75,89968,90480,-512,0.0
1747352622654819,7290204,1,78,75,180254,180960,-706,0.0
1747352622744008,7380684,1,79,75,269443,271440,-1997,0.0
1747352622838899,7471164,1,80,75,364334,361920,2414,31068.76553438277
1747352622929089,7561644,1,81,75,454524,452400,2124,35310.73446327684
1747352623019322,7652124,1,82,75,544757,542880,1877,39957.37879595099
1747352623108635,7742604,1,83,75,634070,633360,710,105633.8028169014
1747352623202924,7833084,1,84,75,728359,723840,4519,16596.5921664085
1747352623293711,7923564,1,85,75,819146,814320,4826,15540.82055532532
1747352623383685,8014044,1,86,75,909120,904800,4320,17361.11111111111
1747352623474052,8104524,1,87,75,999487,995280,4207,17827.430473021155
1747352623567871,8195004,1,88,75,1093306,1085760,7546,9939.04055128545
1747352623657581,8285484,1,89,75,1183016,1176240,6776,11068.476977567889
1747352623748386,8375964,1,90,75,1273821,1266720,7101,10561.892691170258
1747352623838130,8466452,1,91,75,1363565,1357208,6357,11798.01793298726
1747352623932641,8556924,1,92,75,1458076,1447680,10396,7214.313197383609
1747352624022195,8647404,1,93,75,1547630,1538160,9470,7919.746568109821
1747352624112752,8737884,1,94,75,1638187,1628640,9547,7855.870954226459
1747352624202746,8828364,1,95,75,1728181,1719120,9061,8277.232093587905
1747352624296545,8918844,1,96,75,1821980,1809600,12380,6058.158319870759
1747352624386378,9009324,1,97,75,1911813,1900080,11733,6392.227051904883
1747352624477397,9099804,1,98,75,2002832,1990560,12272,6111.4732724902215
1747352624567188,9190284,1,99,75,2092623,2081040,11583,6475.006475006475
1747352624661274,9280764,1,100,75,2186709,2171520,15189,4937.783922575548
1747352624751356,9372284,1,101,75,2276791,2263040,13751,5454.148789178969
1747352624845934,9463804,1,102,75,2371369,2354560,16809,4461.895413171515
1747352624940178,9555324,1,103,75,2465613,2446080,19533,3839.6559668253726
1747352625030022,9646844,1,104,75,2555457,2537600,17857,4200.033600268802
1747352625124215,9738364,1,105,75,2649650,2629120,20530,3653.190452995616
1747352625214198,9829884,1,106,75,2739633,2720640,18993,3948.8232506713
1747352625308791,9921404,1,107,75,2834226,2812160,22066,3398.894226411674
1747352625398999,10012924,1,108,75,2924434,2903680,20754,3613.761202659728
1747352625492705,10105484,1,109,75,3018140,2996240,21900,3424.657534246576
1747352625586607,10198052,1,110,75,3112042,3088808,23234,3228.027890160971
1747352625681135,10290604,1,111,75,3206570,3181360,25210,2975.0099166997225
1747352625771599,10383164,1,112,75,3297034,3273920,23114,3244.786709353639
1747352625865564,10475724,1,113,75,3390999,3366480,24519,3058.8523186100574
1747352625959104,10568284,1,114,75,3484539,3459040,25499,2941.291815365308
1747352626054147,10660844,1,115,75,3579582,3551600,27982,2680.294475019656
1747352626144384,10753404,1,116,75,3669819,3644160,25659,2922.9510113410497
1747352626238400,10845964,1,117,75,3763835,3736720,27115,2765.996680803983
1747352626332801,10938524,1,118,75,3858236,3829280,28956,2590.136759220887
1747352626426705,11031084,1,119,75,3952140,3921840,30300,2475.247524752476
1747352626520137,11123644,1,120,75,4045572,4014400,31172,2406.0053894520724
1747352626611212,11216204,1,121,75,4136647,4106960,29687,2526.3583386667565
1747352626705356,11308764,1,122,75,4230791,4199520,31271,2398.3882830737743
1747352626798886,11401324,1,123,75,4324321,4292080,32241,2326.2305759746905
1747352626893647,11493884,1,124,75,4419082,4384640,34442,2177.5738923407466
1747352626983965,11586444,1,125,75,4509400,4477200,32200,2329.192546583851
1747352627078064,11679004,1,126,75,4603499,4569760,33739,2222.946738196153
1747352627171732,11771564,1,127,75,4697167,4662320,34847,2152.26561827417
1747352627265922,11864124,1,128,75,4791357,4754880,36477,2056.090138991693
1747352627355906,11956684,1,129,75,4881341,4847440,33901,2212.3241202324416
1747352627450380,12049244,1,130,75,4975815,4940000,35815,2094.094653078319
1747352627545192,12141804,1,131,75,5070627,5032560,38067,1970.2104184726927
1747352627639308,12234364,1,132,75,5164743,5125120,39623,1892.8400171617493
1747352627728946,12326932,1,133,75,5254381,5217688,36693,2043.98659144796
1747352627822942,12419484,1,134,75,5348377,5310240,38137,1966.5941211946408
1747352627917757,12512044,1,135,75,5443192,5402800,40392,1856.8033273915628
1747352628011773,12604604,1,136,75,5537208,5495360,41848,1792.200344102466
1747352628105275,12697164,1,137,75,5630710,5587920,42790,1752.745968684272
1747352628196395,12789724,1,138,75,5721830,5680480,41350,1813.7847642079807
1747352628289834,12882284,1,139,75,5815269,5773040,42229,1776.0306898103197
1747352628383942,12974844,1,140,75,5909377,5865600,43777,1713.2284076113026
1747352628478677,13067404,1,141,75,6004112,5958160,45952,1632.1378830083563
1747352628568861,13159964,1,142,75,6094296,6050720,43576,1721.1308977418764
1747352628663074,13252524,1,143,75,6188509,6143280,45229,1658.228127970992
1747352628756796,13345084,1,144,75,6282231,6235840,46391,1616.6928930180422
1747352628851273,13437644,1,145,75,6376708,6328400,48308,1552.537881924319
1747352628941767,13530204,1,146,75,6467202,6420960,46242,1621.902166861295
1747352629035133,13622764,1,147,75,6560568,6513520,47048,1594.1166468287706
1747352629129834,13715324,1,148,75,6655269,6606080,49189,1524.7311390758098
1747352629224052,13807884,1,149,75,6749487,6698640,50847,1475.013275119476
1747352629314364,13900444,1,150,75,6839799,6791200,48599,1543.2416304862238
1747352629407874,13993004,1,151,75,6933309,6883760,49549,1513.653151425861
1747352629502131,14085564,1,152,75,7027566,6976320,51246,1463.5288607891348
1747352629596362,14178124,1,153,75,7121797,7068880,52917,1417.3139066840524
1747352629691020,14270684,1,154,75,7216455,7161440,55015,1363.264564209761
1747352629784595,14363244,1,155,75,7310030,7254000,56030,1338.5686239514546
1747352629875218,14455804,1,156,75,7400653,7346560,54093,1386.5010260107592
1747352629969361,14548364,1,157,75,7494796,7439120,55676,1347.0795315755445
1747352630063130,14640924,1,158,75,7588565,7531680,56885,1318.4495033840203
1747352630153275,14733484,1,159,75,7678710,7624240,54470,1376.9047181935011
1747352630247512,14826044,1,160,75,7772947,7716800,56147,1335.7792936399094
1747352630342236,14918604,1,161,75,7867671,7809360,58311,1286.2067191439007
1747352630436523,15011164,1,162,75,7961958,7901920,60038,1249.2088344048768
1747352630526893,15103724,1,163,75,8052328,7994480,57848,1296.5011754943991
1747352630620400,15196284,1,164,75,8145835,8087040,58795,1275.618675057403
1747352630715102,15288844,1,165,75,8240537,8179600,60937,1230.7793294714213
1747352630809531,15381404,1,166,75,8334966,8272160,62806,1194.1534248320224
1747352630899543,15473964,1,167,75,8424978,8364720,60258,1244.6480135417703
1747352630993707,15566524,1,168,75,8519142,8457280,61862,1212.3759335294687
1747352631087771,15659084,1,169,75,8613206,8549840,63366,1183.600037875201
1747352631181549,15751644,1,170,75,8706984,8642400,64584,1161.2783351913786
1747352631276079,15844204,1,171,75,8801514,8734960,66554,1126.9044685518527
1747352631365862,15936764,1,172,75,8891297,8827520,63777,1175.972529281716
1747352631459857,16029324,1,173,75,8985292,8920080,65212,1150.0950745261607
1747352631554595,16121892,1,174,75,9080030,9012648,67382,1113.056899468701
1747352631648356,16214444,1,175,75,9173791,9105200,68591,1093.4379145952091
1747352631738573,16307004,1,176,75,9264008,9197760,66248,1132.109648593165
1747352631833391,16399564,1,177,75,9358826,9290320,68506,1094.794616529939
1747352631927522,16492124,1,178,75,9452957,9382880,70077,1070.251295004067
1747352632021475,16584684,1,179,75,9546910,9475440,71470,1049.391353015251
1747352632111366,16677244,1,180,75,9636801,9568000,68801,1090.1004345867066
1747352632205032,16769804,1,181,75,9730467,9660560,69907,1072.853934512996
1747352632300202,16862364,1,182,75,9825637,9753120,72517,1034.2402471144696
1747352632393939,16954924,1,183,75,9919374,9845680,73694,1017.7219312291368
1747352632484540,17047484,1,184,75,10009975,9938240,71735,1045.514741757859
1747352632577820,17140044,1,185,75,10103255,10030800,72455,1035.1252501552688
1747352632672172,17232604,1,186,75,10197607,10123360,74247,1010.1418239120774
1747352632766419,17325164,1,187,75,10291854,10215920,75934,987.6998446018912
1747352632860745,17417724,1,188,75,10386180,10308480,77700,965.2509652509652
1747352632950737,17510284,1,189,75,10476172,10401040,75132,998.2430921578024
1747352633044991,17602844,1,190,75,10570426,10493600,76826,976.2320047900448
1747352633139185,17695404,1,191,75,10664620,10586160,78460,955.9010960999236
1747352633233323,17787964,1,192,75,10758758,10678720,80038,937.0548989230116
1747352633324216,17880524,1,193,75,10849651,10771280,78371,956.9866404664992
1747352633418342,17973084,1,194,75,10943777,10863840,79937,938.238863104695
1747352633512229,18065644,1,195,75,11037664,10956400,81264,922.917897223863
1747352633605729,18158204,1,196,75,11131164,11048960,82204,912.364361831541
1747352633696863,18250772,1,197,75,11222298,11141528,80770,928.562585118237
1747352633789629,18343324,1,198,75,11315064,11234080,80984,926.108861009582
1747352633884820,18435884,1,199,75,11410255,11326640,83615,896.9682473240448
1747352633979072,18528444,1,200,75,11504507,11419200,85307,879.1775586997551
1747352634069179,18621004,1,201,75,11594614,11511760,82854,905.2067492215224
1747352634163783,18713564,1,202,75,11689218,11604320,84898,883.4130368206554
1747352634257575,18806124,1,203,75,11783010,11696880,86130,870.7767328456983
1747352634352220,18898684,1,204,75,11877655,11789440,88215,850.1955449753443
1747352634445578,18991244,1,205,75,11971013,11882000,89013,842.5735566714975
1747352634535892,19083804,1,206,75,12061327,11974560,86767,864.3839247640232
1747352634630391,19176364,1,207,75,12155826,12067120,88706,845.4895948413862
1747352634724135,19268924,1,208,75,12249570,12159680,89890,834.3530982311714
1747352634818485,19361484,1,209,75,12343920,12252240,91680,818.062827225131
1747352634908603,19454044,1,210,75,12434038,12344800,89238,840.4491360182882
1747352635003435,19546604,1,211,75,12528870,12437360,91510,819.5825592831385
1747352635096968,19639164,1,212,75,12622403,12529920,92483,810.959852080923
1747352635191153,19731724,1,213,75,12716588,12622480,94108,796.9566880605262
1747352635281691,19824284,1,214,75,12807126,12715040,92086,814.4560519514367
1747352635376052,19916844,1,215,75,12901487,12807600,93887,798.8326392365291
1747352635469507,20009404,1,216,75,12994942,12900160,94782,791.2894853453187
1747352635564084,20101964,1,217,75,13089519,12992720,96799,774.8013925763696
1747352635654119,20194524,1,218,75,13179554,13085280,94274,795.5533869359526
1747352635748839,20287084,1,219,75,13274274,13177840,96434,777.7339942343987
1747352635842504,20379644,1,220,75,13367939,13270400,97539,768.9231999507889
1747352635937094,20472204,1,221,75,13462529,13362960,99569,753.246492382167
1747352636031339,20564764,1,222,75,13556774,13455520,101254,740.7114780650642
1747352636120982,20657324,1,223,75,13646417,13548080,98337,762.6834253638001
1747352636214934,20749884,1,224,75,13740369,13640640,99729,752.038023042445
1747352636309604,20842444,1,225,75,13835039,13733200,101839,736.4565637918676
1747352636403921,20935004,1,226,75,13929356,13825760,103596,723.9661763002433
1747352636494415,21027564,1,227,75,14019850,13918320,101530,738.6979217965134
1747352636587968,21120124,1,228,75,14113403,14010880,102523,731.5431659237439
1747352636682460,21212684,1,229,75,14207895,14103440,104455,718.0125412857211
1747352636776009,21305244,1,230,75,14301444,14196000,105444,711.2780243541596
1747352636866221,21397804,1,231,75,14391656,14288560,103096,727.4773027081555
1747352636960444,21490364,1,232,75,14485879,14381120,104759,715.9289416661098
1747352637055247,21582924,1,233,75,14580682,14473680,107002,700.9214781032131
1747352637149158,21675484,1,234,75,14674593,14566240,108353,692.1820346460181
1747352637243179,21768044,1,235,75,14768614,14658800,109814,682.9730271185823
1747352637332799,21860604,1,236,75,14858234,14751360,106874,701.7609521492599
1747352637427240,21953164,1,237,75,14952675,14843920,108755,689.623465587789
1747352637521469,22045732,1,238,75,15046904,14936488,110416,679.249384147225
1747352637615779,22138284,1,239,75,15141214,15029040,112174,668.6041328650133
1747352637706069,22230844,1,240,75,15231504,15121600,109904,682.4137429028971
1747352637800479,22323404,1,241,75,15325914,15214160,111754,671.1169175152567
1747352637894344,22415964,1,242,75,15419779,15306720,113059,663.3704525955474
1747352637988452,22508524,1,243,75,15513887,15399280,114607,654.4102890748384
1747352638078308,22601084,1,244,75,15603743,15491840,111903,670.2233184096941
1747352638173015,22693644,1,245,75,15698450,15584400,114050,657.6063130206051
1747352638267367,22786204,1,246,75,15792802,15676960,115842,647.4335733153779
1747352638361549,22878764,1,247,75,15886984,15769520,117464,638.4934958795886
1747352638451638,22971324,1,248,75,15977073,15862080,114993,652.2136130025306
1747352638545646,23063884,1,249,75,16071081,15954640,116441,644.1030221313798
1747352638640030,23156444,1,250,75,16165465,16047200,118265,634.1690271847124
1747352638733813,23249004,1,251,75,16259248,16139760,119488,627.6780931976433
1747352638828532,23341564,1,252,75,16353967,16232320,121647,616.5380157340502
1747352638918120,23434124,1,253,75,16443555,16324880,118675,631.9780914261639
1747352639012111,23526684,1,254,75,16537546,16417440,120106,624.4484039098796
1747352639106289,23619244,1,255,75,16631724,16510000,121724,616.1480069665802
1747352639200842,23711804,1,256,75,16726277,16602560,123717,606.2222653313611
1747352639290976,23804364,1,257,75,16816411,16695120,121291,618.3476102926021
1747352639385678,23896924,1,258,75,16911113,16787680,123433,607.6170878128215
1747352639479697,23989484,1,259,75,17005132,16880240,124892,600.5188482849181
1747352639574120,24082044,1,260,75,17099555,16972800,126755,591.692635398998
1747352639664133,24174612,1,261,75,17189568,17065368,124200,603.8647342995168
1747352639757898,24267164,1,262,75,17283333,17157920,125413,598.0241282801624
1747352639852407,24359724,1,263,75,17377842,17250480,127362,588.8726621755311
1747352639946804,24452284,1,264,75,17472239,17343040,129199,580.4998490700392
1747352640036997,24544844,1,265,75,17562432,17435600,126832,591.3334174340861
1747352640130266,24637404,1,266,75,17655701,17528160,127541,588.0461969092293
1747352640224621,24729964,1,267,75,17750056,17620720,129336,579.8849508257562
1747352640318722,24822524,1,268,75,17844157,17713280,130877,573.0571452585252
1747352640413790,24915084,1,269,75,17939225,17805840,133385,562.2821156801739
1747352640503914,25007644,1,270,75,18029349,17898400,130949,572.7420598859097
1747352640598017,25100204,1,271,75,18123452,17990960,132492,566.0719137759261
1747352640690971,25192764,1,272,75,18216406,18083520,132886,564.3935403277998
1747352640785591,25285324,1,273,75,18311026,18176080,134946,555.7778667022365
1747352640876690,25377884,1,274,75,18402125,18268640,133485,561.8608832453085
1747352640970411,25470444,1,275,75,18495846,18361200,134646,557.0161757497439
1747352641064634,25563004,1,276,75,18590069,18453760,136309,550.2204549956349
1747352641158493,25655564,1,277,75,18683928,18546320,137608,545.026451950468
1747352641248484,25748124,1,278,75,18773919,18638880,135039,555.395108079888
1747352641343245,25840684,1,279,75,18868680,18731440,137240,546.4879044010493
1747352641436993,25933244,1,280,75,18962428,18824000,138428,541.7979021585229
1747352641531890,26025804,1,281,75,19057325,18916560,140765,532.8028984477676
1747352641621693,26118364,1,282,75,19147128,19009120,138008,543.446756709756
1747352641715541,26210924,1,283,75,19240976,19101680,139296,538.42177808408
1747352641809608,26303484,1,284,75,19335043,19194240,140803,532.6591052747456
1747352641904640,26396044,1,285,75,19430075,19286800,143275,523.4688536032105
1747352641998066,26488604,1,286,75,19523501,19379360,144141,520.3238495639687
1747352642088677,26581164,1,287,75,19614112,19471920,142192,527.4558343648025
1747352642183166,26673724,1,288,75,19708601,19564480,144121,520.3960560917562
1747352642277333,26766284,1,289,75,19802768,19657040,145728,514.6574440052701
1747352642371857,26858844,1,290,75,19897292,19749600,147692,507.8135579449124
1747352642461849,26951404,1,291,75,19987284,19842160,145124,516.7994266971693
1747352642555785,27043964,1,292,75,20081220,19934720,146500,511.9453924914676
1747352642649782,27136524,1,293,75,20175217,20027280,147937,506.9725626449096
1747352642744152,27229084,1,294,75,20269587,20119840,149747,500.8447581587611
1747352642834542,27321644,1,295,75,20359977,20212400,147577,508.2092738028283
1747352642928183,27414204,1,296,75,20453618,20304960,148658,504.5137160462269
1747352643022667,27506764,1,297,75,20548102,20397520,150582,498.0674981073435
1747352643116532,27599324,1,298,75,20641967,20490080,151887,493.7881451342116
1747352643207202,27691884,1,299,75,20732637,20582640,149997,500.010000200004
1747352643300644,27784444,1,300,75,20826079,20675200,150879,497.08706977114105
1747352643394644,27877004,1,301,75,20920079,20767760,152319,492.38768636873925
1747352643488839,27969572,1,302,75,21014274,20860328,153946,487.1838177023112
1747352643583307,28062124,1,303,75,21108742,20952880,155862,481.1949031835855
1747352643674039,28154684,1,304,75,21199474,21045440,154034,486.9054883986652
1747352643767790,28247244,1,305,75,21293225,21138000,155225,483.16959252697694
1747352643861488,28339804,1,306,75,21386923,21230560,156363,479.65311486732793
1747352643956595,28432364,1,307,75,21482030,21323120,158910,471.96526335661696
1747352644046389,28524924,1,308,75,21571824,21415680,156144,480.32585305871504
1747352644140214,28617484,1,309,75,21665649,21508240,157409,476.4657675228227
1747352644234495,28710044,1,310,75,21759930,21600800,159130,471.3127631496261
1747352644328456,28802604,1,311,75,21853891,21693360,160531,467.1994817200416
1747352644419102,28895164,1,312,75,21944537,21785920,158617,472.83708555829446
1747352644513302,28987724,1,313,75,22038737,21878480,160257,467.99827776633776
1747352644607101,29080284,1,314,75,22132536,21971040,161496,464.4077871897756
1747352644701074,29172844,1,315,75,22226509,22063600,162909,460.3797211940408
1747352644792201,29265404,1,316,75,22317636,22156160,161476,464.4653075379623
1747352644886270,29357964,1,317,75,22411705,22248720,162985,460.1650458631163
1747352644980428,29450524,1,318,75,22505863,22341280,164583,455.6971254625325
1747352645074308,29543084,1,319,75,22599743,22433840,165903,452.0713911140848
1747352645168238,29635644,1,320,75,22693673,22526400,167273,448.3688341812486
1747352645259074,29728204,1,321,75,22784509,22618960,165549,453.03807331968176
1747352645352674,29820764,1,322,75,22878109,22711520,166589,450.2097977657589
1747352645447015,29913324,1,323,75,22972450,22804080,168370,445.44752628140407
1747352645541540,30005884,1,324,75,23066975,22896640,170335,440.3088032406728
1747352645631228,30098452,1,325,75,23156663,22989208,167455,447.881520408468
1747352645725295,30191004,1,326,75,23250730,23081760,168970,443.8657749896431
1747352645819255,30283564,1,327,75,23344690,23174320,170370,440.2183483007572
1747352645914353,30376124,1,328,75,23439788,23266880,172908,433.7566798528697
1747352646004468,30468684,1,329,75,23529903,23359440,170463,439.9781770824167
1747352646098432,30561244,1,330,75,23623867,23452000,171867,436.38394805285486
1747352646192231,30653804,1,331,75,23717666,23544560,173106,433.26054556167895
1747352646286909,30746364,1,332,75,23812344,23637120,175224,428.0235584166553
1747352646377147,30838924,1,333,75,23902582,23729680,172902,433.7717319637714
1747352646470737,30931484,1,334,75,23996172,23822240,173932,431.2029988731228
1747352646564725,31024044,1,335,75,24090160,23914800,175360,427.69160583941607
1747352646659834,31116604,1,336,75,24185269,24007360,177909,421.56383319562246
1747352646753201,31209164,1,337,75,24278636,24099920,178716,419.6602430672128
1747352646843847,31301724,1,338,75,24369282,24192480,176802,424.2033461159942
1747352646937421,31394284,1,339,75,24462856,24285040,177816,421.78431637198
1747352647031736,31486844,1,340,75,24557171,24377600,179571,417.6620946589371
1747352647126170,31579404,1,341,75,24651605,24470160,181445,413.3483975860454
1747352647216756,31671964,1,342,75,24742191,24562720,179471,417.89481308958
1747352647310618,31764524,1,343,75,24836053,24655280,180773,414.8849662283638
1747352647405132,31857084,1,344,75,24930567,24747840,182727,410.448373803543
1747352647498761,31949644,1,345,75,25024196,24840400,183796,408.06111123201816
1747352647589475,32042204,1,346,75,25114910,24932960,181950,412.2011541632317
1747352647682907,32134764,1,347,75,25208342,25025520,182822,410.2350920567546
1747352647777203,32227324,1,348,75,25302638,25118080,184558,406.3763153046739
1747352647871725,32319884,1,349,75,25397160,25210640,186520,402.101651297448
1747352647961239,32412444,1,350,75,25486674,25303200,183474,408.7772654436051
1747352648056295,32505004,1,351,75,25581730,25395760,185970,403.2908533634457
1747352648150179,32597564,1,352,75,25675614,25488320,187294,400.4399500250943
1747352648244660,32690124,1,353,75,25770095,25580880,189215,396.37449462251936
1747352648338160,32782684,1,354,75,25863595,25673440,190155,394.4150824327522
1747352648428526,32875244,1,355,75,25953961,25766000,187961,399.01894541952856
1747352648522458,32967804,1,356,75,26047893,25858560,189333,396.1274579708767
1747352648617388,33060364,1,357,75,26142823,25951120,191703,391.2301841911707
1747352648710869,33152924,1,358,75,26236304,26043680,192624,389.35958136057815
1747352648801533,33245484,1,359,75,26326968,26136240,190728,393.230149742041
1747352648895312,33338044,1,360,75,26420747,26228800,191947,390.7328585494954
1747352648990048,33430604,1,361,75,26515483,26321360,194123,386.35298238745537
1747352649084248,33523164,1,362,75,26609683,26413920,195763,383.1163192227336
1747352649174038,33615724,1,363,75,26699473,26506480,192993,388.6151311187453
1747352649268294,33708284,1,364,75,26793729,26599040,194689,385.2297767208214
1747352649362297,33800844,1,365,75,26887732,26691600,196132,382.3955295413293
1747352649456142,33893412,1,366,75,26981577,26784168,197409,379.9218880598149
1747352649546665,33985964,1,367,75,27072100,26876720,195380,383.86733544886886
1747352649641160,34078524,1,368,75,27166595,26969280,197315,380.10288117983936
1747352649735628,34171084,1,369,75,27261063,27061840,199223,376.46255703407735
1747352649829780,34263644,1,370,75,27355215,27154400,200815,373.47807683688967
1747352649923924,34356204,1,371,75,27449359,27246960,202399,370.5551904900716
1747352650013249,34448764,1,372,75,27538684,27339520,199164,376.5740796529493
1747352650108385,34541324,1,373,75,27633820,27432080,201740,371.7656389412115
1747352650201789,34633884,1,374,75,27727224,27524640,202584,370.2167989574695
1747352650296543,34726444,1,375,75,27821978,27617200,204778,366.250280791882
1747352650386274,34819004,1,376,75,27911709,27709760,201949,371.3808931958069
1747352650480397,34911564,1,377,75,28005832,27802320,203512,368.52863713196274
1747352650575014,35004124,1,378,75,28100449,27894880,205569,364.8410022912015
1747352650668713,35096684,1,379,75,28194148,27987440,206708,362.8306596745167
1747352650759357,35189244,1,380,75,28284792,28080000,204792,366.2252431735615
1747352650852867,35281804,1,381,75,28378302,28172560,205742,364.5342224728057
1747352650947882,35374364,1,382,75,28473317,28265120,208197,360.23573826712203
1747352651041663,35466924,1,383,75,28567098,28357680,209418,358.13540383348135
1747352651136212,35559484,1,384,75,28661647,28450240,211407,354.7659254423931
1747352651226358,35652044,1,385,75,28751793,28542800,208993,358.8636939993205
1747352651319861,35744604,1,386,75,28845296,28635360,209936,357.25173386174833
1747352651414303,35837164,1,387,75,28939738,28727920,211818,354.0775571481177
1747352651509008,35929724,1,388,75,29034443,28820480,213963,350.5278950098849
1747352651598472,36022292,1,389,75,29123907,28913048,210859,355.6879241578496
1747352651693477,36114844,1,390,75,29218912,29005600,213312,351.5976597659766
1747352651787114,36207404,1,391,75,29312549,29098160,214389,349.8313812742258
1747352651881675,36299964,1,392,75,29407110,29190720,216390,346.5964231249134
1747352651971924,36392524,1,393,75,29497359,29283280,214079,350.3379593514544
1747352652065900,36485084,1,394,75,29591335,29375840,215495,348.0359173066661
1747352652159897,36577644,1,395,75,29685332,29468400,216932,345.73045931443954
1747352652254024,36670204,1,396,75,29779459,29560960,218499,343.2509988604067
1747352652344578,36762764,1,397,75,29870013,29653520,216493,346.431524344898
1747352652438158,36855324,1,398,75,29963593,29746080,217513,344.806977054245
1747352652533692,36947884,1,399,75,30059127,29838640,220487,340.1561089769465
1747352652626277,37040444,1,400,75,30151712,29931200,220512,340.11754462342185
1747352652721005,37133004,1,401,75,30246440,30023760,222680,336.8061792707024
1747352652811113,37225564,1,402,75,30336548,30116320,220228,340.55615089816007
1747352652905785,37318124,1,403,75,30431220,30208880,222340,337.3212197535306
1747352652999727,37410684,1,404,75,30525162,30301440,223722,335.2374822324134
1747352653093723,37503244,1,405,75,30619158,30394000,225158,333.09942351593105
1747352653183399,37595804,1,406,75,30708834,30486560,222274,337.42138081826937
1747352653277665,37688364,1,407,75,30803100,30579120,223980,334.851326011251
1747352653372606,37780924,1,408,75,30898041,30671680,226361,331.32916005849063
1747352653466479,37873484,1,409,75,30991914,30764240,227674,329.41837891019617
1747352653556234,37966044,1,410,75,31081669,30856800,224869,333.52752046747213
1747352653650802,38058604,1,411,75,31176237,30949360,226877,330.5755982316409
1747352653745315,38151164,1,412,75,31270750,31041920,228830,327.7542280295416
1747352653839401,38243724,1,413,75,31364836,31134480,230356,325.5830106443939
1747352653929314,38336284,1,414,75,31454749,31227040,227709,329.3677456754015
1747352654023539,38428844,1,415,75,31548974,31319600,229374,326.97690235161787
1747352654117932,38521404,1,416,75,31643367,31412160,231207,324.3846423334934
1747352654211664,38613964,1,417,75,31737099,31504720,232379,322.7486132567917
1747352654306222,38706524,1,418,75,31831657,31597280,234377,319.99726935663483
1747352654395714,38799084,1,419,75,31921149,31689840,231309,324.2415989001725
1747352654490783,38891644,1,420,75,32016218,31782400,233818,320.76230230350103
1747352654584151,38984204,1,421,75,32109586,31874960,234626,319.65766794813874
1747352654678252,39076764,1,422,75,32203687,31967520,236167,317.57188768964335
1747352654769264,39169324,1,423,75,32294699,32060080,234619,319.66720512831444
1747352654862994,39261884,1,424,75,32388429,32152640,235789,318.0809961448583
1747352654957521,39354444,1,425,75,32482956,32245200,237756,315.44945237975065
1747352655052032,39447004,1,426,75,32577467,32337760,239707,312.8819767466115
1747352655141134,39539564,1,427,75,32666569,32430320,236249,317.4616612133808
1747352655235335,39632124,1,428,75,32760770,32522880,237890,315.2717642607928
1747352655330351,39724684,1,429,75,32855786,32615440,240346,312.05012773251894
1747352655423416,39817252,1,430,75,32948851,32708008,240843,311.4061857724742
1747352655514693,39909804,1,431,75,33040128,32800560,239568,313.0635143257864
1747352655608469,40002364,1,432,75,33133904,32893120,240784,311.4824905309323
1747352655702742,40094924,1,433,75,33228177,32985680,242497,309.2821766867219
1747352655797073,40187484,1,434,75,33322508,33078240,244268,307.03980873466844
1747352655891255,40280044,1,435,75,33416690,33170800,245890,305.0144373500346
1747352655981602,40372604,1,436,75,33507037,33263360,243677,307.78448519967003
1747352656075485,40465164,1,437,75,33600920,33355920,245000,306.12244897959187
1747352656170004,40557724,1,438,75,33695439,33448480,246959,303.69413546378144
1747352656263542,40650284,1,439,75,33788977,33541040,247937,302.4961986311039
1747352656353423,40742844,1,440,75,33878858,33633600,245258,305.80042241231683
1747352656452412,40835404,1,441,75,33977847,33726160,251687,297.9891690870009
1747352656542590,40927964,1,442,75,34068025,33818720,249305,300.836324983454
1747352656636116,41020524,1,443,75,34161551,33911280,250271,299.6751521350856
1747352656726446,41113084,1,444,75,34251881,34003840,248041,302.36936635475587
1747352656820517,41205644,1,445,75,34345952,34096400,249552,300.53856510867473
1747352656915268,41298204,1,446,75,34440703,34188960,251743,297.9228816690037
1747352657009415,41390764,1,447,75,34534850,34281520,253330,296.0565270595666
1747352657099219,41483324,1,448,75,34624654,34374080,250574,299.3127778620288
1747352657193762,41575884,1,449,75,34719197,34466640,252557,296.9626658536489
1747352657288071,41668444,1,450,75,34813506,34559200,254306,294.9202928755122
1747352657382090,41761004,1,451,75,34907525,34651760,255765,293.2379332590464
1747352657476190,41853564,1,452,75,35001625,34744320,257305,291.4828705233089
1747352657566190,41946132,1,453,75,35091625,34836888,254737,294.4213051107613
1747352657660808,42038684,1,454,75,35186243,34929440,256803,292.05266293618064
1747352657754325,42131244,1,455,75,35279760,35022000,257760,290.9683426443204
1747352657848953,42223804,1,456,75,35374388,35114560,259828,288.6524931878012
1747352657939068,42316364,1,457,75,35464503,35207120,257383,291.3945365467028
1747352658032942,42408924,1,458,75,35558377,35299680,258697,289.91445590787674
1747352658127648,42501484,1,459,75,35653083,35392240,260843,287.52928006502
1747352658221529,42594044,1,460,75,35746964,35484800,262164,286.08046871423994
1747352658311753,42686604,1,461,75,35837188,35577360,259828,288.6524931878012
1747352658405479,42779164,1,462,75,35930914,35669920,260994,287.3629278833996
1747352658499826,42871724,1,463,75,36025261,35762480,262781,285.40876242955164
1747352658594304,42964284,1,464,75,36119739,35855040,264699,283.3407001915383
1747352658684556,43056844,1,465,75,36209991,35947600,262391,285.83297445415434
1747352658778349,43149404,1,466,75,36303784,36040160,263624,284.49610050678234
1747352658872268,43241964,1,467,75,36397703,36132720,264983,283.03702501669915
1747352658966643,43334524,1,468,75,36492078,36225280,266798,281.11155256036403
1747352659061179,43427084,1,469,75,36586614,36317840,268774,279.0448480879847
1747352659151392,43519644,1,470,75,36676827,36410400,266427,281.50300082198873
1747352659245658,43612204,1,471,75,36771093,36502960,268133,279.7119340029016
1747352659340085,43704764,1,472,75,36865520,36595520,270000,277.77777777777777
1747352659434091,43797324,1,473,75,36959526,36688080,271446,276.29804823058726
1747352659523371,43889884,1,474,75,37048806,36780640,268166,279.67751318213345
1747352659617706,43982444,1,475,75,37143141,36873200,269941,277.83849063313835
1747352659712688,44075004,1,476,75,37238123,36965760,272363,275.36779959098703
1747352659806526,44167564,1,477,75,37331961,37058320,273641,274.08173482774873
1747352659896836,44260124,1,478,75,37422271,37150880,271391,276.35404269117254
1747352659991127,44352684,1,479,75,37516562,37243440,273122,274.6025585635724
1747352660084761,44445244,1,480,75,37610196,37336000,274196,273.5269661118324
1747352660178930,44537804,1,481,75,37704365,37428560,275805,271.93125577853914
1747352660268729,44630364,1,482,75,37794164,37521120,273044,274.6810037942603
1747352660363794,44722924,1,483,75,37889229,37613680,275549,272.18389469749485
1747352660460454,44815484,1,484,75,37985889,37706240,279649,268.1933423684691
1747352660552239,44908044,1,485,75,38077674,37798800,278874,268.9386604703199
1747352660646309,45000604,1,486,75,38171744,37891360,280384,267.4902990184889
1747352660735819,45093164,1,487,75,38261254,37983920,277334,270.4320422306677
1747352660830386,45185724,1,488,75,38355821,38076480,279341,268.4890510164996
1747352660924584,45278284,1,489,75,38450019,38169040,280979,266.92386263742134
1747352661019246,45370844,1,490,75,38544681,38261600,283081,264.9418364355078
1747352661109372,45463404,1,491,75,38634807,38354160,280647,267.2396284300207
1747352661203567,45555964,1,492,75,38729002,38446720,282282,265.6917550534572
1747352661296894,45648524,1,493,75,38822329,38539280,283049,264.97178933682864
1747352661391950,45741092,1,494,75,38917385,38631848,285537,262.66298238056714
1747352661481441,45833644,1,495,75,39006876,38724400,282476,265.50928220450584
1747352661575388,45926204,1,496,75,39100823,38816960,283863,264.2119614039167
1747352661670335,46018764,1,497,75,39195770,38909520,286250,262.0087336244541
1747352661763693,46111324,1,498,75,39289128,39002080,287048,261.2803433572085
1747352661854236,46203884,1,499,75,39379671,39094640,285031,263.12927365795304
1747352661948569,46296444,1,500,75,39474004,39187200,286804,261.5026289730966
1747352662042693,46389004,1,501,75,39568128,39279760,288368,260.0843366809077
1747352662136953,46481564,1,502,75,39662388,39372320,290068,258.5600617786174
1747352662231028,46574124,1,503,75,39756463,39464880,291583,257.2166415737543
1747352662321831,46666684,1,504,75,39847266,39557440,289826,258.77595522830944
1747352662415760,46759244,1,505,75,39941195,39650000,291195,257.5593674341936
1747352662509266,46851804,1,506,75,40034701,39742560,292141,256.72534837629775
1747352662603448,46944364,1,507,75,40128883,39835120,293763,255.30785020577807
1747352662693749,47036924,1,508,75,40219184,39927680,291504,257.28634941544544
1747352662787894,47129484,1,509,75,40313329,40020240,293089,255.8949670577879
1747352662882044,47222044,1,510,75,40407479,40112800,294679,254.51423413273423
1747352662977005,47314604,1,511,75,40502440,40205360,297080,252.45725057223643
1747352663066228,47407164,1,512,75,40591663,40297920,293743,255.32523328215484
1747352663161175,47499724,1,513,75,40686610,40390480,296130,253.2671461857968
1747352663254734,47592284,1,514,75,40780169,40483040,297129,252.41561745908345
1747352663349424,47684844,1,515,75,40874859,40575600,299259,250.61902900163403
1747352663443919,47777404,1,516,75,40969354,40668160,301194,249.0089444012829
1747352663533434,47869972,1,517,75,41058869,40760728,298141,251.55882619297583
1747352663627431,47962524,1,518,75,41152866,40853280,299586,250.34547675792592
1747352663722015,48055084,1,519,75,41247450,40945840,301610,248.6654951758894
1747352663816053,48147644,1,520,75,41341488,41038400,303088,247.45288497070155
1747352663906325,48240204,1,521,75,41431760,41130960,300800,249.33510638297872
1747352664000929,48332764,1,522,75,41526364,41223520,302844,247.6522566073622
1747352664095110,48425324,1,523,75,41620545,41316080,304465,246.333732941389
1747352664189034,48517884,1,524,75,41714469,41408640,305829,245.23508234994063
1747352664279248,48610444,1,525,75,41804683,41501200,303483,247.1308112810273
1747352664373885,48703004,1,526,75,41899320,41593760,305560,245.4509752585417
1747352664467096,48795564,1,527,75,41992531,41686320,306211,244.92915016116336
1747352664561907,48888124,1,528,75,42087342,41778880,308462,243.14178083524064
1747352664652115,48980684,1,529,75,42177550,41871440,306110,245.00996373852536
1747352664751033,49073244,1,530,75,42276468,41964000,312468,240.0245785168401
1747352664840392,49165804,1,531,75,42365827,42056560,309267,242.5089000766328
1747352664934393,49258364,1,532,75,42459828,42149120,310708,241.3841935193172
1747352665028323,49350924,1,533,75,42553758,42241680,312078,240.3245342510526
1747352665119027,49443484,1,534,75,42644462,42334240,310222,241.76235083262955
1747352665212984,49536044,1,535,75,42738419,42426800,311619,240.67852088608203
1747352665306936,49628604,1,536,75,42832371,42519360,313011,239.60819268332423
1747352665400993,49721164,1,537,75,42926428,42611920,314508,238.46770193445
1747352665491468,49813724,1,538,75,43016903,42704480,312423,240.0591505747016
1747352665585296,49906284,1,539,75,43110731,42797040,313691,239.08878482328151
1747352665679727,49998844,1,540,75,43205162,42889600,315562,237.67120248952665
1747352665774196,50091404,1,541,75,43299631,42982160,317471,236.2420504550022
1747352665863714,50183964,1,542,75,43389149,43074720,314429,238.5276167274647
1747352665958764,50276524,1,543,75,43484199,43167280,316919,236.65352976628097
1747352666052532,50369084,1,544,75,43577967,43259840,318127,235.754902916131
1747352666146643,50461644,1,545,75,43672078,43352400,319678,234.61107739663035
1747352666236688,50554204,1,546,75,43762123,43444960,317163,236.47146735274924
1747352666330672,50646764,1,547,75,43856107,43537520,318587,235.4145021611052
1747352666425691,50739324,1,548,75,43951126,43630080,321046,233.61138279249704
1747352666519403,50831884,1,549,75,44044838,43722640,322198,232.77611903239625
1747352666613026,50924444,1,550,75,44138461,43815200,323261,232.01066630369888
1747352666704114,51017004,1,551,75,44229549,43907760,321789,233.07198195090567
1747352666798158,51109564,1,552,75,44323593,44000320,323273,232.002053991518
1747352666892490,51202124,1,553,75,44417925,44092880,325045,230.73728253011123
1747352666986257,51294684,1,554,75,44511692,44185440,326252,229.8836482228461
1747352667076481,51387244,1,555,75,44601916,44278000,323916,231.54151076204943
1747352667170358,51479804,1,556,75,44695793,44370560,325233,230.6039055077437
1747352667264949,51572364,1,557,75,44790384,44463120,327264,229.17277794074508
1747352667359409,51664932,1,558,75,44884844,44555688,329156,227.8554849372334
1747352667449352,51757484,1,559,75,44974787,44648240,326547,229.6759731370982
1747352667543759,51850044,1,560,75,45069194,44740800,328394,228.3841970316145
1747352667636955,51942604,1,561,75,45162390,44833360,329030,227.9427407835152
1747352667731946,52035164,1,562,75,45257381,44925920,331461,226.27096400481503
1747352667821468,52127724,1,563,75,45346903,45018480,328423,228.36403053379328
1747352667915793,52220284,1,564,75,45441228,45111040,330188,227.1433244091245
1747352668010370,52312844,1,565,75,45535805,45203600,332205,225.7642118571364
1747352668104153,52405404,1,566,75,45629588,45296160,333428,224.93611814244755
1747352668198173,52497964,1,567,75,45723608,45388720,334888,223.9554716800841
1747352668289143,52590524,1,568,75,45814578,45481280,333298,225.023852528368
1747352668382924,52683084,1,569,75,45908359,45573840,334519,224.20251166600403
1747352668476821,52775644,1,570,75,46002256,45666400,335856,223.30998999571244
1747352668571245,52868204,1,571,75,46096680,45758960,337720,222.07746061826364
1747352668661886,52960764,1,572,75,46187321,45851520,335801,223.3465653765176
1747352668756042,53053324,1,573,75,46281477,45944080,337397,222.29006185591453
1747352668849425,53145884,1,574,75,46374860,46036640,338220,221.74915735320204
1747352668944260,53238444,1,575,75,46469695,46129200,340495,220.26755165274088
1747352669033588,53331004,1,576,75,46559023,46221760,337263,222.3783812632871
1747352669128409,53423564,1,577,75,46653844,46314320,339524,220.8974917826133
1747352669222160,53516124,1,578,75,46747595,46406880,340715,220.12532468485392
1747352669316464,53608684,1,579,75,46841899,46499440,342459,219.00431876516603
1747352669406948,53701244,1,580,75,46932383,46592000,340383,220.34002873233976
1747352669501229,53793812,1,581,75,47026664,46684568,342096,219.2367054861793
1747352669595194,53886364,1,582,75,47120629,46777120,343509,218.33489078888763
1747352669689218,53978924,1,583,75,47214653,46869680,344973,217.40831891191488
1747352669783033,54071484,1,584,75,47308468,46962240,346228,216.62026179280707
1747352669873255,54164044,1,585,75,47398690,47054800,343890,218.0929948530053
1747352669967904,54256604,1,586,75,47493339,47147360,345979,216.7761627150781
1747352670061615,54349164,1,587,75,47587050,47239920,347130,216.0573848414139
1747352670156118,54441724,1,588,75,47681553,47332480,349073,214.8547724974432
1747352670246338,54534284,1,589,75,47771773,47425040,346733,216.3047647613581
1747352670340257,54626844,1,590,75,47865692,47517600,348092,215.46028061546943
1747352670435264,54719404,1,591,75,47960699,47610160,350539,213.95622170428967
1747352670529397,54811964,1,592,75,48054832,47702720,352112,213.0004089607852
1747352670619744,54904524,1,593,75,48145179,47795280,349899,214.34756886987387
1747352670713641,54997084,1,594,75,48239076,47887840,351236,213.5316425423362
1747352670807627,55089644,1,595,75,48333062,47980400,352662,212.6682205624649
1747352670901178,55182204,1,596,75,48426613,48072960,353653,212.0722855454358
1747352670992363,55274764,1,597,75,48517798,48165520,352278,212.9000391736072
1747352671085698,55367324,1,598,75,48611133,48258080,353053,212.4326942413745
1747352671180033,55459884,1,599,75,48705468,48350640,354828,211.3700158950252
1747352671273979,55552444,1,600,75,48799414,48443200,356214,210.54759217773588
1747352671368264,55645004,1,601,75,48893699,48535760,357939,209.53290923872504
1747352671458778,55737564,1,602,75,48984213,48628320,355893,210.7374969443063
1747352671552648,55830124,1,603,75,49078083,48720880,357203,209.9646419542949
1747352671647271,55922684,1,604,75,49172706,48813440,359266,208.75896967706385
1747352671741510,56015244,1,605,75,49266945,48906000,360945,207.7878901217637
1747352671831255,56107804,1,606,75,49356690,48998560,358130,209.4211599139977
1747352671925495,56200364,1,607,75,49450930,49091120,359810,208.44334509880213
1747352672020480,56292924,1,608,75,49545915,49183680,362235,207.0479108865792
1747352672113736,56385484,1,609,75,49639171,49276240,362931,206.65085098820435
1747352672204391,56478044,1,610,75,49729826,49368800,361026,207.74127071180467
1747352672298915,56570604,1,611,75,49824350,49461360,362990,206.61726218353124
1747352672393151,56663164,1,612,75,49918586,49553920,364666,205.6676520432396
1747352672486482,56755724,1,613,75,50011917,49646480,365437,205.23373385836683
1747352672577451,56848284,1,614,75,50102886,49739040,363846,206.1311653831566
1747352672671605,56940844,1,615,75,50197040,49831600,365440,205.2320490367776
1747352672765526,57033404,1,616,75,50290961,49924160,366801,204.4705439734352
1747352672859733,57125964,1,617,75,50385168,50016720,368448,203.5565398645128
1747352672953429,57218524,1,618,75,50478864,50109280,369584,202.9308628079137
1747352673044219,57311084,1,619,75,50569654,50201840,367814,203.9074097233928
1747352673138583,57403644,1,620,75,50664018,50294400,369618,202.91219583461844
1747352673232226,57496204,1,621,75,50757661,50386960,370701,202.3193894810103
1747352673326578,57588772,1,622,75,50852013,50479528,372485,201.3503899485885
1747352673416950,57681324,1,623,75,50942385,50572080,370305,202.53574755944425
1747352673510398,57773884,1,624,75,51035833,50664640,371193,202.0512240263152
1747352673605341,57866444,1,625,75,51130776,50757200,373576,200.76236160781207
1747352673698816,57959004,1,626,75,51224251,50849760,374491,200.2718356382396
1747352673789078,58051564,1,627,75,51314513,50942320,372193,201.5083572232685
1747352673883798,58144124,1,628,75,51409233,51034880,374353,200.34566305065005
1747352673978012,58236684,1,629,75,51503447,51127440,376007,199.4643716739316
1747352674071833,58329244,1,630,75,51597268,51220000,377268,198.79767168166927
1747352674166204,58421804,1,631,75,51691639,51312560,379079,197.84794198570748
1747352674256530,58514364,1,632,75,51781965,51405120,376845,199.0208175775186
1747352674350471,58606924,1,633,75,51875906,51497680,378226,198.29414159788064
1747352674444622,58699484,1,634,75,51970057,51590240,379817,197.4635153244852
1747352674538784,58792044,1,635,75,52064219,51682800,381419,196.63414774827683
1747352674628374,58884604,1,636,75,52153809,51775360,378449,198.17729733728984
1747352674723504,58977164,1,637,75,52248939,51867920,381019,196.840577504009
1747352674817714,59069724,1,638,75,52343149,51960480,382669,195.99183628671256
1747352674910980,59162284,1,639,75,52436415,52053040,383375,195.63090968373
1747352675001748,59254844,1,640,75,52527183,52145600,381583,196.5496366452384
1747352675095745,59347404,1,641,75,52621180,52238160,383020,195.8122291264164
1747352675189818,59439964,1,642,75,52715253,52330720,384533,195.04177794883665
1747352675284345,59532524,1,643,75,52809780,52423280,386500,194.0491591203105
1747352675374597,59625084,1,644,75,52900032,52515840,384192,195.2148925537232
1747352675468298,59717652,1,645,75,52993733,52608408,385325,194.6408875624473
1747352675562919,59810204,1,646,75,53088354,52700960,387394,193.60134643283064
1747352675656964,59902764,1,647,75,53182399,52793520,388879,192.8620470634825
1747352675751218,59995324,1,648,75,53276653,52886080,390573,192.0255624428724
1747352675841588,60087884,1,649,75,53367023,52978640,388383,193.10834923258744
1747352675935247,60180444,1,650,75,53460682,53071200,389482,192.56345607755944
1747352676029546,60273004,1,651,75,53554981,53163760,391221,191.70750036424425
1747352676123490,60365564,1,652,75,53648925,53256320,392605,191.03169852650885
1747352676213582,60458124,1,653,75,53739017,53348880,390137,192.24016178932013
1747352676308547,60550684,1,654,75,53833982,53441440,392542,191.0623576585436
1747352676402151,60643244,1,655,75,53927586,53534000,393586,190.5555583786009
1747352676498835,60735804,1,656,75,54024270,53626560,397710,188.57961831485247
1747352676586267,60828364,1,657,75,54111702,53719120,392582,191.04289040251464
1747352676680474,60920924,1,658,75,54205909,53811680,394229,190.24475622036937
1747352676774808,61013484,1,659,75,54300243,53904240,396003,189.39250460223784
1747352676869181,61106044,1,660,75,54394616,53996800,397816,188.52937036217747
1747352676959435,61198604,1,661,75,54484870,54089360,395510,189.6285808197012
1747352677053263,61291164,1,662,75,54578698,54181920,396778,189.0225768565797
1747352677147368,61383724,1,663,75,54672803,54274480,398323,188.2894033234335
1747352677241675,61476284,1,664,75,54767110,54367040,400070,187.4671932411828
1747352677335723,61568844,1,665,75,54861158,54459600,401558,186.77252103058584
1747352677425960,61661404,1,666,75,54951395,54552160,399235,187.8592808746728
1747352677520468,61753964,1,667,75,55045903,54644720,401183,186.94710394009715
1747352677614479,61846524,1,668,75,55139914,54737280,402634,186.2733897286369
1747352677708460,61939084,1,669,75,55233895,54829840,404055,185.61829453910977
1747352677798913,62031644,1,670,75,55324348,54922400,401948,186.5913003672117
1747352677892933,62124204,1,671,75,55418368,55014960,403408,185.91599571649547
1747352677986761,62216764,1,672,75,55512196,55107520,404676,185.3334519467426
1747352678081166,62309324,1,673,75,55606601,55200080,406521,184.49231405019663
1747352678171380,62401884,1,674,75,55696815,55292640,404175,185.563184264242
1747352678266229,62494444,1,675,75,55791664,55385200,406464,184.51818611242325
1747352678360068,62587004,1,676,75,55885503,55477760,407743,183.9393931962045
1747352678453993,62679564,1,677,75,55979428,55570320,409108,183.32567439404752
1747352678544804,62772124,1,678,75,56070239,55662880,407359,184.1127850372767
1747352678638397,62864684,1,679,75,56163832,55755440,408392,183.6470841740289
1747352678732528,62957244,1,680,75,56257963,55848000,409963,182.9433387891102
1747352678826732,63049804,1,681,75,56352167,55940560,411607,182.21264458573347
1747352678920820,63142364,1,682,75,56446255,56033120,413135,181.5387222094473
1747352679011509,63234924,1,683,75,56536944,56125680,411264,182.3646125116713
1747352679105314,63327484,1,684,75,56630749,56218240,412509,181.81421496258264
1747352679199442,63420044,1,685,75,56724877,56310800,414077,181.12573265358856
1747352679293712,63512612,1,686,75,56819147,56403368,415779,180.3842906928921
1747352679383548,63605164,1,687,75,56908983,56495920,413063,181.5703657795542
1747352679477957,63697724,1,688,75,57003392,56588480,414912,180.76122165664043
1747352679572465,63790284,1,689,75,57097900,56681040,416860,179.91651873530682
1747352679666581,63882844,1,690,75,57192016,56773600,418416,179.24744751634736
1747352679757131,63975404,1,691,75,57282566,56866160,416406,180.11267849166438
1747352679850887,64067964,1,692,75,57376322,56958720,417602,179.59684101129784
1747352679944865,64160524,1,693,75,57470300,57051280,419020,178.98906973414157
1747352680038790,64253084,1,694,75,57564225,57143840,420385,178.40788800742178
1747352680129776,64345644,1,695,75,57655211,57236400,418811,179.0783909687186
1747352680223776,64438204,1,696,75,57749211,57328960,420251,178.46477462278497
1747352680317339,64530764,1,697,75,57842774,57421520,421254,178.0398524405703
1747352680411931,64623324,1,698,75,57937366,57514080,423286,177.1851655854434
1747352680506421,64715884,1,699,75,58031856,57606640,425216,176.38094521372668
1747352680596589,64808444,1,700,75,58122024,57699200,422824,177.37876752502223
1747352680690931,64901004,1,701,75,58216366,57791760,424606,176.63433865748482
1747352680784888,64993564,1,702,75,58310323,57884320,426003,176.05509820353376
1747352680878657,65086124,1,703,75,58404092,57976880,427212,175.55686638015786
1747352680968925,65178684,1,704,75,58494360,58069440,424920,176.50381248234962
1747352681062881,65271244,1,705,75,58588316,58162000,426316,175.92583904896838
1747352681157070,65363804,1,706,75,58682505,58254560,427945,175.25616609611046
1747352681251867,65456364,1,707,75,58777302,58347120,430182,174.3448121957683
1747352681341963,65548924,1,708,75,58867398,58439680,427718,175.34917866444715
1747352681436199,65641492,1,709,75,58961634,58532248,429386,174.668014327435
1747352681529643,65734044,1,710,75,59055078,58624800,430278,174.30591385104515
1747352681624623,65826604,1,711,75,59150058,58717360,432698,173.3310530670352
1747352681714374,65919164,1,712,75,59239809,58809920,429889,174.46364061420505
1747352681808130,66011724,1,713,75,59333565,58902480,431085,173.97960958975608
1747352681902726,66104284,1,714,75,59428161,58995040,433121,173.16177234537233
1747352681996938,66196844,1,715,75,59522373,59087600,434773,172.5038123342526
1747352682091095,66289404,1,716,75,59616530,59180160,436370,171.87249352613608
1747352682181019,66381964,1,717,75,59706454,59272720,433734,172.9170413202562
1747352682275348,66474524,1,718,75,59800783,59365280,435503,172.21465753393204
1747352682369756,66567084,1,719,75,59895191,59457840,437351,171.48697499262607
1747352682463826,66659644,1,720,75,59989261,59550400,438861,170.89693547615303
1747352682554563,66752204,1,721,75,60079998,59642960,437038,171.6097913682563
1747352682648525,66844764,1,722,75,60173960,59735520,438440,171.06103457713712
1747352682742915,66937324,1,723,75,60268350,59828080,440270,170.35001249233426
1747352682836516,67029884,1,724,75,60361951,59920640,441311,169.94817713585203
1747352682926524,67122444,1,725,75,60451959,60013200,438759,170.93666454705203
1747352683021041,67215004,1,726,75,60546476,60105760,440716,170.17762005463837
1747352683306981,67498924,1,729,75,60832416,60389680,442736,169.40117812872683
1747352683401494,67591484,1,730,75,60926929,60482240,444689,168.65719637769317
1747352683495503,67684044,1,731,75,61020938,60574800,446138,168.1094190586769
1747352683586734,67776604,1,732,75,61112169,60667360,444809,168.6116962561459
1747352683679818,67869164,1,733,75,61205253,60759920,445333,168.41329971055367
1747352683775067,67961724,1,734,75,61300502,60852480,448022,167.40249362754508
1747352683868501,68054284,1,735,75,61393936,60945040,448896,167.0765611633875
1747352683958667,68146844,1,736,75,61484102,61037600,446502,167.97237190426918
1747352684053640,68239404,1,737,75,61579075,61130160,448915,167.06948976977824
1747352684147405,68331964,1,738,75,61672840,61222720,450120,166.6222340709144
1747352684241406,68424524,1,739,75,61766841,61315280,451561,166.0905171172887
1747352684331309,68517084,1,740,75,61856744,61407840,448904,167.07358366154008
1747352684426009,68609644,1,741,75,61951444,61500400,451044,166.2808949902892
1747352684519901,68702204,1,742,75,62045336,61592960,452376,165.79128866252853
1747352684614586,68794764,1,743,75,62140021,61685520,454501,165.01613857835298
1747352684704315,68887324,1,744,75,62229750,61778080,451670,166.05043505213982
1747352684802219,68979884,1,745,75,62327654,61870640,457014,164.10875815620528
1747352684892921,69072444,1,746,75,62418356,61963200,455156,164.77866929140777
1747352684987258,69165004,1,747,75,62512693,62055760,456933,164.1378495315506
1747352685081235,69257564,1,748,75,62606670,62148320,458350,163.6304134395113
1747352685171439,69350124,1,749,75,62696874,62240880,455994,164.47584836642588
1747352685269998,69442684,1,750,75,62795433,62333440,461993,162.34012203648106
1747352685359441,69535244,1,751,75,62884876,62426000,458876,163.44284730515434
1747352685453938,69627804,1,752,75,62979373,62518560,460813,162.75582503097786
1747352685543916,69720364,1,753,75,63069351,62611120,458231,163.67290733276448
1747352685637830,69812924,1,754,75,63163265,62703680,459585,163.1907046574627
1747352685732501,69905484,1,755,75,63257936,62796240,461696,162.44455225949542
1747352685826830,69998044,1,756,75,63352265,62888800,463465,161.82451749323033
1747352685916935,70090604,1,757,75,63442370,62981360,461010,162.6862757857747
1747352686010550,70183164,1,758,75,63535985,63073920,462065,162.3148258361919
1747352686104464,70275724,1,759,75,63629899,63166480,463419,161.84058055453056
1747352686199115,70368292,1,760,75,63724550,63259048,465502,161.11638618094014
1747352686293455,70460844,1,761,75,63818890,63351600,467290,160.4999037000578
1747352686383470,70553404,1,762,75,63908905,63444160,464745,161.3788206435787
1747352686477956,70645964,1,763,75,64003391,63536720,466671,160.7127933812043
1747352686571855,70738524,1,764,75,64097290,63629280,468010,160.25298604730668
1747352686665721,70831084,1,765,75,64191156,63721840,469316,159.80703832812006
1747352686755892,70923644,1,766,75,64281327,63814400,466927,160.62468008917884
1747352686850167,71016204,1,767,75,64375602,63906960,468642,160.03687249542295
1747352686944691,71108764,1,768,75,64470126,63999520,470606,159.36898382086076
1747352687039121,71201324,1,769,75,64564556,64092080,472476,158.7382216239555
1747352687129381,71293884,1,770,75,64654816,64184640,470176,159.51473490777923
1747352687223663,71386444,1,771,75,64749098,64277200,471898,158.9326506999394
1747352687317761,71479004,1,772,75,64843196,64369760,473436,158.41634349732593
1747352687411495,71571564,1,773,75,64936930,64462320,474610,158.02448325993976
1747352687501324,71664124,1,774,75,65026759,64554880,471879,158.93905005308565
1747352687596310,71756684,1,775,75,65121745,64647440,474305,158.12610029411456
1747352687690510,71849244,1,776,75,65215945,64740000,475945,157.58123312567628
1747352687784152,71941804,1,777,75,65309587,64832560,477027,157.22380494185865
1747352687878610,72034364,1,778,75,65404045,64925120,478925,156.60072036331368
1747352687968863,72126924,1,779,75,65494298,65017680,476618,157.358723338187
1747352688062414,72219484,1,780,75,65587849,65110240,477609,157.03221672958423
1747352688157139,72312044,1,781,75,65682574,65202800,479774,156.32360236277916
1747352688251165,72404604,1,782,75,65776600,65295360,481240,155.84739423156844
1747352688341196,72497172,1,783,75,65866631,65387928,478703,156.67334443276937
1747352688435216,72589724,1,784,75,65960651,65480480,480171,156.19435576076023
1747352688530093,72682284,1,785,75,66055528,65573040,482488,155.44428047951453
1747352688623759,72774844,1,786,75,66149194,65665600,483594,155.08877281355848
1747352688713633,72867404,1,787,75,66239068,65758160,480908,155.9549851530854
1747352688807968,72959964,1,788,75,66333403,65850720,482683,155.3814822564706
1747352688902853,73052524,1,789,75,66428288,65943280,485008,154.63662455052287
1747352688996893,73145084,1,790,75,66522328,66035840,486488,154.16618703852922
1747352689086462,73237644,1,791,75,66611897,66128400,483497,155.11988698999167
1747352689181154,73330204,1,792,75,66706589,66220960,485629,154.43888235669615
1747352689275566,73422764,1,793,75,66801001,66313520,487481,153.85215013508218
1747352689368901,73515324,1,794,75,66894336,66406080,488256,153.60794337396774
1747352689463420,73607884,1,795,75,66988855,66498640,490215,152.99409442795508
1747352689553651,73700444,1,796,75,67079086,66591200,487886,153.72443562635533
1747352689647239,73793004,1,797,75,67172674,66683760,488914,153.4012116650372
1747352689742240,73885564,1,798,75,67267675,66776320,491355,152.6391305675123
1747352689836326,73978124,1,799,75,67361761,66868880,492881,152.166547300464
1747352689926354,74070684,1,800,75,67451789,66961440,490349,152.95228500516978
1747352690019795,74163244,1,801,75,67545230,67054000,491230,152.67797162225435
1747352690114984,74255804,1,802,75,67640419,67146560,493859,151.86520849068256
1747352690208700,74348364,1,803,75,67734135,67239120,495015,151.51056028605194
1747352690299516,74440924,1,804,75,67824951,67331680,493271,152.04623827470093
1747352690393665,74533484,1,805,75,67919100,67424240,494860,151.55801640868123
1747352690487785,74626044,1,806,75,68013220,67516800,496420,151.08174529632169
1747352690581143,74718604,1,807,75,68106578,67609360,497218,150.83926969659183
1747352690672156,74811164,1,808,75,68197591,67701920,495671,151.3100423466372
1747352690765882,74903724,1,809,75,68291317,67794480,496837,150.95494095649076
1747352690860464,74996284,1,810,75,68385899,67887040,498859,150.3430829152125
1747352690954588,75088844,1,811,75,68480023,67979600,500423,149.87320726665243
1747352691048500,75181404,1,812,75,68573935,68072160,501775,149.46938368790794
1747352691138445,75273964,1,813,75,68663880,68164720,499160,150.2524240724417
1747352691233295,75366524,1,814,75,68758730,68257280,501450,149.56625785222857
1747352691326967,75459084,1,815,75,68852402,68349840,502562,149.23531822939262
1747352691421625,75551644,1,816,75,68947060,68442400,504660,148.61490904767567
1747352691511446,75644204,1,817,75,69036881,68534960,501921,149.4259056704143
1747352691605988,75736764,1,818,75,69131423,68627520,503903,148.83816925082803
1747352691699375,75829324,1,819,75,69224810,68720080,504730,148.59429794147366
1747352691793986,75921884,1,820,75,69319421,68812640,506781,147.9929200187063
1747352691884105,76014444,1,821,75,69409540,68905200,504340,148.7092041083396
1747352691978776,76107004,1,822,75,69504211,68997760,506451,148.08935119093456
1747352692072307,76199564,1,823,75,69597742,69090320,507422,147.8059682079216
1747352692166746,76292132,1,824,75,69692181,69182888,509293,147.26297043155904
1747352692256675,76384684,1,825,75,69782110,69275440,506670,148.0253419385399
1747352692350377,76477244,1,826,75,69875812,69368000,507812,147.6924531125692
1747352692445589,76569804,1,827,75,69971024,69460560,510464,146.92515045135406
1747352692539585,76662364,1,828,75,70065020,69553120,511900,146.51299081851923
1747352692633914,76754924,1,829,75,70159349,69645680,513669,146.00842176576745
1747352692723734,76847484,1,830,75,70249169,69738240,510929,146.79143286053446
1747352692818313,76940044,1,831,75,70343748,69830800,512948,146.21365128629023
1747352692912235,77032604,1,832,75,70437670,69923360,514310,145.82644708444323
1747352693006543,77125164,1,833,75,70531978,70015920,516058,145.33250138550318
1747352693096831,77217724,1,834,75,70622266,70108480,513786,145.97517254265395
1747352693190418,77310284,1,835,75,70715853,70201040,514813,145.6839667995952
1747352693284947,77402844,1,836,75,70810382,70293600,516782,145.12889380822088
1747352693378916,77495404,1,837,75,70904351,70386160,518191,144.73427751543352
1747352693468838,77587964,1,838,75,70994273,70478720,515553,145.4748590348616
1747352693563327,77680524,1,839,75,71088762,70571280,517482,144.9325773650098
1747352693657972,77773084,1,840,75,71183407,70663840,519567,144.35096917240702
1747352693751898,77865644,1,841,75,71277333,70756400,520933,143.97244943207667
1747352693841937,77958204,1,842,75,71367372,70848960,518412,144.67257702368002
1747352693935752,78050764,1,843,75,71461187,70941520,519667,144.32319158230175
1747352694030172,78143324,1,844,75,71555607,71034080,521527,143.80847012714588
1747352694124464,78235884,1,845,75,71649899,71126640,523259,143.33246059790656
1747352694218945,78328444,1,846,75,71744380,71219200,525180,142.8081800525534
1747352694309146,78421012,1,847,75,71834581,71311768,522813,143.45473429314114
1747352694403043,78513564,1,848,75,71928478,71404320,524158,143.08662655153597
1747352694497226,78606124,1,849,75,72022661,71496880,525781,142.64494152508362
1747352694591019,78698684,1,850,75,72116454,71589440,527014,142.3112099488818
1747352694689790,78791244,1,851,75,72215225,71682000,533225,140.65357025645835
1747352694779877,78886932,1,852,75,72305312,71777688,527624,142.14668021166588
1747352694874242,78979484,1,853,75,72399677,71870240,529437,141.65991421075594
1747352694964065,79072044,1,854,75,72489500,71962800,526700,142.39605088285552
1747352695058609,79164604,1,855,75,72584044,72055360,528684,141.86167918832422
1747352695152105,79257164,1,856,75,72677540,72147920,529620,141.6109663532344
1747352695246534,79349724,1,857,75,72771969,72240480,531489,141.11298634590744
1747352695336688,79442284,1,858,75,72862123,72333040,529083,141.75469633308953
1747352695431284,79534844,1,859,75,72956719,72425600,531119,141.2112916314423
1747352695524775,79627404,1,860,75,73050210,72518160,532050,140.964195094446
1747352695619230,79719964,1,861,75,73144665,72610720,533945,140.46390545842738
1747352695713589,79812524,1,862,75,73239024,72703280,535744,139.99223509735992
1747352695803502,79905084,1,863,75,73328937,72795840,533097,140.6873420784585
1747352695897649,79997644,1,864,75,73423084,72888400,534684,140.26976681553964
1747352695992179,80090204,1,865,75,73517614,72980960,536654,139.75485135674012
1747352696086693,80182764,1,866,75,73612128,73073520,538608,139.2478388735407
1747352696176665,80275324,1,867,75,73702100,73166080,536020,139.9201522331256
1747352696270816,80367884,1,868,75,73796251,73258640,537611,139.50607409446607
1747352696364507,80460444,1,869,75,73889942,73351200,538742,139.2132040939819
1747352696458803,80553004,1,870,75,73984238,73443760,540478,138.76605523259042
1747352696549193,80645564,1,871,75,74074628,73536320,538308,139.32544194030183
1747352696643223,80738124,1,872,75,74168658,73628880,539778,138.94601113791225
1747352696737335,80830684,1,873,75,74262770,73721440,541330,138.54765115548742
1747352696831525,80923244,1,874,75,74356960,73814000,542960,138.13172241049065
1747352696925836,81015804,1,875,75,74451271,73906560,544711,137.68769127115112
1747352697015649,81108364,1,876,75,74541084,73999120,541964,138.38557542567403
1747352697110504,81200924,1,877,75,74635939,74091680,544259,137.8020391027066
1747352697204774,81293484,1,878,75,74730209,74184240,545969,137.3704367830408
1747352697300339,81386044,1,879,75,74825774,74276800,548974,136.61849195043845
1747352697388405,81478604,1,880,75,74913840,74369360,544480,137.74610637672643
1747352697483320,81571164,1,881,75,75008755,74461920,546835,137.15288889701648
1747352697576806,81663724,1,882,75,75102241,74554480,547761,136.92102942706762
1747352697671512,81756284,1,883,75,75196947,74647040,549907,136.38669811440843
1747352697760930,81848844,1,884,75,75286365,74739600,546765,137.1704479986832
1747352697855305,81941404,1,885,75,75380740,74832160,548580,136.71661380290934
1747352697949872,82033964,1,886,75,75475307,74924720,550587,136.21825433582703
1747352698044408,82126524,1,887,75,75569843,75017280,552563,135.73112930109326
1747352698134229,82219084,1,888,75,75659664,75109840,549824,136.4072866953789
1747352698227954,82311644,1,889,75,75753389,75202400,550989,136.11886988669465
1747352698322176,82404204,1,890,75,75847611,75294960,552651,135.70951649413465
1747352698416677,82496764,1,891,75,75942112,75387520,554592,135.23455080491604
1747352698510323,82589324,1,892,75,76035758,75480080,555678,134.9702525563366
1747352698601009,82681892,1,893,75,76126444,75572648,553796,135.4289305087072
1747352698695561,82774444,1,894,75,76220996,75665200,555796,134.94159727669864
1747352698789473,82867004,1,895,75,76314908,75757760,557148,134.6141420233044
1747352698883502,82959564,1,896,75,76408937,75850320,558617,134.2601460392362
1747352698973716,83052124,1,897,75,76499151,75942880,556271,134.8263705999414
1747352699068312,83144684,1,898,75,76593747,76035440,558307,134.33469399452272
1747352699162392,83237244,1,899,75,76687827,76128000,559827,133.9699585764888
1747352699256478,83329804,1,900,75,76781913,76220560,561353,133.60577034415064
1747352699346293,83422364,1,901,75,76871728,76313120,558608,134.26230916850457
1747352699440764,83514924,1,902,75,76966199,76405680,560519,133.80456327082578
1747352699534960,83607484,1,903,75,77060395,76498240,562155,133.41516129893003
1747352699629128,83700044,1,904,75,77154563,76590800,563763,133.034626252521
1747352699719480,83792604,1,905,75,77244915,76683360,561555,133.55771028661485
1747352699813490,83885164,1,906,75,77338925,76775920,563005,133.2137370005595
1747352699907301,83977724,1,907,75,77432736,76868480,564256,132.9183916520161
1747352700001461,84070284,1,908,75,77526896,76961040,565856,132.54255499632416
1747352700095644,84162844,1,909,75,77621079,77053600,567479,132.1634809393828
1747352700190272,84255404,1,910,75,77715707,77146160,569547,131.68360117777812
1747352700279975,84347964,1,911,75,77805410,77238720,566690,132.34749157387637
1747352700374839,84440524,1,912,75,77900274,77331280,568994,131.8115832504385
1747352700468886,84533084,1,913,75,77994321,77423840,570481,131.4680068223131
1747352700558524,84625644,1,914,75,78083959,77516400,567559,132.14485190085963
1747352700652950,84718204,1,915,75,78178385,77608960,569425,131.71181454976514
1747352700746944,84810772,1,916,75,78272379,77701528,570851,131.3827951602082
1747352700840947,84903324,1,917,75,78366382,77794080,572302,131.0496905479974
1747352700931863,84995884,1,918,75,78457298,77886640,570658,131.4272296191414
1747352701025728,85088444,1,919,75,78551163,77979200,571963,131.12736313362927
1747352701119546,85181004,1,920,75,78644981,78071760,573221,130.8395889194569
1747352701213639,85273564,1,921,75,78739074,78164320,574754,130.4906098957119
1747352701304391,85366124,1,922,75,78829826,78256880,572946,130.90238870678914
1747352701398281,85458684,1,923,75,78923716,78349440,574276,130.59922406647675
1747352701493095,85551244,1,924,75,79018530,78442000,576530,130.0886337224429
1747352701587102,85643804,1,925,75,79112537,78534560,577977,129.76294904468517
1747352701681108,85736364,1,926,75,79206543,78627120,579423,129.4391144293547
1747352701770906,85828924,1,927,75,79296341,78719680,576661,130.0590815054252
1747352701865282,85921484,1,928,75,79390717,78812240,578477,129.65078991904605
1747352701959275,86014044,1,929,75,79484710,78904800,579910,129.33041334000103
1747352702245793,86297964,1,932,75,79771228,79188720,582508,128.75359651712938
1747352702336300,86390524,1,933,75,79861735,79281280,580455,129.20898260847093
1747352702430846,86483084,1,934,75,79956281,79373840,582441,128.7684074438441
1747352702525179,86575644,1,935,75,80050614,79466400,584214,128.3776150520186
1747352702618651,86668204,1,936,75,80144086,79558960,585126,128.17752073912283
1747352702709669,86760764,1,937,75,80235104,79651520,583584,128.51620332291495
1747352702803654,86853324,1,938,75,80329089,79744080,585009,128.20315584888436
1747352702897897,86945884,1,939,75,80423332,79836640,586692,127.83538892638728
1747352702992134,87038444,1,940,75,80517569,79929200,588369,127.4710258358275
1747352703085045,87131004,1,941,75,80610480,80021760,588720,127.3950264981655
1747352703176530,87223564,1,942,75,80701965,80114320,587645,127.62807477303474
1747352703274759,87316124,1,943,75,80800194,80206880,593314,126.40861331436642
1747352703364597,87408684,1,944,75,80890032,80299440,590592,126.99122236671
1747352703458191,87501244,1,945,75,80983626,80392000,591626,126.76927653619008
1747352703548879,87593804,1,946,75,81074314,80484560,589754,127.17166818707462
1747352703642696,87686364,1,947,75,81168131,80577120,591011,126.9011913483844
1747352703737019,87778924,1,948,75,81262454,80669680,592774,126.52376791154808
1747352703831002,87871484,1,949,75,81356437,80762240,594197,126.22076516710788
1747352703921359,87964044,1,950,75,81446794,80854800,591994,126.69047321425556
1747352704015415,88056604,1,951,75,81540850,80947360,593490,126.37112672496588
1747352704109336,88149164,1,952,75,81634771,81039920,594851,126.08199364210532
1747352704203404,88241724,1,953,75,81728839,81132480,596359,125.7631728539353
1747352704294161,88334284,1,954,75,81819596,81225040,594556,126.14455156452884
1747352704388516,88426844,1,955,75,81913951,81317600,596351,125.76485995663629
1747352704482823,88519404,1,956,75,82008258,81410160,598098,125.39751010703932
1747352704576511,88611964,1,957,75,82101946,81502720,599226,125.16145828118272
1747352704671267,88704524,1,958,75,82196702,81595280,601422,124.70445045242776
1747352704760526,88797084,1,959,75,82285961,81687840,598121,125.39268810157142
1747352704855582,88889644,1,960,75,82381017,81780400,600617,124.87159038122464
1747352704948893,88982204,1,961,75,82474328,81872960,601368,124.71564832182624
1747352705043523,89074764,1,962,75,82568958,81965520,603438,124.28783072991756
1747352705134028,89167324,1,963,75,82659463,82058080,601383,124.71253760083007
1747352705228159,89259884,1,964,75,82753594,82150640,602954,124.38759839059033
1747352705321684,89352444,1,965,75,82847119,82243200,603919,124.18883989409176
1747352705416680,89445004,1,966,75,82942115,82335760,606355,123.68991762251488
1747352705506587,89537572,1,967,75,83032022,82428328,603694,124.23512574251194
1747352705600568,89630124,1,968,75,83126003,82520880,605123,123.9417440751715
1747352705695105,89722684,1,969,75,83220540,82613440,607100,123.5381321034426
1747352705789341,89815244,1,970,75,83314776,82706000,608776,123.1980235751738
1747352705879545,89907804,1,971,75,83404980,82798560,606420,123.67665974077372
1747352705972889,90000364,1,972,75,83498324,82891120,607204,123.51697287896656
1747352706069506,90092924,1,973,75,83594941,82983680,611261,122.69717845568422
1747352706161841,90185484,1,974,75,83687276,83076240,611036,122.74235887901858
1747352706256278,90278044,1,975,75,83781713,83168800,612913,122.366469629458
1747352706345656,90370604,1,976,75,83871091,83261360,609731,123.00506288838848
1747352706440114,90463164,1,977,75,83965549,83353920,611629,122.62335500769258
1747352706534815,90555724,1,978,75,84060250,83446480,613770,122.19561073366243
1747352706628126,90648284,1,979,75,84153561,83539040,614521,122.04627669355482
1747352706720706,90740844,1,980,75,84246141,83631600,614541,122.04230474451664
1747352706812878,90833404,1,981,75,84338313,83724160,614153,122.11940672763954
1747352706907024,90925964,1,982,75,84432459,83816720,615739,121.80485562876478
1747352707000371,91018524,1,983,75,84525806,83909280,616526,121.64937082945409
1747352707091347,91111084,1,984,75,84616782,84001840,614942,121.9627216875738
1747352707185701,91203644,1,985,75,84711136,84094400,616736,121.60794894411872
1747352707279416,91296204,1,986,75,84804851,84186960,617891,121.3806318590172
1747352707374425,91388764,1,987,75,84899860,84279520,620340,120.90144114517844
1747352707468289,91481324,1,988,75,84993724,84372080,621644,120.6478305911422
1747352707557826,91573884,1,989,75,85083261,84464640,618621,121.23739737254311
1747352707652641,91666452,1,990,75,85178076,84557208,620868,120.79862386207697
1747352707746638,91759004,1,991,75,85272073,84649760,622313,120.51813155116476
1747352707840421,91851564,1,992,75,85365856,84742320,623536,120.28174796643658
1747352707931380,91944124,1,993,75,85456815,84834880,621935,120.59138012814844
1747352708025316,92036684,1,994,75,85550751,84927440,623311,120.3251667305727
1747352708119379,92129244,1,995,75,85644814,85020000,624814,120.035722631055
1747352708213637,92221804,1,996,75,85739072,85112560,626512,119.71039660852466
1747352708303479,92314364,1,997,75,85828914,85205120,623794,120.2319996665566
1747352708397418,92406924,1,998,75,85922853,85297680,625173,119.96679319164456
1747352708492276,92499484,1,999,75,86017711,85390240,627471,119.52743632773466
1747352708586248,92592044,1,1000,75,86111683,85482800,628883,119.2590672668843
1747352708680418,92685644,1,1001,75,86205853,85576400,629453,119.151072439086
1747352708775039,92779244,1,1002,75,86300474,85670000,630474,118.95811722608704
1747352708869114,92872844,1,1003,75,86394549,85763600,630949,118.8685614843672
1747352708962714,92966444,1,1004,75,86488149,85857200,630949,118.8685614843672
1747352709057567,93060044,1,1005,75,86583002,85950800,632202,118.63296857649928
1747352709151141,93153644,1,1006,75,86676576,86044400,632176,118.63784768798564
1747352709245299,93247244,1,1007,75,86770734,86138000,632734,118.53322249159994
1747352709340005,93340844,1,1008,75,86865440,86231600,633840,118.32639151836426
1747352709434611,93434444,1,1009,75,86960046,86325200,634846,118.13888722619345
1747352709528682,93528044,1,1010,75,87054117,86418800,635317,118.0513035224935
1747352709623033,93621644,1,1011,75,87148468,86512400,636068,117.91192136689789
1747352709716866,93715244,1,1012,75,87242301,86606000,636301,117.868744509281
1747352709811343,93808844,1,1013,75,87336778,86699600,637178,117.70651215202032
1747352709904498,93902444,1,1014,75,87429933,86793200,636733,117.788774886805
1747352709999719,93996052,1,1015,75,87525154,86886808,638346,117.49114116795594
1747352710093752,94089644,1,1016,75,87619187,86980400,638787,117.410028695011
1747352710187466,94183244,1,1017,75,87712901,87074000,638901,117.38907905919696
1747352710282438,94276844,1,1018,75,87807873,87167600,640273,117.13753352085752
1747352710375858,94370444,1,1019,75,87901293,87261200,640093,117.17047366554549
1747352710470135,94464044,1,1020,75,87995570,87354800,640770,117.04667821527228
1747352710564349,94557644,1,1021,75,88089784,87448400,641384,116.93462886507928
1747352710658279,94651244,1,1022,75,88183714,87542000,641714,116.87449549176112
1747352710753128,94744844,1,1023,75,88278563,87635600,642963,116.64745871846436
1747352710847416,94838444,1,1024,75,88372851,87729200,643651,116.52277398776668
1747352710941057,94932044,1,1025,75,88466492,87822800,643692,116.51535206278778
1747352711035553,95025644,1,1026,75,88560988,87916400,644588,116.3533916237969
1747352711133618,95119244,1,1027,75,88659053,88010000,649053,115.55296716909098
1747352711227524,95212844,1,1028,75,88752959,88103600,649359,115.4985146891011
1747352711322573,95306444,1,1029,75,88848008,88197200,650808,115.24136150754138
1747352711416124,95400044,1,1030,75,88941559,88290800,650759,115.2500388008464
1747352711510961,95493644,1,1031,75,89036396,88384400,651996,115.03138056061694
1747352711604951,95587244,1,1032,75,89130386,88478000,652386,114.96261415787586
1747352711698682,95680844,1,1033,75,89224117,88571600,652517,114.93953414240548
1747352711793244,95774444,1,1034,75,89318679,88665200,653479,114.77032926842332
1747352711887626,95868044,1,1035,75,89413061,88758800,654261,114.63315099020116
1747352711981751,95961644,1,1036,75,89507186,88852400,654786,114.5412394278436
1747352712075829,96055244,1,1037,75,89601264,88946000,655264,114.45768423108856
1747352712170348,96148844,1,1038,75,89695783,89039600,656183,114.29738350429685
1747352712264190,96242444,1,1039,75,89789625,89133200,656425,114.2552462200556
1747352712358324,96336044,1,1040,75,89883759,89226800,656959,114.16237542982137
1747352712452846,96429644,1,1041,75,89978281,89320400,657881,114.00238036970212
1747352712547157,96523244,1,1042,75,90072592,89414000,658592,113.87930615616348
1747352712640976,96616844,1,1043,75,90166411,89507600,658811,113.84145073473272
1747352712735440,96710444,1,1044,75,90260875,89601200,659675,113.6923485049456
1747352712829702,96804044,1,1045,75,90355137,89694800,660337,113.57836983237348
1747352712923811,96897644,1,1046,75,90449246,89788400,660846,113.49088895143495
1747352713017792,96991252,1,1047,75,90543227,89882008,661219,113.42686764899376
1747352713112034,97084844,1,1048,75,90637469,89975600,661869,113.31547481450256
1747352713205864,97178444,1,1049,75,90731299,90069200,662099,113.27611127641032
1747352713300501,97272044,1,1050,75,90825936,90162800,663136,113.09897215654104
1747352713394481,97365644,1,1051,75,90919916,90256400,663516,113.03419962743928
1747352713489028,97459244,1,1052,75,91014463,90350000,664463,112.8731020387892
1747352713583501,97552844,1,1053,75,91108936,90443600,665336,112.7249990982
1747352713676950,97646444,1,1054,75,91202385,90537200,665185,112.750588182235
1747352713771188,97740044,1,1055,75,91296623,90630800,665823,112.6425491459442
1747352713865589,97833644,1,1056,75,91391024,90724400,666624,112.5072004608295
1747352713960130,97927244,1,1057,75,91485565,90818000,667565,112.34861024769124
1747352714054542,98020844,1,1058,75,91579977,90911600,668377,112.21211980663608
1747352714147890,98114444,1,1059,75,91673325,91005200,668125,112.25444340505146
1747352714242230,98208044,1,1060,75,91767665,91098800,668865,112.1302504989796
1747352714336369,98301644,1,1061,75,91861804,91192400,669404,112.03996390819296
1747352714430970,98395244,1,1062,75,91956405,91286000,670405,111.87267398065347
1747352714524804,98488844,1,1063,75,92050239,91379600,670639,111.83363926046653
1747352714619370,98582444,1,1064,75,92144805,91473200,671605,111.67278385360444
1747352714713748,98676044,1,1065,75,92239183,91566800,672383,111.54356966193376
1747352714807877,98769644,1,1066,75,92333312,91660400,672912,111.45588130394464
1747352714902163,98863244,1,1067,75,92427598,91754000,673598,111.34237334433892
1747352714996443,98956844,1,1068,75,92521878,91847600,674278,111.23008610691733
1747352715090826,99050444,1,1069,75,92616261,91941200,675061,111.10107086618838
1747352715184562,99144044,1,1070,75,92709997,92034800,675197,111.07869258897772
1747352715278752,99237644,1,1071,75,92804187,92128400,675787,110.98171465269382
1747352715372734,99331244,1,1072,75,92898169,92222000,676169,110.91901580817812
1747352715467097,99424844,1,1073,75,92992532,92315600,676932,110.79399407916895
1747352715565228,99518444,1,1074,75,93090663,92409200,681463,110.05733253309424
1747352715659474,99612044,1,1075,75,93184909,92502800,682109,109.95310133717632
1747352715754173,99705644,1,1076,75,93279608,92596400,683208,109.7762321284294
1747352715847604,99799244,1,1077,75,93373039,92690000,683039,109.80339336406853
1747352715942016,99892844,1,1078,75,93467451,92783600,683851,109.67301356582064
1747352716036120,99986452,1,1079,75,93561555,92877208,684347,109.5935249222982
1747352716130790,100080044,1,1080,75,93656225,92970800,685425,109.421162052741
1747352716225364,100174684,1,1081,75,93750799,93065440,685359,109.4316992991994
1747352716319044,100269324,1,1082,75,93844479,93160080,684399,109.58519810812116
1747352716417294,100363964,1,1083,75,93942729,93254720,688009,109.01020190142862
1747352716511266,100458604,1,1084,75,94036701,93349360,687341,109.11614467927856
1747352716605467,100553244,1,1085,75,94130902,93444000,686902,109.1858809553619
1747352716703774,100647884,1,1086,75,94229209,93538640,690569,108.60609149845996
1747352716797897,100742524,1,1087,75,94323332,93633280,690052,108.6874612348055
1747352716892406,100837164,1,1088,75,94417841,93727920,689921,108.70809846344726
1747352716986439,100931804,1,1089,75,94511874,93822560,689314,108.80382525235234
1747352717085335,101026444,1,1090,75,94610770,93917200,693570,108.13616505904234
1747352717178741,101121084,1,1091,75,94704176,94011840,692336,108.32890388481894
1747352717273662,101215724,1,1092,75,94799097,94106480,692617,108.28495402220852
1747352717367737,101310364,1,1093,75,94893172,94201120,692052,108.3733592273413
1747352717465600,101405004,1,1094,75,94991035,94295760,695275,107.87098630038474
1747352717559847,101499644,1,1095,75,95085282,94390400,694882,107.93199420908874
1747352717654023,101594284,1,1096,75,95179458,94485040,694418,108.0041127966153
1747352717752133,101688924,1,1097,75,95277568,94579680,697888,107.46710073822734
1747352717846485,101783572,1,1098,75,95371920,94674328,697592,107.51270083372516
1747352717940640,101878204,1,1099,75,95466075,94768960,697115,107.58626625449172
1747352718035128,101972844,1,1100,75,95560563,94863600,696963,107.60972964131524
1747352718133023,102067484,1,1101,75,95658458,94958240,700218,107.10950018422834
1747352718228001,102162124,1,1102,75,95753436,95052880,700556,107.0578226437287
1747352718321707,102256764,1,1103,75,95847142,95147520,699622,107.2007455454517
1747352718420208,102351404,1,1104,75,95945643,95242160,703483,106.61238437886917
1747352718514434,102446044,1,1105,75,96039869,95336800,703069,106.67516275073996
1747352718608321,102540684,1,1106,75,96133756,95431440,702316,106.78953633407184
1747352718702625,102635324,1,1107,75,96228060,95526080,701980,106.84065073079005
1747352718800614,102729964,1,1108,75,96326049,95620720,705329,106.33335649037542
1747352718895296,102824604,1,1109,75,96420731,95715360,705371,106.32702506907712
1747352718989400,102919244,1,1110,75,96514835,95810000,704835,106.40788269595012
1747352719083941,103013884,1,1111,75,96609376,95904640,704736,106.42283067701948
1747352719181544,103108524,1,1112,75,96706979,95999280,707699,105.97725869331454
1747352719276430,103203164,1,1113,75,96801865,96093920,707945,105.94043322574493
1747352719370906,103297804,1,1114,75,96896341,96188560,707781,105.96498069318052
1747352719468289,103392444,1,1115,75,96993724,96283200,710524,105.55589958959864
1747352719562763,103487084,1,1116,75,97088198,96377840,710358,105.58056641862272
1747352719657407,103581732,1,1117,75,97182842,96472488,710354,105.58116094229074
1747352719751623,103676364,1,1118,75,97277058,96567120,709938,105.64302798272526
1747352719849472,103771004,1,1119,75,97374907,96661760,713147,105.1676582808313
1747352719943529,103865644,1,1120,75,97468964,96756400,712564,105.25370352698144
1747352720038206,103960284,1,1121,75,97563641,96851040,712601,105.24823849531504
1747352720136708,104054924,1,1122,75,97662143,96945680,716463,104.68091164512336
1747352720229943,104149564,1,1123,75,97755378,97040320,715058,104.8865966117434
1747352720324461,104244204,1,1124,75,97849896,97134960,714936,104.90449494779952
1747352720419193,104338844,1,1125,75,97944628,97229600,715028,104.89099727563116
1747352720516830,104433484,1,1126,75,98042265,97324240,718025,104.45318756310714
1747352720611031,104528124,1,1127,75,98136466,97418880,717586,104.51708924087148
1747352720705777,104622764,1,1128,75,98231212,97513520,717692,104.50165251946518
1747352720800161,104717404,1,1129,75,98325596,97608160,717436,104.53894145261738
1747352720897857,104812044,1,1130,75,98423292,97702800,720492,104.09553471794274
1747352720991810,104906684,1,1131,75,98517245,97797440,719805,104.19488611498949
1747352721086904,105001324,1,1132,75,98612339,97892080,720259,104.12920907617956
1747352721184857,105095964,1,1133,75,98710292,97986720,723572,103.65243541762256
1747352721278463,105190604,1,1134,75,98803898,98081360,722538,103.80076895609642
1747352721373048,105285244,1,1135,75,98898483,98176000,722483,103.8086709306655
1747352721467198,105379884,1,1136,75,98992633,98270640,721993,103.87912348180662
1747352721566031,105474524,1,1137,75,99091466,98365280,726186,103.27932513157786
1747352721659496,105569164,1,1138,75,99184931,98459920,725011,103.44670632583508
1747352721753505,105663804,1,1139,75,99278940,98554560,724380,103.5368176923714
1747352721848150,105758444,1,1140,75,99373585,98649200,724385,103.53610303912976
1747352721946196,105853084,1,1141,75,99471631,98743840,727791,103.05156288000263
1747352722040491,105947724,1,1142,75,99565926,98838480,727446,103.1004363210465
1747352722134865,106042364,1,1143,75,99660300,98933120,727180,103.13815011413956
1747352722233047,106137004,1,1144,75,99758482,99027760,730722,102.6382126171102
1747352722327816,106231644,1,1145,75,99853251,99122400,730851,102.62009629869836
1747352722421809,106326284,1,1146,75,99947244,99217040,730204,102.71102322090812
1747352722515244,106420924,1,1147,75,100040679,99311680,728999,102.88079956213932
1747352722613633,106515564,1,1148,75,100139068,99406320,732748,102.35442471354408
1747352722708629,106610204,1,1149,75,100234064,99500960,733104,102.30472074903425
1747352722802092,106704844,1,1150,75,100327527,99595600,731927,102.46923531991578
1747352722900877,106799484,1,1151,75,100426312,99690240,736072,101.89220619721983
1747352722995094,106894124,1,1152,75,100520529,99784880,735649,101.95079446855767
1747352723088938,106988764,1,1153,75,100614373,99879520,734853,102.06122857224508
1747352723183378,107083404,1,1154,75,100708813,99974160,734653,102.0890134526096
1747352723281856,107178044,1,1155,75,100807291,100068800,738491,101.55844824107538
1747352723376159,107272684,1,1156,75,100901594,100163440,738154,101.60481417156852
1747352723470258,107367324,1,1157,75,100995693,100258080,737613,101.6793359119213
1747352723564276,107461964,1,1158,75,101089711,100352720,736991,101.76515045638278
1747352723662586,107556604,1,1159,75,101188021,100447360,740661,101.26090073596424
1747352723756824,107651244,1,1160,75,101282259,100542000,740259,101.315890789575
1747352723850977,107745884,1,1161,75,101376412,100636640,739772,101.38258814878098
1747352723949422,107840532,1,1162,75,101474857,100731288,743569,100.86488274793597
1747352724043499,107935164,1,1163,75,101568934,100825920,743014,100.94022454489418
1747352724138310,108029804,1,1164,75,101663745,100920560,743185,100.91699913211382
1747352724231848,108124444,1,1165,75,101757283,101015200,742083,101.06686179308782
1747352724329906,108219084,1,1166,75,101855341,101109840,745501,100.60348678271392
1747352724423988,108313724,1,1167,75,101949423,101204480,744943,100.6788438846999
1747352724518625,108408364,1,1168,75,102044060,101299120,744940,100.67924933551694
1747352724616629,108503004,1,1169,75,102142064,101393760,748304,100.22664585516048
1747352724711267,108597644,1,1170,75,102236702,101488400,748302,100.2269137326908
1747352724805006,108692284,1,1171,75,102330441,101583040,747401,100.3477383626728
1747352724899602,108786924,1,1172,75,102425037,101677680,747357,100.35364624938282
1747352724997695,108881564,1,1173,75,102523130,101772320,750810,99.8921165141647
1747352725091843,108976204,1,1174,75,102617278,101866960,750318,99.95761796998072
1747352725186458,109070844,1,1175,75,102711893,101961600,750293,99.96094858941774
1747352725280830,109165484,1,1176,75,102806265,102056240,750025,99.99666677777408
1747352725378579,109260124,1,1177,75,102904014,102150880,753134,99.58387219273064
1747352725472833,109354764,1,1178,75,102998268,102245520,752748,99.6349375886751
1747352725567421,109449404,1,1179,75,103092856,102340160,752696,99.64182086792012
1747352725665742,109544044,1,1180,75,103191177,102434800,756377,99.15690191531472
1747352725759572,109638692,1,1181,75,103285007,102529448,755559,99.26425335413911
1747352725853903,109733324,1,1182,75,103379338,102624080,755258,99.30381406089045
1747352725948354,109827964,1,1183,75,103473789,102718720,755069,99.32867062480383
1747352726046033,109922604,1,1184,75,103571468,102813360,758108,98.930495391158
1747352726140867,110017244,1,1185,75,103666302,102908000,758302,98.90518553294068
1747352726234408,110111884,1,1186,75,103759843,103002640,757203,99.04873594003192
1747352726333325,110206524,1,1187,75,103858760,103097280,761480,98.49240951830645
1747352726427136,110301164,1,1188,75,103952571,103191920,760651,98.59975205449015
1747352726521857,110395804,1,1189,75,104047292,103286560,760732,98.5892535084629
1747352726615482,110490444,1,1190,75,104140917,103381200,759717,98.7209710984485
1747352726714130,110585084,1,1191,75,104239565,103475840,763725,98.20288716488264
1747352726808093,110679724,1,1192,75,104333528,103570480,763048,98.29001583124524
1747352726902678,110774364,1,1193,75,104428113,103665120,762993,98.29710102189664
1747352726996986,110869004,1,1194,75,104522421,103759760,762661,98.33989151143167
1747352727094649,110963644,1,1195,75,104620084,103854400,765684,97.95163540050464
1747352727188960,111058284,1,1196,75,104714395,103949040,765355,97.99374146637837
1747352727283185,111152924,1,1197,75,104808620,104043680,764940,98.04690563965802
1747352727381542,111247564,1,1198,75,104906977,104138320,768657,97.57277953625608
1747352727476161,111342204,1,1199,75,105001596,104232960,768636,97.57544533433251
1747352727570340,111436844,1,1200,75,105095775,104327600,768175,97.63400266866272
1747352727663422,111531484,1,1201,75,105188857,104422240,766617,97.83242479621508
1747352727762827,111626124,1,1202,75,105288262,104516880,771382,97.22809191814171
1747352727856855,111720764,1,1203,75,105382290,104611520,770770,97.30529211048692
1747352727950849,111815404,1,1204,75,105476284,104706160,770124,97.3869143150973
1747352728045313,111910044,1,1205,75,105570748,104800800,769948,97.40917568459167
1747352728143650,112004684,1,1206,75,105669085,104895440,773645,96.94368864272371
1747352728237651,112099324,1,1207,75,105763086,104990080,773006,97.02382646447764
1747352728331798,112193964,1,1208,75,105857233,105084720,772513,97.085744835362
1747352728430083,112288604,1,1209,75,105955518,105179360,776158,96.62980990983796
1747352728523925,112383244,1,1210,75,106049360,105274000,775360,96.72926124638876
1747352728618445,112477884,1,1211,75,106143880,105368640,775240,96.744234043651
1747352728712135,112572524,1,1212,75,106237570,105463280,774290,96.86293249299358
1747352728810294,112667164,1,1213,75,106335729,105557920,777809,96.42470066558757
1747352728904909,112761804,1,1214,75,106430344,105652560,777784,96.42780000617138
1747352728999069,112856444,1,1215,75,106524504,105747200,777304,96.48734600619578
1747352729097336,112951084,1,1216,75,106622771,105841840,780931,96.03921473215944
1747352729191367,113045724,1,1217,75,106716802,105936480,780322,96.1141682536184
1747352729285869,113140364,1,1218,75,106811304,106031120,780184,96.13116905755564
1747352729380095,113235004,1,1219,75,106905530,106125760,779770,96.18220757402824
1747352729478186,113329644,1,1220,75,107003621,106220400,783221,95.7584130149728
1747352729572650,113424284,1,1221,75,107098085,106315040,783045,95.77993601900276
1747352729666911,113518924,1,1222,75,107192346,106409680,782666,95.82631671747592
1747352729760818,113613564,1,1223,75,107286253,106504320,781933,95.9161462682864
1747352729859255,113708204,1,1224,75,107384690,106598960,785730,95.4526364018174
1747352729953341,113802844,1,1225,75,107478776,106693600,785176,95.51998532813026
1747352730048059,113897492,1,1226,75,107573494,106788248,785246,95.5114702908388
1747352730146094,113992124,1,1227,75,107671529,106882880,788649,95.09934077136975
1747352730240466,114086764,1,1228,75,107765901,106977520,788381,95.13166857141408
1747352730334334,114181404,1,1229,75,107859769,107072160,787609,95.22491490066771
1747352730428556,114276044,1,1230,75,107953991,107166800,787191,95.27547952148844
1747352730526466,114370684,1,1231,75,108051901,107261440,790461,94.88134139445212
1747352730621665,114465324,1,1232,75,108147100,107356080,791020,94.8142904098506
1747352730715979,114559964,1,1233,75,108241414,107450720,790694,94.8533819657162
1747352730814187,114654604,1,1234,75,108339622,107545360,794262,94.42727966338563
1747352730907222,114749244,1,1235,75,108432657,107640000,792657,94.6184793674944
1747352731001963,114843884,1,1236,75,108527398,107734640,792758,94.60642465922766
1747352731096282,114938524,1,1237,75,108621717,107829280,792437,94.64474778436646
1747352731194880,115033164,1,1238,75,108720315,107923920,796395,94.1743732695459
1747352731288463,115127804,1,1239,75,108813898,108018560,795338,94.29953051407075
1747352731382806,115222444,1,1240,75,108908241,108113200,795041,94.33475757853998
1747352731476812,115317084,1,1241,75,109002247,108207840,794407,94.41004422166472
1747352731575202,115411724,1,1242,75,109100637,108302480,798157,93.96647526739729
1747352731669991,115506364,1,1243,75,109195426,108397120,798306,93.94893687383032
1747352731763817,115601004,1,1244,75,109289252,108491760,797492,94.04483054375468
1747352731862511,115695652,1,1245,75,109387946,108586408,801538,93.57011146071676
1747352731956170,115790284,1,1246,75,109481605,108681040,800565,93.68383579097262
1747352732050441,115884924,1,1247,75,109575876,108775680,800196,93.72703687596538
1747352732144931,115979564,1,1248,75,109670366,108870320,800046,93.74460968494311
1747352732243203,116074204,1,1249,75,109768638,108964960,803678,93.32095690064926
1747352732337291,116168844,1,1250,75,109862726,109059600,803126,93.38509773061762
1747352732431845,116263484,1,1251,75,109957280,109154240,803040,93.39509862522416
1747352732526105,116358124,1,1252,75,110051540,109248880,802660,93.43931428001892
1747352732624179,116452764,1,1253,75,110149614,109343520,806094,93.04125821554312
1747352732718225,116547404,1,1254,75,110243660,109438160,805500,93.1098696461825
1747352732813015,116642044,1,1255,75,110338450,109532800,805650,93.09253397877492
1747352732911155,116736684,1,1256,75,110436590,109627440,809150,92.6898597293456
1747352733005125,116831324,1,1257,75,110530560,109722080,808480,92.76667326340788
1747352733099047,116925964,1,1258,75,110624482,109816720,807762,92.84913130352751
1747352733193379,117020604,1,1259,75,110718814,109911360,807454,92.88454822194204
1747352733291967,117115244,1,1260,75,110817402,110006000,811402,92.43260430711288
1747352733385949,117209884,1,1261,75,110911384,110100640,810744,92.50762262810456
1747352733480253,117304524,1,1262,75,111005688,110195280,810408,92.54597684129476
1747352733578728,117399164,1,1263,75,111104163,110289920,814243,92.11009489796044
1747352733672613,117493804,1,1264,75,111198048,110384560,813488,92.19558247939736
1747352733766977,117588444,1,1265,75,111292412,110479200,813212,92.22687318927905
1747352733861755,117683084,1,1266,75,111387190,110573840,813350,92.21122517981188
1747352733959626,117777724,1,1267,75,111485061,110668480,816581,91.84636919056408
1747352734053551,117872364,1,1268,75,111578986,110763120,815866,91.92686053837272
1747352734147328,117967004,1,1269,75,111672763,110857760,815003,92.02420113790993
1747352734241628,118061644,1,1270,75,111767063,110952400,814663,92.06260748309424
1747352734342625,118156284,1,1271,75,111868060,111047040,821020,91.3497844145088
1747352734434640,118250924,1,1272,75,111960075,111141680,818395,91.6427886289628
1747352734528051,118345564,1,1273,75,112053486,111236320,817166,91.78061740209456
1747352734627243,118440204,1,1274,75,112152678,111330960,821718,91.2721882689682
1747352734720673,118534844,1,1275,75,112246108,111425600,820508,91.40678701487371
1747352734814926,118629484,1,1276,75,112340361,111520240,820121,91.44992019470298
1747352734909016,118724124,1,1277,75,112434451,111614880,819571,91.511290663042
1747352735007790,118818764,1,1278,75,112533225,111709520,823705,91.05201498109152
1747352735101852,118913404,1,1279,75,112627287,111804160,823127,91.1159517304134
1747352735196236,119008044,1,1280,75,112721671,111898800,822871,91.14429843802978
1747352735294656,119102684,1,1281,75,112820091,111993440,826651,90.72752588456314
1747352735388736,119197324,1,1282,75,112914171,112088080,826091,90.78902929580396
1747352735482398,119291964,1,1283,75,113007833,112182720,825113,90.89664082374172
1747352735576688,119386604,1,1284,75,113102123,112277360,824763,90.93521411605516
1747352735675533,119481244,1,1285,75,113200968,112372000,828968,90.47393868038333
1747352735769820,119575884,1,1286,75,113295255,112466640,828615,90.51248167122246
1747352735864018,119670524,1,1287,75,113389453,112561280,828173,90.5607886274969
1747352735957413,119765164,1,1288,75,113482848,112655920,826928,90.69713445426927
1747352736055986,119859804,1,1289,75,113581421,112750560,830861,90.26780652840849
1747352736150390,119954452,1,1290,75,113675825,112845208,830617,90.29432337647796
1747352736244706,120049084,1,1291,75,113770141,112939840,830301,90.32868803000358
1747352736342657,120143724,1,1292,75,113868092,113034480,833612,89.96991406073809
1747352736437132,120238364,1,1293,75,113962567,113129120,833447,89.98772567421803
1747352736530973,120333004,1,1294,75,114056408,113223760,832648,90.07407692085972
1747352736625466,120427644,1,1295,75,114150901,113318400,832501,90.08998187389564
1747352736723986,120522284,1,1296,75,114249421,113413040,836381,89.67205137371604
1747352736818096,120616924,1,1297,75,114343531,113507680,835851,89.72891101404437
1747352736912217,120711564,1,1298,75,114437652,113602320,835332,89.78466047032796
1747352737010584,120806204,1,1299,75,114536019,113696960,839059,89.38584771750259
1747352737104495,120900844,1,1300,75,114629930,113791600,838330,89.46357639593
1747352737198560,120995484,1,1301,75,114723995,113886240,837755,89.5249804537126
1747352737293140,121090124,1,1302,75,114818575,113980880,837695,89.5313926906571
1747352737390997,121184764,1,1303,75,114916432,114075520,840912,89.18888064387237
1747352737485847,121279404,1,1304,75,115011282,114170160,841122,89.16661316669877
1747352737579874,121374044,1,1305,75,115105309,114264800,840509,89.23164415848017
1747352737674385,121468684,1,1306,75,115199820,114359440,840380,89.24534139317927
1747352737772570,121563324,1,1307,75,115298005,114454080,843925,88.87045649791155
1747352737866569,121657964,1,1308,75,115392004,114548720,843284,88.93800902187164
1747352737960673,121752612,1,1309,75,115486108,114643368,842740,88.99541970239932
1747352738059454,121847244,1,1310,75,115584889,114738000,846889,88.55942160070565
1747352738152732,121941884,1,1311,75,115678167,114832640,845527,88.70207574684191
1747352738247455,122036524,1,1312,75,115772890,114927280,845610,88.69336928371236
1747352738341250,122131164,1,1313,75,115866685,115021920,844765,88.78208732606109
1747352738440125,122225804,1,1314,75,115965560,115116560,849000,88.33922261484099
1747352738534348,122320444,1,1315,75,116059783,115211200,848583,88.3826331661134
1747352738627988,122415084,1,1316,75,116153423,115305840,847583,88.48690924664605
1747352738722190,122509724,1,1317,75,116247625,115400480,847145,88.53265969816265
1747352738820624,122604364,1,1318,75,116346059,115495120,850939,88.1379276305352
1747352738915502,122699004,1,1319,75,116440937,115589760,851177,88.11328313617497
1747352739009470,122793644,1,1320,75,116534905,115684400,850505,88.18290309874722
1747352739107761,122888284,1,1321,75,116633196,115779040,854156,87.80597455265783
1747352739202125,122982924,1,1322,75,116727560,115873680,853880,87.83435611561343
1747352739296328,123077564,1,1323,75,116821763,115968320,853443,87.87933113283489
1747352739390191,123172204,1,1324,75,116915626,116062960,852666,87.9594120089226
1747352739488728,123266844,1,1325,75,117014163,116157600,856563,87.55923382168037
1747352739582250,123361484,1,1326,75,117107685,116252240,855445,87.67366692189445
1747352739677216,123456124,1,1327,75,117202651,116346880,855771,87.64026824933306
1747352739775526,123550764,1,1328,75,117300961,116441520,859441,87.26602524198869
1747352739868898,123645404,1,1329,75,117394333,116536160,858173,87.3949658169157
1747352739963619,123740044,1,1330,75,117489054,116630800,858254,87.38671768497439
1747352740057308,123834684,1,1331,75,117582743,116725440,857303,87.48365513709855
1747352740156423,123929324,1,1332,75,117681858,116820080,861778,87.02937415436458
1747352740250340,124023964,1,1333,75,117775775,116914720,861055,87.10244990157423
1747352740344866,124118604,1,1334,75,117870301,117009360,860941,87.11398342046668
1747352740438647,124213244,1,1335,75,117964082,117104000,860082,87.20098781278995
1747352740536747,124307884,1,1336,75,118062182,117198640,863542,86.85159494268953
1747352740631035,124402524,1,1337,75,118156470,117293280,863190,86.88701212942689
1747352740725062,124497164,1,1338,75,118250497,117387920,862577,86.94875935713564
1747352740824064,124591804,1,1339,75,118349499,117482560,866939,86.51127703333222
1747352740917500,124686444,1,1340,75,118442935,117577200,865735,86.63159049824715
1747352741012429,124781084,1,1341,75,118537864,117671840,866024,86.60268075711528
1747352741105797,124875724,1,1342,75,118631232,117766480,864752,86.73006827390975
1747352741204884,124970364,1,1343,75,118730319,117861120,869199,86.286339491877
1747352741299150,125065004,1,1344,75,118824585,117955760,868825,86.32348286478866
1747352741393147,125159644,1,1345,75,118918582,118050400,868182,86.38741646336828
1747352741490522,125254284,1,1346,75,119015957,118145040,870917,86.11612817294873
1747352741585202,125348924,1,1347,75,119110637,118239680,870957,86.11217316124677
1747352741679459,125443564,1,1348,75,119204894,118334320,870574,86.1500573185048
1747352741773477,125538204,1,1349,75,119298912,118428960,869952,86.21165305672038
1747352741871973,125632844,1,1350,75,119397408,118523600,873808,85.83121234870818
1747352741966488,125727484,1,1351,75,119491923,118618240,873683,85.84349243375458
1747352742060190,125822124,1,1352,75,119585625,118712880,872745,85.93575442998814
1747352742157259,125916764,1,1353,75,119682694,118807520,875174,85.69724420515234
1747352742252611,126011412,1,1354,75,119778046,118902168,875878,85.62836376755666
1747352742346892,126106044,1,1355,75,119872327,118996800,875527,85.66269229846709
1747352742441429,126200684,1,1356,75,119966864,119091440,875424,85.6727711371861
1747352742539882,126295324,1,1357,75,120065317,119186080,879237,85.30123277341603
1747352742633890,126389964,1,1358,75,120159325,119280720,878605,85.36259183592172
1747352742728407,126484604,1,1359,75,120253842,119375360,878482,85.37454381535422
1747352742821901,126579244,1,1360,75,120347336,119470000,877336,85.48606235239407
1747352742920314,126673884,1,1361,75,120445749,119564640,881109,85.12000217907206
1747352743014558,126768524,1,1362,75,120539993,119659280,880713,85.15827517023139
1747352743109270,126863164,1,1363,75,120634705,119753920,880785,85.15131388477324
1747352743207691,126957804,1,1364,75,120733126,119848560,884566,84.78734204118179
1747352743301512,127052444,1,1365,75,120826947,119943200,883747,84.8659175080651
1747352743395724,127147084,1,1366,75,120921159,120037840,883319,84.90703811420336
1747352743489561,127241724,1,1367,75,121014996,120132480,882516,84.98429490230205
1747352743588077,127336364,1,1368,75,121113512,120227120,886392,84.61267700972031
1747352743682226,127431004,1,1369,75,121207661,120321760,885901,84.65957257075
1747352743776223,127525644,1,1370,75,121301658,120416400,885258,84.72106436767587
1747352743871030,127620284,1,1371,75,121396465,120511040,885425,84.70508512861055
1747352743968867,127714924,1,1372,75,121494302,120605680,888622,84.40034120244603
1747352744062976,127809572,1,1373,75,121588411,120700328,888083,84.45156590093494
1747352744157970,127904204,1,1374,75,121683405,120794960,888445,84.4171558171862
1747352744255934,127998844,1,1375,75,121781369,120889600,891769,84.10249739562599
1747352744349949,128093484,1,1376,75,121875384,120984240,891144,84.16148231935578
1747352744443874,128188124,1,1377,75,121969309,121078880,890429,84.22906262037736
1747352744538329,128282764,1,1378,75,122063764,121173520,890244,84.24656610996536
1747352744636369,128377404,1,1379,75,122161804,121268160,893644,83.92603766152965
1747352744730654,128472044,1,1380,75,122256089,121362800,893289,83.95939052199232
1747352744824633,128566684,1,1381,75,122350068,121457440,892628,84.02156329400377
1747352744919129,128661324,1,1382,75,122444564,121552080,892484,84.03511995733257
1747352745017655,128755964,1,1383,75,122543090,121646720,896370,83.67080558251615
1747352745111544,128850604,1,1384,75,122636979,121741360,895619,83.74096574547882
1747352745205894,128945244,1,1385,75,122731329,121836000,895329,83.7680897189748
1747352745304416,129039884,1,1386,75,122829851,121930640,899211,83.40645299045497
1747352745398357,129134524,1,1387,75,122923792,122025280,898512,83.47133928094449
1747352745493026,129229164,1,1388,75,123018461,122119920,898541,83.46864528162877
1747352745587139,129323804,1,1389,75,123112574,122214560,898014,83.51762890110845
1747352745685323,129418444,1,1390,75,123210758,122309200,901558,83.18932337131943
1747352745778963,129513084,1,1391,75,123304398,122403840,900558,83.28169868015165
1747352745873634,129607724,1,1392,75,123399069,122498480,900589,83.27883196441441
1747352745972348,129702364,1,1393,75,123497783,122593120,904663,82.90379953640195
1747352746065670,129797004,1,1394,75,123591105,122687760,903345,83.02475798283048
1747352746160012,129891644,1,1395,75,123685447,122782400,903047,83.05215564638385
1747352746254534,129986284,1,1396,75,123779969,122877040,902929,83.06300938390505
1747352746353086,130080924,1,1397,75,123878521,122971680,906841,82.70468582695312
1747352746446846,130175564,1,1398,75,123972281,123066320,905961,82.7850205472421
1747352746541025,130270204,1,1399,75,124066460,123160960,905500,82.82716731087797
1747352746634959,130364844,1,1400,75,124160394,123255600,904794,82.89179636469738
1747352746733491,130459484,1,1401,75,124258926,123350240,908686,82.53676187373857
1747352746827837,130554124,1,1402,75,124353272,123444880,908392,82.5634747994258
1747352746921918,130648764,1,1403,75,124447353,123539520,907833,82.61431342548684
1747352747019940,130743404,1,1404,75,124545375,123634160,911215,82.30768808678522
1747352747114476,130838044,1,1405,75,124639911,123728800,911111,82.3170832094004
1747352747208714,130932684,1,1406,75,124734149,123823440,910709,82.35341914925624
1747352747302946,131027324,1,1407,75,124828381,123918080,910301,82.39033023142895
1747352747401201,131121964,1,1408,75,124926636,124012720,913916,82.0644348058246
1747352747495364,131216604,1,1409,75,125020799,124107360,913439,82.10728904721607
1747352747589539,131311244,1,1410,75,125114974,124202000,912974,82.14910829881245
1747352747687651,131405884,1,1411,75,125213086,124296640,916446,81.83788242842459
1747352747781437,131500524,1,1412,75,125306872,124391280,915592,81.91421506522556
1747352747875866,131595164,1,1413,75,125401301,124485920,915381,81.93309671055003
1747352747970322,131689804,1,1414,75,125495757,124580560,915197,81.94956932769665
1747352748069223,131784444,1,1415,75,125594658,124675200,919458,81.56979437886233
1747352748163427,131879084,1,1416,75,125688862,124769840,919022,81.60849250616415
1747352748256980,131973724,1,1417,75,125782415,124864480,917935,81.70513162696706
1747352748351465,132068372,1,1418,75,125876900,124959128,917772,81.71964278709744
1747352748449277,132163004,1,1419,75,125974712,125053760,920952,81.43746905376176
1747352748544464,132257644,1,1420,75,126069899,125148400,921499,81.38912793177204
1747352748637966,132352284,1,1421,75,126163401,125243040,920361,81.48976325593979
1747352748736556,132446924,1,1422,75,126261991,125337680,924311,81.14152054881961
1747352748830822,132541564,1,1423,75,126356257,125432320,923937,81.17436578468012
1747352748924570,132636204,1,1424,75,126450005,125526960,923045,81.25280999301226
1747352749019482,132730844,1,1425,75,126544917,125621600,923317,81.22887372375901
1747352749117265,132825484,1,1426,75,126642700,125716240,926460,80.95330613302248
1747352749211828,132920124,1,1427,75,126737263,125810880,926383,80.9600348883777
1747352749306241,133014764,1,1428,75,126831676,125905520,926156,80.97987811988477
1747352749404318,133109404,1,1429,75,126929753,126000160,929593,80.68046984002676
1747352749498252,133204044,1,1430,75,127023687,126094800,928887,80.74179098211084
1747352749592788,133298684,1,1431,75,127118223,126189440,928783,80.75083200273906
1747352749687131,133393324,1,1432,75,127212566,126284080,928486,80.77666222215521
1747352749785001,133487964,1,1433,75,127310436,126378720,931716,80.49663202091625
1747352749878885,133582604,1,1434,75,127404320,126473360,930960,80.56200051559681
1747352749973397,133677244,1,1435,75,127498832,126568000,930832,80.57307870808052
1747352750067230,133771884,1,1436,75,127592665,126662640,930025,80.64299346791753
1747352750166033,133866532,1,1437,75,127691468,126757288,934180,80.28431351559657
1747352750260035,133961164,1,1438,75,127785470,126851920,933550,80.33849284987414
1747352750354041,134055804,1,1439,75,127879476,126946560,932916,80.39309005312376
1747352750452598,134150444,1,1440,75,127978033,127041200,936833,80.05695785694995
1747352750546835,134245084,1,1441,75,128072270,127135840,936430,80.09141099708468
1747352750641104,134339724,1,1442,75,128166539,127230480,936059,80.12315463021028
1747352750735429,134434364,1,1443,75,128260864,127325120,935744,80.15012653033308
1747352750833207,134529004,1,1444,75,128358642,127419760,938882,79.88224292296583
1747352750927434,134623644,1,1445,75,128452869,127514400,938469,79.91739737807002
1747352751022233,134718284,1,1446,75,128547668,127609040,938628,79.90385967603778
1747352751115931,134812924,1,1447,75,128641366,127703680,937686,79.98413114838016
1747352751214815,134907564,1,1448,75,128740250,127798320,941930,79.62375123416814
1747352751308749,135002204,1,1449,75,128834184,127892960,941224,79.68347598446279
1747352751402682,135096844,1,1450,75,128928117,127987600,940517,79.74337518620078
1747352751500705,135191484,1,1451,75,129026140,128082240,943900,79.45756965780274
1747352751594833,135286124,1,1452,75,129120268,128176880,943388,79.5006932460451
1747352751689816,135380764,1,1453,75,129215251,128271520,943731,79.47179863753549
1747352751783577,135475404,1,1454,75,129309012,128366160,942852,79.54588843211872
1747352751881803,135570044,1,1455,75,129407238,128460800,946438,79.24449356429052
1747352751976550,135664684,1,1456,75,129501985,128555440,946545,79.2355355529848
1747352752070176,135759324,1,1457,75,129595611,128650080,945531,79.3205087934716
1747352752168610,135853964,1,1458,75,129694045,128744720,949325,79.00350248861034
1747352752263275,135948604,1,1459,75,129788710,128839360,949350,79.00142202559645
1747352752357532,136043244,1,1460,75,129882967,128934000,948967,79.03330674301635
1747352752451076,136137884,1,1461,75,129976511,129028640,947871,79.12469101808158
1747352752549328,136232524,1,1462,75,130074763,129123280,951483,78.82431950964967
1747352752643610,136327164,1,1463,75,130169045,129217920,951125,78.85398869759496
1747352752738494,136421804,1,1464,75,130263929,129312560,951369,78.8337648168061
1747352752831925,136516444,1,1465,75,130357360,129407200,950160,78.93407426117706
1747352752930179,136611084,1,1466,75,130455614,129501840,953774,78.63498061385611
1747352753025020,136705724,1,1467,75,130550455,129596480,953975,78.61841243219162
1747352753119248,136800364,1,1468,75,130644683,129691120,953563,78.65238059782101
1747352753216996,136895004,1,1469,75,130742431,129785760,956671,78.39685743583739
1747352753311801,136989644,1,1470,75,130837236,129880400,956836,78.38333841954108
1747352753405581,137084284,1,1471,75,130931016,129975040,955976,78.45385239796815
1747352753500046,137178924,1,1472,75,131025481,130069680,955801,78.46821671038218
1747352753598541,137273564,1,1473,75,131123976,130164320,959656,78.15300482672959
1747352753692081,137368204,1,1474,75,131217516,130258960,958556,78.24269004627794
1747352753786076,137462844,1,1475,75,131311511,130353600,957911,78.29537399612282
1747352753885011,137557484,1,1476,75,131410446,130448240,962206,77.94588684751498
1747352753979527,137652124,1,1477,75,131504962,130542880,962082,77.9559330701541
1747352754072985,137746764,1,1478,75,131598420,130637520,960900,78.05182641273807
1747352754167302,137841404,1,1479,75,131692737,130732160,960577,78.07807182557983
1747352754265817,137936044,1,1480,75,131791252,130826800,964452,77.76436774458449
1747352754360022,138030684,1,1481,75,131885457,130921440,964017,77.7994578933774
1747352754454407,138125332,1,1482,75,131979842,131016088,963754,77.82068868196656
1747352754548381,138219964,1,1483,75,132073816,131110720,963096,77.873856811782
1747352754646564,138314604,1,1484,75,132171999,131205360,966639,77.58842753085692
1747352754740798,138409244,1,1485,75,132266233,131300000,966233,77.62102929624635
1747352754834701,138503884,1,1486,75,132360136,131394640,965496,77.68028039474011
1747352754933750,138598524,1,1487,75,132459185,131489280,969905,77.32716090751155
1747352755027947,138693164,1,1488,75,132553382,131583920,969462,77.36249589978772
1747352755122048,138787804,1,1489,75,132647483,131678560,968923,77.40553170891805
1747352755216261,138882444,1,1490,75,132741696,131773200,968496,77.43965901769342
1747352755313956,138977084,1,1491,75,132839391,131867840,971551,77.19615336714182
1747352755408772,139071724,1,1492,75,132934207,131962480,971727,77.1821715358326
1747352755502295,139166364,1,1493,75,133027730,132057120,970610,77.2709945292136
1747352755597479,139261004,1,1494,75,133122914,132151760,971154,77.22771053818447
1747352755695537,139355644,1,1495,75,133220972,132246400,974572,76.95685901092993
1747352755788962,139450284,1,1496,75,133314397,132341040,973357,77.05292097349688
1747352755883186,139544924,1,1497,75,133408621,132435680,972941,77.08586646055619
1747352755981626,139639564,1,1498,75,133507061,132530320,976741,76.78596475421837
1747352756076206,139734204,1,1499,75,133601641,132624960,976681,76.79068191149413
1747352756169818,139828844,1,1500,75,133695253,132719600,975653,76.87159266665505
1747352847177226,841164,1,9,100,0,0,0,0.0
1747352847266470,929564,1,10,100,89244,88400,844,118483.41232227487
1747352847385795,1019004,1,11,100,208569,177840,30729,3254.254938331869
1747352847459806,1109484,1,12,100,282580,268320,14260,7012.622720897616
1747352847544904,1199964,1,13,100,367678,358800,8878,11263.798152737105
1747352847722017,1384044,1,15,100,544791,542880,1911,52328.62375719519
1747352848118960,1755324,1,19,100,941734,914160,27574,3626.60477261188
1747352848196218,1848924,1,20,100,1018992,1007760,11232,8903.133903133903
1747352848479339,2126604,1,23,100,1302113,1285440,16673,5997.720866070893
1747352848565450,2217084,1,24,100,1388224,1375920,12304,8127.43823146944
1747352848655430,2307564,1,25,100,1478204,1466400,11804,8471.704506946797
1747352849044662,2678844,1,29,100,1867436,1837680,29756,3360.666756284447
1747352849142032,2772444,1,30,100,1964806,1931280,33526,2982.759649227465
1747352849219909,2866044,1,31,100,2042683,2024880,17803,5617.030837499298
1747352849310689,2956524,1,32,100,2133463,2115360,18103,5523.946307241893
1747352849420646,3047004,1,33,100,2243420,2205840,37580,2660.989888238425
1747352850362874,3979884,1,43,100,3185648,3138720,46928,2130.923968632799
1747352850432925,4070364,1,44,100,3255699,3229200,26499,3773.7273104645456
1747352850522997,4160844,1,45,100,3345771,3319680,26091,3832.7392587482273
1747352853181386,6778524,1,73,100,6004160,5937360,66800,1497.005988023952
1747352853357002,6965724,1,75,100,6179776,6124560,55216,1811.0692552883224
1747352853443685,7059324,1,76,100,6266459,6218160,48299,2070.4362409159608
1747352853533775,7149804,1,77,100,6356549,6308640,47909,2087.290488217245
1747352853840824,7427484,1,80,100,6663598,6586320,77278,1294.029348585626
1747352854020551,7614684,1,82,100,6843325,6773520,69805,1432.562137382709
1747352854397629,7989084,1,86,100,7220403,7147920,72483,1379.6338451774898
1747352854573635,8173164,1,88,100,7396409,7332000,64409,1552.578055861759
1747352854654857,8263644,1,89,100,7477631,7422480,55151,1813.2037497053543
1747352854746037,8354124,1,90,100,7568811,7512960,55851,1790.4782367370326
1747352854835788,8444604,1,91,100,7658562,7603440,55122,1814.1576865861184
1747352854929717,8535084,1,92,100,7752491,7693920,58571,1707.3295658260915
1747352855020246,8625564,1,93,100,7843020,7784400,58620,1705.90242238144
1747352855114006,8716044,1,94,100,7936780,7874880,61900,1615.5088852988692
1747352855208181,8806524,1,95,100,8030955,7965360,65595,1524.5064410397133
1747352855294565,8897004,1,96,100,8117339,8055840,61499,1626.0426998812989
1747352855384052,8987484,1,97,100,8206826,8146320,60506,1652.728655009421
1747352855474259,9077964,1,98,100,8297033,8236800,60233,1660.21948101539
1747352855564490,9168444,1,99,100,8387264,8327280,59984,1667.111229661243
1747352855658723,9258924,1,100,100,8481497,8417760,63737,1568.9473931939062
1747352856044114,9634364,1,104,100,8866888,8793200,73688,1357.0730648138094
1747352856137856,9725884,1,105,100,8960630,8884720,75910,1317.3494928204452
1747352856609629,10201164,1,110,100,9432403,9360000,72403,1381.1582392994767
1747352856728268,10293724,1,111,100,9551042,9452560,98482,1015.4139842813915
1747352856814169,10389404,1,112,100,9636943,9548240,88703,1127.3575865528787
1747352856908224,10485084,1,113,100,9730998,9643920,87078,1148.3956912193664
1747352857002526,10580764,1,114,100,9825300,9739600,85700,1166.8611435239206
1747352857108578,10673324,1,115,100,9931352,9832160,99192,1008.145818211146
1747352858349662,11914044,1,128,100,11172436,11072880,99556,1004.4598015187432
1747352858456130,12009724,1,129,100,11278904,11168560,110344,906.2567969259768
1747352858746674,12296764,1,132,100,11569448,11455600,113848,878.3641346356545
1747352858816424,12392444,1,133,100,11639198,11551280,87918,1137.4235082690689
1747352858906341,12485004,1,134,100,11729115,11643840,85275,1172.6766344180592
1747352859000835,12577564,1,135,100,11823609,11736400,87209,1146.6706417915582
1747352859095435,12670124,1,136,100,11918209,11828960,89249,1120.4607334535965
1747352859189442,12762684,1,137,100,12012216,11921520,90696,1102.5844579694806
1747352859283602,12855244,1,138,100,12106376,12014080,92296,1083.470572939239
1747352859374088,12947804,1,139,100,12196862,12106640,90222,1108.3771142293454
1747352859475705,13040364,1,140,100,12298479,12199200,99279,1007.262361627333
1747352863428513,16963244,1,181,100,16251287,16122080,129207,773.9518756723708
1747352863518845,17058924,1,182,100,16341619,16217760,123859,807.3696703509636
1747352866229524,19734844,1,210,100,19052298,18893680,158618,630.4454727710599
1747352866315875,19830524,1,211,100,19138649,18989360,149289,669.8417164024141
1747352866402157,19923084,1,212,100,19224931,19081920,143011,699.2469110767703
1747352866492295,20015644,1,213,100,19315069,19174480,140589,711.293202170867
1747352866590464,20108204,1,214,100,19413238,19267040,146198,684.0038851420676
1747352866680082,20200764,1,215,100,19502856,19359600,143256,698.0510414921539
1747352866774547,20293324,1,216,100,19597321,19452160,145161,688.8902666694222
1747352866873456,20385884,1,217,100,19696230,19544720,151510,660.0224407629859
1747352866958593,20478444,1,218,100,19781367,19637280,144087,694.0251375904836
1747352867057127,20571004,1,219,100,19879901,19729840,150061,666.3956657625898
1747352867147131,20663564,1,220,100,19969905,19822400,147505,677.9431205721841
1747352867241536,20756124,1,221,100,20064310,19914960,149350,669.5681285570806
1747352867331322,20848684,1,222,100,20154096,20007520,146576,682.239930138631
1747352867426275,20941244,1,223,100,20249049,20100080,148969,671.280602004444
1747352867524087,21033804,1,224,100,20346861,20192640,154221,648.4201243669798
1747352867618313,21126364,1,225,100,20441087,20285200,155887,641.490310288863
1747352867707574,21218924,1,226,100,20530348,20377760,152588,655.3595302382887
1747352867798560,21311484,1,227,100,20621334,20470320,151014,662.1902605056484
1747352867896773,21404044,1,228,100,20719547,20562880,156667,638.2965142627356
1747352867986545,21496604,1,229,100,20809319,20655440,153879,649.8612546221382
1747352868085320,21589164,1,230,100,20908094,20748000,160094,624.6330280959936
1747352868179233,21681724,1,231,100,21002007,20840560,161447,619.3983164753757
1747352868265231,21774284,1,232,100,21088005,20933120,154885,645.6403137811925
1747352868359840,21866844,1,233,100,21182614,21025680,156934,637.2105471089758
1747352868454054,21959404,1,234,100,21276828,21118240,158588,630.5647337755694
1747352868552691,22055084,1,235,100,21375465,21213920,161545,619.022563372435
1747352868670937,22147644,1,236,100,21493711,21306480,187231,534.0995882092175
1747352868748315,22243324,1,237,100,21571089,21402160,168929,591.964671548402
1747352868859032,22339004,1,238,100,21681806,21497840,183966,543.5787047606623
1747352868949237,22434684,1,239,100,21772011,21593520,178491,560.2523376528789
1747352869146473,22622924,1,241,100,21969247,21781760,187487,533.3703136750815
1747352869343011,22814284,1,243,100,22165785,21973120,192665,519.0356317961227
1747352869608536,23101324,1,246,100,22431310,22260160,171150,584.28279287175
1747352869793297,23289564,1,248,100,22616071,22448400,167671,596.406057099916
1747352870473028,23956204,1,255,100,23295802,23115040,180762,553.2136179064183
1747352870575634,24051884,1,256,100,23398408,23210720,187688,532.7991134222752
1747352870862315,24335804,1,259,100,23685089,23494640,190449,525.0749544497477
1747352870960663,24431484,1,260,100,23783437,23590320,193117,517.820802932937
1747352871046862,24527164,1,261,100,23869636,23686000,183636,544.5555337733342
1747352871156587,24622844,1,262,100,23979361,23781680,197681,505.8655105953532
1747352871234432,24718524,1,263,100,24057206,23877360,179846,556.0312711986923
1747352871349171,24811084,1,264,100,24171945,23969920,202025,494.9882440292043
1747352871439343,24903644,1,265,100,24262117,24062480,199637,500.909150107445
1747352871812206,25286364,1,269,100,24634980,24445200,189780,526.9259142164611
1747352872771007,26243164,1,279,100,25593781,25402000,191781,521.4280872453476
1747352872967909,26431404,1,281,100,25790683,25590240,200443,498.8949476908647
1747352873065435,26527084,1,282,100,25888209,25685920,202289,494.3422529153834
1747352873147150,26619644,1,283,100,25969924,25778480,191444,522.345960176344
1747352873241357,26712204,1,284,100,26064131,25871040,193091,517.8905283001279
1747352873332319,26804764,1,285,100,26155093,25963600,191493,522.2123001885186
1747352873425863,26897324,1,286,100,26248637,26056160,192477,519.5425946996264
1747352873519926,26989884,1,287,100,26342700,26148720,193980,515.5170636148056
1747352873610314,27082444,1,288,100,26433088,26241280,191808,521.3546880213547
1747352873704752,27175004,1,289,100,26527526,26333840,193686,516.2995776669454
1747352873798863,27267564,1,290,100,26621637,26426400,195237,512.1979952570466
1747352873893189,27360124,1,291,100,26715963,26518960,197003,507.6064831500028
1747352873986620,27452684,1,292,100,26809394,26611520,197874,505.37210548126586
1747352874077684,27545244,1,293,100,26900458,26704080,196378,509.2220106121867
1747352874171138,27637804,1,294,100,26993912,26796640,197272,506.914311204834
1747352874265297,27730364,1,295,100,27088071,26889200,198871,502.8385234649597
1747352874359773,27822924,1,296,100,27182547,26981760,200787,498.04021176669806
1747352874450286,27915484,1,297,100,27273060,27074320,198740,503.1699708161417
1747352874544396,28008044,1,298,100,27367170,27166880,200290,499.2760497278946
1747352874638185,28100604,1,299,100,27460959,27259440,201519,496.23112460859767
1747352874732852,28193164,1,300,100,27555626,27352000,203626,491.0964218714702
1747352874831239,28285724,1,301,100,27654013,27444560,209453,477.4340782896402
1747352874917176,28378284,1,302,100,27739950,27537120,202830,493.02371444066455
1747352875010798,28470844,1,303,100,27833572,27629680,203892,490.455731465678
1747352875105248,28563404,1,304,100,27928022,27722240,205782,485.95115219018186
1747352875199209,28655964,1,305,100,28021983,27814800,207183,482.6650835251927
1747352875289379,28748524,1,306,100,28112153,27907360,204793,488.2979398709917
1747352875383610,28841084,1,307,100,28206384,27999920,206464,484.3459392436454
1747352875486609,28933644,1,308,100,28309383,28092480,216903,461.0355781155632
1747352875571890,29026204,1,309,100,28394664,28185040,209624,477.0446132122276
1747352875666699,29118764,1,310,100,28489473,28277600,211873,471.9808564564621
1747352875760709,29211324,1,311,100,28583483,28370160,213323,468.77270617795546
1747352875850730,29303884,1,312,100,28673504,28462720,210784,474.4193107636253
1747352875944656,29396444,1,313,100,28767430,28555280,212150,471.36460051850105
1747352876035544,29489004,1,314,100,28858318,28647840,210478,475.1090375241118
1747352876129694,29581564,1,315,100,28952468,28740400,212068,471.5468623271781
1747352876223627,29674124,1,316,100,29046401,28832960,213441,468.51354706921353
1747352876317255,29766692,1,317,100,29140029,28925528,214501,466.1982927818518
1747352876411464,29859244,1,318,100,29234238,29018080,216158,462.62456166322784
1747352876501510,29951804,1,319,100,29324284,29110640,213644,468.06837542828254
1747352876595658,30044364,1,320,100,29418432,29203200,215232,464.6149271483794
1747352876689950,30136924,1,321,100,29512724,29295760,216964,460.905956748585
1747352876780245,30229484,1,322,100,29603019,29388320,214699,465.7683547664405
1747352876874915,30322044,1,323,100,29697689,29480880,216809,461.2354653173992
1747352876969175,30414604,1,324,100,29791949,29573440,218509,457.6470534394464
1747352877062491,30507164,1,325,100,29885265,29666000,219265,456.0691400816364
1747352877157521,30599724,1,326,100,29980295,29758560,221735,450.9887929284957
1747352877247773,30692284,1,327,100,30070547,29851120,219427,455.7324303754779
1747352877341531,30784844,1,328,100,30164305,29943680,220625,453.257790368272
1747352877435262,30877404,1,329,100,30258036,30036240,221796,450.8647586070082
1747352877530304,30969964,1,330,100,30353078,30128800,224278,445.87520844666
1747352877620381,31062524,1,331,100,30443155,30221360,221795,450.86679140647897
1747352877714482,31155084,1,332,100,30537256,30313920,223336,447.7558476913708
1747352877808203,31247644,1,333,100,30630977,30406480,224497,445.4402508719493
1747352877902923,31340204,1,334,100,30725697,30499040,226657,441.1952862695615
1747352877997129,31432764,1,335,100,30819903,30591600,228303,438.014393152959
1747352878086869,31525324,1,336,100,30909643,30684160,225483,443.4924140622575
1747352878181420,31617884,1,337,100,31004194,30776720,227474,439.61068078110026
1747352878274755,31710444,1,338,100,31097529,30869280,228249,438.1180202322902
1747352878365090,31803004,1,339,100,31187864,30961840,226024,442.4308922946236
1747352878459775,31895572,1,340,100,31282549,31054408,228141,438.3254215594741
1747352878553970,31988124,1,341,100,31376744,31146960,229784,435.19131009992
1747352878647744,32080684,1,342,100,31470518,31239520,230998,432.90418098858
1747352878741651,32173244,1,343,100,31564425,31332080,232345,430.3944565194
1747352878832251,32265804,1,344,100,31655025,31424640,230385,434.0560366343295
1747352878925817,32358364,1,345,100,31748591,31517200,231391,432.168926189869
1747352879020517,32450924,1,346,100,31843291,31609760,233531,428.2086746513311
1747352879115213,32543484,1,347,100,31937987,31702320,235667,424.3275469200185
1747352879204389,32636044,1,348,100,32027163,31794880,232283,430.5093355949424
1747352879298787,32728604,1,349,100,32121561,31887440,234121,427.12956120980175
1747352879393568,32821164,1,350,100,32216342,31980000,236342,423.1156544329827
1747352879487232,32913724,1,351,100,32310006,32072560,237446,421.14838742282456
1747352879578185,33006284,1,352,100,32400959,32165120,235839,424.0180801309368
1747352879671760,33098844,1,353,100,32494534,32257680,236854,422.2010183488562
1747352879766627,33191404,1,354,100,32589401,32350240,239161,418.12837377331584
1747352879859895,33283964,1,355,100,32682669,32442800,239869,416.8942214291968
1747352879954847,33376524,1,356,100,32777621,32535360,242261,412.7779543550138
1747352880048352,33469084,1,357,100,32871126,32627920,243206,411.17406642928216
1747352880138799,33561644,1,358,100,32961573,32720480,241093,414.777699891743
1747352880232745,33654204,1,359,100,33055519,32813040,242479,412.4068476032976
1747352880331658,33746764,1,360,100,33154432,32905600,248832,401.8775720164609
1747352880417569,33839324,1,361,100,33240343,32998160,242183,412.9108979573298
1747352880511295,33931884,1,362,100,33334069,33090720,243349,410.932446815068
1747352880605637,34024444,1,363,100,33428411,33183280,245131,407.945139537635
1747352880703965,34117004,1,364,100,33526739,33275840,250899,398.5667539527858
1747352880790147,34209564,1,365,100,33612921,33368400,244521,408.9628293684388
1747352880888307,34302124,1,366,100,33711081,33460960,250121,399.80649365707
1747352880978344,34394684,1,367,100,33801118,33553520,247598,403.88048368726726
1747352881072709,34487244,1,368,100,33895483,33646080,249403,400.9574864777088
1747352881162268,34579804,1,369,100,33985042,33738640,246402,405.8408616813175
1747352881257366,34672364,1,370,100,34080140,33831200,248940,401.7032216598377
1747352881351167,34764924,1,371,100,34173941,33923760,250181,399.71060951870845
1747352881445651,34857484,1,372,100,34268425,34016320,252105,396.6601217746573
1747352881539288,34950044,1,373,100,34362062,34108880,253182,394.9727863750188
1747352881629806,35042604,1,374,100,34452580,34201440,251140,398.1842796846381
1747352881727444,35135164,1,375,100,34550218,34294000,256218,390.2926414225386
1747352881818112,35227724,1,376,100,34640886,34386560,254326,393.1961340956096
1747352881912055,35320284,1,377,100,34734829,34479120,255709,391.0695360742093
1747352882002262,35412844,1,378,100,34825036,34571680,253356,394.7015267055053
1747352882096262,35505404,1,379,100,34919036,34664240,254796,392.4708394166313
1747352882190907,35597964,1,380,100,35013681,34756800,256881,389.2853110973563
1747352882284775,35690532,1,381,100,35107549,34849368,258181,387.3251711008944
1747352882375776,35783084,1,382,100,35198550,34941920,256630,389.6660561898453
1747352882469901,35875644,1,383,100,35292675,35034480,258195,387.3041693293828
1747352882564300,35968204,1,384,100,35387074,35127040,260034,384.5650953336872
1747352882658380,36060764,1,385,100,35481154,35219600,261554,382.3302262630279
1747352882747786,36153324,1,386,100,35570560,35312160,258400,386.9969040247678
1747352882842098,36245884,1,387,100,35664872,35404720,260152,384.3906639195548
1747352882936904,36338444,1,388,100,35759678,35497280,262398,381.1004657047691
1747352883030411,36431004,1,389,100,35853185,35589840,263345,379.7300119614954
1747352883124283,36523564,1,390,100,35947057,35682400,264657,377.8475536260141
1747352883215296,36616124,1,391,100,36038070,35774960,263110,380.06917258941127
1747352883308956,36708684,1,392,100,36131730,35867520,264210,378.4868097346807
1747352883402650,36801244,1,393,100,36225424,35960080,265344,376.8692715870719
1747352883497548,36893804,1,394,100,36320322,36052640,267682,373.5776032755285
1747352883587684,36986364,1,395,100,36410458,36145200,265258,376.991457373576
1747352883681406,37078924,1,396,100,36504180,36237760,266420,375.3471961564448
1747352883775344,37171484,1,397,100,36598118,36330320,267798,373.4157835383386
1747352883869630,37264044,1,398,100,36692404,36422880,269524,371.0244727742242
1747352883959793,37356604,1,399,100,36782567,36515440,267127,374.3537718014278
1747352884054480,37449164,1,400,100,36877254,36608000,269254,371.3965252141101
1747352884148794,37541724,1,401,100,36971568,36700560,271008,368.9927972605975
1747352884242718,37634284,1,402,100,37065492,36793120,272372,367.1449341341988
1747352884333262,37726844,1,403,100,37156036,36885680,270356,369.8826732160559
1747352884427463,37819412,1,404,100,37250237,36978248,271989,367.6619275044212
1747352884521333,37911964,1,405,100,37344107,37070800,273307,365.8889088095072
1747352884623299,38004524,1,406,100,37446073,37163360,282713,353.7156055788025
1747352884709397,38097084,1,407,100,37532171,37255920,276251,361.98963985650727
1747352884803543,38189644,1,408,100,37626317,37348480,277837,359.92326436003844
1747352884898575,38282204,1,409,100,37721349,37441040,280309,356.7491589638578
1747352884988751,38374764,1,410,100,37811525,37533600,277925,359.8093010704327
1747352885082211,38467324,1,411,100,37904985,37626160,278825,358.6478974267014
1747352885181151,38559884,1,412,100,38003925,37718720,285205,350.6249890429691
1747352885267093,38652444,1,413,100,38089867,37811280,278587,358.9542943497005
1747352885373559,38745004,1,414,100,38196333,37903840,292493,341.88852382792066
1747352885454882,38837564,1,415,100,38277656,37996400,281256,355.5479705321842
1747352885549298,38930124,1,416,100,38372072,38088960,283112,353.2171013591794
1747352885643347,39022684,1,417,100,38466121,38181520,284601,351.36910973608667
1747352885733514,39115244,1,418,100,38556288,38274080,282208,354.3485655970064
1747352885828169,39207804,1,419,100,38650943,38366640,284303,351.73740692148874
1747352885918319,39300364,1,420,100,38741093,38459200,281893,354.7445307261975
1747352886012713,39392924,1,421,100,38835487,38551760,283727,352.45147624300824
1747352886106727,39485484,1,422,100,38929501,38644320,285181,350.6544966179373
1747352886200894,39578044,1,423,100,39023668,38736880,286788,348.6896243915366
1747352886294855,39670604,1,424,100,39117629,38829440,288189,346.994507076953
1747352886384763,39763164,1,425,100,39207537,38922000,285537,350.21730984075623
1747352886487205,39855724,1,426,100,39309979,39014560,295419,338.5022628876274
1747352886573728,39948284,1,427,100,39396502,39107120,289382,345.56399499623336
1747352886667212,40040844,1,428,100,39489986,39199680,290306,344.4641171729141
1747352886757694,40133404,1,429,100,39580468,39292240,288228,346.9475554075246
1747352886851585,40225964,1,430,100,39674359,39384800,289559,345.3527605772917
1747352886945799,40318524,1,431,100,39768573,39477360,291213,343.39126343947555
1747352887039769,40411084,1,432,100,39862543,39569920,292623,341.7366372431422
1747352887130446,40503644,1,433,100,39953220,39662480,290740,343.9499208915182
1747352887224056,40596204,1,434,100,40046830,39755040,291790,342.71222454504954
1747352887318289,40688764,1,435,100,40141063,39847600,293463,340.75846018067017
1747352887422192,40781324,1,436,100,40244966,39940160,304806,328.0775312821926
1747352887621612,40969564,1,438,100,40444386,40128400,315986,316.4697170127791
1747352887699502,41062124,1,439,100,40522276,40220960,301316,331.8774973781678
1747352887793768,41154684,1,440,100,40616542,40313520,303022,330.0090422477576
1747352887880228,41247244,1,441,100,40703002,40406080,296922,336.788786280572
1747352887978238,41339804,1,442,100,40801012,40498640,302372,330.7184527667906
1747352888068314,41432364,1,443,100,40891088,40591200,299888,333.4578242543883
1747352888161984,41524924,1,444,100,40984758,40683760,300998,332.22812111708384
1747352888256205,41617484,1,445,100,41078979,40776320,302659,330.4048450566479
1747352888346563,41710044,1,446,100,41169337,40868880,300457,332.8263278938417
1747352888440801,41802604,1,447,100,41263575,40961440,302135,330.97787412911447
1747352888551358,41895164,1,448,100,41374132,41054000,320132,312.37114690190293
1747352888633387,41990844,1,449,100,41456161,41149680,306481,326.2845005073724
1747352888743939,42086524,1,450,100,41566713,41245360,321353,311.18427399152955
1747352888846128,42179084,1,451,100,41668902,41337920,330982,302.1312337226798
1747352888919868,42274764,1,452,100,41742642,41433600,309042,323.58061363827574
1747352889018094,42367324,1,453,100,41840868,41526160,314708,317.75487118217524
1747352889104673,42459884,1,454,100,41927447,41618720,308727,323.910769061339
1747352889198646,42552444,1,455,100,42021420,41711280,310140,322.43502934158766
1747352889289126,42645004,1,456,100,42111900,41803840,308060,324.6120885541778
1747352889383031,42737564,1,457,100,42205805,41896400,309405,323.2009825309869
1747352889477331,42830124,1,458,100,42300105,41988960,311145,321.3935624869434
1747352889566764,42922684,1,459,100,42389538,42081520,308018,324.6563512521996
1747352889661783,43015244,1,460,100,42484557,42174080,310477,322.08504977824447
1747352889756008,43107804,1,461,100,42578782,42266640,312142,320.3670124494621
1747352889849775,43200364,1,462,100,42672549,42359200,313349,319.13297952123673
1747352889940154,43292924,1,463,100,42762928,42451760,311168,321.3698066639243
1747352890033906,43385484,1,464,100,42856680,42544320,312360,320.1434242540658
1747352890128151,43478052,1,465,100,42950925,42636888,314037,318.4338151236956
1747352890221966,43570604,1,466,100,43044740,42729440,315300,317.15826197272435
1747352890316627,43663164,1,467,100,43139401,42822000,317401,315.0588687496259
1747352890407262,43755724,1,468,100,43230036,42914560,315476,316.9813234604217
1747352890501359,43848284,1,469,100,43324133,43007120,317013,315.4444770403737
1747352890595463,43940844,1,470,100,43418237,43099680,318557,313.91556299186647
1747352890689027,44033404,1,471,100,43511801,43192240,319561,312.9292998832774
1747352890779781,44125964,1,472,100,43602555,43284800,317755,314.7078724174285
1747352890873609,44218524,1,473,100,43696383,43377360,319023,313.4570234747965
1747352890968067,44311084,1,474,100,43790841,43469920,320921,311.6031671345908
1747352891062044,44403644,1,475,100,43884818,43562480,322338,310.2333575315352
1747352891151947,44496204,1,476,100,43974721,43655040,319681,312.8118342973152
1747352891246279,44588764,1,477,100,44069053,43747600,321453,311.0874684635079
1747352891340672,44681324,1,478,100,44163446,43840160,323286,309.3236329442042
1747352891435004,44773884,1,479,100,44257778,43932720,325058,307.63740624750045
1747352891525452,44866444,1,480,100,44348226,44025280,322946,309.6492912127724
1747352891619502,44959004,1,481,100,44442276,44117840,324436,308.2272004339839
1747352891713750,45051564,1,482,100,44536524,44210400,326124,306.63183329040487
1747352891807380,45144124,1,483,100,44630154,44302960,327194,305.62907632780554
1747352891901489,45236684,1,484,100,44724263,44395520,328743,304.18898653355353
1747352891991479,45329244,1,485,100,44814253,44488080,326173,306.58576890177915
1747352892086514,45421804,1,486,100,44909288,44580640,328648,304.2769163360191
1747352892180589,45514364,1,487,100,45003363,44673200,330163,302.88069832173807
1747352892274619,45606932,1,488,100,45097393,44765768,331625,301.5454202789295
1747352892365028,45699484,1,489,100,45187802,44858320,329482,303.50671660363844
1747352892459058,45792044,1,490,100,45281832,44950880,330952,302.1586211897797
1747352892552552,45884604,1,491,100,45375326,45043440,331886,301.3082805541662
1747352892647099,45977164,1,492,100,45469873,45136000,333873,299.5150850772599
1747352892737248,46069724,1,493,100,45560022,45228560,331462,301.69370847940337
1747352893028235,46353644,1,496,100,45851009,45512480,338529,295.3956677271371
1747352893122518,46446204,1,497,100,45945292,45605040,340252,293.8998154309159
1747352893212513,46538772,1,498,100,46035287,45697608,337679,296.13923282170344
1747352893307039,46631324,1,499,100,46129813,45790160,339653,294.41812673522685
1747352893396742,46723884,1,500,100,46219516,45882720,336796,296.91564032826994
1747352893491032,46816444,1,501,100,46313806,45975280,338526,295.3982855083509
1747352893589283,46909004,1,502,100,46412057,46067840,344217,290.5144138726443
1747352893896447,47192924,1,505,100,46719221,46351760,367461,272.1377234590882
1747352893965652,47285484,1,506,100,46788426,46444320,344106,290.6081265656513
1747352894059896,47378044,1,507,100,46882670,46536880,345790,289.19286272014807
1747352894149850,47470612,1,508,100,46972624,46629448,343176,291.3956686947805
1747352894244145,47563164,1,509,100,47066919,46722000,344919,289.92314137522146
1747352894334360,47655724,1,510,100,47157134,46814560,342574,291.9077338034994
1747352894428515,47748284,1,511,100,47251289,46907120,344169,290.55493086245417
1747352894523405,47840844,1,512,100,47346179,46999680,346499,288.6011215039581
1747352894617426,47933404,1,513,100,47440200,47092240,347960,287.3893550982872
1747352894711671,48025964,1,514,100,47534445,47184800,349645,286.0043758669508
1747352894801444,48118524,1,515,100,47624218,47277360,346858,288.30241770407486
1747352894896143,48211084,1,516,100,47718917,47369920,348997,286.5354143445359
1747352894990152,48303644,1,517,100,47812926,47462480,350446,285.3506674352112
1747352895091925,48396204,1,518,100,47914699,47555040,359659,278.0411445285673
1747352895178617,48488764,1,519,100,48001391,47647600,353791,282.6527526138313
1747352895272259,48581324,1,520,100,48095033,47740160,354873,281.79095056541354
1747352895363041,48673884,1,521,100,48185815,47832720,353095,283.2099010181396
1747352895457178,48766444,1,522,100,48279952,47925280,354672,281.95064735868635
1747352895550695,48859004,1,523,100,48373469,48017840,355629,281.1919162947904
1747352895640777,48951564,1,524,100,48463551,48110400,353151,283.1649917457405
1747352895743792,49044124,1,525,100,48566566,48202960,363606,275.0229644175289
1747352895845328,49136684,1,526,100,48668102,48295520,372582,268.3972924081142
1747352895948676,49232364,1,527,100,48771450,48391200,380250,262.98487836949374
1747352896042124,49324924,1,528,100,48864898,48483760,381138,262.37215916544665
1747352896222895,49516284,1,530,100,49045669,48675120,370549,269.8698417753117
1747352897463278,50757004,1,543,100,50286052,49915840,370212,270.1155013883937
1747352897570430,50849564,1,544,100,50393204,50008400,384804,259.8725584973129
1747352897647948,50942124,1,545,100,50470722,50100960,369762,270.4442316949822
1747352897750828,51034684,1,546,100,50573602,50193520,380082,263.1011202845702
1747352897938878,51222924,1,548,100,50761652,50381760,379892,263.2327082433955
1747352898024708,51315484,1,549,100,50847482,50474320,373162,267.9801265938118
1747352898131450,51408044,1,550,100,50954224,50566880,387344,258.1684497500929
1747352898208940,51500604,1,551,100,51031714,50659440,372274,268.6193502635156
1747352898311045,51593164,1,552,100,51133819,50752000,381819,261.9042006814747
1747352898397048,51685724,1,553,100,51219822,50844560,375262,266.48048563403705
1747352898487533,51778284,1,554,100,51310307,50937120,373187,267.9621744594533
1747352898598057,51870844,1,555,100,51420831,51029680,391151,255.65574420108857
1747352898684142,51963404,1,556,100,51506916,51122240,384676,259.9590304568
1747352898770698,52055964,1,557,100,51593472,51214800,378672,264.08078759454094
1747352898862118,52148524,1,558,100,51684892,51307360,377532,264.878208999502
1747352898958632,52241084,1,559,100,51781406,51399920,381486,262.1328174559486
1747352899057154,52333644,1,560,100,51879928,51492480,387448,258.0991513699903
1747352899261350,52521884,1,562,100,52084124,51680720,403404,247.8904522513411
1747352899548906,52808924,1,565,100,52371680,51967760,403920,247.57377698554168
1747352899622442,52904604,1,566,100,52445216,52063440,381776,261.9336993420225
1747352900318695,53571244,1,573,100,53141469,52730080,411389,243.07893502256988
1747352900416316,53666924,1,574,100,53239090,52825760,413330,241.9374349793144
1747352900506579,53759484,1,575,100,53329353,52918320,411033,243.28946824220927
1747352900609488,53855164,1,576,100,53432262,53014000,418262,239.08459291066364
1747352900772039,54046524,1,578,100,53594813,53205360,389453,256.7703933465656
1747352900891436,54142204,1,579,100,53714210,53301040,413170,242.03112520270108
1747352900965232,54234764,1,580,100,53788006,53393600,394406,253.54583855215185
1747352901059854,54327332,1,581,100,53882628,53486168,396460,252.2322554608284
1747352901154128,54419884,1,582,100,53976902,53578720,398182,251.1414378349599
1747352901243856,54512444,1,583,100,54066630,53671280,395350,252.94043252813964
1747352901338546,54605004,1,584,100,54161320,53763840,397480,251.58498540807085
1747352901428794,54697564,1,585,100,54251568,53856400,395168,253.05692768645235
1747352901526767,54790124,1,586,100,54349541,53948960,400581,249.6374016740684
1747352901616773,54882684,1,587,100,54439547,54041520,398027,251.2392375391619
1747352901711378,54975244,1,588,100,54534152,54134080,400072,249.9550080985423
1747352901805547,55067804,1,589,100,54628321,54226640,401681,248.95377177411925
1747352901895628,55160364,1,590,100,54718402,54319200,399202,250.49974699525552
1747352901989354,55252924,1,591,100,54812128,54411760,400368,249.77021140550693
1747352902084056,55345484,1,592,100,54906830,54504320,402510,248.4410325209312
1747352902178150,55438044,1,593,100,55000924,54596880,404044,247.4977972696043
1747352902268149,55530604,1,594,100,55090923,54689440,401483,249.07654869571067
1747352902362365,55623164,1,595,100,55185139,54782000,403139,248.0534009361535
1747352902456577,55715724,1,596,100,55279351,54874560,404791,247.0410656363408
1747352902550933,55808284,1,597,100,55373707,54967120,406587,245.9498213174548
1747352902641015,55900844,1,598,100,55463789,55059680,404109,247.45798782011784
1747352902734694,55993404,1,599,100,55557468,55152240,405228,246.77465525580664
1747352902829594,56085964,1,600,100,55652368,55244800,407568,245.35782985906647
1747352902927822,56178524,1,601,100,55750596,55337360,413236,241.99246919435868
1747352903013019,56271084,1,602,100,55835793,55429920,405873,246.38248910373443
1747352903111539,56363644,1,603,100,55934313,55522480,411833,242.81686994485628
1747352903201583,56456212,1,604,100,56024357,55615048,409309,244.31419783097857
1747352903296486,56548764,1,605,100,56119260,55707600,411660,242.91891366661807
1747352903385783,56641324,1,606,100,56208557,55800160,408397,244.85978104638377
1747352903480676,56733884,1,607,100,56303450,55892720,410730,243.46894553599688
1747352903578439,56826444,1,608,100,56401213,55985280,415933,240.423337412516
1747352903672405,56919004,1,609,100,56495179,56077840,417339,239.6133598824936
1747352903762392,57011564,1,610,100,56585166,56170400,414766,241.09980085156448
1747352903856619,57104124,1,611,100,56679393,56262960,416433,240.13466752154608
1747352903951213,57196684,1,612,100,56773987,56355520,418467,238.96746935839624
1747352904041576,57289244,1,613,100,56864350,56448080,416270,240.2286977202297
1747352904139581,57381804,1,614,100,56962355,56540640,421715,237.1269696358916
1747352904226025,57474364,1,615,100,57048799,56633200,415599,240.6165558627427
1747352904324447,57566924,1,616,100,57147221,56725760,421461,237.26987787719384
1747352904414359,57659484,1,617,100,57237133,56818320,418813,238.7700477301325
1747352904511991,57752044,1,618,100,57334765,56910880,423885,235.913042452552
1747352904598910,57844604,1,619,100,57421684,57003440,418244,239.0948824131368
1747352904693143,57937164,1,620,100,57515917,57096000,419917,238.1422995496729
1747352904786515,58029724,1,621,100,57609289,57188560,420729,237.68268885672248
1747352904880738,58122284,1,622,100,57703512,57281120,422392,236.7469080853804
1747352904979469,58214844,1,623,100,57802243,57373680,428563,233.33792231247213
1747352905069033,58307404,1,624,100,57891807,57466240,425567,234.9806258473989
1747352905159918,58399964,1,625,100,57982692,57558800,423892,235.90914666943468
1747352905257414,58492524,1,626,100,58080188,57651360,428828,233.19372802149115
1747352905351643,58585084,1,627,100,58174417,57743920,430497,232.28965590933268
1747352905442562,58677644,1,628,100,58265336,57836480,428856,233.1785028074692
1747352905532688,58770204,1,629,100,58355462,57929040,426422,234.50947652794648
1747352905626958,58862764,1,630,100,58449732,58021600,428132,233.5728233348593
1747352905732959,58955324,1,631,100,58555733,58114160,441573,226.4631216129609
1747352905815056,59047884,1,632,100,58637830,58206720,431110,231.95936072000185
1747352905917609,59140444,1,633,100,58740383,58299280,441103,226.7044205094955
1747352906011479,59233004,1,634,100,58834253,58391840,442413,226.0331409791304
1747352906114142,59325564,1,635,100,58936916,58484400,452516,220.98666124512727
1747352906191726,59421244,1,636,100,59014500,58580080,434420,230.19198011141293
1747352906282148,59513804,1,637,100,59104922,58672640,432282,231.3304740886736
1747352906474376,59702044,1,639,100,59297150,58860880,436270,229.21585256836363
1747352906564431,59794604,1,640,100,59387205,58953440,433765,230.5395778820329
1747352906658947,59887164,1,641,100,59481721,59046000,435721,229.50466009212315
1747352906753305,59979724,1,642,100,59576079,59138560,437519,228.56150247189265
1747352906843158,60072284,1,643,100,59665932,59231120,434812,229.98445305097377
1747352906937153,60164844,1,644,100,59759927,59323680,436247,229.22793738409663
1747352907031305,60257404,1,645,100,59854079,59416240,437839,228.3944554961984
1747352907125166,60349964,1,646,100,59947940,59508800,439140,227.71781208726148
1747352907215584,60442524,1,647,100,60038358,59601360,436998,228.8339992402711
1747352907309307,60535084,1,648,100,60132081,59693920,438161,228.2266107663621
1747352907404444,60627644,1,649,100,60227218,59786480,440738,226.8921672286029
1747352907498356,60720204,1,650,100,60321130,59879040,442090,226.19828541699653
1747352907592259,60812764,1,651,100,60415033,59971600,443433,225.5132116915069
1747352907682451,60905324,1,652,100,60505225,60064160,441065,226.72395225193569
1747352907789307,60997884,1,653,100,60612081,60156720,455361,219.6059829453993
1747352907878900,61090444,1,654,100,60701674,60249280,452394,221.0462561395597
1747352907965159,61183012,1,655,100,60787933,60341848,446085,224.1725231738345
1747352908055467,61275564,1,656,100,60878241,60434400,443841,225.305909098078
1747352908251854,61463804,1,658,100,61074628,60622640,451988,221.24481180916308
1747352908358435,61556364,1,659,100,61181209,60715200,466009,214.5881302721621
1747352908432428,61648932,1,660,100,61255202,60807768,447434,223.4966497852197
1747352908526386,61741484,1,661,100,61349160,60900320,448840,222.79654219766508
1747352908620530,61834044,1,662,100,61443304,60992880,450424,222.01303660550948
1747352908735317,61926604,1,663,100,61558091,61085440,472651,211.5725979634022
1747352908820928,62019164,1,664,100,61643702,61178000,465702,214.72959102602093
1747352908911523,62111724,1,665,100,61734297,61270560,463737,215.6394680605601
1747352908996707,62204284,1,666,100,61819481,61363120,456361,219.1247718363313
1747352909099115,62296844,1,667,100,61921889,61455680,466209,214.49607364937185
1747352909177212,62389404,1,668,100,61999986,61548240,451746,221.3633324921527
1747352909279240,62481964,1,669,100,62102014,61640800,461214,216.81909048727923
1747352909365667,62574524,1,670,100,62188441,61733360,455081,219.74110103476085
1747352909459841,62667084,1,671,100,62282615,61825920,456695,218.9645168000525
1747352909554472,62759644,1,672,100,62377246,61918480,458766,217.9760487917588
1747352909644352,62852204,1,673,100,62467126,62011040,456086,219.2568945330486
1747352909738060,62944764,1,674,100,62560834,62103600,457234,218.70639541241465
1747352909833015,63037324,1,675,100,62655789,62196160,459629,217.5667766829334
1747352909927055,63129884,1,676,100,62749829,62288720,461109,216.8684627712753
1747352910017166,63222444,1,677,100,62839940,62381280,458660,218.02642480268608
1747352910111016,63315004,1,678,100,62933790,62473840,459950,217.4149364061311
1747352910205327,63407564,1,679,100,63028101,62566400,461701,216.590390750724
1747352910295773,63500124,1,680,100,63118547,62658960,459587,217.58665932674336
1747352910393391,63592684,1,681,100,63216165,62751520,464645,215.2180697091328
1747352910484214,63685244,1,682,100,63306988,62844080,462908,216.02564656476017
1747352910577780,63777812,1,683,100,63400554,62936648,463906,215.5609110466345
1747352912212247,65401244,1,700,100,65035021,64560080,474941,210.5524686224184
1747352912306988,65493804,1,701,100,65129762,64652640,477122,209.590000041918
1747352912405468,65586364,1,702,100,65228242,64745200,483042,207.02133561884887
1747352912495568,65678924,1,703,100,65318342,64837760,480582,208.08103507830089
1747352912585479,65771484,1,704,100,65408253,64930320,477933,209.23434874762785
1747352912679382,65864044,1,705,100,65502156,65022880,479276,208.6480441332343
1747352912777556,65956604,1,706,100,65600330,65115440,484890,206.2323413557714
1747352912867824,66049164,1,707,100,65690598,65208000,482598,207.21179946870893
1747352912962086,66141724,1,708,100,65784860,65300560,484300,206.48358455502787
1747352913056164,66234284,1,709,100,65878938,65393120,485818,205.8384003886229
1747352913150645,66326844,1,710,100,65973419,65485680,487739,205.02768898939803
1747352913244551,66419404,1,711,100,66067325,65578240,489085,204.4634368259096
1747352913334436,66511964,1,712,100,66157210,65670800,486410,205.58787853868137
1747352913429275,66604524,1,713,100,66252049,65763360,488689,204.62911995154383
1747352913519105,66697084,1,714,100,66341879,65855920,485959,205.77867680195243
1747352913609092,66789644,1,715,100,66431866,65948480,483386,206.8740095906791
1747352913719584,66882204,1,716,100,66542358,66041040,501318,199.47418604558385
1747352913801680,66974764,1,717,100,66624454,66133600,490854,203.7265663517054
1747352913891659,67067324,1,718,100,66714433,66226160,488273,204.8034603592662
1747352913986029,67159884,1,719,100,66808803,66318720,490083,204.04706957801025
1747352914075702,67252444,1,720,100,66898476,66411280,487196,205.25620078982584
1747352914170041,67345004,1,721,100,66992815,66503840,488975,204.50943299759703
1747352914264236,67437564,1,722,100,67087010,66596400,490610,203.82788773159945
1747352914362244,67530124,1,723,100,67185018,66688960,496058,201.5893302799269
1747352914452330,67622684,1,724,100,67275104,66781520,493584,202.599760121884
1747352914547227,67715244,1,725,100,67370001,66874080,495921,201.6450200737617
1747352914637309,67807804,1,726,100,67460083,66966640,493443,202.65765245428548
1747352914734908,67900364,1,727,100,67557682,67059200,498482,200.6090490729856
1747352914825748,67992924,1,728,100,67648522,67151760,496762,201.30364238810537
1747352914914996,68085484,1,729,100,67737770,67244320,493450,202.6547775863816
1747352915009438,68178044,1,730,100,67832212,67336880,495332,201.8847964597482
1747352915120646,68270604,1,731,100,67943420,67429440,513980,194.56009961477105
1747352915215026,68363164,1,732,100,68037800,67522000,515800,193.87359441644043
1747352916835975,69989724,1,749,100,69658749,69148560,510189,196.0057939312686
1747352916946943,70082284,1,750,100,69769717,69241120,528597,189.18003696577924
1747352917033162,70177964,1,751,100,69855936,69336800,519136,192.6277507242804
1747352917229630,70366204,1,753,100,70052404,69525040,527364,189.62234813146137
1747352917307765,70458764,1,754,100,70130539,69617600,512939,194.95495565749533
1747352917401859,70551324,1,755,100,70224633,69710160,514473,194.3736600365812
1747352917492237,70643884,1,756,100,70315011,69802720,512291,195.2015553659932
1747352917590256,70736444,1,757,100,70413030,69895280,517750,193.1434089811685
1747352917680595,70829004,1,758,100,70503369,69987840,515529,193.9755086522776
1747352917774176,70921564,1,759,100,70596950,70080400,516550,193.5921014422612
1747352917868953,71014124,1,760,100,70691727,70172960,518767,192.7647672269053
1747352917970950,71106684,1,761,100,70793724,70265520,528204,189.32079272402328
1747352918053174,71199244,1,762,100,70875948,70358080,517868,193.09939984706529
1747352918146810,71291804,1,763,100,70969584,70450640,518944,192.69901954738856
1747352918240957,71384364,1,764,100,71063731,70543200,520531,192.11151689332624
1747352918335826,71476924,1,765,100,71158600,70635760,522840,191.2631015224543
1747352918425704,71569484,1,766,100,71248478,70728320,520158,192.2492781039607
1747352918519978,71662044,1,767,100,71342752,70820880,521872,191.61786798295367
1747352918613630,71754604,1,768,100,71436404,70913440,522964,191.21775112627256
1747352918704229,71847164,1,769,100,71527003,71006000,521003,191.9374744483237
1747352918798226,71939724,1,770,100,71621000,71098560,522440,191.4095398514661
1747352918892252,72032292,1,771,100,71715026,71191128,523898,190.8768500738693
1747352918986767,72124844,1,772,100,71809541,71283680,525861,190.16432098976725
1747352919080817,72217404,1,773,100,71903591,71376240,527351,189.6270226092299
1747352919175404,72309964,1,774,100,71998178,71468800,529378,188.9009365708436
1747352919265377,72402524,1,775,100,72088151,71561360,526791,189.8286037536708
1747352919359447,72495084,1,776,100,72182221,71653920,528301,189.28603201583945
1747352919453468,72587644,1,777,100,72276242,71746480,529762,188.76401100871715
1747352919543919,72680204,1,778,100,72366693,71839040,527653,189.51849037151308
1747352919638259,72772764,1,779,100,72461033,71931600,529433,188.8813126495704
1747352919732502,72865324,1,780,100,72555276,72024160,531116,188.2827856814707
1747352919826600,72957884,1,781,100,72649374,72116720,532654,187.7391327203025
1747352919916439,73050444,1,782,100,72739213,72209280,529933,188.70310020323325
1747352920010730,73143004,1,783,100,72833504,72301840,531664,188.08871768635828
1747352920104836,73235564,1,784,100,72927610,72394400,533210,187.5433694041748
1747352920199422,73328124,1,785,100,73022196,72486960,535236,186.8334715901023
1747352920289202,73420684,1,786,100,73111976,72579520,532456,187.80894571570232
1747352920387585,73513244,1,787,100,73210359,72672080,538279,185.77726420685187
1747352920477389,73605804,1,788,100,73300163,72764640,535523,186.73334291897828
1747352920571179,73698364,1,789,100,73393953,72857200,536753,186.3054328527274
1747352920661749,73790924,1,790,100,73484523,72949760,534763,186.9987265386723
1747352920756002,73883484,1,791,100,73578776,73042320,536456,186.40857777711497
1747352920850081,73976044,1,792,100,73672855,73134880,537975,185.88224359868025
1747352920944032,74068604,1,793,100,73766806,73227440,539366,185.40286187857595
1747352921034559,74161172,1,794,100,73857333,73320008,537325,186.1071046387196
1747352921129024,74253724,1,795,100,73951798,73412560,539238,185.44687132583385
1747352921226885,74346284,1,796,100,74049659,73505120,544539,183.64157571817628
1747352921317583,74438844,1,797,100,74140357,73597680,542677,184.27167541650007
1747352921423457,74531404,1,798,100,74246231,73690240,555991,179.8590264950332
1747352921505685,74623964,1,799,100,74328459,73782800,545659,183.26463963757584
1747352921604252,74716524,1,800,100,74427026,73875360,551666,181.2691012315423
1747352921690073,74809084,1,801,100,74512847,73967920,544927,183.5108188803271
1747352921784216,74901644,1,802,100,74606990,74060480,546510,182.9792684488847
1747352921874059,74994204,1,803,100,74696833,74153040,543793,183.8935035941985
1747352921984775,75086764,1,804,100,74807549,74245600,561949,177.95209173786233
1747352922070777,75179324,1,805,100,74893551,74338160,555391,180.05333179687824
1747352922169332,75271884,1,806,100,74992106,74430720,561386,178.13055544669797
1747352922279245,75364444,1,807,100,75102019,74523280,578739,172.78946122518096
1747352922755085,75839724,1,812,100,75577859,74998560,579299,172.62242814159873
1747352922832443,75935404,1,813,100,75655217,75094240,560977,178.26042778937463
1747352922918098,76027964,1,814,100,75740872,75186800,554072,180.481959023376
1747352923008813,76120524,1,815,100,75831587,75279360,552227,181.08495238371177
1747352923102327,76213084,1,816,100,75925101,75371920,553181,180.77265849694768
1747352923196859,76305644,1,817,100,76019633,75464480,555153,180.13052257665905
1747352923291048,76398204,1,818,100,76113822,75557040,556782,179.6035072972905
1747352923381291,76490772,1,819,100,76204065,75649608,554457,180.35663721442785
1747352923475139,76583324,1,820,100,76297913,75742160,555753,179.9360507275714
1747352923570155,76675884,1,821,100,76392929,75834720,558209,179.1443706568687
1747352923664140,76768444,1,822,100,76486914,75927280,559634,178.68821408277554
1747352923758149,76861004,1,823,100,76580923,76019840,561083,178.22675076592947
1747352923852669,76953564,1,824,100,76675443,76112400,563043,177.606328468696
1747352923941767,77046124,1,825,100,76764541,76204960,559581,178.70513830884178
1747352924036579,77138684,1,826,100,76859353,76297520,561833,177.98883298061878
1747352924130673,77231244,1,827,100,76953447,76390080,563367,177.5041846611534
1747352924220664,77323804,1,828,100,77043438,76482640,560798,178.31732638133516
1747352924315523,77416364,1,829,100,77138297,76575200,563097,177.58929633793113
1747352924413630,77508924,1,830,100,77236404,76667760,568644,175.85695092184213
1747352924503584,77601484,1,831,100,77326358,76760320,566038,176.6665842222607
1747352924593291,77694044,1,832,100,77416065,76852880,563185,177.5615472713229
1747352924691490,77786604,1,833,100,77514264,76945440,568824,175.8013023360477
1747352924782173,77879164,1,834,100,77604947,77038000,566947,176.38333036421395
1747352924876566,77971724,1,835,100,77699340,77130560,568780,175.81490207109957
1747352924970846,78064284,1,836,100,77793620,77223120,570500,175.28483786152498
1747352925060958,78156844,1,837,100,77883732,77315680,568052,176.0402216698471
1747352925155116,78249404,1,838,100,77977890,77408240,569650,175.54638813306417
1747352925249203,78341964,1,839,100,78071977,77500800,571177,175.0770776834501
1747352925342721,78434524,1,840,100,78165495,77593360,572135,174.783923374728
1747352925433702,78527084,1,841,100,78256476,77685920,570556,175.26763367662423
1747352925527424,78619644,1,842,100,78350198,77778480,571718,174.91140737216602
1747352925621872,78712204,1,843,100,78444646,77871040,573606,174.33569383862792
1747352925716210,78804764,1,844,100,78538984,77963600,575384,173.7969773229704
1747352925805921,78897324,1,845,100,78628695,78056160,572535,174.66181106831897
1747352925900216,78989884,1,846,100,78722990,78148720,574270,174.13411809775891
1747352925994691,79082444,1,847,100,78817465,78241280,576185,173.5553685014362
1747352926088019,79175004,1,848,100,78910793,78333840,576953,173.32434357737978
1747352926178399,79267564,1,849,100,79001173,78426400,574773,173.98172843887934
1747352926272882,79360124,1,850,100,79095656,78518960,576696,173.40158419687322
1747352926366939,79452684,1,851,100,79189713,78611520,578193,172.95263000416818
1747352926461104,79545244,1,852,100,79283878,78704080,579798,172.4738615862766
1747352926551062,79637804,1,853,100,79373836,78796640,577196,173.25137388339488
1747352926650112,79730364,1,854,100,79472886,78889200,583686,171.32499323266276
1747352926747606,79822924,1,855,100,79570380,78981760,588620,169.8888926641976
1747352926834044,79915484,1,856,100,79656818,79074320,582498,171.6744091825208
1747352926928024,80008044,1,857,100,79750798,79166880,583918,171.25692306111472
1747352927018341,80100604,1,858,100,79841115,79259440,581675,171.91730777496022
1747352927112199,80193164,1,859,100,79934973,79352000,582973,171.5345307587144
1747352927207074,80285732,1,860,100,80029848,79444568,585280,170.85839256424276
1747352927300510,80378284,1,861,100,80123284,79537120,586164,170.60071925263236
1747352927390121,80470844,1,862,100,80212895,79629680,583215,171.46335399466747
1747352927489089,80563404,1,863,100,80311863,79722240,589623,169.5998968832627
1747352927579405,80655964,1,864,100,80402179,79814800,587379,170.24782976579007
1747352927673176,80748524,1,865,100,80495950,79907360,588590,169.89755177627893
1747352927764140,80841084,1,866,100,80586914,79999920,586994,170.35949260128723
1747352927862203,80933644,1,867,100,80684977,80092480,592497,168.77722587624916
1747352927952383,81026204,1,868,100,80775157,80185040,590117,169.4579210563329
1747352928045979,81118764,1,869,100,80868753,80277600,591153,169.16094479770888
1747352928140499,81211324,1,870,100,80963273,80370160,593113,168.60193588742786
1747352928230487,81303884,1,871,100,81053261,80462720,590541,169.33625269032973
1747352928325240,81396444,1,872,100,81148014,80555280,592734,168.70974163790166
1747352928427273,81489004,1,873,100,81250047,80647840,602207,166.05585786947012
1747352928513384,81581564,1,874,100,81336158,80740400,595758,167.85339013492057
1747352928607382,81674124,1,875,100,81430156,80832960,597196,167.4492126538021
1747352928697901,81766684,1,876,100,81520675,80925520,595155,168.023456074468
1747352928791911,81859244,1,877,100,81614685,81018080,596605,167.61508871028568
1747352928886139,81951804,1,878,100,81708913,81110640,598273,167.1477736752285
1747352928976341,82044364,1,879,100,81799115,81203200,595915,167.80916741481587
1747352929069753,82136924,1,880,100,81892527,81295760,596767,167.5695874604326
1747352929164152,82229484,1,881,100,81986926,81388320,598606,167.0547906302309
1747352929258305,82322044,1,882,100,82081079,81480880,600199,166.6114072166065
1747352929352703,82414612,1,883,100,82175477,81573448,602029,166.10495507691488
1747352929450855,82507164,1,884,100,82273629,81666000,607629,164.5741068974654
1747352929537010,82599724,1,885,100,82359784,81758560,601224,166.3273588546033
1747352929631169,82692284,1,886,100,82453943,81851120,602823,165.88617222634173
1747352929721259,82784844,1,887,100,82544033,81943680,600353,166.56866876654234
1747352929816043,82877404,1,888,100,82638817,82036240,602577,165.9538946889775
1747352929909897,82969964,1,889,100,82732671,82128800,603871,165.59828175222853
1747352930004192,83062524,1,890,100,82826966,82221360,605606,165.12385940694116
1747352930098514,83155084,1,891,100,82921288,82313920,607368,164.6448281766573
1747352930188662,83247644,1,892,100,83011436,82406480,604956,165.30127810948233
1747352930283023,83340204,1,893,100,83105797,82499040,606757,164.81062435208824
1747352930381045,83432764,1,894,100,83203819,82591600,612219,163.3402426255964
1747352930475105,83525324,1,895,100,83297879,82684160,613719,162.94102023890412
1747352930564831,83617884,1,896,100,83387605,82776720,610885,163.696931501019
1747352930684491,83710444,1,897,100,83507265,82869280,637985,156.74349710416388
1747352933952231,86960444,1,931,100,86775005,86119280,655725,152.50295474474817
1747352934046335,87053004,1,932,100,86869109,86211840,657269,152.14470787455366
1747352934214604,87241244,1,934,100,87037378,86400080,637298,156.91246481237977
1747352934312432,87333804,1,935,100,87135206,86492640,642566,155.62603685847057
1747352934402945,87426364,1,936,100,87225719,86585200,640519,156.12339368543323
1747352934492942,87518924,1,937,100,87315716,86677760,637956,156.75062229997053
1747352934612253,87611484,1,938,100,87435027,86770320,664707,150.44222492015277
1747352934689944,87704044,1,939,100,87512718,86862880,649838,153.88450660010648
1747352934775979,87796604,1,940,100,87598753,86955440,643313,155.44532754662194
1747352934869384,87889164,1,941,100,87692158,87048000,644158,155.24141592590638
1747352934959453,87981724,1,942,100,87782227,87140560,641667,155.84407488619487
1747352935053845,88074284,1,943,100,87876619,87233120,643499,155.40039689261366
1747352935152689,88166844,1,944,100,87975463,87325680,649783,153.8975319452802
1747352935922633,88929164,1,952,100,88745407,88088000,657407,152.11277032340698
1747352936114512,89117404,1,954,100,88937286,88276240,661046,151.27540292203568
1747352936504305,89497004,1,958,100,89327079,88655840,671239,148.978232790407
1747352936585401,89589564,1,959,100,89408175,88748400,659775,151.56682202265924
1747352936680151,89682124,1,960,100,89502925,88840960,661965,151.06538865347866
1747352936765846,89774684,1,961,100,89588620,88933520,655100,152.64845061822624
1747352936860741,89867244,1,962,100,89683515,89026080,657435,152.1062918767635
1747352936950763,89959804,1,963,100,89773537,89118640,654897,152.69576742602274
1747352937045042,90052364,1,964,100,89867816,89211200,656616,152.29601471788686
1747352937138852,90144924,1,965,100,89961626,89303760,657866,152.0066396500199
1747352937228879,90237484,1,966,100,90051653,89396320,655333,152.59417731138214
1747352937323068,90330044,1,967,100,90145842,89488880,656962,152.21580548037784
1747352937416831,90422604,1,968,100,90239605,89581440,658165,151.93758404047617
1747352937511750,90515164,1,969,100,90334524,89674000,660524,151.39495309784354
1747352938014732,90990444,1,974,100,90837506,90149280,688226,145.30110748504126
1747352938084528,91086124,1,975,100,90907302,90244960,662342,150.97940338978958
1747352938178728,91178684,1,976,100,91001502,90337520,663982,150.606492344672
1747352938273562,91271244,1,977,100,91096336,90430080,666256,150.09245695348335
1747352938420561,91363804,1,978,100,91243335,90522640,720695,138.754951817343
1747352938462015,91456364,1,979,100,91284789,90615200,669589,149.34534468158827
1747352938551588,91548924,1,980,100,91374362,90707760,666602,150.0145514114869
1747352938645722,91641484,1,981,100,91468496,90800320,668176,149.66116711764565
1747352938740358,91734052,1,982,100,91563132,90892888,670244,149.19939604084485
1747352938829810,91826604,1,983,100,91652584,90985440,667144,149.89267684338014
1747352938923473,91919164,1,984,100,91746247,91078000,668247,149.6452658971907
1747352939018526,92011724,1,985,100,91841300,91170560,670740,149.08906580791364
1747352939112849,92104284,1,986,100,91935623,91263120,672503,148.6982214205736
1747352939202802,92196844,1,987,100,92025576,91355680,669896,149.2769026834016
1747352939301477,92289404,1,988,100,92124251,91448240,676011,147.92658699340691
1747352939390731,92381964,1,989,100,92213505,91540800,672705,148.65357028712438
1747352939489962,92474524,1,990,100,92312736,91633360,679376,147.1938955747627
1747352939575503,92567084,1,991,100,92398277,91725920,672357,148.73051072570078
1747352939670158,92659644,1,992,100,92492932,91818480,674452,148.26852022086078
1747352939764135,92752204,1,993,100,92586909,91911040,675869,147.9576663525032
1747352939857708,92844764,1,994,100,92680482,92003600,676882,147.7362376307835
1747352939948077,92937324,1,995,100,92770851,92096160,674691,148.21599813840706
1747352940046218,93029884,1,996,100,92868992,92188720,680272,147.00002352000377
1747352940136944,93122444,1,997,100,92959718,92281280,678438,147.3974040369201
1747352940230765,93215004,1,998,100,93053539,92373840,679699,147.12394751206048
1747352940325342,93307564,1,999,100,93148116,92466400,681716,146.68865040574082
1747352940419431,93400124,1,1000,100,93242205,92558960,683245,146.36038317148314
1747352940513645,93493724,1,1001,100,93336419,92652560,683859,146.2289741013864
1747352940611483,93587324,1,1002,100,93434257,92746160,688097,145.3283476021549
1747352940702117,93680924,1,1003,100,93524891,92839760,685131,145.95748842192222
1747352940796234,93774524,1,1004,100,93619008,92933360,685648,145.84743191841878
1747352940890696,93868124,1,1005,100,93713470,93026960,686510,145.66430204949674
1747352940984464,93961724,1,1006,100,93807238,93120560,686678,145.6286643812675
1747352941078386,94055324,1,1007,100,93901160,93214160,687000,145.56040756914118
1747352941173276,94148924,1,1008,100,93996050,93307760,688290,145.28759679786137
1747352941267381,94242524,1,1009,100,94090155,93401360,688795,145.18107709841098
1747352941361834,94336124,1,1010,100,94184608,93494960,689648,145.00150801568336
1747352941456043,94429724,1,1011,100,94278817,93588560,690257,144.87357607383916
1747352941549385,94523324,1,1012,100,94372159,93682160,689999,144.92774627209604
1747352941644002,94616924,1,1013,100,94466776,93775760,691016,144.71444944834852
1747352941738080,94710524,1,1014,100,94560854,93869360,691494,144.6144145863883
1747352941832198,94804124,1,1015,100,94654972,93962960,692012,144.50616463298326
1747352941926225,94897724,1,1016,100,94748999,94056560,692439,144.41705334332698
1747352942020740,94991324,1,1017,100,94843514,94150160,693354,144.2264701725237
1747352942114550,95084924,1,1018,100,94937324,94243760,693564,144.18280072206747
1747352942209136,95178524,1,1019,100,95031910,94337360,694550,143.97811532647037
1747352942303632,95272124,1,1020,100,95126406,94430960,695446,143.79261653672606
1747352942398299,95365724,1,1021,100,95221073,94524560,696513,143.57233820474275
1747352942491863,95459324,1,1022,100,95314637,94618160,696477,143.5797592741756
1747352942585800,95552924,1,1023,100,95408574,94711760,696814,143.51031982709875
1747352942680080,95646524,1,1024,100,95502854,94805360,697494,143.37040892108033
1747352942774987,95740124,1,1025,100,95597761,94898960,698801,143.102256579484
1747352942869309,95833724,1,1026,100,95692083,94992560,699523,142.95455617613715
1747352942963765,95927332,1,1027,100,95786539,95086168,700371,142.78146867874312
1747352943057195,96020924,1,1028,100,95879969,95179760,700209,142.81450252710263
1747352943151426,96114524,1,1029,100,95974200,95273360,700840,142.68591975343872
1747352943245645,96208124,1,1030,100,96068419,95366960,701459,142.56000707097633
1747352943340067,96301724,1,1031,100,96162841,95460560,702281,142.3931446244452
1747352943434004,96395324,1,1032,100,96256778,95554160,702618,142.3248479259
1747352943528286,96488924,1,1033,100,96351060,95647760,703300,142.18683349921795
1747352943622559,96582524,1,1034,100,96445333,95741360,703973,142.05090252040918
1747352943717036,96676124,1,1035,100,96539810,95834960,704850,141.87415762218913
1747352943810875,96769724,1,1036,100,96633649,95928560,705089,141.82606734752636
1747352943909195,96863324,1,1037,100,96731969,96022160,709809,140.88296992571242
1747352943999409,96956924,1,1038,100,96822183,96115760,706423,141.55824484763377
1747352944093632,97050524,1,1039,100,96916406,96209360,707046,141.43351351962957
1747352944191147,97144124,1,1040,100,97013921,96302960,710961,140.65469132624716
1747352944286011,97237724,1,1041,100,97108785,96396560,712225,140.4050686229773
1747352944375641,97331324,1,1042,100,97198415,96490160,708255,141.1920847717277
1747352944474124,97424924,1,1043,100,97296898,96583760,713138,140.22531403459078
1747352944564195,97518524,1,1044,100,97386969,96677360,709609,140.9226771362821
1747352944662509,97612124,1,1045,100,97485283,96770960,714323,139.9926923814577
1747352944756809,97705724,1,1046,100,97579583,96864560,715023,139.8556410073522
1747352944850480,97799324,1,1047,100,97673254,96958160,715094,139.84175506996283
1747352944945340,97892924,1,1048,100,97768114,97051760,716354,139.59578644078206
1747352945039613,97986524,1,1049,100,97862387,97145360,717027,139.4647621358749
1747352945133716,98080124,1,1050,100,97956490,97238960,717530,139.36699510821848
1747352945227592,98173724,1,1051,100,98050366,97332560,717806,139.31340780099356
1747352945321951,98267324,1,1052,100,98144725,97426160,718565,139.16625496649573
1747352945416546,98360924,1,1053,100,98239320,97519760,719560,138.9738173328145
1747352945510691,98454524,1,1054,100,98333465,97613360,720105,138.86863721262873
1747352945604425,98548124,1,1055,100,98427199,97706960,720239,138.8428007925147
1747352945698718,98641724,1,1056,100,98521492,97800560,720932,138.70933735775358
1747352945792713,98735324,1,1057,100,98615487,97894160,721327,138.63337986793783
1747352945887197,98828924,1,1058,100,98709971,97987760,722211,138.46368997425958
1747352945981743,98922532,1,1059,100,98804517,98081368,723149,138.28408806483864
1747352946075920,99016124,1,1060,100,98898694,98174960,723734,138.17231192675763
1747352946169361,99109724,1,1061,100,98992135,98268560,723575,138.2026742217462
1747352946264389,99203324,1,1062,100,99087163,98362160,725003,137.93046373601214
1747352946370845,99296924,1,1063,100,99193619,98455760,737859,135.52724843093327
1747352946551024,99487244,1,1065,100,99373798,98646080,727718,137.4158671353464
1747352946645041,99580844,1,1066,100,99467815,98739680,728135,137.33716961827133
1747352946738897,99674444,1,1067,100,99561671,98833280,728391,137.2889011533641
1747352946833621,99768044,1,1068,100,99656395,98926880,729515,137.07737332337237
1747352946927649,99861644,1,1069,100,99750423,99020480,729943,136.99699839576516
1747352947021375,99955244,1,1070,100,99844149,99114080,730069,136.97335457333486
1747352947115591,100048844,1,1071,100,99938365,99207680,730685,136.85787993458192
1747352947210204,100143484,1,1072,100,100032978,99302320,730658,136.86293724286875
1747352947324745,100238124,1,1073,100,100147519,99396960,750559,133.23402956996054
1747352948020632,100922444,1,1080,100,100843406,100081280,762126,131.21189934472778
1747352948209519,101114844,1,1082,100,101032293,100273680,758613,131.81951798875053
1747352948987794,101896924,1,1090,100,101810568,101055760,754808,132.4840224268953
1747352949196838,102092444,1,1092,100,102019612,101251280,768332,130.15206967821203
1747352949298552,102190204,1,1093,100,102121326,101349040,772286,129.48570866233493
1747352949389168,102284844,1,1094,100,102211942,101443680,768262,130.1639284514918
1747352949467045,102379484,1,1095,100,102289819,101538320,751499,133.06737600449236
1747352949564718,102474124,1,1096,100,102387492,101632960,754532,132.53248371175775
1747352949655385,102568764,1,1097,100,102478159,101727600,750559,133.23402956996054
1747352949749346,102663404,1,1098,100,102572120,101822240,749880,133.3546700805462
1747352949950058,102855804,1,1100,100,102772832,102014640,758192,131.8927131913816
1747352951523127,104416844,1,1116,100,104345901,103575680,770221,129.8328661514033
1747352951641847,104511484,1,1117,100,104464621,103670320,794301,125.89685774032765
1747352952808775,105684604,1,1129,100,105631549,104843440,788109,126.8860018093944
1747352952911069,105782364,1,1130,100,105733843,104941200,792643,126.16020074611144
1747352952993342,105877004,1,1131,100,105816116,105035840,780276,128.15977936012385
1747352953091139,105974764,1,1132,100,105913913,105133600,780313,128.1537024245399
1747352953186275,106069404,1,1133,100,106009049,105228240,780809,128.0722942486575
1747352953284442,106164044,1,1134,100,106107216,105322880,784336,127.49637910283349
1747352953382750,106258684,1,1135,100,106205524,105417520,788004,126.90290912228872
1747352953480453,106353324,1,1136,100,106303227,105512160,791067,126.41154289080444
1747352953582683,106447964,1,1137,100,106405457,105606800,798657,125.21019661757175
1747352953758722,106643492,1,1139,100,106581496,105802328,779168,128.3420263665859
1747352953852797,106738124,1,1140,100,106675571,105896960,778611,128.43383923422607
1747352953951886,106832764,1,1141,100,106774660,105991600,783060,127.70413505989325
1747352954045572,106927404,1,1142,100,106868346,106086240,782106,127.85990645769245
1747352954139940,107022044,1,1143,100,106962714,106180880,781834,127.9043889112011
1747352954234605,107116684,1,1144,100,107057379,106275520,781859,127.90029915879974
1747352954332091,107211324,1,1145,100,107154865,106370160,784705,127.4364251534016
1747352954426327,107305964,1,1146,100,107249101,106464800,784301,127.502068721065
1747352954521019,107400604,1,1147,100,107343793,106559440,784353,127.49361575719097
1747352954619009,107495244,1,1148,100,107441783,106654080,787703,126.95140173390224
1747352954713334,107589884,1,1149,100,107536108,106748720,787388,127.00218951774728
1747352954811957,107684524,1,1150,100,107634731,106843360,791371,126.36298272238936
1747352954901754,107779164,1,1151,100,107724528,106938000,786528,127.14105537247244
1747352955007770,107873804,1,1152,100,107830544,107032640,797904,125.32836030399648
1747352955098575,107968444,1,1153,100,107921349,107127280,794069,125.93364052746044
1747352955188779,108063084,1,1154,100,108011553,107221920,789633,126.64111049056966
1747352955282248,108157724,1,1155,100,108105022,107316560,788462,126.82919405120349
1747352955380810,108252364,1,1156,100,108203584,107411200,792384,126.20143768677814
1747352955479422,108347004,1,1157,100,108302196,107505840,796356,125.57198037058804
1747352955569902,108441644,1,1158,100,108392676,107600480,792196,126.23138718196002
1747352955667166,108536284,1,1159,100,108489940,107695120,794820,125.81464985782944
1747352955761886,108630924,1,1160,100,108584660,107789760,794900,125.8019876714052
1747352955856060,108725564,1,1161,100,108678834,107884400,794434,125.87578074453008
1747352955958781,108820204,1,1162,100,108781555,107979040,802515,124.60826277390454
1747352956049161,108914844,1,1163,100,108871935,108073680,798255,125.2732522815391
1747352956143102,109009484,1,1164,100,108965876,108168320,797556,125.38304520309543
1747352956245501,109104124,1,1165,100,109068275,108262960,805315,124.17501226228246
1747352957035822,109886204,1,1173,100,109858596,109045040,813556,122.91716857843836
1747352957133484,109983964,1,1174,100,109956258,109142800,813458,122.93197681994644
1747352957219496,110078604,1,1175,100,110042270,109237440,804830,124.24984158145196
1747352957318173,110173244,1,1176,100,110140947,109332080,808867,123.62971910091522
1747352957411901,110267884,1,1177,100,110234675,109426720,807955,123.76926932811853
1747352957506152,110362524,1,1178,100,110328926,109521360,807566,123.82888828900673
1747352957617805,110457164,1,1179,100,110440579,109616000,824579,121.27400770575046
1747352957703206,110551804,1,1180,100,110525980,109710640,815340,122.64822037432238
1747352957793503,110646444,1,1181,100,110616277,109805280,810997,123.3050183909435
1747352957887646,110741084,1,1182,100,110710420,109899920,810500,123.38062924120914
1747352957982161,110835732,1,1183,100,110804935,109994568,810367,123.40087886105924
1747352958076335,110930364,1,1184,100,110899109,110089200,809909,123.47066151876322
1747352958173777,111025004,1,1185,100,110996551,110183840,812711,123.04496924490996
1747352958268162,111119644,1,1186,100,111090936,110278480,812456,123.0835885266402
1747352958362906,111214284,1,1187,100,111185680,110373120,812560,123.06783499064686
1747352958460798,111308924,1,1188,100,111283572,110467760,815812,122.57726044725992
1747352958555395,111403564,1,1189,100,111378169,110562400,815769,122.58372161727156
1747352958649502,111498204,1,1190,100,111472276,110657040,815236,122.6638666594704
1747352958743960,111592844,1,1191,100,111566734,110751680,815054,122.69125726638973
1747352958850048,111687484,1,1192,100,111672822,110846320,826502,120.99184272996315
1747352958935820,111782124,1,1193,100,111758594,110940960,817634,122.30411161962444
1747352959030016,111876764,1,1194,100,111852790,111035600,817190,122.370562537476
1747352959124014,111971404,1,1195,100,111946788,111130240,816548,122.46677476400652
1747352959222526,112066044,1,1196,100,112045300,111224880,820420,121.8887886692182
1747352959316196,112160684,1,1197,100,112138970,111319520,819450,122.03307096223077
1747352959411289,112255324,1,1198,100,112234063,111414160,819903,121.96564715582208
1747352959509681,112349964,1,1199,100,112332455,111508800,823655,121.4100563949712
1747352959603129,112444604,1,1200,100,112425903,111603440,822463,121.5860166353988
1747352959697734,112539244,1,1201,100,112520508,111698080,822428,121.59119096139722
1747352959792095,112633892,1,1202,100,112614869,111792728,822141,121.63363705252505
1747352959890437,112728524,1,1203,100,112713211,111887360,825851,121.08721791218996
1747352959984149,112823164,1,1204,100,112806923,111982000,824923,121.22343539942516
1747352960079230,112917804,1,1205,100,112902004,112076640,825364,121.15866454073596
1747352960173375,113012444,1,1206,100,112996149,112171280,824869,121.23137128441002
1747352960271273,113107084,1,1207,100,113094047,112265920,828127,120.75442534780294
1747352960369172,113201724,1,1208,100,113191946,112360560,831386,120.28107281094462
1747352960463474,113296364,1,1209,100,113286248,112455200,831048,120.3299929727284
1747352960557987,113391004,1,1210,100,113380761,112549840,830921,120.34838450346062
1747352960652469,113485644,1,1211,100,113475243,112644480,830763,120.37127315491902
1747352960746745,113580284,1,1212,100,113569519,112739120,830399,120.4240371195052
1747352960840767,113674924,1,1213,100,113663541,112833760,829781,120.5137259108126
1747352960938851,113769564,1,1214,100,113761625,112928400,833225,120.01560202826369
1747352961033002,113864204,1,1215,100,113855776,113023040,832736,120.08607770049572
1747352961127563,113958844,1,1216,100,113950337,113117680,832657,120.09747110755087
1747352961225765,114053484,1,1217,100,114048539,113212320,836219,119.58589795256984
1747352961320089,114148124,1,1218,100,114142863,113306960,835903,119.63110552300924
1747352961414539,114242764,1,1219,100,114237313,113401600,835713,119.65830374781773
1747352961512416,114337404,1,1220,100,114335190,113496240,838950,119.19661481613925
1747352961606759,114432044,1,1221,100,114429533,113590880,838653,119.2388270238108
1747352961700713,114526684,1,1222,100,114523487,113685520,837967,119.33644164985016
1747352961799038,114621324,1,1223,100,114621812,113780160,841652,118.8139516094538
1747352961889108,114715964,1,1224,100,114711882,113874800,837082,119.46260939788456
1747352961987615,114810604,1,1225,100,114810389,113969440,840949,118.91327535914785
1747352962085514,114905244,1,1226,100,114908288,114064080,844208,118.45421981312664
1747352962175755,114999884,1,1227,100,114998529,114158720,839809,119.07469436502824
1747352962282456,115094524,1,1228,100,115105230,114253360,851870,117.38880345592636
1747352962368581,115189164,1,1229,100,115191355,114348000,843355,118.57402873048716
1747352962462268,115283804,1,1230,100,115285042,114442640,842402,118.70817020852276
1747352962556454,115378444,1,1231,100,115379228,114537280,841948,118.7721807047466
1747352962655374,115473084,1,1232,100,115478148,114631920,846228,118.17146206459724
1747352962757684,115567724,1,1233,100,115580458,114726560,853898,117.11000611314232
1747352962850979,115662364,1,1234,100,115673753,114821200,852553,117.29476056034052
1747352962941997,115757004,1,1235,100,115764771,114915840,848931,117.7952036148992
1747352963039681,115851644,1,1236,100,115862455,115010480,851975,117.37433610141142
1747352963134418,115946284,1,1237,100,115957192,115105120,852072,117.36097418997456
1747352963224478,116040924,1,1238,100,116047252,115199760,847492,117.99521411411553
1747352963322702,116135564,1,1239,100,116145476,115294400,851076,117.49831977402722
1747352963420788,116230204,1,1240,100,116243562,115389040,854522,117.02448854447282
1747352963510695,116324844,1,1241,100,116333469,115483680,849789,117.6762702270799
1747352963609716,116419484,1,1242,100,116432490,115578320,854170,117.07271386258004
1747352963703669,116514124,1,1243,100,116526443,115672960,853483,117.16695001540744
1747352963809684,116608764,1,1244,100,116632458,115767600,864858,115.6259177807224
1747352963900327,116703404,1,1245,100,116723101,115862240,860861,116.16277192252872
1747352963990020,116798044,1,1246,100,116812794,115956880,855914,116.83416791873952
1747352964096792,116892692,1,1247,100,116919566,116051528,868038,115.20232985191892
1747352964178182,116987324,1,1248,100,117000956,116146160,854796,116.98697700971928
1747352964277268,117081964,1,1249,100,117100042,116240800,859242,116.3816480106885
1747352964370968,117176604,1,1250,100,117193742,116335440,858302,116.5091075169346
1747352964465409,117271244,1,1251,100,117288183,116430080,858103,116.53612678198306
1747352964563661,117365884,1,1252,100,117386435,116524720,861715,116.04764916474704
1747352964657953,117460524,1,1253,100,117480727,116619360,861367,116.09453345670312
1747352964752256,117555164,1,1254,100,117575030,116714000,861030,116.1399718941268
1747352964846037,117649804,1,1255,100,117668811,116808640,860171,116.25595375803184
1747352964940429,117744444,1,1256,100,117763203,116903280,859923,116.28948173266676
1747352965038466,117839084,1,1257,100,117861240,116997920,863320,115.83190473984156
1747352965132896,117933724,1,1258,100,117955670,117092560,863110,115.86008735850588
1747352965231341,118028364,1,1259,100,118054115,117187200,866915,115.35156272529602
1747352965325477,118123004,1,1260,100,118148251,117281840,866411,115.41866389046308
1747352965419951,118217644,1,1261,100,118242725,117376480,866245,115.4407817649741
1747352965513324,118312284,1,1262,100,118336098,117471120,864978,115.60987678299333
1747352965608261,118406924,1,1263,100,118431035,117565760,865275,115.57019444685216
1747352965706463,118501564,1,1264,100,118529237,117660400,868837,115.09638746968648
1747352965800865,118596204,1,1265,100,118623639,117755040,868599,115.12792439318947
1747352965898631,118690852,1,1266,100,118721405,117849688,871717,114.716129202482
1747352965988342,118785484,1,1267,100,118811116,117944320,866796,115.36739901891563
1747352966086782,118880124,1,1268,100,118909556,118038960,870596,114.86384040358558
1747352966181693,118974764,1,1269,100,119004467,118133600,870867,114.828096597988
1747352966275671,119069404,1,1270,100,119098445,118228240,870205,114.91545095695842
1747352966369387,119164044,1,1271,100,119192161,118322880,869281,115.03760003957294
1747352966467830,119258684,1,1272,100,119290604,118417520,873084,114.5365165322008
1747352966561839,119353324,1,1273,100,119384613,118512160,872453,114.61935485349926
1747352966656536,119447964,1,1274,100,119479310,118606800,872510,114.61186691270014
1747352966754445,119542604,1,1275,100,119577219,118701440,875779,114.18405785021108
1747352966849303,119637244,1,1276,100,119672077,118796080,875997,114.15564208553224
1747352966947253,119731884,1,1277,100,119770027,118890720,879307,113.7259228005691
1747352967050032,119826524,1,1278,100,119872806,118985360,887446,112.68291253777696
1747352967135400,119921164,1,1279,100,119958174,119080000,878174,113.8726493838351
1747352967233772,120015804,1,1280,100,120056546,119174640,881906,113.39076953779654
1747352967528688,120305964,1,1283,100,120351462,119464800,886662,112.78254847957848
1747352967618497,120400604,1,1284,100,120441271,119559440,881831,113.40041345790746
1747352967713119,120495244,1,1285,100,120535893,119654080,881813,113.40272824283608
1747352967811425,120589884,1,1286,100,120634199,119748720,885479,112.93322597147984
1747352968004458,120782284,1,1288,100,120827232,119941120,886112,112.85255137048138
1747352968097973,120876924,1,1289,100,120920747,120035760,884987,112.996010110883
1747352968192924,120971564,1,1290,100,121015698,120130400,885298,112.95631527463068
1747352968286755,121066204,1,1291,100,121109529,120225040,884489,113.05963104120006
1747352968384849,121160844,1,1292,100,121207623,120319680,887943,112.6198415889308
1747352968478743,121255484,1,1293,100,121301517,120414320,887197,112.71453803383014
1747352968576850,121350124,1,1294,100,121399624,120508960,890664,112.27578525684208
1747352968773375,121542524,1,1296,100,121596149,120701360,894789,111.7581910372166
1747352968864062,121637164,1,1297,100,121686836,120796000,890836,112.25410737778896
1747352968962225,121731804,1,1298,100,121784999,120890640,894359,111.81192339988752
1747352969056844,121826444,1,1299,100,121879618,120985280,894338,111.81454886183973
1747352969150689,121921084,1,1300,100,121973463,121079920,893543,111.91403211708894
1747352969261116,122015724,1,1301,100,122083890,121174560,909330,109.97107760658947
1747352969371481,122113484,1,1302,100,122194255,121272320,921935,108.46751669043914
1747352969446117,122208124,1,1303,100,122268891,121366960,901931,110.87322644415148
1747352969535964,122302764,1,1304,100,122358738,121461600,897138,111.46557162889098
1747352969629765,122397404,1,1305,100,122452539,121556240,896299,111.5699113800194
1747352969739923,122492044,1,1306,100,122562697,121650880,911817,109.6711291849132
1747352969831032,122586684,1,1307,100,122653806,121745520,908286,110.09748030906565
1747352969920806,122681324,1,1308,100,122743580,121840160,903420,110.69048725952491
1747352970027217,122775964,1,1309,100,122849991,121934800,915191,109.26680878636265
1747352970108914,122870604,1,1310,100,122931688,122029440,902248,110.83427173016732
1747352970198796,122965244,1,1311,100,123021570,122124080,897490,111.42185428249896
1747352970302025,123059884,1,1312,100,123124799,122218720,906079,110.36565244310928
1747352970395589,123154524,1,1313,100,123218363,122313360,905003,110.49687128108968
1747352970616481,123350052,1,1315,100,123439255,122508888,930367,107.48446580757916
1747352971378996,124132124,1,1323,100,124201770,123290960,910810,109.7923826044949
1747352971477118,124226764,1,1324,100,124299892,123385600,914292,109.37424805204463
1747352971571109,124321404,1,1325,100,124393883,123480240,913643,109.45194129435676
1747352971665408,124416044,1,1326,100,124488182,123574880,913302,109.49280741748076
1747352971759899,124510684,1,1327,100,124582673,123669520,913153,109.51067345778856
1747352971854498,124605324,1,1328,100,124677272,123764160,913112,109.51559063948343
1747352971951973,124699964,1,1329,100,124774747,123858800,915947,109.17662266484852
1747352972045973,124797724,1,1330,100,124868747,123956560,912187,109.62664453670136
1747352972140285,124892364,1,1331,100,124963059,124051200,911859,109.6660777598291
1747352972243379,124987004,1,1332,100,125066153,124145840,920313,108.65868459969596
1747352972333807,125081644,1,1333,100,125156581,124240480,916101,109.15826966677254
1747352972428028,125176284,1,1334,100,125250802,124335120,915682,109.20821857369698
1747352972525676,125270924,1,1335,100,125348450,124429760,918690,108.85064602858418
1747352972619571,125365564,1,1336,100,125442345,124524400,917945,108.93898871936771
1747352972922893,125655724,1,1339,100,125745667,124814560,931107,107.39904221534152
1747352973103763,125848124,1,1341,100,125926537,125006960,919577,108.74565153325932
1747352973218366,125942764,1,1342,100,126041140,125101600,939540,106.43506396747344
1747352973791081,126526204,1,1348,100,126613855,125685040,928815,107.66406657945878
1747352973885397,126620844,1,1349,100,126708171,125779680,928491,107.70163631096048
1747352973987848,126715484,1,1350,100,126810622,125874320,936302,106.80314684791873
1747352974077320,126810132,1,1351,100,126900094,125968968,931126,107.39685069475024
1747352974172128,126904764,1,1352,100,126994902,126063600,931302,107.3765545440684
1747352974282567,126999404,1,1353,100,127105341,126158240,947101,105.5853599563299
1747352974376917,127094044,1,1354,100,127199691,126252880,946811,105.61769983660942
1747352975544556,128267164,1,1366,100,128367330,127426000,941330,106.23267079557648
1747352975859561,128557324,1,1369,100,128682335,127716160,966175,103.50091857065232
1747352975949432,128655084,1,1370,100,128772206,127813920,958286,104.35298021676202
1747352976031833,128749724,1,1371,100,128854607,127908560,946047,105.70299361448215
1747352976126338,128844364,1,1372,100,128949112,128003200,945912,105.71807948308088
1747352976219844,128939004,1,1373,100,129042618,128097840,944778,105.84497098789345
1747352976314533,129033644,1,1374,100,129137307,128192480,944827,105.8394817252259
1747352976408025,129128284,1,1375,100,129230799,128287120,943679,105.96823708061746
1747352976502745,129222924,1,1376,100,129325519,128381760,943759,105.95925442830216
1747352976600822,129317564,1,1377,100,129423596,128476400,947196,105.57477016372536
1747352976699434,129412204,1,1378,100,129522208,128571040,951168,105.13389853317184
1747352976789571,129506844,1,1379,100,129612345,128665680,946665,105.6339887922338
1747352976887110,129601484,1,1380,100,129709884,128760320,949564,105.3114903260865
1747352976981608,129696124,1,1381,100,129804382,128854960,949422,105.327241205702
1747352977075584,129790764,1,1382,100,129898358,128949600,948758,105.40095577586698
1747352977169966,129885404,1,1383,100,129992740,129044240,948500,105.42962572482868
1747352977268796,129980044,1,1384,100,130091570,129138880,952690,104.96593855293956
1747352977362997,130074684,1,1385,100,130185771,129233520,952251,105.01432920522004
1747352977457211,130169324,1,1386,100,130279985,129328160,951825,105.06132955112548
1747352977555086,130263964,1,1387,100,130377860,129422800,955060,104.70546353108703
1747352977649383,130358604,1,1388,100,130472157,129517440,954717,104.7430809339312
1747352977743436,130453244,1,1389,100,130566210,129612080,954130,104.80752098770608
1747352977838443,130547884,1,1390,100,130661217,129706720,954497,104.7672229456981
1747352977936085,130642524,1,1391,100,130758859,129801360,957499,104.4387513720641
1747352978030640,130737172,1,1392,100,130853414,129896008,957406,104.44889628851293
1747352978124003,130831804,1,1393,100,130946777,129990640,956137,104.58752249939076
1747352978218579,130926444,1,1394,100,131041353,130085280,956073,104.59452363993128
1747352978316451,131021084,1,1395,100,131139225,130179920,959305,104.2421336279911
1747352978411219,131115724,1,1396,100,131233993,130274560,959433,104.22822646292131
1747352978505758,131210364,1,1397,100,131328532,130369200,959332,104.23919977651116
1747352978603752,131305004,1,1398,100,131426526,130463840,962686,103.8760301905294
1747352978697865,131399644,1,1399,100,131520639,130558480,962159,103.9329258469754
1747352978795861,131494284,1,1400,100,131618635,130653120,965515,103.57166900566018
1747352978886333,131588924,1,1401,100,131709107,130747760,961347,104.02071260429378
1747352978984732,131683564,1,1402,100,131807506,130842400,965106,103.61556139947322
1747352979079051,131778204,1,1403,100,131901825,130937040,964785,103.65003601838752
1747352979172771,131872844,1,1404,100,131995545,131031680,963865,103.74896899462064
1747352979271567,131967484,1,1405,100,132094341,131126320,968021,103.3035440346852
1747352979364947,132062124,1,1406,100,132187721,131220960,966761,103.43818172226642
1747352979459250,132156764,1,1407,100,132282024,131315600,966424,103.47425146726488
1747352979554290,132251404,1,1408,100,132377064,131410240,966824,103.43144150331396
1747352979651746,132346044,1,1409,100,132474520,131504880,969640,103.1310589497133
1747352979745884,132440684,1,1410,100,132568658,131599520,969138,103.18447940334606
1747352979840736,132535332,1,1411,100,132663510,131694168,969342,103.1627640193038
1747352979935161,132629964,1,1412,100,132757935,131788800,969135,103.18479881543853
1747352980033497,132724604,1,1413,100,132856271,131883440,972831,102.79277695714876
1747352980127549,132819244,1,1414,100,132950323,131978080,972243,102.85494470003898
1747352980221483,132913884,1,1415,100,133044257,132072720,971537,102.92968770103457
1747352980319507,133008524,1,1416,100,133142281,132167360,974921,102.57241355966278
1747352980414423,133103164,1,1417,100,133237197,132262000,975197,102.54338354199204
1747352980508614,133197804,1,1418,100,133331388,132356640,974748,102.59061829313832
1747352980602164,133292444,1,1419,100,133424938,132451280,973658,102.7054674228528
1747352980700989,133387084,1,1420,100,133523763,132545920,977843,102.26590567197393
1747352980794927,133481724,1,1421,100,133617701,132640560,977141,102.3393757912113
1747352980889597,133576364,1,1422,100,133712371,132735200,977171,102.33623388332236
1747352980983836,133671004,1,1423,100,133806610,132829840,976770,102.37824667014752
1747352981080788,133765644,1,1424,100,133903562,132924480,979082,102.13649112127484
1747352981175276,133860284,1,1425,100,133998050,133019120,978930,102.1523500148121
1747352981270198,133954924,1,1426,100,134092972,133113760,979212,102.12293150002247
1747352981368206,134049564,1,1427,100,134190980,133208400,982580,101.77288363288486
1747352981461976,134144204,1,1428,100,134284750,133303040,981710,101.86307565370628
1747352981556751,134238844,1,1429,100,134379525,133397680,981845,101.84906986336948
1747352981655383,134333484,1,1430,100,134478157,133492320,985837,101.43664723478628
1747352981749380,134428124,1,1431,100,134572154,133586960,985194,101.50285121509064
1747352981843236,134522764,1,1432,100,134666010,133681600,984410,101.5836897227781
1747352981937241,134617404,1,1433,100,134760015,133776240,983775,101.64925923102336
1747352982036238,134712044,1,1434,100,134859012,133870880,988132,101.2010541101796
1747352982130271,134806684,1,1435,100,134953045,133965520,987525,101.263259157996
1747352982228796,134901324,1,1436,100,135051570,134060160,991410,100.86644274316376
1747352982519507,135191484,1,1439,100,135342281,134350320,991961,100.8104149255868
1747352982612913,135286124,1,1440,100,135435687,134444960,990727,100.93597933638632
1747352982707260,135380764,1,1441,100,135530034,134539600,990434,100.965839217959
1747352982801751,135475404,1,1442,100,135624525,134634240,990285,100.98103071338048
1747352982900441,135570044,1,1443,100,135723215,134728880,994335,100.56972750632332
1747352982994527,135664684,1,1444,100,135817301,134823520,993781,100.62579179919922
1747352983088218,135759324,1,1445,100,135910992,134918160,992832,100.72197511764328
1747352983182859,135853964,1,1446,100,136005633,135012800,992833,100.72187366858272
1747352983281395,135948604,1,1447,100,136104169,135107440,996729,100.32817345537252
1747352983375571,136043244,1,1448,100,136198345,135202080,996265,100.37490025244288
1747352983469687,136137884,1,1449,100,136292461,135296720,995741,100.42772166657797
1747352983567341,136232524,1,1450,100,136390115,135391360,998755,100.12465519571867
1747352983661661,136327164,1,1451,100,136484435,135486000,998435,100.15674530640452
1747352983755652,136421804,1,1452,100,136578426,135580640,997786,100.22189126726572
1747352983850000,136516444,1,1453,100,136672774,135675280,997494,100.25122958133082
1747352983948212,136611084,1,1454,100,136770986,135769920,1001066,99.89351351459344
1747352984042734,136705724,1,1455,100,136865508,135864560,1000948,99.90528978528356
1747352984137344,136800364,1,1456,100,136960118,135959200,1000918,99.90828419510888
1747352984235142,136895004,1,1457,100,137057916,136053840,1004076,99.5940546333146
1747352984329162,136989644,1,1458,100,137151936,136148480,1003456,99.65559027999235
1747352984436366,137084284,1,1459,100,137259140,136243120,1016020,98.42325938465778
1747352984522092,137178924,1,1460,100,137344866,136337760,1007106,99.2944138948631
1747352984616304,137273564,1,1461,100,137439078,136432400,1006678,99.33662998496044
1747352984709918,137368204,1,1462,100,137532692,136527040,1005652,99.43797655650263
1747352984807347,137462844,1,1463,100,137630121,136621680,1008441,99.1629654089828
1747352984996909,137655244,1,1465,100,137819683,136814080,1005603,99.4428218690676
1747352985095538,137749884,1,1466,100,137918312,136908720,1009592,99.049913232276
1747352985189187,137844524,1,1467,100,138011961,137003360,1008601,99.14723463490516
1747352985283604,137939164,1,1468,100,138106378,137098000,1008378,99.16916077106006
1747352985381683,138033804,1,1469,100,138204457,137192640,1011817,98.83210106175326
1747352985476585,138128444,1,1470,100,138299359,137287280,1012079,98.80651609212325
1747352985570027,138223084,1,1471,100,138392801,137381920,1010881,98.92361217591387
1747352985665189,138317724,1,1472,100,138487963,137476560,1011403,98.8725562411818
1747352985763007,138412364,1,1473,100,138585781,137571200,1014581,98.5628550110834
1747352985856553,138507004,1,1474,100,138679327,137665840,1013487,98.66924785419052
1747352985950964,138601644,1,1475,100,138773738,137760480,1013258,98.69154746372593
1747352986045867,138696284,1,1476,100,138868641,137855120,1013521,98.6659378542724
1747352986143734,138790932,1,1477,100,138966508,137949768,1016740,98.35356138245766
1747352986237921,138885564,1,1478,100,139060695,138044400,1016295,98.3966269636277
1747352986332369,138980204,1,1479,100,139155143,138139040,1016103,98.41521971689878
1747352986430596,139074844,1,1480,100,139253370,138233680,1019690,98.0690209769636
1747352986525075,139169484,1,1481,100,139347849,138328320,1019529,98.0845076501012
1747352986619230,139264124,1,1482,100,139442004,138422960,1019044,98.13118962478558
1747352986712884,139358764,1,1483,100,139535658,138517600,1018058,98.22623072555788
1747352986811587,139453404,1,1484,100,139634361,138612240,1022121,97.83577482509408
1747352986905445,139548044,1,1485,100,139728219,138706880,1021339,97.91068391591824
1747352987000177,139642684,1,1486,100,139822951,138801520,1021431,97.90186512843256
1747352987098220,139737324,1,1487,100,139920994,138896160,1024834,97.57677828799592
1747352987192700,139831964,1,1488,100,140015474,138990800,1024674,97.59201463099484
1747352987286835,139926604,1,1489,100,140109609,139085440,1024169,97.6401355635642
1747352987380830,140021244,1,1490,100,140203604,139180080,1023524,97.70166600880876
1747352987478712,140115884,1,1491,100,140301486,139274720,1026766,97.3931742967726
1747352987573683,140210524,1,1492,100,140396457,139369360,1027097,97.36178764031052
1747352987671793,140305164,1,1493,100,140494567,139464000,1030567,97.0339628573397
1747352987765118,140399804,1,1494,100,140587892,139558640,1029252,97.1579360545328
1747352987860345,140494444,1,1495,100,140683119,139653280,1029839,97.1025568074233
1747352987953719,140589092,1,1496,100,140776493,139747928,1028565,97.22282986490887
1747352988048406,140683724,1,1497,100,140871180,139842560,1028620,97.21763138962882
1747352988155068,140778364,1,1498,100,140977842,139937200,1040642,96.09452626359496
1747352988241129,140873004,1,1499,100,141063903,140031840,1032063,96.89330980763772
1747352988343002,140967644,1,1500,100,141165776,140126480,1039296,96.21897900117004
1747351963754720,109580,1,1,12,0,0,0,0.0
1747351963840605,197404,1,2,12,85885,87824,-1939,0.0
1747351963930698,285804,1,3,12,175978,176224,-246,0.0
1747351964020371,374204,1,4,12,265651,264624,1027,11684.518013631938
1747351964106461,462604,1,5,12,351741,353024,-1283,0.0
1747351964197102,551004,1,6,12,442382,441424,958,12526.096033402922
1747351964286870,639404,1,7,12,532150,529824,2326,5159.071367153912
1747351964376977,727804,1,8,12,622257,618224,4033,2975.45251673692
1747351964663499,1000284,1,11,12,908779,890704,18075,663.9004149377593
1747351964753696,1090764,1,12,12,998976,981184,17792,674.4604316546763
1747351964835861,1181244,1,13,12,1081141,1071664,9477,1266.2234884457107
1747351964926166,1271724,1,14,12,1171446,1162144,9302,1290.0451515803054
1747351965015670,1362204,1,15,12,1260950,1252624,8326,1441.268316118184
1747351965106312,1452684,1,16,12,1351592,1343104,8488,1413.760603204524
1747351965208649,1543164,1,17,12,1453929,1433584,20345,589.8255099533055
1747351965290074,1633644,1,18,12,1535354,1524064,11290,1062.887511071745
1747351965385058,1724124,1,19,12,1630338,1614544,15794,759.7821957705459
1747351965479331,1814604,1,20,12,1724611,1705024,19587,612.6512482769184
1747351965576707,1905084,1,21,12,1821987,1795504,26483,453.1208699920704
1747351965663643,1995564,1,22,12,1908923,1885984,22939,523.1265530319542
1747351965752999,2086044,1,23,12,1998279,1976464,21815,550.0802200320879
1747351965847470,2176524,1,24,12,2092750,2066944,25806,465.0081376424088
1747351965937482,2267004,1,25,12,2182762,2157424,25338,473.5969689793985
1747351966027912,2357484,1,26,12,2273192,2247904,25288,474.5333755140778
1747351966109544,2447964,1,27,12,2354824,2338384,16440,729.92700729927
1747351966199573,2538444,1,28,12,2444853,2428864,15989,750.5159797360685
1747351966293707,2628924,1,29,12,2538987,2519344,19643,610.9046479661965
1747351966383977,2719404,1,30,12,2629257,2609824,19433,617.5063037101837
1747351966477963,2809892,1,31,12,2723243,2700312,22931,523.3090576076054
1747351966568441,2900364,1,32,12,2813721,2790784,22937,523.1721672407028
1747351966658265,2990844,1,33,12,2903545,2881264,22281,538.5754678874378
1747351966756861,3081324,1,34,12,3002141,2971744,30397,394.7758002434451
1747351966838786,3171804,1,35,12,3084066,3062224,21842,549.4002380734365
1747351966940694,3262284,1,36,12,3185974,3152704,33270,360.6853020739405
1747351967031096,3352764,1,37,12,3276376,3243184,33192,361.532899493854
1747351967116850,3443244,1,38,12,3362130,3333664,28466,421.5555399423874
1747351967214670,3533724,1,39,12,3459950,3424144,35806,335.1393621180808
1747351967301810,3624204,1,40,12,3547090,3514624,32466,369.6174459434485
1747351967387070,3714684,1,41,12,3632350,3605104,27246,440.43162299053074
1747351967481558,3805164,1,42,12,3726838,3695584,31254,383.95085429065085
1747351967567551,3895644,1,43,12,3812831,3786064,26767,448.3132215040909
1747351967661461,3986124,1,44,12,3906741,3876544,30197,397.3904692519124
1747351967755839,4076604,1,45,12,4001119,3967024,34095,351.9577650681918
1747351967853908,4167084,1,46,12,4099188,4057504,41684,287.8802418194031
1747351967932398,4257564,1,47,12,4177678,4147984,29694,404.1220448575469
1747351968026479,4348044,1,48,12,4271759,4238464,33295,360.4144766481454
1747351968116354,4438524,1,49,12,4361634,4328944,32690,367.0847353930866
1747351968210282,4529004,1,50,12,4455562,4419424,36138,332.06043499916984
1747351968296761,4619484,1,51,12,4542041,4509904,32137,373.4013753617326
1747351968391270,4709964,1,52,12,4636550,4600384,36166,331.8033512138473
1747351968480881,4800444,1,53,12,4726161,4690864,35297,339.97223560075923
1747351968574592,4890924,1,54,12,4819872,4781344,38528,311.4617940199336
1747351968661733,4981404,1,55,12,4907013,4871824,35189,341.0156583023104
1747351968755806,5071892,1,56,12,5001086,4962312,38774,309.48573786558
1747351968847037,5162364,1,57,12,5092317,5052784,39533,303.54387473756105
1747351968935107,5252844,1,58,12,5180387,5143264,37123,323.2497373595884
1747351969025005,5343324,1,59,12,5270285,5233744,36541,328.39823759612494
1747351969120018,5433804,1,60,12,5365298,5324224,41074,292.1556215610849
1747351969209762,5524284,1,61,12,5455042,5414704,40338,297.48624126134166
1747351969299990,5614764,1,62,12,5545270,5505184,40086,299.356383774884
1747351969389971,5705244,1,63,12,5635251,5595664,39587,303.12981534342083
1747351969484534,5795724,1,64,12,5729814,5686144,43670,274.7881841080833
1747351969578353,5886204,1,65,12,5823633,5776624,47009,255.2702673956051
1747351969664146,5976684,1,66,12,5909426,5867104,42322,283.54047540286376
1747351969767184,6067164,1,67,12,6012464,5957584,54880,218.6588921282799
1747351969860809,6157644,1,68,12,6106089,6048064,58025,206.80741059887976
1747351969951661,6248124,1,69,12,6196941,6138544,58397,205.49000804835865
1747351970037671,6338604,1,70,12,6282951,6229024,53927,222.52304040647545
1747351970131458,6429084,1,71,12,6376738,6319504,57234,209.6655833944858
1747351970225672,6519564,1,72,12,6470952,6409984,60968,196.82456370555045
1747351970308058,6610044,1,73,12,6553338,6500464,52874,226.9546468963952
1747351970406151,6700524,1,74,12,6651431,6590944,60487,198.38973663762465
1747351970496130,6791004,1,75,12,6741410,6681424,59986,200.0466775580969
1747351970582055,6881484,1,76,12,6827335,6771904,55431,216.485360177518
1747351970680017,6971964,1,77,12,6925297,6862384,62913,190.73959277096944
1747351970770738,7062444,1,78,12,7016018,6952864,63154,190.011717389239
1747351970856616,7152924,1,79,12,7101896,7043344,58552,204.9460308785353
1747351970954875,7243404,1,80,12,7200155,7133824,66331,180.91088631258387
1747351971044942,7333884,1,81,12,7290222,7224304,65918,182.0443581419339
1747351971131204,7424364,1,82,12,7376484,7314784,61700,194.48946515397083
1747351971225223,7514844,1,83,12,7470503,7405264,65239,183.9390548598231
1747351971318912,7605324,1,84,12,7564192,7495744,68448,175.3155680224404
1747351971404929,7695804,1,85,12,7650209,7586224,63985,187.5439556145972
1747351971499087,7786284,1,86,12,7744367,7676704,67663,177.34951154988693
1747351971585375,7876764,1,87,12,7830655,7767184,63471,189.0627215578768
1747351971683589,7967244,1,88,12,7928869,7857664,71205,168.52749104697702
1747351971773419,8057724,1,89,12,8018699,7948144,70555,170.0800793707037
1747351971863617,8148204,1,90,12,8108897,8038624,70273,170.76259729910493
1747351971949608,8238684,1,91,12,8194888,8129104,65784,182.41517694272164
1747351972044481,8329164,1,92,12,8289761,8219584,70177,170.9961953346538
1747351972134333,8419644,1,93,12,8379613,8310064,69549,172.54022343958937
1747351972223771,8510124,1,94,12,8469051,8400544,68507,175.1645817215759
1747351972315112,8600612,1,95,12,8560392,8491032,69360,173.01038062283737
1747351972408711,8691084,1,96,12,8653991,8581504,72487,165.54692565563482
1747351972502669,8781564,1,97,12,8747949,8671984,75965,157.9674850259988
1747351972589209,8872044,1,98,12,8834489,8762464,72025,166.60881638320026
1747351972679014,8962524,1,99,12,8924294,8852944,71350,168.18500350385426
1747351972773012,9053004,1,100,12,9018292,8943424,74868,160.28209648982207
1747351972859584,9144524,1,101,12,9104864,9034944,69920,171.62471395881008
1747351972962099,9236044,1,102,12,9207379,9126464,80915,148.30377556695296
1747351973051373,9327564,1,103,12,9296653,9217984,78669,152.53784845364757
1747351973142232,9419084,1,104,12,9387512,9309504,78008,153.8303763716542
1747351973236317,9510604,1,105,12,9481597,9401024,80573,148.9332654859568
1747351973321830,9602124,1,106,12,9567110,9492544,74566,160.93125553201193
1747351973419979,9693644,1,107,12,9665259,9584064,81195,147.79235174579716
1747351973506864,9785164,1,108,12,9752144,9675584,76560,156.7398119122257
1747351973600264,9876684,1,109,12,9845544,9767104,78440,152.9831718510964
1747351973698526,9968204,1,110,12,9943806,9858624,85182,140.87483271113618
1747351973788876,10059724,1,111,12,10034156,9950144,84012,142.836737608913
1747351973878980,10152284,1,112,12,10124260,10042704,81556,147.138162734808
1747351973977765,10247964,1,113,12,10223045,10138384,84661,141.7417701184725
1747351974067502,10340524,1,114,12,10312782,10230944,81838,146.63114934382563
1747351974357926,10624444,1,117,12,10603206,10514864,88342,135.83572932467
1747351974448568,10717004,1,118,12,10693848,10607424,86424,138.8503193557345
1747351974542477,10809564,1,119,12,10787757,10699984,87773,136.71630227974433
1747351974632556,10902124,1,120,12,10877836,10792544,85292,140.69314824368053
1747351974727003,10994684,1,121,12,10972283,10885104,87179,137.64782803198017
1747351974821633,11087244,1,122,12,11066913,10977664,89249,134.45528801443157
1747351974914897,11179804,1,123,12,11160177,11070224,89953,133.40299934410191
1747351975009875,11272364,1,124,12,11255155,11162784,92371,129.9109027725152
1747351975099247,11364924,1,125,12,11344527,11255344,89183,134.55479183252413
1747351975194068,11457484,1,126,12,11439348,11347904,91444,131.22785529941822
1747351975288154,11550044,1,127,12,11533434,11440464,92970,129.07389480477573
1747351975382354,11642604,1,128,12,11627634,11533024,94610,126.83648662932036
1747351975472306,11735164,1,129,12,11717586,11625584,92002,130.43194713158408
1747351975566647,11827724,1,130,12,11811927,11718144,93783,127.95495985413132
1747351975660488,11920284,1,131,12,11905768,11810704,95064,126.23074981065388
1747351975758787,12012844,1,132,12,12004067,11903264,100803,119.0440760691646
1747351975845573,12105404,1,133,12,12090853,11995824,95029,126.27724168411748
1747351975938879,12197964,1,134,12,12184159,12088384,95775,125.29365700861392
1747351976032776,12290524,1,135,12,12278056,12180944,97112,123.56866298706647
1747351976127651,12383084,1,136,12,12372931,12273504,99427,120.69156265400746
1747351976217457,12475644,1,137,12,12462737,12366064,96673,124.12979839251912
1747351976311957,12568204,1,138,12,12557237,12458624,98613,121.6878099236409
1747351976405976,12660772,1,139,12,12651256,12551192,100064,119.92324912056284
1747351976499857,12753324,1,140,12,12745137,12643744,101393,118.35136547887922
1747351976594431,12845884,1,141,12,12839711,12736304,103407,116.0463024746874
1747351976684242,12938444,1,142,12,12929522,12828864,100658,119.21556160464148
1747351976779156,13031004,1,143,12,13024436,12921424,103012,116.49128256902108
1747351976881220,13123564,1,144,12,13126500,13013984,112516,106.65149845355327
1747351976966720,13216124,1,145,12,13212000,13106544,105456,113.79153390987712
1747351977056935,13308684,1,146,12,13302215,13199104,103111,116.37943575370232
1747351977151365,13401244,1,147,12,13396645,13291664,104981,114.30639830064489
1747351977246100,13493804,1,148,12,13491380,13384224,107156,111.98626301840308
1747351977339785,13586364,1,149,12,13585065,13476784,108281,110.82276669037044
1747351977429599,13678924,1,150,12,13674879,13569344,105535,113.706353342493
1747351977524096,13771484,1,151,12,13769376,13661904,107472,111.65698972755696
1747351977618870,13864044,1,152,12,13864150,13754464,109686,109.40320551392156
1747351977712713,13956604,1,153,12,13957993,13847024,110969,108.13830889707936
1747351977802377,14049164,1,154,12,14047657,13939584,108073,111.0360589601473
1747351977908737,14141724,1,155,12,14154017,14032144,121873,98.46315426714696
1747351977991210,14234284,1,156,12,14236490,14124704,111786,107.34796843969728
1747351978085663,14326844,1,157,12,14330943,14217264,113679,105.56039374026864
1747351978179527,14419404,1,158,12,14424807,14309824,114983,104.3632536983728
1747351978269354,14511964,1,159,12,14514634,14402384,112250,106.90423162583518
1747351978364179,14604524,1,160,12,14609459,14494944,114515,104.7897655328996
1747351978458176,14697084,1,161,12,14703456,14587504,115952,103.49109976542016
1747351978552295,14789652,1,162,12,14797575,14680072,117503,102.1250521263287
1747351978642462,14882204,1,163,12,14887742,14772624,115118,104.24086589412605
1747351978736488,14974764,1,164,12,14981768,14865184,116584,102.93007616825638
1747351978830995,15067324,1,165,12,15076275,14957744,118531,101.23933823219242
1747351978924482,15159884,1,166,12,15169762,15050304,119458,100.45371595037588
1747351979014922,15252444,1,167,12,15260202,15142864,117338,102.26865976921373
1747351979109369,15345004,1,168,12,15354649,15235424,119225,100.65003145313484
1747351979203584,15437564,1,169,12,15448864,15327984,120880,99.27200529450695
1747351979297905,15530124,1,170,12,15543185,15420544,122641,97.84656028571196
1747351979391486,15625804,1,171,12,15636766,15516224,120542,99.55036418841566
1747351979481366,15718364,1,172,12,15726646,15608784,117862,101.81398584785596
1747351979580715,15810924,1,173,12,15825995,15701344,124651,96.26878244057409
1747351979674548,15903484,1,174,12,15919828,15793904,125924,95.29557510879576
1747351979765107,15996044,1,175,12,16010387,15886464,123923,96.8343245402387
1747351979859285,16088604,1,176,12,16104565,15979024,125541,95.5863024828542
1747351979952973,16181164,1,177,12,16198253,16071584,126669,94.73509698505552
1747351980047030,16273724,1,178,12,16292310,16164144,128166,93.62857544122464
1747351980137026,16366284,1,179,12,16382306,16256704,125602,95.53987993821757
1747351980231873,16458844,1,180,12,16477153,16349264,127889,93.83136939064345
1747351980325698,16551404,1,181,12,16570978,16441824,129154,92.91233720984252
1747351980419993,16643964,1,182,12,16665273,16534384,130889,91.68073711312638
1747351980510314,16736524,1,183,12,16755594,16626944,128650,93.27633113097552
1747351980604647,16829084,1,184,12,16849927,16719504,130423,92.0083114174647
1747351980698539,16921644,1,185,12,16943819,16812064,131755,91.0781374520891
1747351980792650,17014204,1,186,12,17037930,16904624,133306,90.01845378302552
1747351980886375,17106764,1,187,12,17131655,16997184,134471,89.23857188538793
1747351980977124,17199324,1,188,12,17222404,17089744,132660,90.45680687471732
1747351981071186,17291884,1,189,12,17316466,17182304,134162,89.44410488812034
1747351981164906,17384444,1,190,12,17410186,17274864,135322,88.67737692319061
1747351981259079,17477004,1,191,12,17504359,17367424,136935,87.6328184905247
1747351981349540,17569564,1,192,12,17594820,17459984,134836,88.99700376753982
1747351981443485,17662124,1,193,12,17688765,17552544,136221,88.09214438302463
1747351981537715,17754684,1,194,12,17782995,17645104,137891,87.02525908144838
1747351981632490,17847244,1,195,12,17877770,17737664,140106,85.64943685495267
1747351981722981,17939804,1,196,12,17968261,17830224,138037,86.93321355868355
1747351981816328,18032364,1,197,12,18061608,17922784,138824,86.44038494784763
1747351981910634,18124924,1,198,12,18155914,18015344,140570,85.36672120651633
1747351982004497,18217484,1,199,12,18249777,18107904,141873,84.5826901524603
1747351982095571,18310044,1,200,12,18340851,18200464,140387,85.47800009972433
1747351982193712,18402604,1,201,12,18438992,18293024,145968,82.20979940808945
1747351982283856,18495164,1,202,12,18529136,18385584,143552,83.5934016941596
1747351982377197,18587724,1,203,12,18622477,18478144,144333,83.14106960986054
1747351982472253,18680284,1,204,12,18717533,18570704,146829,81.72772408720348
1747351982562421,18772844,1,205,12,18807701,18663264,144437,83.08120495440919
1747351982656262,18865404,1,206,12,18901542,18755824,145718,82.35084203735984
1747351982750953,18957964,1,207,12,18996233,18848384,147849,81.16389018525658
1747351982844781,19050532,1,208,12,19090061,18940952,149109,80.47803955495644
1747351982935012,19143084,1,209,12,19180292,19033504,146788,81.75055181622476
1747351983029348,19235644,1,210,12,19274628,19126064,148564,80.7732694327024
1747351983123312,19328204,1,211,12,19368592,19218624,149968,80.01707030833245
1747351983217247,19420764,1,212,12,19462527,19311184,151343,79.29008939957579
1747351983307219,19513324,1,213,12,19552499,19403744,148755,80.66955732580418
1747351983402168,19605884,1,214,12,19647448,19496304,151144,79.3944847297941
1747351983496011,19698444,1,215,12,19741291,19588864,152427,78.72620992343876
1747351983590714,19791004,1,216,12,19835994,19681424,154570,77.63472860192792
1747351983680552,19883564,1,217,12,19925832,19773984,151848,79.0263948158685
1747351983774850,19976124,1,218,12,20020130,19866544,153586,78.13212141731668
1747351983868285,20068684,1,219,12,20113565,19959104,154461,77.68951385786704
1747351983962270,20161244,1,220,12,20207550,20051664,155886,76.97933104961318
1747351984053100,20253804,1,221,12,20298380,20144224,154156,77.8432237473728
1747351984147513,20346364,1,222,12,20392793,20236784,156009,76.91863930927062
1747351984241110,20438924,1,223,12,20486390,20329344,157046,76.41073316098469
1747351984343271,20531484,1,224,12,20588551,20421904,166647,72.00849700264632
1747351984429882,20624044,1,225,12,20675162,20514464,160698,74.6742336556771
1747351984519327,20716604,1,226,12,20764607,20607024,157583,76.15034616678194
1747351984613963,20809164,1,227,12,20859243,20699584,159659,75.1601851445894
1747351984708326,20901724,1,228,12,20953606,20792144,161462,74.32089284165934
1747351984802080,20994284,1,229,12,21047360,20884704,162656,73.77532952980523
1747351984892322,21086844,1,230,12,21137602,20977264,160338,74.84189649365715
1747351984986787,21179412,1,231,12,21232067,21069832,162235,73.96677658951522
1747351985080681,21271964,1,232,12,21325961,21162384,163577,73.35994669177207
1747351985175175,21364524,1,233,12,21420455,21254944,165511,72.50273395725964
1747351985265508,21457084,1,234,12,21510788,21347504,163284,73.49158521349305
1747351985359176,21549644,1,235,12,21604456,21440064,164392,72.9962528590199
1747351985453186,21642204,1,236,12,21698466,21532624,165842,72.3580275201698
1747351985548101,21734764,1,237,12,21793381,21625184,168197,71.34491102695054
1747351985641663,21827324,1,238,12,21886943,21717744,169199,70.92240497875284
1747351985731265,21919884,1,239,12,21976545,21810304,166241,72.1843588525093
1747351985826511,22012444,1,240,12,22071791,21902864,168927,71.03660160897903
1747351985920202,22105004,1,241,12,22165482,21995424,170058,70.5641604629009
1747351986014884,22197564,1,242,12,22260164,22087984,172180,69.69450574979672
1747351986104887,22290124,1,243,12,22350167,22180544,169623,70.74512300808263
1747351986199036,22382684,1,244,12,22444316,22273104,171212,70.08854519543023
1747351986293383,22475244,1,245,12,22538663,22365664,172999,69.36456280094104
1747351986387117,22567804,1,246,12,22632397,22458224,174173,68.89701618505738
1747351986477330,22660364,1,247,12,22722610,22550784,171826,69.83809202332591
1747351986571322,22752924,1,248,12,22816602,22643344,173258,69.2608710708885
1747351986665639,22845484,1,249,12,22910919,22735904,175015,68.56555152415507
1747351986759714,22938044,1,250,12,23004994,22828464,176530,67.97711437149493
1747351986850257,23030604,1,251,12,23095537,22921024,174513,68.76278558044386
1747351986944572,23123164,1,252,12,23189852,23013584,176268,68.0781537204711
1747351987038344,23215724,1,253,12,23283624,23106144,177480,67.6132521974307
1747351987133134,23308284,1,254,12,23378414,23198704,179710,66.77424739858661
1747351987226550,23400844,1,255,12,23471830,23291264,180566,66.457694139539
1747351987317397,23493404,1,256,12,23562677,23383824,178853,67.09420585620593
1747351987411646,23585964,1,257,12,23656926,23476384,180542,66.46652856399065
1747351987505353,23678524,1,258,12,23750633,23568944,181689,66.0469263411654
1747351987603637,23771084,1,259,12,23848917,23661504,187413,64.0297097853404
1747351987689984,23863644,1,260,12,23935264,23754064,181200,66.2251655629139
1747351987784533,23956204,1,261,12,24029813,23846624,183189,65.50611663364067
1747351987878467,24048764,1,262,12,24123747,23939184,184563,65.01844898489946
1747351987972862,24141324,1,263,12,24218142,24031744,186398,64.37837315851029
1747351988062492,24233884,1,264,12,24307772,24124304,183468,65.40650140623978
1747351988177315,24326444,1,265,12,24422595,24216864,205731,58.32859413505986
1747351988250929,24419004,1,266,12,24496209,24309424,186785,64.24498755253366
1747351988344844,24511564,1,267,12,24590124,24401984,188140,63.78228978420325
1747351988434974,24604124,1,268,12,24680254,24494544,185710,64.61687577405633
1747351988529967,24696684,1,269,12,24775247,24587104,188143,63.78127275529783
1747351988623858,24789244,1,270,12,24869138,24679664,189474,63.3332277779537
1747351988717320,24881804,1,271,12,24962600,24772224,190376,63.03315543976132
1747351988811542,24974372,1,272,12,25056822,24864792,192030,62.49023590064052
1747351988901606,25066924,1,273,12,25146886,24957344,189542,63.310506378533525
1747351988996342,25159484,1,274,12,25241622,25049904,191718,62.59193189997809
1747351989090708,25252044,1,275,12,25335988,25142464,193524,62.00781298443604
1747351989184920,25344604,1,276,12,25430200,25235024,195176,61.48296921752675
1747351989274803,25437164,1,277,12,25520083,25327584,192499,62.33798617135673
1747351989369498,25529724,1,278,12,25614778,25420144,194634,61.65418169487346
1747351989463435,25622284,1,279,12,25708715,25512704,196011,61.22105392044325
1747351989557059,25714844,1,280,12,25802339,25605264,197075,60.89052391221616
1747351989651559,25810524,1,281,12,25896839,25700944,195895,61.25730620995941
1747351989745949,25903084,1,282,12,25991229,25793504,197725,60.69035276267543
1747351989839810,25995644,1,283,12,26085090,25886064,199026,60.29362997799282
1747351989930415,26088204,1,284,12,26175695,25978624,197071,60.891759822602005
1747351990024780,26180764,1,285,12,26270060,26071184,198876,60.33910577445242
1747351990118372,26273324,1,286,12,26363652,26163744,199908,60.02761270184285
1747351990212583,26365884,1,287,12,26457863,26256304,201559,59.53591752290893
1747351990401272,26554124,1,289,12,26646552,26444544,202008,59.403587976713794
1747351990495098,26646684,1,290,12,26740378,26537104,203274,59.033619646388615
1747351990588953,26739244,1,291,12,26834233,26629664,204569,58.65991425875866
1747351990679644,26831804,1,292,12,26924924,26722224,202700,59.20078934385792
1747351990773802,26924364,1,293,12,27019082,26814784,204298,58.73772626261637
1747351990868031,27016924,1,294,12,27113311,26907344,205967,58.26176037908985
1747351990962003,27109484,1,295,12,27207283,26999904,207379,57.86506830489104
1747351991052140,27202044,1,296,12,27297420,27092464,204956,58.54915201311501
1747351991146697,27294604,1,297,12,27391977,27185024,206953,57.984179982894666
1747351991240533,27387164,1,298,12,27485813,27277584,208229,57.6288605333551
1747351991334992,27479724,1,299,12,27580272,27370144,210128,57.10804842762506
1747351991425411,27572284,1,300,12,27670691,27462704,207987,57.69591368691312
1747351991519474,27664844,1,301,12,27764754,27555264,209490,57.28197049978519
1747351991612942,27757404,1,302,12,27858222,27647824,210398,57.03476268785825
1747351991707505,27849964,1,303,12,27952785,27740384,212401,56.49690914826201
1747351991801432,27942524,1,304,12,28046712,27832944,213768,56.13562366677893
1747351991891809,28035092,1,305,12,28137089,27925512,211577,56.7169399320342
1747351991985756,28127644,1,306,12,28231036,28018064,212972,56.34543508066788
1747351992080413,28220204,1,307,12,28325693,28110624,215069,55.79604685008067
1747351992174751,28312764,1,308,12,28420031,28203184,216847,55.3385566782109
1747351992264398,28405324,1,309,12,28509678,28295744,213934,56.0920657772958
1747351992358987,28497884,1,310,12,28604267,28388304,215963,55.5650736468747
1747351992453657,28590444,1,311,12,28698937,28480864,218073,55.02744493816291
1747351992546659,28683004,1,312,12,28791939,28573424,218515,54.91613848019587
1747351992932265,29065724,1,316,12,29177545,28956144,221401,54.20029719829631
1747351993026625,29158284,1,317,12,29271905,29048704,223201,53.76319998566314
1747351993117008,29250844,1,318,12,29362288,29141264,221024,54.29274648906906
1747351993210815,29343404,1,319,12,29456095,29233824,222271,53.98814960116255
1747351993301148,29435964,1,320,12,29546428,29326384,220044,54.53454763592736
1747351993399416,29528524,1,321,12,29644696,29418944,225752,53.15567525426131
1747351993489112,29621084,1,322,12,29734392,29511504,222888,53.83869925702595
1747351993583629,29713644,1,323,12,29828909,29604064,224845,53.37009940181014
1747351993677333,29806204,1,324,12,29922613,29696624,225989,53.09992964259322
1747351993772238,29898772,1,325,12,30017518,29789192,228326,52.556432469363976
1747351993861586,29991324,1,326,12,30106866,29881744,225122,53.30443048658061
1747351993955750,30083884,1,327,12,30201030,29974304,226726,52.927321965720736
1747351994050478,30176444,1,328,12,30295758,30066864,228894,52.42601378804163
1747351994145025,30269004,1,329,12,30390305,30159424,230881,51.97482685885802
1747351994238613,30361564,1,330,12,30483893,30251984,231909,51.74443423929213
1747351994329157,30454124,1,331,12,30574437,30344544,229893,52.19819655230912
1747351994423609,30546684,1,332,12,30668889,30437104,231785,51.77211640097504
1747351994516901,30639244,1,333,12,30762181,30529664,232517,51.60912965503598
1747351994611894,30731804,1,334,12,30857174,30622224,234950,51.074696743988085
1747351994705903,30827484,1,335,12,30951183,30717904,233279,51.440549728008094
1747351994800287,30920044,1,336,12,31045567,30810464,235103,51.04145842460539
1747351994894005,31012604,1,337,12,31139285,30903024,236261,50.791285908380985
1747351994984607,31105164,1,338,12,31229887,30995584,234303,51.215733473323006
1747351995078753,31197724,1,339,12,31324033,31088144,235889,50.87138442233424
1747351995172501,31290284,1,340,12,31417781,31180704,237077,50.61646638012122
1747351995267305,31382844,1,341,12,31512585,31273264,239321,50.14185967800569
1747351995357433,31475404,1,342,12,31602713,31365824,236889,50.65663665260945
1747351995450790,31567964,1,343,12,31696070,31458384,237686,50.48677667174339
1747351995545716,31660524,1,344,12,31790996,31550944,240052,49.98916901338044
1747351995639291,31753084,1,345,12,31884571,31643504,241067,49.77869223079061
1747351995733865,31845644,1,346,12,31979145,31736064,243081,49.36626062917299
1747351995824185,31938204,1,347,12,32069465,31828624,240841,49.82540348196528
1747351995918334,32030764,1,348,12,32163614,31921184,242430,49.49882440292043
1747351996012740,32123324,1,349,12,32258020,32013744,244276,49.124760516792485
1747351996106882,32215884,1,350,12,32352162,32106304,245858,48.80866191053372
1747351996196489,32308444,1,351,12,32441769,32198864,242905,49.4020296000494
1747351996290751,32401004,1,352,12,32536031,32291424,244607,49.058285331163866
1747351996384956,32493564,1,353,12,32630236,32383984,246252,48.73056868573656
1747351996479505,32586124,1,354,12,32724785,32476544,248241,48.340121092003336
1747351996569025,32678684,1,355,12,32814305,32569104,245201,48.93944151940653
1747351996663146,32771244,1,356,12,32908426,32661664,246762,48.62985386728913
1747351996753833,32863804,1,357,12,32999113,32754224,244889,49.00179264891441
1747351996848074,32956364,1,358,12,33093354,32846784,246570,48.6677211339579
1747351996942452,33048924,1,359,12,33187732,32939344,248388,48.31151263346055
1747351997036448,33141484,1,360,12,33281728,33031904,249824,48.03381580632766
1747351997155112,33234044,1,361,12,33400392,33124464,275928,43.489605984169785
1747351997224908,33326604,1,362,12,33470188,33217024,253164,47.40010428022941
1747351997318323,33419164,1,363,12,33563603,33309584,254019,47.24056074545605
1747351997408782,33511724,1,364,12,33654062,33402144,251918,47.63454774966458
1747351997502989,33604284,1,365,12,33748269,33494704,253565,47.3251434543411
1747351997597118,33696844,1,366,12,33842398,33587264,255134,47.034107567004
1747351997691031,33789404,1,367,12,33936311,33679824,256487,46.78599695111253
1747351997781441,33881964,1,368,12,34026721,33772384,254337,47.18149541749726
1747351998162151,34261564,1,372,12,34407431,34151984,255447,46.97647652937792
1747351998453475,34548604,1,375,12,34698755,34439024,259731,46.20164708871872
1747351998551888,34641164,1,376,12,34797168,34531584,265584,45.18344478583048
1747351998642195,34733724,1,377,12,34887475,34624144,263331,45.57002403818768
1747351998735624,34826284,1,378,12,34980904,34716704,264200,45.42013626040878
1747351998821991,34918844,1,379,12,35067271,34809264,258007,46.510365997821765
1747351998920465,35011404,1,380,12,35165745,34901824,263921,45.46815145441249
1747351999010299,35103964,1,381,12,35255579,34994384,261195,45.942686498593005
1747351999104944,35196524,1,382,12,35350224,35086944,263280,45.57885141294439
1747351999198276,35289084,1,383,12,35443556,35179504,264052,45.44559404965688
1747351999288981,35381644,1,384,12,35534261,35272064,262197,45.76711404020641
1747351999387711,35474204,1,385,12,35632991,35364624,268367,44.71488670365581
1747351999476886,35566764,1,386,12,35722166,35457184,264982,45.28609490455956
1747351999571353,35659324,1,387,12,35816633,35549744,266889,44.9625125051988
1747351999665563,35751884,1,388,12,35910843,35642304,268539,44.68624669042485
1747351999755400,35844444,1,389,12,36000680,35734864,265816,45.14400938995395
1747351999850072,35937004,1,390,12,36095352,35827424,267928,44.7881520408468
1747351999943731,36029564,1,391,12,36189011,35919984,269027,44.605188326822216
1747352000038365,36122124,1,392,12,36283645,36012544,271101,44.2639459094581
1747352000132051,36214684,1,393,12,36377331,36105104,272227,44.0808589890055
1747352000226276,36307244,1,394,12,36471556,36197664,273892,43.81288975216509
1747352000317279,36399804,1,395,12,36562559,36290224,272335,44.06337782510512
1747352000411292,36492364,1,396,12,36656572,36382784,273788,43.82953233888995
1747352000501213,36584924,1,397,12,36746493,36475344,271149,44.25611010920196
1747352000599879,36677484,1,398,12,36845159,36567904,277255,43.281455699626704
1747352000690113,36770044,1,399,12,36935393,36660464,274929,43.64763266152352
1747352000780056,36862604,1,400,12,37025336,36753024,272312,44.06709950351068
1747352000877724,36955172,1,401,12,37123004,36845592,277412,43.25696076593659
1747352000972564,37047724,1,402,12,37217844,36938144,279700,42.90311047550947
1747352001066210,37140284,1,403,12,37311490,37030704,280786,42.73717350580157
1747352001152166,37232844,1,404,12,37397446,37123264,274182,43.76654922642624
1747352001250400,37325404,1,405,12,37495680,37215824,279856,42.879195014578926
1747352001344622,37417964,1,406,12,37589902,37308384,281518,42.62604877840849
1747352001439333,37510524,1,407,12,37684613,37400944,283669,42.302824771124094
1747352001533494,37603084,1,408,12,37778774,37493504,285270,42.06541171521716
1747352001623158,37695644,1,409,12,37868438,37586064,282374,42.496830444729326
1747352001713328,37788204,1,410,12,37958608,37678624,279984,42.85959197668438
1747352001807338,37880764,1,411,12,38052618,37771184,281434,42.63877143486573
1747352001902189,37973324,1,412,12,38147469,37863744,283725,42.294475284166005
1747352001996436,38065884,1,413,12,38241716,37956304,285412,42.04448306308074
1747352002089702,38158444,1,414,12,38334982,38048864,286118,41.9407377375768
1747352002180015,38251004,1,415,12,38425295,38141424,283871,42.27272246900881
1747352002275008,38343564,1,416,12,38520288,38233984,286304,41.91349055549346
1747352002369217,38436124,1,417,12,38614497,38326544,287953,41.67346754505076
1747352002459178,38528684,1,418,12,38704458,38419104,285354,42.05302886940432
1747352002552996,38621244,1,419,12,38798276,38511664,286612,41.86844933219824
1747352002647008,38713804,1,420,12,38892288,38604224,288064,41.65740946456343
1747352002741679,38806364,1,421,12,38986959,38696784,290175,41.35435513052468
1747352002836350,38898924,1,422,12,39081630,38789344,292286,41.05567834244541
1747352002930328,38991484,1,423,12,39175608,38881904,293704,40.85746193446463
1747352003020083,39084052,1,424,12,39265363,38974472,290891,41.25256539391043
1747352003118163,39176604,1,425,12,39363443,39067024,296419,40.48323488035518
1747352003208398,39269164,1,426,12,39453678,39159584,294094,40.80328058375893
1747352003302761,39361724,1,427,12,39548041,39252144,295897,40.55465246352615
1747352003396947,39454284,1,428,12,39642227,39344704,297523,40.33301627101098
1747352003486875,39546844,1,429,12,39732155,39437264,294891,40.69300182101183
1747352003581203,39639404,1,430,12,39826483,39529824,296659,40.45048355182213
1747352003675191,39731964,1,431,12,39920471,39622384,298087,40.25670357982737
1747352003769198,39824524,1,432,12,40014478,39714944,299534,40.06222999726241
1747352003859418,39917084,1,433,12,40104698,39807504,297194,40.377665767142
1747352003954041,40009644,1,434,12,40199321,39900064,299257,40.09931263094932
1747352004047696,40102204,1,435,12,40292976,39992624,300352,39.9531216705732
1747352004141861,40194764,1,436,12,40387141,40085184,301957,39.74075779001646
1747352004231968,40287324,1,437,12,40477248,40177744,299504,40.06624285485336
1747352004326494,40379884,1,438,12,40571774,40270304,301470,39.80495571698676
1747352004420973,40472444,1,439,12,40666253,40362864,303389,39.55318089976894
1747352004515347,40565004,1,440,12,40760627,40455424,305203,39.31809320353994
1747352004609078,40657564,1,441,12,40854358,40547984,306374,39.16781450123053
1747352004695335,40750124,1,442,12,40940615,40640544,300071,39.99053557324767
1747352004789013,40842684,1,443,12,41034293,40733104,301189,39.84209250669846
1747352004883364,40935244,1,444,12,41128644,40825664,302980,39.60657469139877
1747352004973997,41027804,1,445,12,41219277,40918224,301053,39.86009108030812
1747352005067453,41120364,1,446,12,41312733,41010784,301949,39.74181070313198
1747352005162416,41212924,1,447,12,41407696,41103344,304352,39.42803070129324
1747352005256602,41305484,1,448,12,41501882,41195904,305978,39.21850590565335
1747352005346962,41398044,1,449,12,41592242,41288464,303778,39.50253145389067
1747352005440319,41490604,1,450,12,41685599,41381024,304575,39.39916276779119
1747352005534380,41583164,1,451,12,41779660,41473584,306076,39.2059488493054
1747352005628735,41675724,1,452,12,41874015,41566144,307871,38.97736389591744
1747352005722807,41768284,1,453,12,41968087,41658704,309383,38.78687581412036
1747352005813194,41860844,1,454,12,42058474,41751264,307210,39.06122847563556
1747352005907596,41953404,1,455,12,42152876,41843824,309052,38.82841722428588
1747352006002108,42045964,1,456,12,42247388,41936384,311004,38.58471273681367
1747352006095697,42138524,1,457,12,42340977,42028944,312033,38.45747084442991
1747352006186198,42231084,1,458,12,42431478,42121504,309974,38.71292430978082
1747352006284189,42323644,1,459,12,42529469,42214064,315405,38.0463213963
1747352006374184,42416204,1,460,12,42619464,42306624,312840,38.35826620636748
1747352006468669,42508764,1,461,12,42713949,42399184,314765,38.12367957047321
1747352006562917,42601324,1,462,12,42808197,42491744,316453,37.92032308115265
1747352006653004,42693884,1,463,12,42898284,42584304,313980,38.2189948404357
1747352006751132,42786444,1,464,12,42996412,42676864,319548,37.553043674189794
1747352006841187,42879012,1,465,12,43086467,42769432,317035,37.85071048937815
1747352006935318,42971564,1,466,12,43180598,42861984,318614,37.66312842499074
1747352007025381,43064124,1,467,12,43270661,42954544,316117,37.96062850147256
1747352007119656,43156684,1,468,12,43364936,43047104,317832,37.75579551461149
1747352007214098,43249244,1,469,12,43459378,43139664,319714,37.53354560638571
1747352007308180,43341804,1,470,12,43553460,43232224,321236,37.35571355638845
1747352007398660,43434364,1,471,12,43643940,43324784,319156,37.59916780508591
1747352007496487,43526924,1,472,12,43741767,43417344,324423,36.988746173976566
1747352007587077,43619484,1,473,12,43832357,43509904,322453,37.21472586702559
1747352007685206,43712044,1,474,12,43930486,43602464,328022,36.58291212174793
1747352007779337,43804604,1,475,12,44024617,43695024,329593,36.40854022991993
1747352007873472,43897164,1,476,12,44118752,43787584,331168,36.235385061358585
1747352007963769,43989724,1,477,12,44209049,43880144,328905,36.48469922926073
1747352008057284,44082284,1,478,12,44302564,43972704,329860,36.379069908446006
1747352008151467,44174844,1,479,12,44396747,44065264,331483,36.20095148167477
1747352008246301,44267404,1,480,12,44491581,44157824,333757,35.95430208205371
1747352008336215,44359964,1,481,12,44581495,44250384,331111,36.241622899873455
1747352008430536,44452524,1,482,12,44675816,44342944,332872,36.04989305198394
1747352008524247,44545084,1,483,12,44769527,44435504,334023,35.92566978920613
1747352008618436,44637644,1,484,12,44863716,44528064,335652,35.751313860784386
1747352008708862,44730204,1,485,12,44954142,44620624,333518,35.98006704285826
1747352008803122,44822764,1,486,12,45048402,44713184,335218,35.79760036752203
1747352008897436,44915324,1,487,12,45142716,44805744,336972,35.61126740500694
1747352008991205,45007892,1,488,12,45236485,44898312,338173,35.484796243342906
1747352009085874,45100444,1,489,12,45331154,44990864,340290,35.26403949572424
1747352009175951,45193004,1,490,12,45421231,45083424,337807,35.52324256158102
1747352009270461,45285564,1,491,12,45515741,45175984,339757,35.31936060184191
1747352009359789,45378124,1,492,12,45605069,45268544,336525,35.65856919991085
1747352009454193,45470684,1,493,12,45699473,45361104,338369,35.464241700628605
1747352009544261,45563244,1,494,12,45789541,45453664,335877,35.7273644816406
1747352009638392,45655804,1,495,12,45883672,45546224,337448,35.56103458903297
1747352009732444,45748364,1,496,12,45977724,45638784,338940,35.40449637103912
1747352009826676,45840924,1,497,12,46071956,45731344,340612,35.230702382769834
1747352009916681,45933484,1,498,12,46161961,45823904,338057,35.496972404062035
1747352010011972,46026044,1,499,12,46257252,45916464,340788,35.21250748265784
1747352010105400,46118604,1,500,12,46350680,46009024,341656,35.12304774392957
1747352010195663,46211164,1,501,12,46440943,46101584,339359,35.36078312347691
1747352010294064,46303724,1,502,12,46539344,46194144,345200,34.762456546929315
1747352010384218,46396284,1,503,12,46629498,46286704,342794,35.00644702065964
1747352010478427,46488844,1,504,12,46723707,46379264,344443,34.8388557758468
1747352010572251,46581404,1,505,12,46817531,46471824,345707,34.71147532447998
1747352010666729,46673964,1,506,12,46912009,46564384,347625,34.51995685005394
1747352010757318,46766524,1,507,12,47002598,46656944,345654,34.716797722578065
1747352010850545,46859084,1,508,12,47095825,46749504,346321,34.64993459824845
1747352010940850,46951644,1,509,12,47186130,46842064,344066,34.87702940714863
1747352011035518,47044204,1,510,12,47280798,46934624,346174,34.66464841380346
1747352011129812,47136764,1,511,12,47375092,47027184,347908,34.491877162928134
1747352011223802,47229324,1,512,12,47469082,47119744,349338,34.350686154955945
1747352011317791,47321884,1,513,12,47563071,47212304,350767,34.21074388411681
1747352011407891,47414444,1,514,12,47653171,47304864,348307,34.452365298429264
1747352011502339,47507004,1,515,12,47747619,47397424,350195,34.26662288153743
1747352011596078,47599564,1,516,12,47841358,47489984,351374,34.151644686288684
1747352011690242,47692124,1,517,12,47935522,47582544,352978,33.996453036733165
1747352011784411,47784684,1,518,12,48029691,47675104,354587,33.842188235891335
1747352011874519,47877244,1,519,12,48119799,47767664,352135,34.07783946497792
1747352011969567,47969804,1,520,12,48214847,47860224,354623,33.838752703575345
1747352012063741,48062364,1,521,12,48309021,47952784,356237,33.68543974938033
1747352012157626,48154924,1,522,12,48402906,48045344,357562,33.56061326427305
1747352012251359,48247484,1,523,12,48496639,48137904,358735,33.450875994815114
1747352012342190,48340044,1,524,12,48587470,48230464,357006,33.61288045579066
1747352012436613,48432604,1,525,12,48681893,48323024,358869,33.43838559474349
1747352012530313,48525164,1,526,12,48775593,48415584,360009,33.33250002083281
1747352012624788,48617724,1,527,12,48870068,48508144,361924,33.15613222665532
1747352012715328,48710284,1,528,12,48960608,48600704,359904,33.34222459322486
1747352012809856,48802852,1,529,12,49055136,48693272,361864,33.1616297835651
1747352012899623,48895404,1,530,12,49144903,48785824,359079,33.418829839673165
1747352012993319,48987964,1,531,12,49238599,48878384,360215,33.31343780797579
1747352013087097,49080524,1,532,12,49332377,48970944,361433,33.2011742148614
1747352013181741,49173084,1,533,12,49427021,49063504,363517,33.0108358068536
1747352013275568,49265644,1,534,12,49520848,49156064,364784,32.8961796570025
1747352013366149,49358204,1,535,12,49611429,49248624,362805,33.07561913424567
1747352013460551,49450764,1,536,12,49705831,49341184,364647,32.908538943142275
1747352013554557,49543324,1,537,12,49799837,49433744,366093,32.778556268489154
1747352013648286,49635884,1,538,12,49893566,49526304,367262,32.674221672811235
1747352013738951,49728444,1,539,12,49984231,49618864,365367,32.84368867467505
1747352013833196,49821004,1,540,12,50078476,49711424,367052,32.69291544522302
1747352013926286,49913564,1,541,12,50171566,49803984,367582,32.645776996697336
1747352014021498,50006124,1,542,12,50266778,49896544,370234,32.411934074126094
1747352014111044,50098684,1,543,12,50356324,49989104,367220,32.67795871684549
1747352014205422,50191244,1,544,12,50450702,50081664,369038,32.516976571518384
1747352014300118,50283804,1,545,12,50545398,50174224,371174,32.32985068997289
1747352014394087,50376364,1,546,12,50639367,50266784,372583,32.20758864467783
1747352014484094,50468924,1,547,12,50729374,50359344,370030,32.42980298894684
1747352014582279,50561484,1,548,12,50827559,50451904,375655,31.94420412346435
1747352014671769,50654044,1,549,12,50917049,50544464,372585,32.20741575747816
1747352014766898,50746604,1,550,12,51012178,50637024,375154,31.986864061158887
1747352014861086,50839164,1,551,12,51106366,50729584,376782,31.84865519053458
1747352014950475,50931732,1,552,12,51195755,50822152,373603,32.11965642674176
1747352015045223,51024284,1,553,12,51290503,50914704,375799,31.931963629493428
1747352015138545,51116844,1,554,12,51383825,51007264,376561,31.86734685748126
1747352015233654,51209404,1,555,12,51478934,51099824,379110,31.653082218881064
1747352015327827,51301964,1,556,12,51573107,51192384,380723,31.518978364847936
1747352015421981,51394524,1,557,12,51667261,51284944,382317,31.38756581580207
1747352015512361,51487084,1,558,12,51757641,51377504,380137,31.567566429997605
1747352015606450,51579644,1,559,12,51851730,51470064,381666,31.441102953891622
1747352015699927,51672204,1,560,12,51945207,51562624,382583,31.36574285841242
1747352015794290,51764764,1,561,12,52039570,51655184,384386,31.21861878424292
1747352015884305,51857324,1,562,12,52129585,51747744,381841,31.426693309518885
1747352015978458,51949884,1,563,12,52223738,51840304,383434,31.296129190421297
1747352016076970,52042444,1,564,12,52322250,51932864,389386,30.81774896888948
1747352016167365,52135004,1,565,12,52412645,52025424,387221,30.990054774921816
1747352016257220,52227564,1,566,12,52502500,52117984,384516,31.20806416377992
1747352016351786,52320124,1,567,12,52597066,52210544,386522,31.04609828159846
1747352016445480,52412684,1,568,12,52690760,52303104,387656,30.95527993891492
1747352016539491,52505244,1,569,12,52784771,52395664,389107,30.839846109167915
1747352016629759,52597804,1,570,12,52875039,52488224,386815,31.022581854374828
1747352016728256,52690364,1,571,12,52973536,52580784,392752,30.553631808367623
1747352016818729,52782924,1,572,12,53064009,52673344,390665,30.716854594089565
1747352016908688,52875484,1,573,12,53153968,52765904,388064,30.922734394326707
1747352017011078,52968044,1,574,12,53256358,52858464,397894,30.15878600833388
1747352017097266,53060604,1,575,12,53342546,52951024,391522,30.64961866766108
1747352017191645,53153164,1,576,12,53436925,53043584,393341,30.507879931153884
1747352017284789,53245724,1,577,12,53530069,53136144,393925,30.46265151995938
1747352017379475,53338284,1,578,12,53624755,53228704,396051,30.299128142587698
1747352017473940,53430844,1,579,12,53719220,53321264,397956,30.15408738654525
1747352017563979,53523404,1,580,12,53809259,53413824,395435,30.346327462161923
1747352017657712,53615964,1,581,12,53902992,53506384,396608,30.256575762465708
1747352017751898,53708524,1,582,12,53997178,53598944,398234,30.133037359944154
1747352017846505,53801084,1,583,12,54091785,53691504,400281,29.97893979479416
1747352017940500,53893644,1,584,12,54185780,53784064,401716,29.871849764510248
1747352018034826,53986204,1,585,12,54280106,53876624,403482,29.741103692358024
1747352018124998,54078764,1,586,12,54370278,53969184,401094,29.91817379467157
1747352018218711,54171324,1,587,12,54463991,54061744,402247,29.832416400868123
1747352018309347,54263884,1,588,12,54554627,54154304,400323,29.975794545904183
1747352018402971,54356444,1,589,12,54648251,54246864,401387,29.89633446025905
1747352018497607,54449004,1,590,12,54742887,54339424,403463,29.74250426928863
1747352018591835,54541564,1,591,12,54837115,54431984,405131,29.62004882371381
1747352018681639,54634124,1,592,12,54926919,54524544,402375,29.82292637465052
1747352018780072,54726692,1,593,12,55025352,54617112,408240,29.394473838918284
1747352018874205,54819244,1,594,12,55119485,54709664,409821,29.281076372367448
1747352018964605,54911804,1,595,12,55209885,54802224,407661,29.436222743897503
1747352019058786,55004364,1,596,12,55304066,54894784,409282,29.31963780474099
1747352019148853,55096924,1,597,12,55394133,54987344,406789,29.49932274471532
1747352019243468,55189484,1,598,12,55488748,55079904,408844,29.35104832160922
1747352019337418,55282044,1,599,12,55582698,55172464,410234,29.25159786853357
1747352019431553,55374604,1,600,12,55676833,55265024,411809,29.139722541275205
1747352019521655,55467164,1,601,12,55766935,55357584,409351,29.31469570124416
1747352019615884,55559724,1,602,12,55861164,55450144,411020,29.195659578609312
1747352019709896,55652284,1,603,12,55955176,55542704,412472,29.092883880602805
1747352019804263,55744844,1,604,12,56049543,55635264,414279,28.96598669012912
1747352019894788,55837404,1,605,12,56140068,55727824,412244,29.10897429677569
1747352019988528,55929964,1,606,12,56233808,55820384,413424,29.02589109485661
1747352020082726,56022524,1,607,12,56328006,55912944,415062,28.911343365569483
1747352020172604,56115084,1,608,12,56417884,56005504,412380,29.099374363451183
1747352020267445,56207644,1,609,12,56512725,56098064,414661,28.93930222519118
1747352020361384,56300204,1,610,12,56606664,56190624,416040,28.843380444188057
1747352020451479,56392764,1,611,12,56696759,56283184,413575,29.01529347760382
1747352020549799,56485324,1,612,12,56795079,56375744,419335,28.616738407240035
1747352020639771,56577884,1,613,12,56885051,56468304,416747,28.79444843034263
1747352020734417,56670444,1,614,12,56979697,56560864,418833,28.6510375256964
1747352020828619,56763004,1,615,12,57073899,56653424,420475,28.53915214935489
1747352020922011,56855572,1,616,12,57167291,56745992,421299,28.483333689375005
1747352021016372,56948124,1,617,12,57261652,56838544,423108,28.361553078646587
1747352021106265,57040684,1,618,12,57351545,56931104,420441,28.541460038388266
1747352021200942,57133244,1,619,12,57446222,57023664,422558,28.39846837593893
1747352021294674,57225804,1,620,12,57539954,57116224,423730,28.319920704222028
1747352021389309,57318364,1,621,12,57634589,57208784,425805,28.181914256525875
1747352021479725,57410924,1,622,12,57725005,57301344,423661,28.32453305827065
1747352021573722,57503484,1,623,12,57819002,57393904,425098,28.228784891954326
1747352021668214,57596044,1,624,12,57913494,57486464,427030,28.10107018242278
1747352021762229,57688604,1,625,12,58007509,57579024,428485,28.005647805640805
1747352021852178,57781164,1,626,12,58097458,57671584,425874,28.1773482297581
1747352021946125,57873724,1,627,12,58191405,57764144,427261,28.08587725067348
1747352022040122,57966284,1,628,12,58285402,57856704,428698,27.99173310815539
1747352022134561,58058844,1,629,12,58379841,57949264,430577,27.869579657064826
1747352022224513,58151404,1,630,12,58469793,58041824,427969,28.039414069710656
1747352022319330,58243964,1,631,12,58564610,58134384,430226,27.89231706126548
1747352022417044,58336524,1,632,12,58662324,58226944,435380,27.56212963388305
1747352022511525,58429084,1,633,12,58756805,58319504,437301,27.441053187621343
1747352022601605,58521644,1,634,12,58846885,58412064,434821,27.597563135175164
1747352022696252,58614204,1,635,12,58941532,58504624,436908,27.46573649372408
1747352022789770,58706764,1,636,12,59035050,58597184,437866,27.405644649276265
1747352022880310,58799324,1,637,12,59125590,58689744,435846,27.532660618658884
1747352022974273,58891884,1,638,12,59219553,58782304,437249,27.444316625080905
1747352023068261,58984444,1,639,12,59313541,58874864,438677,27.35497872010614
1747352023161845,59077004,1,640,12,59407125,58967424,439701,27.291272933197785
1747352023253276,59169564,1,641,12,59498556,59059984,438572,27.36152786771613
1747352023347080,59262124,1,642,12,59592360,59152544,439816,27.284137002746604
1747352023441315,59354684,1,643,12,59686595,59245104,441491,27.18062202853512
1747352023535267,59447244,1,644,12,59780547,59337664,442883,27.095192183940227
1747352023629798,59539804,1,645,12,59875078,59430224,444854,26.975142406272617
1747352023723785,59632364,1,646,12,59969065,59522784,446281,26.888888390946512
1747352023810015,59724924,1,647,12,60055295,59615344,439951,27.27576480108012
1747352023908156,59817484,1,648,12,60153436,59707904,445532,26.93409227620014
1747352024002400,59910044,1,649,12,60247680,59800464,447216,26.83267146077064
1747352024096330,60002604,1,650,12,60341610,59893024,448586,26.750723384144848
1747352024186097,60095164,1,651,12,60431377,59985584,445793,26.91832307819997
1747352024280460,60187724,1,652,12,60525740,60078144,447596,26.809891062475984
1747352024375250,60280284,1,653,12,60620530,60170704,449826,26.676981766282964
1747352024468844,60372844,1,654,12,60714124,60263264,450860,26.615800913809167
1747352024559142,60465404,1,655,12,60804422,60355824,448598,26.75000780208561
1747352024653735,60557964,1,656,12,60899015,60448384,450631,26.62932643337897
1747352024747586,60650532,1,657,12,60992866,60540952,451914,26.55372482374965
1747352024842079,60743084,1,658,12,61087359,60633504,453855,26.44016260700004
1747352024935822,60835644,1,659,12,61181102,60726064,455038,26.37142392503484
1747352025026289,60928204,1,660,12,61271569,60818624,452945,26.49328284891101
1747352025120745,61020764,1,661,12,61366025,60911184,454841,26.38284587361297
1747352025210435,61113324,1,662,12,61455715,61003744,451971,26.55037601970038
1747352025304635,61205884,1,663,12,61549915,61096304,453611,26.454384924527844
1747352025398712,61298444,1,664,12,61643992,61188864,455128,26.366209066460424
1747352025492861,61391004,1,665,12,61738141,61281424,456717,26.27447631684391
1747352025586988,61483564,1,666,12,61832268,61373984,458284,26.18463660088504
1747352025680989,61576124,1,667,12,61926269,61466544,459725,26.10256131382892
1747352025771470,61668684,1,668,12,62016750,61559104,457646,26.221140357394145
1747352025866235,61761244,1,669,12,62111515,61651664,459851,26.095409165142623
1747352025959598,61853804,1,670,12,62204878,61744224,460654,26.04992033066032
1747352026050397,61946364,1,671,12,62295677,61836784,458893,26.14988679278176
1747352026148891,62038924,1,672,12,62394171,61929344,464827,25.816056296213432
1747352026234797,62131484,1,673,12,62480077,62021904,458173,26.19098026291379
1747352026328815,62224044,1,674,12,62574095,62114464,459631,26.10789959772078
1747352026423233,62316604,1,675,12,62668513,62207024,461489,26.0027866319674
1747352026517450,62409164,1,676,12,62762730,62299584,463146,25.909756318741824
1747352026607034,62501724,1,677,12,62852314,62392144,460170,26.07731925158093
1747352026701012,62594284,1,678,12,62946292,62484704,461588,25.997209632832742
1747352026799639,62686844,1,679,12,63044919,62577264,467655,25.659941623632808
1747352026889031,62779412,1,680,12,63134311,62669832,464479,25.83539837107813
1747352026979822,62871964,1,681,12,63225102,62762384,462718,25.93372205101163
1747352027078302,62964524,1,682,12,63323582,62854944,468638,25.60611815516454
1747352027171987,63057084,1,683,12,63417267,62947504,469763,25.544795992873
1747352027261962,63149644,1,684,12,63507242,63040064,467178,25.686141042600465
1747352027356500,63242204,1,685,12,63601780,63132624,469156,25.577846174833105
1747352027450988,63334764,1,686,12,63696268,63225184,471084,25.47316402170313
1747352027545460,63427324,1,687,12,63790740,63317744,472996,25.37019340544106
1747352027635176,63519884,1,688,12,63880456,63410304,470152,25.5236604332216
1747352027733177,63612444,1,689,12,63978457,63502864,475593,25.23165816149523
1747352027823428,63705004,1,690,12,64068708,63595424,473284,25.35475528435358
1747352027913872,63797564,1,691,12,64159152,63687984,471168,25.46862265688672
1747352028008247,63890124,1,692,12,64253527,63780544,472983,25.370890708545552
1747352028102499,63982684,1,693,12,64347779,63873104,474675,25.280455048190863
1747352028196098,64075244,1,694,12,64441378,63965664,475714,25.225240375519743
1747352028289948,64167804,1,695,12,64535228,64058224,477004,25.15702174405246
1747352028384853,64260364,1,696,12,64630133,64150784,479349,25.033952297803896
1747352028479199,64352924,1,697,12,64724479,64243344,481135,24.941024868280213
1747352028568729,64445484,1,698,12,64814009,64335904,478105,25.099089112224306
1747352028662999,64538044,1,699,12,64908279,64428464,479815,25.00963913174869
1747352028757012,64630604,1,700,12,65002292,64521024,481268,24.93413233375168
1747352028851156,64723164,1,701,12,65096436,64613584,482852,24.852335705350708
1747352028945692,64815724,1,702,12,65190972,64706144,484828,24.751045731682165
1747352029035721,64908284,1,703,12,65281001,64798704,482297,24.880934362021744
1747352029130456,65000844,1,704,12,65375736,64891264,484472,24.769233309664955
1747352029224433,65093404,1,705,12,65469713,64983824,485889,24.69699869723332
1747352029318938,65185964,1,706,12,65564218,65076384,487834,24.598531467671386
1747352029409002,65278524,1,707,12,65654282,65168944,485338,24.72503698453449
1747352029503078,65371084,1,708,12,65748358,65261504,486854,24.648046436919486
1747352029596576,65463644,1,709,12,65841856,65354064,487792,24.600649457145668
1747352029690821,65556204,1,710,12,65936101,65446624,489477,24.515962956379973
1747352029781628,65648764,1,711,12,66026908,65539184,487724,24.604079356357285
1747352029875036,65741324,1,712,12,66120316,65631744,488572,24.5613747820178
1747352029969636,65833884,1,713,12,66214916,65724304,490612,24.459246818259643
1747352030063369,65926444,1,714,12,66308649,65816864,491785,24.40090690037313
1747352030153960,66019004,1,715,12,66399240,65909424,489816,24.49899554118281
1747352030248186,66111564,1,716,12,66493466,66001984,491482,24.415950126352545
1747352030342519,66204124,1,717,12,66587799,66094544,493255,24.32818724594784
1747352030436421,66296684,1,718,12,66681701,66187104,494597,24.262177085586853
1747352030530613,66389244,1,719,12,66775893,66279664,496229,24.18238353663329
1747352030621266,66481804,1,720,12,66866546,66372224,494322,24.275674560306847
1747352030714789,66574372,1,721,12,66960069,66464792,495277,24.228865866979486
1747352030809004,66666924,1,722,12,67054284,66557344,496940,24.14778444077756
1747352030903098,66759484,1,723,12,67148378,66649904,498474,24.073472237268145
1747352030994053,66852044,1,724,12,67239333,66742464,496869,24.15123503378154
1747352031087928,66944604,1,725,12,67333208,66835024,498184,24.0874857482376
1747352031181675,67037164,1,726,12,67426955,66927584,499371,24.03023002937696
1747352031276625,67129724,1,727,12,67521905,67020144,501761,23.915768662769725
1747352031366477,67222284,1,728,12,67611757,67112704,499053,24.04554225703482
1747352031460211,67314844,1,729,12,67705491,67205264,500227,23.98910894453918
1747352031554343,67407404,1,730,12,67799623,67297824,501799,23.91395758062492
1747352031648434,67499964,1,731,12,67893714,67390384,503330,23.84121749150656
1747352031739287,67592524,1,732,12,67984567,67482944,501623,23.92234805820307
1747352031833708,67685084,1,733,12,68078988,67575504,503484,23.83392520914269
1747352031927033,67777644,1,734,12,68172313,67668064,504249,23.797766579606503
1747352032021514,67870204,1,735,12,68266794,67760624,506170,23.7074500661833
1747352032115487,67962764,1,736,12,68360767,67853184,507583,23.641453712988813
1747352032205770,68055324,1,737,12,68451050,67945744,505306,23.747986368655823
1747352032299788,68147884,1,738,12,68545068,68038304,506764,23.67966153870441
1747352032394194,68240444,1,739,12,68639474,68130864,508610,23.59371620691689
1747352032488355,68333004,1,740,12,68733635,68223424,510211,23.51968107312465
1747352032578394,68425564,1,741,12,68823674,68315984,507690,23.636471074868524
1747352032673367,68518124,1,742,12,68918647,68408544,510103,23.52466070577903
1747352032767422,68610684,1,743,12,69012702,68501104,511598,23.45591655948616
1747352032860980,68703252,1,744,12,69106260,68593672,512588,23.41061437255652
1747352032951851,68795804,1,745,12,69197131,68686224,510907,23.487640607781845
1747352033046007,68888364,1,746,12,69291287,68778784,512503,23.41449708587072
1747352033140162,68980924,1,747,12,69385442,68871344,514098,23.34185310971838
1747352033233878,69073484,1,748,12,69479158,68963904,515254,23.28948440963098
1747352033324289,69166044,1,749,12,69569569,69056464,513105,23.38702604730026
1747352033418009,69258604,1,750,12,69663289,69149024,514265,23.33427318600333
1747352033512147,69351164,1,751,12,69757427,69241584,515843,23.262892003962445
1747352033606638,69443724,1,752,12,69851918,69334144,517774,23.17613476149826
1747352033701266,69536284,1,753,12,69946546,69426704,519842,23.08393704240904
1747352033791321,69628844,1,754,12,70036601,69519264,517337,23.19571188606266
1747352033884919,69721404,1,755,12,70130199,69611824,518375,23.14926452857487
1747352033979816,69813964,1,756,12,70225096,69704384,520712,23.04536864908049
1747352034073910,69906524,1,757,12,70319190,69796944,522246,22.977677186613207
1747352034163597,69999084,1,758,12,70408877,69889504,519373,23.10478211227769
1747352034258312,70091644,1,759,12,70503592,69982064,521528,23.00931110122563
1747352034352110,70184204,1,760,12,70597390,70074624,522766,22.95482108629865
1747352034445941,70276764,1,761,12,70691221,70167184,524037,22.899146434316663
1747352034536229,70369324,1,762,12,70781509,70259744,521765,22.998859639876187
1747352034631045,70461884,1,763,12,70876325,70352304,524021,22.89984561687413
1747352034724562,70554444,1,764,12,70969842,70444864,524978,22.858100720411144
1747352034814933,70647004,1,765,12,71060213,70537424,522789,22.95381119342603
1747352034913734,70742684,1,766,12,71159014,70633104,525910,22.81759236371242
1747352035007272,70835244,1,767,12,71252552,70725664,526888,22.775238760419672
1747352035102005,70927804,1,768,12,71347285,70818224,529061,22.681694549399783
1747352035196031,71020364,1,769,12,71441311,70910784,530527,22.619018447694465
1747352035286184,71112924,1,770,12,71531464,71003344,528120,22.72210861167916
1747352035384449,71208604,1,771,12,71629729,71099024,530705,22.611431963143367
1747352035478673,71301164,1,772,12,71723953,71191584,532369,22.54075650535625
1747352035568709,71393724,1,773,12,71813989,71284144,529845,22.648132944540382
1747352035662393,71486284,1,774,12,71907673,71376704,530969,22.60018946492168
1747352035753112,71578844,1,775,12,71998392,71469264,529128,22.678822515535
1747352035851545,71674524,1,776,12,72096825,71564944,531881,22.561437614804813
1747352035945020,71767084,1,777,12,72190300,71657504,532796,22.522691611798887
1747352036039613,71859644,1,778,12,72284893,71750064,534829,22.437078019329544
1747352036134011,71952204,1,779,12,72379291,71842624,536667,22.36023455886052
1747352036223895,72044764,1,780,12,72469175,71935184,533991,22.47228885880099
1747352036317894,72137324,1,781,12,72563174,72027744,535430,22.41189324468185
1747352036412525,72229884,1,782,12,72657805,72120304,537501,22.32553985946073
1747352036506612,72322444,1,783,12,72751892,72212864,539028,22.262294352055925
1747352036600761,72415004,1,784,12,72846041,72305424,540617,22.19686025411705
1747352036690765,72507564,1,785,12,72936045,72397984,538061,22.302304013857164
1747352036784399,72600124,1,786,12,73029679,72490544,539135,22.25787604217868
1747352036879674,72692684,1,787,12,73124954,72583104,541850,22.14635046599612
1747352036973425,72785244,1,788,12,73218705,72675664,543041,22.097778989063443
1747352037063955,72877804,1,789,12,73309235,72768224,541011,22.18069503207883
1747352037157734,72970364,1,790,12,73403014,72860784,542230,22.13083009055198
1747352037251709,73062924,1,791,12,73496989,72953344,543645,22.073227933669948
1747352037345555,73155484,1,792,12,73590835,73045904,544931,22.02113662096669
1747352037436399,73248044,1,793,12,73681679,73138464,543215,22.090700735436243
1747352037530548,73340604,1,794,12,73775828,73231024,544804,22.02626999801764
1747352037624275,73433164,1,795,12,73869555,73323584,545971,21.97918937086402
1747352037718959,73525724,1,796,12,73964239,73416144,548095,21.8940147237249
1747352037813198,73618284,1,797,12,74058478,73508704,549774,21.82715079287125
1747352037902615,73710844,1,798,12,74147895,73601264,546631,21.95265178886672
1747352037997423,73803404,1,799,12,74242703,73693824,548879,21.862742061547262
1747352038091126,73895972,1,800,12,74336406,73786392,550014,21.81762646041737
1747352038186051,73988524,1,801,12,74431331,73878944,552387,21.72390009178348
1747352038275620,74081084,1,802,12,74520900,73971504,549396,21.842168490487737
1747352038370265,74173644,1,803,12,74615545,74064064,551481,21.7595891789563
1747352038468425,74269324,1,804,12,74713705,74159744,553961,21.66217477403644
1747352038557922,74361892,1,805,12,74803202,74252312,550890,21.78293307193813
1747352038652112,74454444,1,806,12,74897392,74344864,552528,21.71835635479107
1747352038746343,74547004,1,807,12,74991623,74437424,554199,21.65287198280762
1747352038841223,74639564,1,808,12,75086503,74529984,556519,21.56260612845204
1747352038930920,74732124,1,809,12,75176200,74622544,553656,21.67410811045125
1747352039025329,74824684,1,810,12,75270609,74715104,555505,21.60196577888588
1747352039119200,74917244,1,811,12,75364480,74807664,556816,21.55110485330881
1747352039214026,75009804,1,812,12,75459306,74900224,559082,21.463756658236186
1747352039304060,75102364,1,813,12,75549340,74992784,556556,21.56117264030933
1747352039398232,75194924,1,814,12,75643512,75085344,558168,21.49890355591865
1747352039492646,75287484,1,815,12,75737926,75177904,560022,21.42772962490759
1747352039585972,75380044,1,816,12,75831252,75270464,560788,21.39846073739096
1747352039680224,75472604,1,817,12,75925504,75363024,562480,21.33409187882236
1747352039770734,75565164,1,818,12,76016014,75455584,560430,21.41212997162893
1747352039865042,75657724,1,819,12,76110322,75548144,562178,21.345552476261968
1747352039958880,75750284,1,820,12,76204160,75640704,563456,21.297137664697868
1747352040053101,75842844,1,821,12,76298381,75733264,565117,21.23454081190267
1747352040143245,75935404,1,822,12,76388525,75825824,562701,21.3257129452409
1747352040233572,76027964,1,823,12,76478852,75918384,560468,21.41067821891705
1747352040331437,76120524,1,824,12,76576717,76010944,565773,21.209919879527657
1747352040426003,76213084,1,825,12,76671283,76103504,567779,21.13498385815608
1747352040516169,76305644,1,826,12,76761449,76196064,565385,21.22447535749976
1747352040610007,76398204,1,827,12,76855287,76288624,566663,21.17660761334338
1747352040704587,76490772,1,828,12,76949867,76381192,568675,21.101683738514968
1747352040799025,76583324,1,829,12,77044305,76473744,570561,21.031931730349605
1747352040892611,76675884,1,830,12,77137891,76566304,571587,20.994179363771394
1747352040982337,76768444,1,831,12,77227617,76658864,568753,21.09878980858123
1747352041077589,76861004,1,832,12,77322869,76751424,571445,20.99939626735732
1747352041171150,76953564,1,833,12,77416430,76843984,572446,20.9626759554613
1747352041265144,77046124,1,834,12,77510424,76936544,573880,20.910294835157178
1747352041356371,77138684,1,835,12,77601651,77029104,572547,20.95897804023076
1747352041449968,77231244,1,836,12,77695248,77121664,573584,20.921085664872106
1747352041544304,77323804,1,837,12,77789584,77214224,575360,20.85650723025584
1747352041638820,77416364,1,838,12,77884100,77306784,577316,20.78584345488433
1747352041753409,77508924,1,839,12,77998689,77399344,599345,20.021857194103564
1747352041847012,77601484,1,840,12,78092292,77491904,600388,19.987075024817283
1747352041913146,77694044,1,841,12,78158426,77584464,573962,20.907307452409743
1747352042011033,77786604,1,842,12,78256313,77677024,579289,20.71504896519699
1747352042101450,77879164,1,843,12,78346730,77769584,577146,20.791965984343648
1747352042195017,77971724,1,844,12,78440297,77862144,578153,20.7557515052244
1747352042289932,78064284,1,845,12,78535212,77954704,580508,20.671549746084462
1747352042384250,78156844,1,846,12,78629530,78047264,582266,20.60913740455393
1747352042478222,78249404,1,847,12,78723502,78139824,583678,20.559280973413426
1747352042568653,78341964,1,848,12,78813933,78232384,581549,20.6345467019976
1747352042662850,78434524,1,849,12,78908130,78324944,583186,20.576625639161435
1747352042756960,78527084,1,850,12,79002240,78417504,584736,20.52208175997373
1747352042847292,78619644,1,851,12,79092572,78510064,582508,20.6005754427407
1747352042941161,78712204,1,852,12,79186441,78602624,583817,20.55438604905304
1747352043035669,78804764,1,853,12,79280949,78695184,585765,20.486031087552178
1747352043130364,78897324,1,854,12,79375644,78787744,587900,20.411634631740093
1747352043223406,78989884,1,855,12,79468686,78880304,588382,20.39491350857096
1747352043313725,79082444,1,856,12,79559005,78972864,586141,20.472889628945936
1747352043408143,79175004,1,857,12,79653423,79065424,587999,20.4081979731258
1747352043502674,79267564,1,858,12,79747954,79157984,589970,20.340017289014696
1747352043596055,79360124,1,859,12,79841335,79250544,590791,20.31175153311408
1747352043687089,79452684,1,860,12,79932369,79343104,589265,20.364352201471323
1747352043777106,79545244,1,861,12,80022386,79435664,586722,20.452616400953094
1747352043870080,79637804,1,862,12,80115360,79528224,587136,20.438194898626552
1747352043964884,79730364,1,863,12,80210164,79620784,589380,20.360378703043875
1747352044058870,79822924,1,864,12,80304150,79713344,590806,20.31123583714451
1747352044148881,79915484,1,865,12,80394161,79805904,588257,20.399247267775817
1747352044247630,80008044,1,866,12,80492910,79898464,594446,20.18686306241441
1747352044337044,80100604,1,867,12,80582324,79991024,591300,20.29426686960933
1747352044435787,80193164,1,868,12,80681067,80083584,597483,20.0842534431942
1747352044526068,80285732,1,869,12,80771348,80176152,595196,20.16142581603372
1747352044616407,80378284,1,870,12,80861687,80268704,592983,20.236667830275067
1747352044710220,80470844,1,871,12,80955500,80361264,594236,20.19399699782578
1747352044804819,80563404,1,872,12,81050099,80453824,596275,20.12494235042556
1747352044894831,80655964,1,873,12,81140111,80546384,593727,20.21130923808417
1747352044992338,80748524,1,874,12,81237618,80638944,598674,20.044297898355364
1747352045086576,80841084,1,875,12,81331856,80731504,600352,19.98827354618624
1747352045177015,80933644,1,876,12,81422295,80824064,598231,20.05914103414901
1747352045271635,81026204,1,877,12,81516915,80916624,600291,19.990304702219422
1747352045361450,81118764,1,878,12,81606730,81009184,597546,20.08213593597815
1747352045459443,81211324,1,879,12,81704723,81101744,602979,19.90119058872697
1747352045549636,81303884,1,880,12,81794916,81194304,600612,19.979620786797465
1747352045643928,81396444,1,881,12,81889208,81286864,602344,19.92217071972162
1747352045734140,81489004,1,882,12,81979420,81379424,599996,20.00013333422223
1747352045832764,81581564,1,883,12,82078044,81471984,606060,19.8000198000198
1747352045922442,81674124,1,884,12,82167722,81564544,603178,19.89462480395505
1747352046021127,81766684,1,885,12,82266407,81657104,609303,19.69463468914481
1747352046110863,81859244,1,886,12,82356143,81749664,606479,19.786340499835937
1747352046201344,81951804,1,887,12,82446624,81842224,604400,19.854401058901388
1747352046298898,82044364,1,888,12,82544178,81934784,609394,19.69169371539595
1747352046393524,82136924,1,889,12,82638804,82027344,611460,19.62515945442057
1747352046479310,82229484,1,890,12,82724590,82119904,604686,19.845010468243025
1747352046577621,82322044,1,891,12,82822901,82212464,610437,19.658048250679432
1747352046672020,82414612,1,892,12,82917300,82305032,612268,19.59926045457218
1747352046765868,82507164,1,893,12,83011148,82397584,613564,19.55786193453332
1747352046859910,82599724,1,894,12,83105190,82490144,615046,19.510735782364247
1747352046950199,82692284,1,895,12,83195479,82582704,612775,19.583044347435848
1747352047044170,82784844,1,896,12,83289450,82675264,614186,19.53805524710756
1747352047134379,82877404,1,897,12,83379659,82767824,611835,19.61313099119861
1747352047233310,82969964,1,898,12,83478590,82860384,618206,19.41100539302433
1747352047323543,83062524,1,899,12,83568823,82952944,615879,19.48434676291934
1747352047417007,83155084,1,900,12,83662287,83045504,616783,19.455789151127707
1747352047511823,83247644,1,901,12,83757103,83138064,619039,19.38488528186431
1747352047605675,83340204,1,902,12,83850955,83230624,620331,19.344511236742967
1747352047695614,83432764,1,903,12,83940894,83323184,617710,19.42659176636285
1747352047790179,83525324,1,904,12,84035459,83415744,619715,19.363739783610207
1747352047879879,83617884,1,905,12,84125159,83508304,616855,19.45351824983181
1747352047974530,83710444,1,906,12,84219810,83600864,618946,19.387797966219992
1747352048068514,83803004,1,907,12,84313794,83693424,620370,19.34329513032545
1747352048162720,83895564,1,908,12,84408000,83785984,622016,19.29210824158864
1747352048257012,83988124,1,909,12,84502292,83878544,623748,19.23853864060486
1747352048343207,84080684,1,910,12,84588487,83971104,617383,19.436881158049378
1747352048445327,84173244,1,911,12,84690607,84063664,626943,19.140496025954512
1747352048535348,84265804,1,912,12,84780628,84156224,624404,19.21832659624218
1747352048625964,84358364,1,913,12,84871244,84248784,622460,19.278347203033125
1747352048723827,84450924,1,914,12,84969107,84341344,627763,19.115494223138352
1747352048818352,84543484,1,915,12,85063632,84433904,629728,19.055846333655168
1747352048908465,84636044,1,916,12,85153745,84526464,627281,19.1301824859991
1747352049002694,84728604,1,917,12,85247974,84619024,628950,19.079418077748628
1747352049096660,84821164,1,918,12,85341940,84711584,630356,19.03686170989092
1747352049190304,84913724,1,919,12,85435584,84804144,631440,19.004180919802355
1747352049280545,85006284,1,920,12,85525825,84896704,629121,19.074232142942293
1747352049370579,85098844,1,921,12,85615859,84989264,626595,19.151126325617025
1747352049465728,85191404,1,922,12,85711008,85081824,629184,19.07232224595667
1747352049555758,85283964,1,923,12,85801038,85174384,626654,19.149323231001475
1747352049653290,85376524,1,924,12,85898570,85266944,631626,18.998584605446894
1747352049747491,85469084,1,925,12,85992771,85359504,633267,18.949353116457985
1747352049841760,85561644,1,926,12,86087040,85452064,634976,18.898352063700045
1747352049935925,85654204,1,927,12,86181205,85544624,636581,18.850703995249624
1747352050026641,85746764,1,928,12,86271921,85637184,634737,18.9054679339632
1747352050120977,85839324,1,929,12,86366257,85729744,636513,18.85271785493776
1747352050215143,85931884,1,930,12,86460423,85822304,638119,18.80526986345807
1747352050309235,86024444,1,931,12,86554515,85914864,639651,18.76023018802441
1747352050399359,86117004,1,932,12,86644639,86007424,637215,18.831948400461386
1747352050493063,86209572,1,933,12,86738343,86099992,638351,18.798435343564904
1747352050583043,86302124,1,934,12,86828323,86192544,635779,18.874483114415543
1747352050678085,86394684,1,935,12,86923365,86285104,638261,18.80108607607233
1747352050772213,86487244,1,936,12,87017493,86377664,639829,18.75501110452949
1747352050865643,86579804,1,937,12,87110923,86470224,640699,18.72954382635216
1747352050960921,86672364,1,938,12,87206201,86562784,643417,18.65042421944089
1747352051054020,86764924,1,939,12,87299300,86655344,643956,18.634813558690347
1747352051144523,86857484,1,940,12,87389803,86747904,641899,18.69452982478552
1747352051238296,86950044,1,941,12,87483576,86840464,643112,18.65926930301409
1747352051332364,87042604,1,942,12,87577644,86933024,644620,18.6156185039248
1747352051422732,87135164,1,943,12,87668012,87025584,642428,18.67913602769493
1747352051520735,87227724,1,944,12,87766015,87118144,647871,18.52220580948985
1747352051615222,87320284,1,945,12,87860502,87210704,649798,18.46727752316874
1747352051702061,87412844,1,946,12,87947341,87303264,644077,18.631312715715666
1747352051800342,87505404,1,947,12,88045622,87395824,649798,18.46727752316874
1747352051890073,87597964,1,948,12,88135353,87488384,646969,18.548029349165105
1747352051987746,87690524,1,949,12,88233026,87580944,652082,18.40259353884941
1747352052074027,87783084,1,950,12,88319307,87673504,645803,18.581517893227502
1747352052168395,87875644,1,951,12,88413675,87766064,647611,18.52964202275749
1747352052263102,87968204,1,952,12,88508382,87858624,649758,18.46841439428218
1747352052356715,88060764,1,953,12,88601995,87951184,650811,18.43853284594145
1747352052446858,88153324,1,954,12,88692138,88043744,648394,18.50726564403742
1747352052545585,88245884,1,955,12,88790865,88136304,654561,18.33289792700757
1747352052639620,88338452,1,956,12,88884900,88228872,656028,18.29190217490717
1747352052729131,88431004,1,957,12,88974411,88321424,652987,18.37708867098426
1747352052823382,88523564,1,958,12,89068662,88413984,654678,18.32962158496238
1747352052913436,88616124,1,959,12,89158716,88506544,652172,18.40005397349165
1747352053011986,88708684,1,960,12,89257266,88599104,658162,18.232593191341948
1747352053106229,88801244,1,961,12,89351509,88691664,659845,18.18608915730209
1747352053200704,88893804,1,962,12,89445984,88784224,661760,18.13346228239845
1747352053290797,88986364,1,963,12,89536077,88876784,659293,18.20131565176636
1747352053380321,89078924,1,964,12,89625601,88969344,656257,18.285519240175724
1747352053478650,89171484,1,965,12,89723930,89061904,662026,18.126176313317
1747352053569353,89264044,1,966,12,89814633,89154464,660169,18.177163726257973
1747352053659342,89356604,1,967,12,89904622,89247024,657598,18.248230681966795
1747352053757351,89449164,1,968,12,90002631,89339584,663047,18.098264527250706
1747352053847082,89541724,1,969,12,90092362,89432144,660218,18.17581465515936
1747352053946360,89634284,1,970,12,90191640,89524704,666936,17.992730936701573
1747352054036549,89726844,1,971,12,90281829,89617264,664565,18.056924454342315
1747352054130591,89819404,1,972,12,90375871,89709824,666047,18.01674656593304
1747352054220610,89911964,1,973,12,90465890,89802384,663506,18.0857445147444
1747352054314988,90004524,1,974,12,90560268,89894944,665324,18.036325158869964
1747352054408608,90097084,1,975,12,90653888,89987504,666384,18.007635237340633
1747352054502395,90189644,1,976,12,90747675,90080064,667611,17.974539065413843
1747352054593512,90282204,1,977,12,90838792,90172624,666168,18.013474078610802
1747352054691744,90374764,1,978,12,90937024,90265184,671840,17.861395570373897
1747352054785872,90467324,1,979,12,91031152,90357744,673408,17.81980612050941
1747352054871276,90559884,1,980,12,91116556,90450304,666252,18.011202968246252
1747352054970421,90652444,1,981,12,91215701,90542864,672837,17.834928816340362
1747352055059696,90745004,1,982,12,91304976,90635424,669552,17.92243171553516
1747352055154056,90837564,1,983,12,91399336,90727984,671352,17.87437886533443
1747352055243889,90930124,1,984,12,91489169,90820544,668625,17.9472798653954
1747352055342355,91022684,1,985,12,91587635,90913104,674531,17.79013862965527
1747352055436826,91115244,1,986,12,91682106,91005664,676442,17.739880137543203
1747352055531247,91207804,1,987,12,91776527,91098224,678303,17.691208796069013
1747352055621403,91300364,1,988,12,91866683,91190784,675899,17.754131904322982
1747352055715751,91392924,1,989,12,91961031,91283344,677687,17.70728964846603
1747352055809020,91485484,1,990,12,92054300,91375904,678396,17.688783542355793
1747352055902619,91578044,1,991,12,92147899,91468464,679435,17.6617336463385
1747352055993841,91670604,1,992,12,92239121,91561024,678097,17.696583232192445
1747352056088150,91763164,1,993,12,92333430,91653584,679846,17.651056268625542
1747352056180601,91855724,1,994,12,92425881,91746144,679737,17.653886723835836
1747352056272134,91948284,1,995,12,92517414,91838704,678710,17.68059996169203
1747352056371011,92040844,1,996,12,92616291,91931264,685027,17.517557702105172
1747352056460584,92133412,1,997,12,92705864,92023832,682032,17.594482370328667
1747352056554593,92225964,1,998,12,92799873,92116384,683489,17.556976044969268
1747352056649256,92318524,1,999,12,92894536,92208944,685592,17.503121389981214
1747352056739299,92411084,1,1000,12,92984579,92301504,683075,17.567617025948834
1747352056841527,92504684,1,1001,12,93086807,92395104,691703,17.348486272287385
1747352056935527,92598292,1,1002,12,93180807,92488712,692095,17.338660155036518
1747352057030553,92691884,1,1003,12,93275833,92582304,693529,17.30280925527267
1747352057123946,92785484,1,1004,12,93369226,92675904,693322,17.307975226518128
1747352057210121,92879084,1,1005,12,93455401,92769504,685897,17.49533822133644
1747352057311985,92972684,1,1006,12,93557265,92863104,694161,17.28705588472991
1747352057410713,93066284,1,1007,12,93655993,92956704,699289,17.160287091603042
1747352057500936,93159884,1,1008,12,93746216,93050304,695912,17.243559530515352
1747352057599408,93253484,1,1009,12,93844688,93143904,700784,17.12367862279961
1747352057689607,93347084,1,1010,12,93934887,93237504,697383,17.207187442194606
1747352057775485,93440684,1,1011,12,94020765,93331104,689661,17.399852971242392
1747352057873777,93534284,1,1012,12,94119057,93424704,694353,17.282275730068136
1747352057976160,93627884,1,1013,12,94221440,93518304,703136,17.066399672325126
1747352058070293,93721484,1,1014,12,94315573,93611904,703669,17.053472584411136
1747352058164357,93815084,1,1015,12,94409637,93705504,704133,17.042234918687235
1747352058258628,93908684,1,1016,12,94503908,93799104,704804,17.026010068047288
1747352058353480,94002284,1,1017,12,94598760,93892704,706056,16.995819028518984
1747352058446629,94095884,1,1018,12,94691909,93986304,705605,17.006682208884573
1747352058536713,94189484,1,1019,12,94781993,94079904,702089,17.091850178538618
1747352058635938,94283084,1,1020,12,94881218,94173504,707714,16.956002000808237
1747352058729835,94376684,1,1021,12,94975115,94267104,708011,16.94888921217326
1747352058815945,94470284,1,1022,12,95061225,94360704,700521,17.130107448598974
1747352058918037,94563884,1,1023,12,95163317,94454304,709013,16.924936496227854
1747352059012410,94657484,1,1024,12,95257690,94547904,709786,16.906504213946175
1747352059106496,94751084,1,1025,12,95351776,94641504,710272,16.89493602450892
1747352059200496,94844684,1,1026,12,95445776,94735104,710672,16.885426751018755
1747352059294991,94938284,1,1027,12,95540271,94828704,711567,16.864188474170387
1747352059388884,95031884,1,1028,12,95634164,94922304,711860,16.857247211530357
1747352059483013,95125484,1,1029,12,95728293,95015904,712389,16.844729494700225
1747352059573169,95219084,1,1030,12,95818449,95109504,708945,16.926559888284704
1747352059672083,95312684,1,1031,12,95917363,95203104,714259,16.800628343500048
1747352059766158,95406284,1,1032,12,96011438,95296704,714734,16.78946293306321
1747352059860433,95499884,1,1033,12,96105713,95390304,715409,16.77362180235362
1747352059954022,95593492,1,1034,12,96199302,95483912,715390,16.77406729196662
1747352060052722,95687084,1,1035,12,96298002,95577504,720498,16.65514685675741
1747352060142912,95780684,1,1036,12,96388192,95671104,717088,16.734347806684816
1747352060241010,95874284,1,1037,12,96486290,95764704,721586,16.630034396454477
1747352060347994,95967884,1,1038,12,96593274,95858304,734970,16.32719702845014
1747352060441831,96061484,1,1039,12,96687111,95951904,735207,16.321933822719316
1747352060519371,96155084,1,1040,12,96764651,96045504,719147,16.68643545756292
1747352060613748,96248684,1,1041,12,96859028,96139104,719924,16.66842611164512
1747352060707550,96342284,1,1042,12,96952830,96232704,720126,16.663750510327358
1747352060806670,96435884,1,1043,12,97051950,96326304,725646,16.53698911039267
1747352060904958,96529484,1,1044,12,97150238,96419904,730334,16.430838493073033
1747352061002621,96623084,1,1045,12,97247901,96513504,734397,16.339936029150447
1747352061084636,96716684,1,1046,12,97329916,96607104,722812,16.601827307792345
1747352061179051,96810284,1,1047,12,97424331,96700704,723627,16.583129153555628
1747352061273244,96903884,1,1048,12,97518524,96794304,724220,16.56955068901715
1747352061371164,96997484,1,1049,12,97616444,96887904,728540,16.471298761907377
1747352061462059,97091084,1,1050,12,97707339,96981504,725835,16.53268304780012
1747352061555233,97184684,1,1051,12,97800513,97075104,725409,16.5423919471636
1747352061662130,97278284,1,1052,12,97907410,97168704,738706,16.244622353141846
1747352061744149,97371884,1,1053,12,97989429,97262304,727125,16.503352243424445
1747352061842638,97465484,1,1054,12,98087918,97355904,732014,16.39312909315942
1747352061932165,97559084,1,1055,12,98177445,97449504,727941,16.48485248117636
1747352062026697,97652684,1,1056,12,98271977,97543104,728873,16.4637735243314
1747352062124778,97746284,1,1057,12,98370058,97636704,733354,16.36317521960745
1747352062227491,97839884,1,1058,12,98472771,97730304,742467,16.162334487593387
1747352062308901,97936604,1,1059,12,98554181,97827024,727157,16.502625980359124
1747352062407629,98030204,1,1060,12,98652909,97920624,732285,16.387062414223973
1747352062502364,98123812,1,1061,12,98747644,98014232,733412,16.361881180018873
1747352062608034,98217404,1,1062,12,98853314,98107824,745490,16.096795396316516
1747352062690545,98311004,1,1063,12,98935825,98201424,734401,16.339847031798705
1747352062784551,98404604,1,1064,12,99029831,98295024,734807,16.330818840865696
1747352062879145,98498204,1,1065,12,99124425,98388624,735801,16.308757395002182
1747352062989786,98591804,1,1066,12,99235066,98482224,752842,15.939599544127454
1747352063067374,98685404,1,1067,12,99312654,98575824,736830,16.285981841130248
1747352063165524,98779004,1,1068,12,99410804,98669424,741380,16.18603145485446
1747352063259764,98872604,1,1069,12,99505044,98763024,742020,16.17207083367025
1747352063353895,98966204,1,1070,12,99599175,98856624,742551,16.160506147052526
1747352063447458,99059804,1,1071,12,99692738,98950224,742514,16.161311436552037
1747352063550812,99153404,1,1072,12,99796092,99043824,752268,15.951761872098771
1747352063636213,99247004,1,1073,12,99881493,99137424,744069,16.127536559109437
1747352063730416,99340604,1,1074,12,99975696,99231024,744672,16.114477246358128
1747352063824604,99434204,1,1075,12,100069884,99324624,745260,16.101763143064165
1747352063927534,99527804,1,1076,12,100172814,99418224,754590,15.902675625173936
1747352064012804,99621404,1,1077,12,100258084,99511824,746260,16.08018653016375
1747352064107333,99715004,1,1078,12,100352613,99605424,747189,16.060193605633916
1747352064197512,99808604,1,1079,12,100442792,99699024,743768,16.13406331006443
1747352064295779,99902204,1,1080,12,100541059,99792624,748435,16.03345647918657
1747352064390507,99995804,1,1081,12,100635787,99886224,749563,16.009328101840673
1747352064492521,100089404,1,1082,12,100737801,99979824,757977,15.831614943461345
1747352064573833,100184044,1,1083,12,100819113,100074464,744649,16.11497497478678
1747352064664144,100278684,1,1084,12,100909424,100169104,740320,16.209206829479143
1747352064771075,100373324,1,1085,12,101016355,100263744,752611,15.94449190883471
1747352064860602,100467964,1,1086,12,101105882,100358384,747498,16.05355465834022
1747352064955596,100562604,1,1087,12,101200876,100453024,747852,16.045955616886765
1747352065049200,100657244,1,1088,12,101294480,100547664,746816,16.06821492844288
1747352065147213,100751884,1,1089,12,101392493,100642304,750189,15.995969015808017
1747352065241843,100846524,1,1090,12,101487123,100736944,750179,15.996182244504311
1747352065336212,100941164,1,1091,12,101581492,100831584,749908,16.00196290744998
1747352065430715,101035804,1,1092,12,101675995,100926224,749771,16.004886825444036
1747352065528394,101130444,1,1093,12,101773674,101020864,752810,15.94027709515017
1747352065622863,101225084,1,1094,12,101868143,101115504,752639,15.943898734984502
1747352065717278,101319724,1,1095,12,101962558,101210144,752414,15.948666558570148
1747352065814846,101414364,1,1096,12,102060126,101304784,755342,15.886843310712235
1747352065909875,101509004,1,1097,12,102155155,101399424,755731,15.878665821568784
1747352066004152,101603644,1,1098,12,102249432,101494064,755368,15.886296480655783
1747352066094166,101698284,1,1099,12,102339446,101588704,750742,15.984186311675648
1747352066188223,101792924,1,1100,12,102433503,101683344,750159,15.99660871895158
1747352066285953,101887564,1,1101,12,102531233,101777984,753249,15.930986964469918
1747352066384730,101982204,1,1102,12,102630010,101872624,757386,15.84396859725424
1747352066474811,102076844,1,1103,12,102720091,101967264,752827,15.939917138997403
1747352066572466,102171484,1,1104,12,102817746,102061904,755842,15.876333942808152
1747352066667460,102266124,1,1105,12,102912740,102156544,756196,15.868901713312422
1747352066761283,102360764,1,1106,12,103006563,102251184,755379,15.886065140810109
1747352066855216,102455404,1,1107,12,103100496,102345824,754672,15.90094769648271
1747352066949831,102550044,1,1108,12,103195111,102440464,754647,15.901474464219696
1747352067047649,102644684,1,1109,12,103292929,102535104,757825,15.834790353973544
1747352067142547,102739324,1,1110,12,103387827,102629744,758083,15.82940126608828
1747352067236678,102833964,1,1111,12,103481958,102724384,757574,15.840036748885256
1747352067334972,102928604,1,1112,12,103580252,102819024,761228,15.76400237510969
1747352067428464,103023244,1,1113,12,103673744,102913664,760080,15.787811809283234
1747352067527578,103117884,1,1114,12,103772858,103008304,764554,15.695425045189744
1747352067617734,103212524,1,1115,12,103863014,103102944,760070,15.78801952451748
1747352067715729,103307164,1,1116,12,103961009,103197584,763425,15.71863640829158
1747352067810243,103401804,1,1117,12,104055523,103292224,763299,15.72123112960976
1747352067903808,103496444,1,1118,12,104149088,103386864,762224,15.743403513927664
1747352068001997,103591084,1,1119,12,104247277,103481504,765773,15.670440195723796
1747352068096367,103685724,1,1120,12,104341647,103576144,765503,15.675967305157522
1747352068191162,103780372,1,1121,12,104436442,103670792,765650,15.67295761771044
1747352068284801,103875004,1,1122,12,104530081,103765424,764657,15.693310857024784
1747352068383099,103969644,1,1123,12,104628379,103860064,768315,15.618593936080904
1747352068489894,104064284,1,1124,12,104735174,103954704,780470,15.37535075018899
1747352068571466,104158924,1,1125,12,104816746,104049344,767402,15.637175821798744
1747352068674364,104253564,1,1126,12,104919644,104143984,775660,15.470695923471624
1747352068764371,104348204,1,1127,12,105009651,104238624,771027,15.563657303829826
1747352068862851,104442844,1,1128,12,105108131,104333264,774867,15.48652865588546
1747352068952894,104537484,1,1129,12,105198174,104427904,770270,15.578952834720292
1747352069055152,104632124,1,1130,12,105300432,104522544,777888,15.426385289398988
1747352069148268,104726764,1,1131,12,105393548,104617184,776364,15.456667233411132
1747352069243510,104821404,1,1132,12,105488790,104711824,776966,15.444691273492015
1747352069341756,104916044,1,1133,12,105587036,104806464,780572,15.373341600774816
1747352069431348,105010684,1,1134,12,105676628,104901104,775524,15.473408946725051
1747352069538023,105105324,1,1135,12,105783303,104995744,787559,15.236953675851586
1747352069632521,105199964,1,1136,12,105877801,105090384,787417,15.239701454248513
1747352069722511,105294604,1,1137,12,105967791,105185024,782767,15.330232367997118
1747352069816465,105389244,1,1138,12,106061745,105279664,782081,15.343679235271026
1747352069915196,105483884,1,1139,12,106160476,105374304,786172,15.263835394799102
1747352070000822,105578532,1,1140,12,106246102,105468952,777150,15.441034549314804
1747352070103932,105673164,1,1141,12,106349212,105563584,785628,15.274404680077597
1747352070201996,105767804,1,1142,12,106447276,105658224,789052,15.208123165520144
1747352070300495,105862444,1,1143,12,106545775,105752864,792911,15.134107106598345
1747352070381883,105957084,1,1144,12,106627163,105847504,779659,15.391344164564252
1747352070484694,106051724,1,1145,12,106729974,105942144,787830,15.23171242526941
1747352070574396,106146364,1,1146,12,106819676,106036784,782892,15.32778467528088
1747352070668403,106241004,1,1147,12,106913683,106131424,782259,15.340187840600109
1747352070762318,106335644,1,1148,12,107007598,106226064,781534,15.354418361837103
1747352070868242,106430284,1,1149,12,107113522,106320704,792818,15.135882384103288
1747352070955519,106524924,1,1150,12,107200799,106415344,785455,15.27776893647631
1747352071050032,106619564,1,1151,12,107295312,106509984,785328,15.280239594156836
1747352071156013,106714204,1,1152,12,107401293,106604624,796669,15.06271738953066
1747352071245957,106808844,1,1153,12,107491237,106699264,791973,15.152031698050312
1747352071340399,106903484,1,1154,12,107585679,106793904,791775,15.155820782419248
1747352071438691,106998124,1,1155,12,107683971,106888544,795427,15.08623670053946
1747352071533212,107092764,1,1156,12,107778492,106983184,795308,15.088494017412122
1747352071627602,107187404,1,1157,12,107872882,107077824,795058,15.093238480714614
1747352071725417,107282044,1,1158,12,107970697,107172464,798233,15.033204590639576
1747352071819229,107376684,1,1159,12,108064509,107267104,797405,15.048814592333882
1747352071914065,107471324,1,1160,12,108159345,107361744,797601,15.045116543234023
1747352072004238,107565964,1,1161,12,108249518,107456384,793134,15.129851954398626
1747352072098049,107660604,1,1162,12,108343329,107551024,792305,15.145682533872687
1747352072195824,107755244,1,1163,12,108441104,107645664,795440,15.085990143819773
1747352072294824,107849884,1,1164,12,108540104,107740304,799800,15.003750937734434
1747352072385208,107944524,1,1165,12,108630488,107834944,795544,15.084017980149431
1747352072479122,108039164,1,1166,12,108724402,107929584,794818,15.097795973417814
1747352072576992,108133804,1,1167,12,108822272,108024224,798048,15.036689522434742
1747352072671005,108228444,1,1168,12,108916285,108118864,797421,15.048512642631684
1747352072778079,108323084,1,1169,12,109023359,108213504,809855,14.817467324397578
1747352072863628,108417724,1,1170,12,109108908,108308144,800764,14.985688667322709
1747352072962421,108512364,1,1171,12,109207701,108402784,804917,14.90836943436404
1747352073056599,108607004,1,1172,12,109301879,108497424,804455,14.916931338608125
1747352073154795,108701644,1,1173,12,109400075,108592064,808011,14.851282965207156
1747352073249569,108796284,1,1174,12,109494849,108686704,808145,14.848820446825757
1747352073343502,108890924,1,1175,12,109588782,108781344,807438,14.861822208020923
1747352073441393,108985564,1,1176,12,109686673,108875984,810689,14.80222378742033
1747352073539665,109080204,1,1177,12,109784945,108970624,814321,14.736203536443249
1747352073630105,109174844,1,1178,12,109875385,109065264,810121,14.812602068086123
1747352073724169,109269484,1,1179,12,109969449,109159904,809545,14.823141394239975
1747352073822315,109364124,1,1180,12,110067595,109254544,813051,14.75922174623732
1747352073912099,109458764,1,1181,12,110157379,109349184,808195,14.847901805876058
1747352074010329,109553404,1,1182,12,110255609,109443824,811785,14.782239139673685
1747352074109239,109648044,1,1183,12,110354519,109538464,816055,14.704891214440204
1747352074203253,109742684,1,1184,12,110448533,109633104,815429,14.716180072084756
1747352074293503,109837332,1,1185,12,110538783,109727752,811031,14.795981904514132
1747352074392045,109931964,1,1186,12,110637325,109822384,814941,14.724992361410212
1747352074489775,110026604,1,1187,12,110735055,109917024,818031,14.66937072066951
1747352074588644,110121244,1,1188,12,110833924,110011664,822260,14.59392406294846
1747352074673813,110215884,1,1189,12,110919093,110106304,812789,14.763979335350257
1747352074776579,110310524,1,1190,12,111021859,110200944,820915,14.61783497682464
1747352074870802,110405164,1,1191,12,111116082,110295584,820498,14.62526416883405
1747352074965455,110499804,1,1192,12,111210735,110390224,820511,14.625032449290748
1747352075062825,110594444,1,1193,12,111308105,110484864,823241,14.576533481690053
1747352075149823,110689084,1,1194,12,111395103,110579504,815599,14.713112693860587
1747352075251978,110783724,1,1195,12,111497258,110674144,823114,14.578782525871263
1747352075345574,110878364,1,1196,12,111590854,110768784,822070,14.597297067159731
1747352075440428,110973004,1,1197,12,111685708,110863424,822284,14.593498110141994
1747352075538762,111067644,1,1198,12,111784042,110958064,825978,14.528231986808365
1747352075632624,111162284,1,1199,12,111877904,111052704,825200,14.54192922927775
1747352075726335,111256924,1,1200,12,111971615,111147344,824271,14.55831880534436
1747352075825272,111351564,1,1201,12,112070552,111241984,828568,14.482818549594
1747352075919143,111446204,1,1202,12,112164423,111336624,827799,14.496272645895925
1747352076013917,111540844,1,1203,12,112259197,111431264,827933,14.493926440907655
1747352076104039,111635492,1,1204,12,112349319,111525912,823407,14.573594832203272
1747352076205952,111730124,1,1205,12,112451232,111620544,830688,14.445856928232985
1747352076296287,111824764,1,1206,12,112541567,111715184,826383,14.52111188153677
1747352076394224,111919404,1,1207,12,112639504,111809824,829680,14.463407578825572
1747352076485054,112014044,1,1208,12,112730334,111904464,825870,14.530131860946636
1747352076587217,112108684,1,1209,12,112832497,111999104,833393,14.398969033817178
1747352076681521,112203324,1,1210,12,112926801,112093744,833057,14.404776623928496
1747352076775133,112297964,1,1211,12,113020413,112188384,832029,14.422574213158436
1747352076865604,112392604,1,1212,12,113110884,112283024,827860,14.495204503176865
1747352076959300,112487244,1,1213,12,113204580,112377664,826916,14.511752100576118
1747352077058339,112581884,1,1214,12,113303619,112472304,831315,14.43496147669656
1747352077152016,112676524,1,1215,12,113397296,112566944,830352,14.451702410543962
1747352077254862,112771164,1,1216,12,113500142,112661584,838558,14.310280266839026
1747352077344363,112865804,1,1217,12,113589643,112756224,833419,14.398519832161254
1747352077438987,112960444,1,1218,12,113684267,112850864,833403,14.398796260632611
1747352077532843,113055084,1,1219,12,113778123,112945504,832619,14.412354270080312
1747352077635672,113149724,1,1220,12,113880952,113040144,840808,14.27198599442441
1747352077729657,113244364,1,1221,12,113974937,113134784,840153,14.283112718754795
1747352077823650,113339004,1,1222,12,114068930,113229424,839506,14.294120589966004
1747352077922511,113433644,1,1223,12,114167791,113324064,843727,14.222609920033376
1747352078016739,113528284,1,1224,12,114262019,113418704,843315,14.229558350082709
1747352078109973,113622924,1,1225,12,114355253,113513344,841909,14.253321914838777
1747352078208929,113717564,1,1226,12,114454209,113607984,846225,14.1806257201099
1747352078302793,113812204,1,1227,12,114548073,113702624,845449,14.193641485175332
1747352078396977,113906844,1,1228,12,114642257,113797264,844993,14.2013010758669
1747352078491982,114001484,1,1229,12,114737262,113891904,845358,14.195169383858673
1747352078589622,114096124,1,1230,12,114834902,113986544,848358,14.144971816143658
1747352078683786,114190764,1,1231,12,114929066,114081184,847882,14.152912787392586
1747352078778205,114285404,1,1232,12,115023485,114175824,847661,14.156602698484418
1747352078872671,114380044,1,1233,12,115117951,114270464,847487,14.15950923141004
1747352078970206,114474684,1,1234,12,115215486,114365104,850382,14.11130527221884
1747352079065238,114569324,1,1235,12,115310518,114459744,850774,14.104803390794734
1747352079159253,114663964,1,1236,12,115404533,114554384,850149,14.11517275207052
1747352079248745,114758604,1,1237,12,115494025,114649024,845001,14.201166625838312
1747352079343842,114853244,1,1238,12,115589122,114743664,845458,14.193490392189794
1747352079445649,114947884,1,1239,12,115690929,114838304,852625,14.074182671162587
1747352079540092,115042524,1,1240,12,115785372,114932944,852428,14.077435278991306
1747352079634308,115137164,1,1241,12,115879588,115027584,852004,14.084440918117757
1747352079732850,115231804,1,1242,12,115978130,115122224,855906,14.020231193612384
1747352079822172,115326444,1,1243,12,116067452,115216864,850588,14.107887720024266
1747352079921144,115421084,1,1244,12,116166424,115311504,854920,14.03640106676648
1747352080018706,115515724,1,1245,12,116263986,115406144,857842,13.988589973444991
1747352080117071,115610364,1,1246,12,116362351,115500784,861567,13.928110059925697
1747352080208062,115705004,1,1247,12,116453342,115595424,857918,13.987350772451448
1747352080305579,115799644,1,1248,12,116550859,115690064,860795,13.940601420779627
1747352080400345,115894292,1,1249,12,116645625,115784712,860913,13.938690669092
1747352080494118,115988924,1,1250,12,116739398,115879344,860054,13.952612277833715
1747352080588415,116083564,1,1251,12,116833695,115973984,859711,13.958178969444385
1747352080691005,116178204,1,1252,12,116936285,116068624,867661,13.830286252349708
1747352080776467,116272844,1,1253,12,117021747,116163264,858483,13.978145170026664
1747352080875599,116367484,1,1254,12,117120879,116257904,862975,13.90538543990266
1747352080973354,116462124,1,1255,12,117218634,116352544,866090,13.855372998187256
1747352081067879,116556764,1,1256,12,117313159,116447184,865975,13.857212968041802
1747352081162222,116651404,1,1257,12,117407502,116541824,865678,13.861967151758506
1747352081256379,116746044,1,1258,12,117501659,116636464,865195,13.869705673287523
1747352081345898,116840684,1,1259,12,117591178,116731104,860074,13.952287826396333
1747352081448128,116935324,1,1260,12,117693408,116825744,867664,13.83023843331059
1747352081543263,117029964,1,1261,12,117788543,116920384,868159,13.822352817859402
1747352081636807,117124604,1,1262,12,117882087,117015024,867063,13.839824787818186
1747352081726849,117219244,1,1263,12,117972129,117109664,862465,13.913608088444168
1747352081829300,117313884,1,1264,12,118074580,117204304,870276,13.788729092839512
1747352081923691,117408524,1,1265,12,118168971,117298944,870027,13.792675399728974
1747352082022053,117503164,1,1266,12,118267333,117393584,873749,13.733921297764002
1747352082111654,117597804,1,1267,12,118356934,117488224,868710,13.813585661498085
1747352082210170,117692452,1,1268,12,118455450,117582872,872578,13.752352225245192
1747352082300793,117787084,1,1269,12,118546073,117677504,868569,13.815828103466735
1747352082402888,117881724,1,1270,12,118648168,117772144,876024,13.698254842333087
1747352082497196,117976364,1,1271,12,118742476,117866784,875692,13.703448244359889
1747352082591409,118071004,1,1272,12,118836689,117961424,875265,13.71013350242498
1747352082689748,118165644,1,1273,12,118935028,118056064,878964,13.652436277253676
1747352082783702,118260284,1,1274,12,119028982,118150704,878278,13.663099838547703
1747352082877637,118354924,1,1275,12,119122917,118245344,877573,13.674076116744702
1747352082972022,118449564,1,1276,12,119217302,118339984,877318,13.678050604227884
1747352083070380,118544204,1,1277,12,119315660,118434624,881036,13.620328794737103
1747352083156607,118638844,1,1278,12,119401887,118529264,872623,13.7516430348501
1747352083254802,118733484,1,1279,12,119500082,118623904,876178,13.695847190867608
1747352083353403,118828124,1,1280,12,119598683,118718544,880139,13.634210050912412
1747352083443554,118922764,1,1281,12,119688834,118813184,875650,13.704105521612515
1747352083541703,119017404,1,1282,12,119786983,118907824,879159,13.649408127540068
1747352083635231,119112044,1,1283,12,119880511,119002464,878047,13.666694379685826
1747352083730048,119206684,1,1284,12,119975328,119097104,878224,13.66393995153856
1747352083831870,119301324,1,1285,12,120077150,119191744,885406,13.553104451517155
1747352083926834,119395964,1,1286,12,120172114,119286384,885730,13.548146726429048
1747352084020395,119490604,1,1287,12,120265675,119381024,884651,13.56467126584382
1747352084119071,119585244,1,1288,12,120364351,119475664,888687,13.503066884066044
1747352084212971,119679884,1,1289,12,120458251,119570304,887947,13.514320111448091
1747352084303306,119774524,1,1290,12,120548586,119664944,883642,13.580160291158636
1747352084397320,119869164,1,1291,12,120642600,119759584,883016,13.589787727515697
1747352084495316,119963804,1,1292,12,120740596,119854224,886372,13.538333792132422
1747352084589861,120058444,1,1293,12,120835141,119948864,886277,13.539784965648437
1747352084688518,120153084,1,1294,12,120933798,120043504,890294,13.478693555162677
1747352084778598,120247724,1,1295,12,121023878,120138144,885734,13.548085542612116
1747352084873066,120342364,1,1296,12,121118346,120232784,885562,13.550716945849077
1747352084975384,120437004,1,1297,12,121220664,120327424,893240,13.434239398146074
1747352085065324,120531644,1,1298,12,121310604,120422064,888540,13.505300830576
1747352085167318,120626284,1,1299,12,121412598,120516704,895894,13.394441753153831
1747352085257418,120720924,1,1300,12,121502698,120611344,891354,13.462664665217186
1747352085351421,120815564,1,1301,12,121596701,120705984,890717,13.47229254634188
1747352085446454,120910204,1,1302,12,121691734,120800624,891110,13.46635095554982
1747352085539940,121004844,1,1303,12,121785220,120895264,889956,13.48381268287421
1747352085646490,121099484,1,1304,12,121891770,120989904,901866,13.305746086447432
1747352085736709,121194124,1,1305,12,121981989,121084544,897445,13.37129294831438
1747352085834875,121288764,1,1306,12,122080155,121179184,900971,13.31896365143828
1747352085920976,121383404,1,1307,12,122166256,121273824,892432,13.446402639080624
1747352086019347,121478044,1,1308,12,122264627,121368464,896163,13.390421162221603
1747352086118107,121572684,1,1309,12,122363387,121463104,900283,13.329142058663775
1747352086207613,121667324,1,1310,12,122452893,121557744,895149,13.405589460525569
1747352086313972,121761964,1,1311,12,122559252,121652384,906868,13.232355756295291
1747352086400489,121856604,1,1312,12,122645769,121747024,898745,13.351951888466695
1747352086502709,121951252,1,1313,12,122747989,121841672,906317,13.240400433843789
1747352086597194,122045884,1,1314,12,122842474,121936304,906170,13.24254830771268
1747352086690860,122140524,1,1315,12,122936140,122030944,905196,13.25679742287858
1747352086785258,122235164,1,1316,12,123030538,122125584,904954,13.260342514647151
1747352086874950,122329804,1,1317,12,123120230,122220224,900006,13.333244445037034
1747352086977477,122424444,1,1318,12,123222757,122314864,907893,13.217416589840434
1747352087071817,122519084,1,1319,12,123317097,122409504,907593,13.221785536027712
1747352087165931,122613724,1,1320,12,123411211,122504144,907067,13.229452730614168
1747352087264386,122708364,1,1321,12,123509666,122598784,910882,13.174044497530964
1747352087354766,122803004,1,1322,12,123600046,122693424,906622,13.23594618264282
1747352087452644,122897644,1,1323,12,123697924,122788064,909860,13.188842239465412
1747352087543009,122992284,1,1324,12,123788289,122882704,905585,13.251102878249972
1747352087645173,123086924,1,1325,12,123890453,122977344,913109,13.141914054072409
1747352087739858,123181564,1,1326,12,123985138,123071984,913154,13.141266423845266
1747352087829614,123276204,1,1327,12,124074894,123166624,908270,13.211930373126933
1747352087924103,123370844,1,1328,12,124169383,123261264,908119,13.214127223414552
1747352088022282,123465484,1,1329,12,124267562,123355904,911658,13.162830798391502
1747352088123972,123560124,1,1330,12,124369252,123450544,918708,13.061821601640563
1747352088210527,123654764,1,1331,12,124455807,123545184,910623,13.177791468038915
1747352088304991,123749412,1,1332,12,124550271,123639832,910439,13.180454703719851
1747352088402580,123844044,1,1333,12,124647860,123734464,913396,13.13778470674275
1747352088501136,123938684,1,1334,12,124746416,123829104,917312,13.081699574408708
1747352088603415,124033324,1,1335,12,124848695,123923744,924951,12.973660226325505
1747352088693943,124127964,1,1336,12,124939223,124018384,920839,13.031594013720095
1747352088792024,124222604,1,1337,12,125037304,124113024,924280,12.983078720733976
1747352088886315,124317244,1,1338,12,125131595,124207664,923931,12.987982868850596
1747352088981047,124411884,1,1339,12,125226327,124302304,924023,12.986689725255756
1747352089070410,124506524,1,1340,12,125315690,124396944,918746,13.061281355238554
1747352089165011,124601164,1,1341,12,125410291,124491584,918707,13.06183581925467
1747352089271764,124695804,1,1342,12,125517044,124586224,930820,12.891858791173377
1747352089361543,124790444,1,1343,12,125606823,124680864,925959,12.959537085335311
1747352089459760,124885084,1,1344,12,125705040,124775504,929536,12.909666758468742
1747352089549768,124979724,1,1345,12,125795048,124870144,924904,12.974319496942384
1747352089647747,125074364,1,1346,12,125893027,124964784,928243,12.92764933320262
1747352089742408,125169004,1,1347,12,125987688,125059424,928264,12.927356872613826
1747352089832636,125263644,1,1348,12,126077916,125154064,923852,12.989093491165251
1747352089938800,125358284,1,1349,12,126184080,125248704,935376,12.829065530866732
1747352090028866,125452924,1,1350,12,126274146,125343344,930802,12.892108096029016
1747352090127690,125547564,1,1351,12,126372970,125437984,934986,12.834416772015835
1747352090217114,125642204,1,1352,12,126462394,125532624,929770,12.906417716209384
1747352090315486,125736844,1,1353,12,126560766,125627264,933502,12.854819807563349
1747352090409677,125831484,1,1354,12,126654957,125721904,933053,12.861005752084822
1747352090500480,125926124,1,1355,12,126745760,125816544,929216,12.9141125421861
1747352090602015,126020764,1,1356,12,126847295,125911184,936111,12.818992619464998
1747352090696482,126115404,1,1357,12,126941762,126005824,935938,12.8213620987715
1747352090791184,126210044,1,1358,12,127036464,126100464,936000,12.82051282051282
1747352090884709,126304684,1,1359,12,127129989,126195104,934885,12.835803334099916
1747352090983208,126399324,1,1360,12,127228488,126289744,938744,12.783037761093546
1747352091081867,126493964,1,1361,12,127327147,126384384,942763,12.728543653070814
1747352091171640,126588604,1,1362,12,127416920,126479024,937896,12.79459556283426
1747352091269705,126683244,1,1363,12,127514985,126573664,941321,12.748042378742214
1747352091356069,126777884,1,1364,12,127601349,126668304,933045,12.861116023342923
1747352091458878,126872524,1,1365,12,127704158,126762944,941214,12.74949161402189
1747352091552946,126967164,1,1366,12,127798226,126857584,940642,12.757244520231929
1747352091650947,127061804,1,1367,12,127896227,126952224,944003,12.711824009033869
1747352091737387,127156444,1,1368,12,127982667,127046864,935803,12.823211722980156
1747352091835137,127251084,1,1369,12,128080417,127141504,938913,12.780736873384434
1747352091929757,127345724,1,1370,12,128175037,127236144,938893,12.781009124575432
1747352092023883,127440364,1,1371,12,128269163,127330784,938379,12.78800996185976
1747352092117452,127535004,1,1372,12,128362732,127425424,937308,12.802621976980886
1747352092216521,127629644,1,1373,12,128461801,127520064,941737,12.742411097790573
1747352092310312,127724284,1,1374,12,128555592,127614704,940888,12.753909073130917
1747352092404506,127818924,1,1375,12,128649786,127709344,940442,12.759957551874544
1747352092502945,127913564,1,1376,12,128748225,127803984,944241,12.708619939189251
1747352092596765,128008212,1,1377,12,128842045,127898632,943413,12.719773842421082
1747352092691210,128102844,1,1378,12,128936490,127993264,943226,12.722295611020051
1747352092785272,128197484,1,1379,12,129030552,128087904,942648,12.730096494131423
1747352092883954,128292124,1,1380,12,129129234,128182544,946690,12.675743907720584
1747352092978013,128386764,1,1381,12,129223293,128277184,946109,12.683528007872244
1747352093079969,128481404,1,1382,12,129325249,128371824,953425,12.5862023756457
1747352093170482,128576044,1,1383,12,129415762,128466464,949298,12.640919921879116
1747352093264783,128670684,1,1384,12,129510063,128561104,948959,12.645435682679652
1747352093366476,128765324,1,1385,12,129611756,128655744,956012,12.552143696941044
1747352093452810,128859964,1,1386,12,129698090,128750384,947706,12.662154718868509
1747352093551775,128954604,1,1387,12,129797055,128845024,952031,12.604631571871083
1747352093645853,129049244,1,1388,12,129891133,128939664,951469,12.612076694038375
1747352093747830,129143884,1,1389,12,129993110,129034304,958806,12.515566235505409
1747352093841844,129238524,1,1390,12,130087124,129128944,958180,12.52374292930347
1747352093932031,129333164,1,1391,12,130177311,129223584,953727,12.582216923710874
1747352094030460,129427804,1,1392,12,130275740,129318224,957516,12.532427656561351
1747352094121357,129522444,1,1393,12,130366637,129412864,953773,12.581610089612518
1747352094223044,129617084,1,1394,12,130468324,129507504,960820,12.489332028891988
1747352094317343,129711724,1,1395,12,130562623,129602144,960479,12.493766131274084
1747352094415351,129806372,1,1396,12,130660631,129696792,963839,12.450212120489002
1747352094501437,129901004,1,1397,12,130746717,129791424,955293,12.561591051122535
1747352094603834,129995644,1,1398,12,130849114,129886064,963050,12.460412231971342
1747352094698268,130090284,1,1399,12,130943548,129980704,962844,12.463078131036802
1747352094788605,130184924,1,1400,12,131033885,130075344,958541,12.519026311863552
1747352094890618,130279564,1,1401,12,131135898,130169984,965914,12.423466271324362
1747352094984738,130374204,1,1402,12,131230018,130264624,965394,12.4301580494596
1747352095074937,130468844,1,1403,12,131320217,130359264,960953,12.487603451989848
1747352095169653,130563484,1,1404,12,131414933,130453904,961029,12.486615908573
1747352095267901,130658124,1,1405,12,131513181,130548544,964637,12.43991263034696
1747352095361973,130752764,1,1406,12,131607253,130643184,964069,12.447241846797274
1747352095455386,130847404,1,1407,12,131700666,130737824,962842,12.463104019143328
1747352095550253,130942044,1,1408,12,131795533,130832464,963069,12.460166405522346
1747352095647966,131036684,1,1409,12,131893246,130927104,966142,12.420534455597624
1747352095742613,131131324,1,1410,12,131987893,131021744,966149,12.4204444656052
1747352095836885,131225964,1,1411,12,132082165,131116384,965781,12.425177136431552
1747352095935039,131320604,1,1412,12,132180319,131211024,969295,12.38013195157305
1747352096029524,131415244,1,1413,12,132274804,131305664,969140,12.382111975565966
1747352096123495,131509884,1,1414,12,132368775,131400304,968471,12.390665285795858
1747352096217219,131604524,1,1415,12,132462499,131494944,967555,12.402395729441736
1747352096315572,131699164,1,1416,12,132560852,131589584,971268,12.354983382547353
1747352096409975,131793804,1,1417,12,132655255,131684224,971031,12.357998869243104
1747352096504723,131888444,1,1418,12,132750003,131778864,971139,12.35662454087417
1747352096602253,131983084,1,1419,12,132847533,131873504,974029,12.319961725985571
1747352096697269,132077724,1,1420,12,132942549,131968144,974405,12.3152077421606
1747352096791408,132172364,1,1421,12,133036688,132062784,973904,12.321542985756295
1747352096885403,132267004,1,1422,12,133130683,132157424,973259,12.329708741455256
1747352096983759,132361644,1,1423,12,133229039,132252064,976975,12.282811740320888
1747352097077614,132456284,1,1424,12,133322894,132346704,976190,12.29268892326289
1747352097172330,132550924,1,1425,12,133417610,132441344,976266,12.29173196649274
1747352097265759,132645564,1,1426,12,133511039,132535984,975055,12.30699806677572
1747352097364241,132740204,1,1427,12,133609521,132630624,978897,12.258695245771516
1747352097458928,132834844,1,1428,12,133704208,132725264,978944,12.258106694560668
1747352097552420,132929484,1,1429,12,133797700,132819904,977796,12.27249855798142
1747352097650887,133024124,1,1430,12,133896167,132914544,981623,12.224652437850375
1747352097745406,133118764,1,1431,12,133990686,133009184,981502,12.22615949840143
1747352097839309,133213404,1,1432,12,134084589,133103824,980765,12.235346897574852
1747352097933826,133308044,1,1433,12,134179106,133198464,980642,12.236881553105006
1747352098032065,133402684,1,1434,12,134277345,133293104,984241,12.192135869162126
1747352098125710,133497324,1,1435,12,134370990,133387744,983246,12.204473753262157
1747352098220305,133591964,1,1436,12,134465585,133482384,983201,12.205032338250266
1747352098314858,133686604,1,1437,12,134560138,133577024,983114,12.20611241422663
1747352098412671,133781244,1,1438,12,134657951,133671664,986287,12.16684393082338
1747352098507417,133875884,1,1439,12,134752697,133766304,986393,12.165536454536884
1747352098600926,133970524,1,1440,12,134846206,133860944,985262,12.179501493003892
1747352098699575,134065172,1,1441,12,134944855,133955592,989263,12.130242412786084
1747352098793538,134159804,1,1442,12,135038818,134050224,988594,12.13845117409169
1747352098887982,134254444,1,1443,12,135133262,134144864,988398,12.140858237268793
1747352098982014,134349084,1,1444,12,135227294,134239504,987790,12.148331123011976
1747352099080116,134443724,1,1445,12,135325396,134334144,991252,12.10590243449698
1747352099174790,134538364,1,1446,12,135420070,134428784,991286,12.10548721559671
1747352099268560,134633004,1,1447,12,135513840,134523424,990416,12.11612090273178
1747352099367395,134727644,1,1448,12,135612675,134618064,994611,12.065018384071765
1747352099461401,134822284,1,1449,12,135706681,134712704,993977,12.07271395615794
1747352099555456,134916924,1,1450,12,135800736,134807344,993392,12.079823473512974
1747352099649863,135011564,1,1451,12,135895143,134901984,993159,12.082657459681682
1747352099748185,135106204,1,1452,12,135993465,134996624,996841,12.038028130865404
1747352099841946,135200844,1,1453,12,136087226,135091264,995962,12.04865245862794
1747352099936290,135295484,1,1454,12,136181570,135185904,995666,12.052234383819473
1747352100030967,135390124,1,1455,12,136276247,135280544,995703,12.051786526705252
1747352100129176,135484764,1,1456,12,136374456,135375184,999272,12.008742364441312
1747352100223604,135579404,1,1457,12,136468884,135469824,999060,12.011290613176389
1747352100317069,135674044,1,1458,12,136562349,135564464,997885,12.025433792471077
1747352100416057,135768684,1,1459,12,136661337,135659104,1002233,11.973263702153092
1747352100510086,135863332,1,1460,12,136755366,135753752,1001614,11.980663209579738
1747352100604304,135957964,1,1461,12,136849584,135848384,1001200,11.985617259288851
1747352100697815,136052604,1,1462,12,136943095,135943024,1000071,11.999148060487704
1747352100796799,136147244,1,1463,12,137042079,136037664,1004415,11.94725287854124
1747352100890599,136241884,1,1464,12,137135879,136132304,1003575,11.957252821164335
1747352100985197,136336524,1,1465,12,137230477,136226944,1003533,11.957753257740404
1747352101083722,136431164,1,1466,12,137329002,136321584,1007418,11.911639458496872
1747352101177934,136525804,1,1467,12,137423214,136416224,1006990,11.916702251263668
1747352101271930,136620444,1,1468,12,137517210,136510864,1006346,11.924328213159292
1747352101365598,136715084,1,1469,12,137610878,136605504,1005374,11.935856706061625
1747352101464141,136809724,1,1470,12,137709421,136700144,1009277,11.889699259965305
1747352101558653,136904364,1,1471,12,137803933,136794784,1009149,11.891207344009654
1747352101652950,136999004,1,1472,12,137898230,136889424,1008806,11.895250424759569
1747352101747304,137093644,1,1473,12,137992584,136984064,1008520,11.898623725855709
1747352101845527,137188284,1,1474,12,138090807,137078704,1012103,11.856500771166573
1747352101939791,137282924,1,1475,12,138185071,137173344,1011727,11.860907141946392
1747352102033359,137377564,1,1476,12,138278639,137267984,1010655,11.873487985514345
1747352102131608,137472204,1,1477,12,138376888,137362624,1014264,11.831239203994226
1747352102226282,137566844,1,1478,12,138471562,137457264,1014298,11.830842612328922
1747352102320135,137661484,1,1479,12,138565415,137551904,1013511,11.84002936327282
1747352102418608,137756124,1,1480,12,138663888,137646544,1017344,11.795420231504782
1747352102512390,137850764,1,1481,12,138757670,137741184,1016486,11.805376561998886
1747352102607529,137945404,1,1482,12,138852809,137835824,1016985,11.79958406466172
1747352102701507,138040044,1,1483,12,138946787,137930464,1016323,11.807269932885507
1747352102799757,138134684,1,1484,12,139045037,138025104,1019933,11.76547871281741
1747352102894238,138229324,1,1485,12,139139518,138119744,1019774,11.767313149776324
1747352102988287,138323964,1,1486,12,139233567,138214384,1019183,11.77413673501226
1747352103082762,138418604,1,1487,12,139328042,138309024,1019018,11.776043210227886
1747352103181269,138513244,1,1488,12,139426549,138403664,1022885,11.731524071620957
1747352103274793,138607884,1,1489,12,139520073,138498304,1021769,11.744337516601112
1747352103368966,138702524,1,1490,12,139614246,138592944,1021302,11.749707726020317
1747352103463530,138797164,1,1491,12,139708810,138687584,1021226,11.750582143423689
1747352103561259,138891804,1,1492,12,139806539,138782224,1024315,11.715146219668751
1747352103655236,138986444,1,1493,12,139900516,138876864,1023652,11.722733897848096
1747352103749809,139081084,1,1494,12,139995089,138971504,1023585,11.72350122364044
1747352103847739,139175724,1,1495,12,140093019,139066144,1026875,11.685940353012782
1747352103942170,139270364,1,1496,12,140187450,139160784,1026666,11.6883192781294
1747352104036465,139365004,1,1497,12,140281745,139255424,1026321,11.692248331662316
1747352104130770,139459644,1,1498,12,140376050,139350064,1025986,11.696066028191415
1747352104228538,139554284,1,1499,12,140473818,139444704,1029114,11.660515744611384
1747352104322932,139648924,1,1500,12,140568212,139539344,1028868,11.663303747419496
1747351654505185,109580,1,1,1,0,0,0,0.0
1747351654594431,197404,1,2,1,89246,87824,1422,703.2348804500702
1747351680708829,109580,1,1,1,26203644,0,26203644,0.0381626311210761
1747351680799226,200524,1,2,1,26294041,90944,26203097,0.0381634277810748
1747351680888812,292044,1,3,1,26383627,182464,26201163,0.0381662447579139
1747351680983215,383564,1,4,1,26478030,273984,26204046,0.0381620456627194
1747351681073754,475084,1,5,1,26568569,365504,26203065,0.0381634743874428
1747351681167930,566604,1,6,1,26662745,457024,26205721,0.0381596064462412
1747351681257372,658124,1,7,1,26752187,548544,26203643,0.0381626325774626
1747351681351721,749644,1,8,1,26846536,640064,26206472,0.0381585129047511
1747351681441819,841164,1,9,1,26936634,731584,26205050,0.0381605835516436
1747351681536383,932684,1,10,1,27031198,823104,26208094,0.0381561513019603
1747351681629969,1022124,1,11,1,27124784,912544,26212240,0.0381501161289534
1747351681724812,1115724,1,12,1,27219627,1006144,26213483,0.0381483071135567
1747351681818880,1209324,1,13,1,27313695,1099744,26213951,0.038147626048435
1747351681912730,1302924,1,14,1,27407545,1193344,26214201,0.0381472622415613
1747351682007079,1396524,1,15,1,27501894,1286944,26214950,0.0381461723177042
1747351682101336,1490124,1,16,1,27596151,1380544,26215607,0.0381452163209495
1747351682191746,1580604,1,17,1,27686561,1471024,26215537,0.0381453181752485
1747351682285587,1674204,1,18,1,27780402,1564624,26215778,0.0381449675077352
1747351682380559,1767804,1,19,1,27875374,1658224,26217150,0.0381429712993212
1747351682474444,1861404,1,20,1,27969259,1751824,26217435,0.0381425566612447
1747351682568972,1955004,1,21,1,28063787,1845424,26218363,0.0381412066039363
1747351682658522,2045484,1,22,1,28153337,1935904,26217433,0.0381425595709541
1747351682752760,2139084,1,23,1,28247575,2029504,26218071,0.0381416313961465
1747351682847012,2232684,1,24,1,28341827,2123104,26218723,0.0381406829005363
1747351682941123,2326284,1,25,1,28435938,2216704,26219234,0.0381399395573493
1747351683034927,2416764,1,26,1,28529742,2307184,26222558,0.0381351048970889
1747351683129997,2510364,1,27,1,28624812,2400784,26224028,0.0381329672161728
1747351683224426,2603964,1,28,1,28719241,2494384,26224857,0.0381317617861557
1747351683318309,2697564,1,29,1,28813124,2587984,26225140,0.0381313502997505
1747351683413621,2791164,1,30,1,28908436,2681584,26226852,0.038128861214453
1747351683506058,2884764,1,31,1,29000873,2775184,26225689,0.038130552070529
1747351683600356,2978364,1,32,1,29095171,2868784,26226387,0.0381295372481158
1747351683695121,3071964,1,33,1,29189936,2962384,26227552,0.0381278435745737
1747351683784701,3162444,1,34,1,29279516,3052864,26226652,0.0381291519786818
1747351683875028,3252924,1,35,1,29369843,3143344,26226499,0.0381293744163107
1747351683964912,3343404,1,36,1,29459727,3233824,26225903,0.0381302409301216
1747351684059616,3433884,1,37,1,29554431,3324304,26230127,0.0381241005809846
1747351684149751,3524364,1,38,1,29644566,3414784,26229782,0.0381246020268105
1747351684243773,3617964,1,39,1,29738588,3508384,26230204,0.0381239886658906
1747351684337751,3711564,1,40,1,29832566,3601984,26230582,0.0381234392740504
1747351684431985,3805164,1,41,1,29926800,3695584,26231216,0.0381225178428632
1747351684526170,3898764,1,42,1,30020985,3789184,26231801,0.0381216676658991
1747351684620525,3992364,1,43,1,30115340,3882784,26232556,0.038120570485011
1747351684714860,4085964,1,44,1,30209675,3976384,26233291,0.0381195024291843
1747351684808491,4179564,1,45,1,30303306,4069984,26233322,0.0381194573832471
1747351684902623,4273172,1,46,1,30397438,4163592,26233846,0.0381186959777075
1747351684997203,4366764,1,47,1,30492018,4257184,26234834,0.0381172604332087
1747351685091295,4460364,1,48,1,30586110,4350784,26235326,0.0381165456072472
1747351685185096,4553964,1,49,1,30679911,4444384,26235527,0.0381162535824037
1747351685279335,4647564,1,50,1,30774150,4537984,26236166,0.0381153252346398
1747351685373412,4741164,1,51,1,30868227,4631584,26236643,0.0381146322721241
1747351685467667,4834764,1,52,1,30962482,4725184,26237298,0.0381136807608771
1747351685562848,4928364,1,53,1,31057663,4818784,26238879,0.038111384255402
1747351685656547,5021964,1,54,1,31151362,4912384,26238978,0.0381112404606612
1747351685750657,5115564,1,55,1,31245472,5005984,26239488,0.0381104997170676
1747351685845275,5209164,1,56,1,31340090,5099584,26240506,0.038109021220856
1747351685939164,5302764,1,57,1,31433979,5193184,26240795,0.0381086015115014
1747351686033530,5396364,1,58,1,31528345,5286784,26241561,0.0381074891085938
1747351686127375,5489964,1,59,1,31622190,5380384,26241806,0.0381071333276375
1747351686222061,5583564,1,60,1,31716876,5473984,26242892,0.0381055563540786
1747351686315652,5677164,1,61,1,31810467,5567584,26242883,0.0381055694223839
1747351686409656,5770764,1,62,1,31904471,5661184,26243287,0.0381049828095085
1747351686504559,5864364,1,63,1,31999374,5754784,26244590,0.0381030909608418
1747351686597914,5957964,1,64,1,32092729,5848384,26244345,0.0381034466663199
1747351686697224,6051564,1,65,1,32192039,5941984,26250055,0.0380951582768112
1747351686791057,6145164,1,66,1,32285872,6035584,26250288,0.0380948201406399
1747351686885103,6238764,1,67,1,32379918,6129184,26250734,0.0380941729096032
1747351686979216,6332364,1,68,1,32474031,6222784,26251247,0.0380934284759882
1747351687072959,6425964,1,69,1,32567774,6316384,26251390,0.0380932209684896
1747351687167903,6519564,1,70,1,32662718,6409984,26252734,0.0380912707986909
1747351687261905,6613164,1,71,1,32756720,6503584,26253136,0.0380906875277681
1747351687356306,6706764,1,72,1,32851121,6597184,26253937,0.038089525391944
1747351687450407,6800364,1,73,1,32945222,6690784,26254438,0.03808879854903
1747351687544384,6893964,1,74,1,33039199,6784384,26254815,0.0380882516216549
1747351687638106,6987564,1,75,1,33132921,6877984,26254937,0.0380880746352581
1747351687733260,7081164,1,76,1,33228075,6971584,26256491,0.0380858203786637
1747351687827488,7174764,1,77,1,33322303,7065184,26257119,0.0380849094677904
1747351687921853,7268372,1,78,1,33416668,7158792,26257876,0.0380838115009759
1747351688012069,7358844,1,79,1,33506884,7249264,26257620,0.0380841828010307
1747351688105976,7452444,1,80,1,33600791,7342864,26257927,0.0380837375319079
1747351688200468,7546044,1,81,1,33695283,7436464,26258819,0.0380824438448659
1747351688293647,7639644,1,82,1,33788462,7530064,26258398,0.0380830544193899
1747351688388438,7733244,1,83,1,33883253,7623664,26259589,0.0380813271677633
1747351688482187,7826844,1,84,1,33977002,7717264,26259738,0.038081111091055
1747351688576367,7920444,1,85,1,34071182,7810864,26260318,0.0380802700104393
1747351688670493,8014044,1,86,1,34165308,7904464,26260844,0.038079507269454
1747351688765602,8107644,1,87,1,34260417,7998064,26262353,0.03807731927143
1747351688858889,8201252,1,88,1,34353704,8091672,26262032,0.0380777846893187
1747351688954035,8294844,1,89,1,34448850,8185264,26263586,0.0380755316505522
1747351689048118,8388444,1,90,1,34542933,8278864,26264069,0.0380748314360581
1747351689141664,8482044,1,91,1,34636479,8372464,26264015,0.0380749097196296
1747351689236240,8575644,1,92,1,34731055,8466064,26264991,0.038073494866227
1747351689330554,8669244,1,93,1,34825369,8559664,26265705,0.0380724598863803
1747351689425023,8762844,1,94,1,34919838,8653264,26266574,0.0380712003019503
1747351689518996,8853324,1,95,1,35013811,8743744,26270067,0.0380661381640176
1747351689612551,8946924,1,96,1,35107366,8837344,26270022,0.0380662033705186
1747351689706638,9040524,1,97,1,35201453,8930944,26270509,0.0380654977031469
1747351689800907,9134124,1,98,1,35295722,9024544,26271178,0.0380645283587968
1747351689895164,9227724,1,99,1,35389979,9118144,26271835,0.0380635764498368
1747351689989518,9321324,1,100,1,35484333,9211744,26272589,0.0380624840589558
1747351690083683,9415964,1,101,1,35578498,9306384,26272114,0.0380631722289268
1747351690182123,9510604,1,102,1,35676938,9401024,26275914,0.0380576675658171
1747351690276537,9605244,1,103,1,35771352,9495664,26275688,0.0380579949038822
1747351690371008,9699884,1,104,1,35865823,9590304,26275519,0.0380582396869116
1747351690464873,9794524,1,105,1,35959688,9684944,26274744,0.0380593622529681
1747351690562883,9889164,1,106,1,36057698,9779584,26278114,0.038054481383253
1747351690656877,9983804,1,107,1,36151692,9874224,26277468,0.0380554169069866
1747351690752006,10078444,1,108,1,36246821,9968864,26277957,0.0380547087431492
1747351690846124,10171004,1,109,1,36340939,10061424,26279515,0.0380524526422957
1747351690943906,10266684,1,110,1,36438721,10157104,26281617,0.0380494092125305
1747351691038289,10362364,1,111,1,36533104,10252784,26280320,0.038051287046733
1747351691136293,10458044,1,112,1,36631108,10348464,26282644,0.0380479224236343
1747351691230370,10550604,1,113,1,36725185,10441024,26284161,0.0380457264738258
1747351691325155,10646284,1,114,1,36819970,10536704,26283266,0.0380470220101261
1747351691418737,10738844,1,115,1,36913552,10629264,26284288,0.0380455426450965
1747351691513198,10834524,1,116,1,37008013,10724944,26283069,0.0380473071847127
1747351691611405,10930212,1,117,1,37106220,10820632,26285588,0.0380436610358497
1747351691706313,11025884,1,118,1,37201128,10916304,26284824,0.0380447668205805
1747351691804580,11121564,1,119,1,37299395,11011984,26287411,0.0380410227541997
1747351691902644,11217244,1,120,1,37397459,11107664,26289795,0.0380375731343663
1747351691997038,11312924,1,121,1,37491853,11203344,26288509,0.0380394338834507
1747351692093937,11408604,1,122,1,37588752,11299024,26289728,0.0380376700740304
1747351692188899,11504284,1,123,1,37683714,11394704,26289010,0.0380387089510027
1747351692287269,11599964,1,124,1,37782084,11490384,26291700,0.0380348170715472
1747351692381806,11695644,1,125,1,37876621,11586064,26290557,0.03803647066131
1747351692480110,11791324,1,126,1,37974925,11681744,26293181,0.0380326747075601
1747351692574493,11887004,1,127,1,38069308,11777424,26291884,0.0380345508903051
1747351692671951,11982684,1,128,1,38166766,11873104,26293662,0.0380319789613177
1747351692766489,12078364,1,129,1,38261304,11968784,26292520,0.0380336308577496
1747351692864710,12174044,1,130,1,38359525,12064464,26295061,0.0380299555114171
1747351692958760,12269724,1,131,1,38453575,12160144,26293431,0.038032313089912
1747351693057160,12365404,1,132,1,38551975,12255824,26296151,0.0380283791342695
1747351693151241,12461092,1,133,1,38646056,12351512,26294544,0.0380307032515947
1747351693249997,12556764,1,134,1,38744812,12447184,26297628,0.0380262432794318
1747351693348616,12652444,1,135,1,38843431,12542864,26300567,0.0380219939745025
1747351693442420,12748124,1,136,1,38937235,12638544,26298691,0.0380247062486874
1747351693541087,12843804,1,137,1,39035902,12734224,26301678,0.0380203879007263
1747351693635180,12939484,1,138,1,39129995,12829904,26300091,0.0380226821268413
1747351693733133,13035164,1,139,1,39227948,12925584,26302364,0.038019396279361
1747351693827753,13130844,1,140,1,39322568,13021264,26301304,0.0380209285440752
1747351693925886,13226524,1,141,1,39420701,13116944,26303757,0.0380173828400254
1747351694020215,13322204,1,142,1,39515030,13212624,26302406,0.0380193355695292
1747351694117904,13417884,1,143,1,39612719,13308304,26304415,0.0380164318423352
1747351694212877,13513564,1,144,1,39707692,13403984,26303708,0.0380174536609059
1747351694311115,13609244,1,145,1,39805930,13499664,26306266,0.0380137568745028
1747351694405350,13704924,1,146,1,39900165,13595344,26304821,0.0380158450802611
1747351694503406,13800604,1,147,1,39998221,13691024,26307197,0.0380124115845561
1747351694597798,13896284,1,148,1,40092613,13786704,26305909,0.0380142727628229
1747351694695898,13991972,1,149,1,40190713,13882392,26308321,0.0380107875375247
1747351694790160,14087644,1,150,1,40284975,13978064,26306911,0.0380128248428711
1747351694888610,14183324,1,151,1,40383425,14073744,26309681,0.038008822683939
1747351694986804,14279004,1,152,1,40481619,14169424,26312195,0.0380051911290563
1747351695080827,14374684,1,153,1,40575642,14265104,26310538,0.0380075846415607
1747351695174817,14467244,1,154,1,40669632,14357664,26311968,0.0380055190094484
1747351695268822,14559804,1,155,1,40763637,14450224,26313413,0.0380034319379245
1747351695358813,14652364,1,156,1,40853628,14542784,26310844,0.0380071426062957
1747351695453252,14744924,1,157,1,40948067,14635344,26312723,0.0380044285040358
1747351695547766,14837484,1,158,1,41042581,14727904,26314677,0.0380016064799123
1747351695641967,14930044,1,159,1,41136782,14820464,26316318,0.0379992368233276
1747351695736387,15025724,1,160,1,41231202,14916144,26315058,0.0380010562773602
1747351695834387,15121404,1,161,1,41329202,15011824,26317378,0.0379977063064565
1747351695928313,15217084,1,162,1,41423128,15107504,26315624,0.0380002389455024
1747351696027093,15312764,1,163,1,41521908,15203184,26318724,0.0379957630164745
1747351696121433,15408444,1,164,1,41616248,15298864,26317384,0.0379976976435043
1747351696219567,15504124,1,165,1,41714382,15394544,26319838,0.0379941548272447
1747351696313524,15599804,1,166,1,41808339,15490224,26318115,0.0379966422367255
1747351696412103,15695484,1,167,1,41906918,15585904,26321014,0.0379924572814709
1747351696506102,15791164,1,168,1,42000917,15681584,26319333,0.0379948838369118
1747351696604180,15886844,1,169,1,42098995,15777264,26321731,0.0379914223726395
1747351696702176,15982524,1,170,1,42196991,15872944,26324047,0.0379880798723691
1747351696796670,16078204,1,171,1,42291485,15968624,26322861,0.0379897914592186
1747351696894839,16173884,1,172,1,42389654,16064304,26325350,0.0379861996136803
1747351696989346,16269564,1,173,1,42484161,16159984,26324177,0.037987892271048
1747351697083268,16362124,1,174,1,42578083,16252544,26325539,0.037985926897831
1747351697177672,16457804,1,175,1,42672487,16348224,26324263,0.0379877681665769
1747351697271558,16550364,1,176,1,42766373,16440784,26325589,0.0379858547514359
1747351697365836,16642924,1,177,1,42860651,16533344,26327307,0.0379833759677736
1747351697459730,16735484,1,178,1,42954545,16625904,26328641,0.0379814514543306
1747351697550730,16828044,1,179,1,43045545,16718464,26327081,0.0379837020291007
1747351697644879,16920612,1,180,1,43139694,16811032,26328662,0.037981421159951
1747351697738947,17013164,1,181,1,43233762,16903584,26330178,0.0379792343219252
1747351697832924,17105724,1,182,1,43327739,16996144,26331595,0.037977190519602
1747351697927267,17198284,1,183,1,43422082,17088704,26333378,0.0379746191316586
1747351698017166,17290844,1,184,1,43511981,17181264,26330717,0.037978456872253
1747351698111421,17383404,1,185,1,43606236,17273824,26332412,0.0379760122240226
1747351698205484,17475964,1,186,1,43700299,17366384,26333915,0.0379738447549481
1747351698300285,17568524,1,187,1,43795100,17458944,26336156,0.0379706134790513
1747351698389799,17661084,1,188,1,43884614,17551504,26333110,0.037975005610807
1747351698483602,17753644,1,189,1,43978417,17644064,26334353,0.0379732131638092
1747351698578007,17846204,1,190,1,44072822,17736624,26336198,0.0379705529249134
1747351698672152,17938764,1,191,1,44166967,17829184,26337783,0.037968267868256
1747351698762987,18031324,1,192,1,44257802,17921744,26336058,0.0379707547727909
1747351698857408,18123884,1,193,1,44352223,18014304,26337919,0.0379680718131147
1747351698951253,18216444,1,194,1,44446068,18106864,26339204,0.0379662194802849
1747351699045678,18309004,1,195,1,44540493,18199424,26341069,0.0379635313965427
1747351699139149,18401564,1,196,1,44633964,18291984,26341980,0.0379622184816782
1747351699229388,18494124,1,197,1,44724203,18384544,26339659,0.0379655636392255
1747351699323462,18586684,1,198,1,44818277,18477104,26341173,0.0379633815092441
1747351699417873,18679244,1,199,1,44912688,18569664,26343024,0.0379607140015512
1747351699512484,18771804,1,200,1,45007299,18662224,26345075,0.0379577587082215
1747351699602310,18864364,1,201,1,45097125,18754784,26342341,0.0379616982408662
1747351699696740,18956924,1,202,1,45191555,18847344,26344211,0.0379590035928576
1747351699791004,19049492,1,203,1,45285819,18939912,26345907,0.0379565600075943
1747351699885002,19142044,1,204,1,45379817,19032464,26347353,0.0379544768690805
1747351699975096,19234604,1,205,1,45469911,19125024,26344887,0.0379580295789463
1747351700068906,19327164,1,206,1,45563721,19217584,26346137,0.0379562286493841
1747351700163884,19419724,1,207,1,45658699,19310144,26348555,0.0379527454162097
1747351700257793,19512284,1,208,1,45752608,19402704,26349904,0.0379508024014053
1747351700347830,19604844,1,209,1,45842645,19495264,26347381,0.0379544365339386
1747351700442090,19697404,1,210,1,45936905,19587824,26349081,0.0379519877752093
1747351700536611,19789964,1,211,1,46031426,19680384,26351042,0.0379491634524357
1747351700630533,19882524,1,212,1,46125348,19772944,26352404,0.0379472020844853
1747351700720923,19975084,1,213,1,46215738,19865504,26350234,0.0379503271204346
1747351700814833,20067644,1,214,1,46309648,19958064,26351584,0.0379483829131486
1747351700908579,20160204,1,215,1,46403394,20050624,26352770,0.0379466750554116
1747351701002854,20252764,1,216,1,46497669,20143184,26354485,0.0379442057016101
1747351701097264,20345324,1,217,1,46592079,20235744,26356335,0.0379415423274897
1747351701187817,20437884,1,218,1,46682632,20328304,26354328,0.0379444317457079
1747351701283920,20530444,1,219,1,46778735,20420864,26357871,0.0379393312912108
1747351701375433,20623004,1,220,1,46870248,20513424,26356824,0.0379408383953999
1747351701470344,20715564,1,221,1,46965159,20605984,26359175,0.0379374544157774
1747351701560473,20808124,1,222,1,47055288,20698544,26356744,0.0379409535563269
1747351701654581,20900684,1,223,1,47149396,20791104,26358292,0.0379387253164962
1747351701748363,20993244,1,224,1,47243178,20883664,26359514,0.0379369665161504
1747351701842325,21085804,1,225,1,47337140,20976224,26360916,0.0379349488462388
1747351701933320,21178364,1,226,1,47428135,21068784,26359351,0.0379372011093899
1747351702027473,21270924,1,227,1,47522288,21161344,26360944,0.037934908552592
1747351702121564,21363484,1,228,1,47616379,21253904,26362475,0.0379327054838364
1747351702214888,21456044,1,229,1,47709703,21346464,26363239,0.0379316062036231
1747351702309607,21548604,1,230,1,47804422,21439024,26365398,0.037928500074226
1747351702399426,21641164,1,231,1,47894241,21531584,26362657,0.0379324436076378
1747351702493402,21733724,1,232,1,47988217,21624144,26364073,0.0379304062767539
1747351702587564,21826284,1,233,1,48082379,21716704,26365675,0.0379281015942129
1747351702682596,21918844,1,234,1,48177411,21809264,26368147,0.0379245458545115
1747351702772314,22011404,1,235,1,48267129,21901824,26365305,0.0379286338618119
1747351702866395,22103964,1,236,1,48361210,21994384,26366826,0.0379264459059274
1747351702960499,22196524,1,237,1,48455314,22086944,26368370,0.0379242251227512
1747351703055164,22289084,1,238,1,48549979,22179504,26370475,0.0379211978547978
1747351703145135,22381644,1,239,1,48639950,22272064,26367886,0.0379249212470047
1747351703239384,22474204,1,240,1,48734199,22364624,26369575,0.0379224921144917
1747351703333492,22566764,1,241,1,48828307,22457184,26371123,0.0379202660425193
1747351703428062,22659324,1,242,1,48922877,22549744,26373133,0.037917375990179
1747351703517733,22751884,1,243,1,49012548,22642304,26370244,0.0379215300396917
1747351703612114,22844452,1,244,1,49106929,22734872,26372057,0.0379189230479821
1747351703706522,22937004,1,245,1,49201337,22827424,26373913,0.0379162545959714
1747351703800356,23029564,1,246,1,49295171,22919984,26375187,0.037914423128071
1747351703894244,23122124,1,247,1,49389059,23012544,26376515,0.0379125142195623
1747351703984834,23214684,1,248,1,49479649,23105104,26374545,0.0379153460277703
1747351704078532,23307244,1,249,1,49573347,23197664,26375683,0.0379137101397525
1747351704173087,23399804,1,250,1,49667902,23290224,26377678,0.0379108426450576
1747351704267321,23492364,1,251,1,49762136,23382784,26379352,0.0379084368713833
1747351704357018,23584924,1,252,1,49851833,23475344,26376489,0.0379125515909263
1747351704451299,23677484,1,253,1,49946114,23567904,26378210,0.0379100780530597
1747351704546073,23770044,1,254,1,50040888,23660464,26380424,0.0379068964168278
1747351704639989,23862604,1,255,1,50134804,23753024,26381780,0.0379049480361067
1747351704730586,23955164,1,256,1,50225401,23845584,26379817,0.0379077686551047
1747351704827867,24047724,1,257,1,50322682,23938144,26384538,0.0379009857970603
1747351704918191,24140284,1,258,1,50413006,24030704,26382302,0.0379041980491315
1747351705012896,24232844,1,259,1,50507711,24123264,26384447,0.0379011165176211
1747351705102535,24325404,1,260,1,50597350,24215824,26381526,0.0379053129830321
1747351705197216,24417964,1,261,1,50692031,24308384,26383647,0.0379022657481734
1747351705291552,24510524,1,262,1,50786367,24400944,26385423,0.0378997145507199
1747351705385172,24603084,1,263,1,50879987,24493504,26386483,0.0378981920402199
1747351705479285,24695644,1,264,1,50974100,24586064,26388036,0.0378959616395854
1747351705570264,24788204,1,265,1,51065079,24678624,26386455,0.0378982322559055
1747351705664048,24880764,1,266,1,51158863,24771184,26387679,0.037896474335617
1747351705758166,24973332,1,267,1,51252981,24863752,26389229,0.0378942484450758
1747351705851938,25065884,1,268,1,51346753,24956304,26390449,0.037892496637704
1747351705942418,25158444,1,269,1,51437233,25048864,26388369,0.0378954834230186
1747351706036865,25251004,1,270,1,51531680,25141424,26390256,0.0378927737571018
1747351706131349,25343564,1,271,1,51626164,25233984,26392180,0.0378900113594254
1747351706225113,25436124,1,272,1,51719928,25326544,26393384,0.0378882829121116
1747351706315276,25528684,1,273,1,51810091,25419104,26390987,0.0378917241708315
1747351706409043,25621244,1,274,1,51903858,25511664,26392194,0.0378899912602946
1747351706503393,25713804,1,275,1,51998208,25604224,26393984,0.0378874216185021
1747351706598161,25806364,1,276,1,52092976,25696784,26396192,0.0378842523951939
1747351706688358,25898924,1,277,1,52183173,25789344,26393829,0.0378876441155999
1747351706782161,25991484,1,278,1,52276976,25881904,26395072,0.0378858599059703
1747351706876178,26084044,1,279,1,52370993,25974464,26396529,0.0378837687333815
1747351706970757,26176604,1,280,1,52465572,26067024,26398548,0.0378808713267108
1747351707063729,26269164,1,281,1,52558544,26159584,26398960,0.0378802801322476
1747351707155054,26361724,1,282,1,52649869,26252144,26397725,0.0378820523359494
1747351707249008,26454284,1,283,1,52743823,26344704,26399119,0.0378800519820377
1747351707343323,26546844,1,284,1,52838138,26437264,26400874,0.0378775339028548
1747351707437381,26639404,1,285,1,52932196,26529824,26402372,0.0378753848328475
1747351707528066,26731964,1,286,1,53022881,26622384,26400497,0.0378780747953343
1747351707621168,26824524,1,287,1,53115983,26714944,26401039,0.0378772971775845
1747351707716175,26917084,1,288,1,53210990,26807504,26403486,0.0378737868173922
1747351707810424,27009644,1,289,1,53305239,26900064,26405175,0.0378713642306858
1747351707900497,27102204,1,290,1,53395312,26992624,26402688,0.0378749315221238
1747351707993872,27194764,1,291,1,53488687,27085184,26403503,0.0378737624322045
1747351708088973,27287324,1,292,1,53583788,27177744,26406044,0.0378701179169435
1747351708182255,27379884,1,293,1,53677070,27270304,26406766,0.0378690824919643
1747351708273268,27472444,1,294,1,53768083,27362864,26405219,0.0378713011242209
1747351708367287,27565004,1,295,1,53862102,27455424,26406678,0.0378692086903168
1747351708460905,27657564,1,296,1,53955720,27547984,26407736,0.0378676914976732
1747351708555903,27750124,1,297,1,54050718,27640544,26410174,0.0378641958208984
1747351708649740,27842684,1,298,1,54144555,27733104,26411451,0.0378623650779353
1747351708739824,27935244,1,299,1,54234639,27825664,26408975,0.0378659149020361
1747351708833830,28027804,1,300,1,54328645,27918224,26410421,0.0378638417009709
1747351708927801,28120364,1,301,1,54422616,28010784,26411832,0.0378618188999536
1747351709021968,28212924,1,302,1,54516783,28103344,26413439,0.037859515377759
1747351709113019,28305484,1,303,1,54607834,28195904,26411930,0.0378616784157765
1747351709206825,28398044,1,304,1,54701640,28288464,26413176,0.0378598923506964
1747351709300360,28490604,1,305,1,54795175,28381024,26414151,0.0378584948651198
1747351709395445,28583164,1,306,1,54890260,28473584,26416676,0.0378548762153118
1747351709484971,28675724,1,307,1,54979786,28566144,26413642,0.0378592244113856
1747351709579077,28768292,1,308,1,55073892,28658712,26415180,0.0378570200922348
1747351709673862,28860844,1,309,1,55168677,28751264,26417413,0.0378538201299271
1747351709767983,28953404,1,310,1,55262798,28843824,26418974,0.0378515834869287
1747351709858277,29045964,1,311,1,55353092,28936384,26416708,0.0378548303596345
1747351709952660,29138524,1,312,1,55447475,29028944,26418531,0.0378522182024428
1747351710046810,29231084,1,313,1,55541625,29121504,26420121,0.0378499402027719
1747351710139874,29323644,1,314,1,55634689,29214064,26420625,0.037849218177087
1747351710235118,29416204,1,315,1,55729933,29306624,26423309,0.0378453735677087
1747351710325051,29508764,1,316,1,55819866,29399184,26420682,0.0378491365211541
1747351710418547,29601324,1,317,1,55913362,29491744,26421618,0.0378477956951765
1747351710513175,29693884,1,318,1,56007990,29584304,26423686,0.0378448336087554
1747351710607496,29786444,1,319,1,56102311,29676864,26425447,0.0378423116172831
1747351710698022,29879004,1,320,1,56192837,29769424,26423413,0.0378452246119757
1747351710791393,29971564,1,321,1,56286208,29861984,26424224,0.0378440630839338
1747351710886220,30064124,1,322,1,56381035,29954544,26426491,0.0378408166260136
1747351710980694,30156684,1,323,1,56475509,30047104,26428405,0.0378380761154522
1747351711070948,30249244,1,324,1,56565763,30139664,26426099,0.037841377949882
1747351711164156,30341804,1,325,1,56658971,30232224,26426747,0.0378404500561495
1747351711258205,30434364,1,326,1,56753020,30324784,26428236,0.0378383180776802
1747351711352649,30526924,1,327,1,56847464,30417344,26430120,0.0378356208749714
1747351711443228,30619484,1,328,1,56938043,30509904,26428139,0.0378384569568065
1747351711537361,30712044,1,329,1,57032176,30602464,26429712,0.0378362049499442
1747351711631812,30804604,1,330,1,57126627,30695024,26431603,0.0378334980288558
1747351711725401,30897172,1,331,1,57220216,30787592,26432624,0.0378320366528877
1747351711819854,30989724,1,332,1,57314669,30880144,26434525,0.0378293160175944
1747351711910410,31082284,1,333,1,57405225,30972704,26432521,0.0378321840735509
1747351712004288,31174844,1,334,1,57499103,31065264,26433839,0.0378302977482763
1747351712098774,31267404,1,335,1,57593589,31157824,26435765,0.0378275415899634
1747351712192104,31359964,1,336,1,57686919,31250384,26436535,0.03782643981142
1747351712283145,31452524,1,337,1,57777960,31342944,26435016,0.0378286133815844
1747351712377017,31545084,1,338,1,57871832,31435504,26436328,0.0378267359975258
1747351712470879,31637644,1,339,1,57965694,31528064,26437630,0.0378248731070069
1747351712565033,31730204,1,340,1,58059848,31620624,26439224,0.0378225926751859
1747351712655537,31822764,1,341,1,58150352,31713184,26437168,0.0378255341116718
1747351712750025,31915324,1,342,1,58244840,31805744,26439096,0.0378227757862825
1747351712843949,32007884,1,343,1,58338764,31898304,26440460,0.0378208245998745
1747351712938140,32100444,1,344,1,58432955,31990864,26442091,0.0378184917372835
1747351713028273,32193004,1,345,1,58523088,32083424,26439664,0.0378219632443135
1747351713122494,32285564,1,346,1,58617309,32175984,26441325,0.0378195873315728
1747351713216950,32378124,1,347,1,58711765,32268544,26443221,0.0378168756370489
1747351713310884,32470684,1,348,1,58805699,32361104,26444595,0.0378149107596467
1747351713404845,32563244,1,349,1,58899660,32453664,26445996,0.0378129074813442
1747351713494963,32655804,1,350,1,58989778,32546224,26443554,0.0378163994143903
1747351713589948,32748364,1,351,1,59084763,32638784,26445979,0.0378129317882314
1747351713683122,32840924,1,352,1,59177937,32731344,26446593,0.0378120539004778
1747351713777421,32933484,1,353,1,59272236,32823904,26448332,0.0378095677262369
1747351713868035,33026044,1,354,1,59362850,32916464,26446386,0.0378123498613383
1747351713961565,33118604,1,355,1,59456380,33009024,26447356,0.0378109630316164
1747351714056298,33211164,1,356,1,59551113,33101584,26449529,0.0378078566162747
1747351714150121,33303724,1,357,1,59644936,33194144,26450792,0.0378060513273099
1747351714240774,33396284,1,358,1,59735589,33286704,26448885,0.0378087771941993
1747351714334204,33488844,1,359,1,59829019,33379264,26449755,0.037807533566946
1747351714428340,33581404,1,360,1,59923155,33471824,26451331,0.0378052809516466
1747351714522179,33673964,1,361,1,60016994,33564384,26452610,0.0378034530430078
1747351714617601,33766524,1,362,1,60112416,33656944,26455472,0.0377993633982413
1747351714707504,33859084,1,363,1,60202319,33749504,26452815,0.0378031600795605
1747351714801274,33951644,1,364,1,60296089,33842064,26454025,0.0378014309731694
1747351714895377,34044204,1,365,1,60390192,33934624,26455568,0.0377992262347192
1747351714989938,34136764,1,366,1,60484753,34027184,26457569,0.0377963674591569
1747351715079962,34229324,1,367,1,60574777,34119744,26455033,0.0377999906482823
1747351715174063,34321884,1,368,1,60668878,34212304,26456574,0.0377977889351811
1747351715268325,34414444,1,369,1,60763140,34304864,26458276,0.0377953574904124
1747351715362664,34507004,1,370,1,60857479,34397424,26460055,0.0377928163792554
1747351715453139,34599564,1,371,1,60947954,34489984,26457970,0.0377957946131165
1747351715547072,34692132,1,372,1,61041887,34582552,26459335,0.0377938447810574
1747351715641467,34784684,1,373,1,61136282,34675104,26461178,0.0377912124698303
1747351715735238,34877244,1,374,1,61230053,34767664,26462389,0.0377894830281574
1747351715825306,34969804,1,375,1,61320121,34860224,26459897,0.0377930420515242
1747351715919907,35062364,1,376,1,61414722,34952784,26461938,0.0377901270874415
1747351716013409,35154924,1,377,1,61508224,35045344,26462880,0.0377887818710586
1747351716107993,35247484,1,378,1,61602808,35137904,26464904,0.037785891836222
1747351716201901,35340044,1,379,1,61696716,35230464,26466252,0.0377839672954069
1747351716292704,35432604,1,380,1,61787519,35323024,26464495,0.0377864758046582
1747351716386504,35525164,1,381,1,61881319,35415584,26465735,0.0377847053935966
1747351716480209,35617724,1,382,1,61975024,35508144,26466880,0.0377830707661802
1747351716575209,35710284,1,383,1,62070024,35600704,26469320,0.0377795878398085
1747351716664863,35802844,1,384,1,62159678,35693264,26466414,0.0377837360210567
1747351716759152,35895404,1,385,1,62253967,35785824,26468143,0.0377812678433844
1747351716857659,35991084,1,386,1,62352474,35881504,26470970,0.0377772329461292
1747351716951795,36086764,1,387,1,62446610,35977184,26469426,0.0377794365469051
1747351717050458,36182444,1,388,1,62545273,36072864,26472409,0.0377751794330466
1747351717144257,36278124,1,389,1,62639072,36168544,26470528,0.0377778637434054
1747351717238333,36370684,1,390,1,62733148,36261104,26472044,0.0377757002821542
1747351717332363,36463244,1,391,1,62827178,36353664,26473514,0.0377736027034416
1747351717426650,36555812,1,392,1,62921465,36446232,26475233,0.0377711501160348
1747351717516996,36648364,1,393,1,63011811,36538784,26473027,0.0377742975897693
1747351717611441,36740924,1,394,1,63106256,36631344,26474912,0.0377716080793771
1747351717705542,36833484,1,395,1,63200357,36723904,26476453,0.037769409671303
1747351717799611,36926044,1,396,1,63294426,36816464,26477962,0.037767257162768
1747351717890071,37018604,1,397,1,63384886,36909024,26475862,0.0377702527683517
1747351717983672,37111164,1,398,1,63478487,37001584,26476903,0.0377687677444752
1747351718078545,37203724,1,399,1,63573360,37094144,26479216,0.0377654685848704
1747351718172252,37296284,1,400,1,63667067,37186704,26480363,0.0377638327692109
1747351718262667,37388844,1,401,1,63757482,37279264,26478218,0.0377668920166757
1747351718356577,37481404,1,402,1,63851392,37371824,26479568,0.0377649665583668
1747351718450723,37573964,1,403,1,63945538,37464384,26481154,0.0377627047522173
1747351718545299,37666524,1,404,1,64040114,37556944,26483170,0.0377598301109723
1747351718634691,37759084,1,405,1,64129506,37649504,26480002,0.03776434760088
1747351718728984,37851644,1,406,1,64223799,37742064,26481735,0.0377618762516881
1747351718823687,37944204,1,407,1,64318502,37834624,26483878,0.0377588206681816
1747351718917857,38036764,1,408,1,64412672,37927184,26485488,0.0377565253847692
1747351719011425,38129324,1,409,1,64506240,38019744,26486496,0.0377550884798049
1747351719101947,38221884,1,410,1,64596762,38112304,26484458,0.0377579937637387
1747351719196509,38314444,1,411,1,64691324,38204864,26486460,0.0377551397959561
1747351719290585,38407004,1,412,1,64785400,38297424,26487976,0.0377529789365559
1747351719384520,38499564,1,413,1,64879335,38389984,26489351,0.0377510192680824
1747351719474609,38592124,1,414,1,64969424,38482544,26486880,0.0377545411162054
1747351719569028,38684692,1,415,1,65063843,38575112,26488731,0.0377519028752264
1747351719663435,38777244,1,416,1,65158250,38667664,26490586,0.0377492593029085
1747351719757521,38869804,1,417,1,65252336,38760224,26492112,0.0377470848681298
1747351719847522,38962364,1,418,1,65342337,38852784,26489553,0.0377507313921076
1747351719941831,39054924,1,419,1,65436646,38945344,26491302,0.0377482390257753
1747351720035360,39147484,1,420,1,65530175,39037904,26492271,0.0377468583195453
1747351720129553,39240044,1,421,1,65624368,39130464,26493904,0.037744531723222
1747351720220522,39332604,1,422,1,65715337,39223024,26492313,0.037746798476977
1747351720314537,39425164,1,423,1,65809352,39315584,26493768,0.0377447254765724
1747351720408655,39517724,1,424,1,65903470,39408144,26495326,0.0377425059801113
1747351720502843,39610284,1,425,1,65997658,39500704,26496954,0.0377401870418765
1747351720596908,39702844,1,426,1,66091723,39593264,26498459,0.0377380435594386
1747351720686960,39795404,1,427,1,66181775,39685824,26495951,0.0377416156906389
1747351720781348,39887964,1,428,1,66276163,39778384,26497779,0.0377390120130445
1747351720875229,39980524,1,429,1,66370044,39870944,26499100,0.0377371306950047
1747351720969458,40073084,1,430,1,66464273,39963504,26500769,0.0377347540367602
1747351721059427,40165644,1,431,1,66554242,40056064,26498178,0.0377384437526232
1747351721153570,40258204,1,432,1,66648385,40148624,26499761,0.0377361893943119
1747351721248427,40350764,1,433,1,66743242,40241184,26502058,0.0377329187038983
1747351721342263,40443324,1,434,1,66837078,40333744,26503334,0.0377311020568204
1747351721432842,40535884,1,435,1,66927657,40426304,26501353,0.0377339224906743
1747351721527102,40628444,1,436,1,67021917,40518864,26503053,0.0377315021027954
1747351721621102,40721004,1,437,1,67115917,40611424,26504493,0.0377294521347757
1747351721714773,40813564,1,438,1,67209588,40703984,26505604,0.0377278706797249
1747351721805375,40906124,1,439,1,67300190,40796544,26503646,0.0377306578875978
1747351721899581,40998684,1,440,1,67394396,40889104,26505292,0.037728314783327
1747351721993812,41091244,1,441,1,67488627,40981664,26506963,0.037725936388865
1747351722087314,41183804,1,442,1,67582129,41074224,26507905,0.0377245957385164
1747351722181822,41276364,1,443,1,67676637,41166784,26509853,0.0377218236555291
1747351722272428,41368924,1,444,1,67767243,41259344,26507899,0.0377246042773891
1747351722365790,41461484,1,445,1,67860605,41351904,26508701,0.0377234629490143
1747351722460935,41554044,1,446,1,67955750,41444464,26511286,0.0377197846984865
1747351722554329,41646604,1,447,1,68049144,41537024,26512120,0.0377185981354942
1747351722645258,41739164,1,448,1,68140073,41629584,26510489,0.037720918689957
1747351722738786,41831724,1,449,1,68233601,41722144,26511457,0.0377195414043068
1747351722833299,41924284,1,450,1,68328114,41814704,26513410,0.0377167629512763
1747351722926976,42016844,1,451,1,68421791,41907264,26514527,0.0377151740251674
1747351723017393,42109404,1,452,1,68512208,41999824,26512384,0.0377182225483758
1747351723111915,42201964,1,453,1,68606730,42092384,26514346,0.0377154314875426
1747351723206275,42294524,1,454,1,68701090,42184944,26516146,0.0377128712445617
1747351723300511,42387084,1,455,1,68795326,42277504,26517822,0.0377104876863567
1747351723390647,42479652,1,456,1,68885462,42370072,26515390,0.0377139465042754
1747351723484265,42572204,1,457,1,68979080,42462624,26516456,0.0377124303489123
1747351723579054,42664764,1,458,1,69073869,42555184,26518685,0.0377092604704946
1747351723673222,42757324,1,459,1,69168037,42647744,26520293,0.0377069740519081
1747351723766749,42849884,1,460,1,69261564,42740304,26521260,0.0377055992060709
1747351723856435,42942444,1,461,1,69351250,42832864,26518386,0.0377096856497978
1747351723951491,43035004,1,462,1,69446306,42925424,26520882,0.0377061366209464
1747351724045804,43127564,1,463,1,69540619,43017984,26522635,0.0377036444531246
1747351724139389,43220124,1,464,1,69634204,43110544,26523660,0.0377021874055088
1747351724229610,43312684,1,465,1,69724425,43203104,26521321,0.0377055124818254
1747351724324216,43405244,1,466,1,69819031,43295664,26523367,0.0377026038964057
1747351724418569,43497804,1,467,1,69913384,43388224,26525160,0.0377000553436812
1747351724512512,43590364,1,468,1,70007327,43480784,26526543,0.0376980897963221
1747351724602709,43682924,1,469,1,70097524,43573344,26524180,0.0377014482634335
1747351724697047,43775484,1,470,1,70191862,43665904,26525958,0.037698921185052
1747351724790683,43868044,1,471,1,70285498,43758464,26527034,0.0376973920265642
1747351724884833,43960604,1,472,1,70379648,43851024,26528624,0.037695132623539
1747351724974990,44053164,1,473,1,70469805,43943584,26526221,0.0376985474108807
1747351725069917,44145724,1,474,1,70564732,44036144,26528588,0.0376951837768372
1747351725164014,44238284,1,475,1,70658829,44128704,26530125,0.0376929999387488
1747351725257930,44330844,1,476,1,70752745,44221264,26531481,0.0376910734836099
1747351725352223,44423404,1,477,1,70847038,44313824,26533214,0.0376886117151129
1747351725442698,44515964,1,478,1,70937513,44406384,26531129,0.0376915735474355
1747351725536329,44608532,1,479,1,71031144,44498952,26532192,0.0376900634519756
1747351725630254,44701084,1,480,1,71125069,44591504,26533565,0.0376881131502683
1747351725724708,44793644,1,481,1,71219523,44684064,26535459,0.0376854231162913
1747351725814636,44886204,1,482,1,71309451,44776624,26532827,0.0376891614301031
1747351725908964,44978764,1,483,1,71403779,44869184,26534595,0.0376866502013691
1747351726003592,45071324,1,484,1,71498407,44961744,26536663,0.0376837132837689
1747351726097618,45163884,1,485,1,71592433,45054304,26538129,0.0376816315875169
1747351726187314,45256444,1,486,1,71682129,45146864,26535265,0.037685698635382
1747351726282409,45349004,1,487,1,71777224,45239424,26537800,0.0376820987421715
1747351726375886,45441564,1,488,1,71870701,45331984,26538717,0.0376807967016642
1747351726470080,45534124,1,489,1,71964895,45424544,26540351,0.0376784768219531
1747351726560335,45626684,1,490,1,72055150,45517104,26538046,0.0376817494400303
1747351727039753,46101964,1,495,1,72534568,45992384,26542184,0.0376758747509247
1747351727133712,46194524,1,496,1,72628527,46084944,26543583,0.037673889014908
1747351727227445,46287084,1,497,1,72722260,46177504,26544756,0.037672224223873
1747351727322276,46379644,1,498,1,72817091,46270064,26547027,0.0376690015043869
1747351727411955,46472212,1,499,1,72906770,46362632,26544138,0.0376731013077162
1747351727506603,46564764,1,500,1,73001418,46455184,26546234,0.037670126768264
1747351727600967,46657324,1,501,1,73095782,46547744,26548038,0.037667566996853
1747351727694676,46749884,1,502,1,73189491,46640304,26549187,0.037665936813809
1747351727789346,46842444,1,503,1,73284161,46732864,26551297,0.0376629435465996
1747351727879227,46935004,1,504,1,73374042,46825424,26548618,0.0376667440843813
1747351727972853,47027564,1,505,1,73467668,46917984,26549684,0.0376652317217786
1747351728066958,47120124,1,506,1,73561773,47010544,26551229,0.0376630400046641
1747351728162084,47212684,1,507,1,73656899,47103104,26553795,0.0376594004736422
1747351728251768,47305244,1,508,1,73746583,47195664,26550919,0.0376634797462189
1747351728346244,47397804,1,509,1,73841059,47288224,26552835,0.0376607620240927
1747351728439841,47490364,1,510,1,73934656,47380784,26553872,0.0376592912702147
1747351728534087,47582924,1,511,1,74028902,47473344,26555558,0.0376569002993648
1747351728624222,47675484,1,512,1,74119037,47565904,26553133,0.0376603393656033
1747351728718552,47768044,1,513,1,74213367,47658464,26554903,0.0376578291398767
1747351728813244,47860604,1,514,1,74308059,47751024,26557035,0.0376548059676089
1747351728907115,47953164,1,515,1,74401930,47843584,26558346,0.0376529472129024
1747351728997603,48045724,1,516,1,74492418,47936144,26556274,0.037655885008567
1747351729091450,48138284,1,517,1,74586265,48028704,26557561,0.0376540601751794
1747351729185910,48230844,1,518,1,74680725,48121264,26559461,0.0376513664942221
1747351729279451,48323404,1,519,1,74774266,48213824,26560442,0.0376499758550704
1747351729373669,48415964,1,520,1,74868484,48306384,26562100,0.0376476257524819
1747351729463847,48508524,1,521,1,74958662,48398944,26559718,0.03765100216802
1747351729558253,48601084,1,522,1,75053068,48491504,26561564,0.0376483854640487
1747351729652737,48693644,1,523,1,75147552,48584064,26563488,0.0376456585821861
1747351729746940,48786204,1,524,1,75241755,48676624,26565131,0.0376433302738089
1747351729836666,48878764,1,525,1,75331481,48769184,26562297,0.0376473465378389
1747351729931090,48971324,1,526,1,75425905,48861744,26564161,0.0376447048337043
1747351730025331,49063884,1,527,1,75520146,48954304,26565842,0.03764232279933
1747351730118770,49156444,1,528,1,75613585,49046864,26566721,0.0376410773463537
1747351730209365,49249004,1,529,1,75704180,49139424,26564756,0.0376438616639279
1747351730304142,49341564,1,530,1,75798957,49231984,26566973,0.0376407203033631
1747351730397384,49434124,1,531,1,75892199,49324544,26567655,0.037639754054319
1747351730492321,49526684,1,532,1,75987136,49417104,26570032,0.0376363867382621
1747351730582570,49619244,1,533,1,76077385,49509664,26567721,0.0376396605489797
1747351730675816,49711804,1,534,1,76170631,49602224,26568407,0.0376386886876582
1747351730771088,49804364,1,535,1,76265903,49694784,26571119,0.0376348470683526
1747351730864401,49896924,1,536,1,76359216,49787344,26571872,0.0376337805631458
1747351730958400,49989484,1,537,1,76453215,49879904,26573311,0.0376317426157395
1747351731049466,50082044,1,538,1,76544281,49972464,26571817,0.0376338584598862
1747351731143109,50174604,1,539,1,76637924,50065024,26572900,0.0376323246615913
1747351731236920,50267172,1,540,1,76731735,50157592,26574143,0.0376305644174489
1747351731331506,50359724,1,541,1,76826321,50250144,26576177,0.0376276843731135
1747351731421564,50452284,1,542,1,76916379,50342704,26573675,0.0376312271449093
1747351731516478,50544844,1,543,1,77011293,50435264,26576029,0.0376278939189899
1747351731610296,50637404,1,544,1,77105111,50527824,26577287,0.03762611285343
1747351731704100,50729964,1,545,1,77198915,50620384,26578531,0.0376243517747463
1747351731794778,50822524,1,546,1,77289593,50712944,26576649,0.0376270161072601
1747351731888890,50915084,1,547,1,77383705,50805504,26578201,0.0376248189258558
1747351731983434,51007644,1,548,1,77478249,50898064,26580185,0.0376220105315294
1747351732077227,51100204,1,549,1,77572042,50990624,26581418,0.0376202654049531
1747351732167086,51192764,1,550,1,77661901,51083184,26578717,0.0376240884765054
1747351732261663,51285324,1,551,1,77756478,51175744,26580734,0.0376212334843725
1747351732356065,51377884,1,552,1,77850880,51268304,26582576,0.037618626577048
1747351732450209,51470444,1,553,1,77945024,51360864,26584160,0.0376163850954854
1747351732544362,51563004,1,554,1,78039177,51453424,26585753,0.0376141311476112
1747351732633829,51655564,1,555,1,78128644,51545984,26582660,0.0376185077038941
1747351732728806,51748124,1,556,1,78223621,51638544,26585077,0.0376150875921856
1747351732822019,51840684,1,557,1,78316834,51731104,26585730,0.0376141636885652
1747351732916355,51933244,1,558,1,78411170,51823664,26587506,0.0376116511266607
1747351733006432,52025804,1,559,1,78501247,51916224,26585023,0.0376151639966608
1747351733101515,52118364,1,560,1,78596330,52008784,26587546,0.0376115945412938
1747351733194903,52210924,1,561,1,78689718,52101344,26588374,0.0376104232624379
1747351733289388,52303484,1,562,1,78784203,52193904,26590299,0.0376077004624882
1747351733379477,52396052,1,563,1,78874292,52286472,26587820,0.0376112069361083
1747351733473477,52488604,1,564,1,78968292,52379024,26589268,0.0376091587026765
1747351733568467,52581164,1,565,1,79063282,52471584,26591698,0.0376057219061377
1747351733662378,52673724,1,566,1,79157193,52564144,26593049,0.0376038114320776
1747351733752015,52766284,1,567,1,79246830,52656704,26590126,0.0376079451447503
1747351733846407,52858844,1,568,1,79341222,52749264,26591958,0.0376053542202495
1747351733941127,52951404,1,569,1,79435942,52841824,26594118,0.0376022998769878
1747351734035287,53043964,1,570,1,79530102,52934384,26595718,0.0376000377203578
1747351734128627,53136524,1,571,1,79623442,53026944,26596498,0.0375989350176854
1747351734218890,53229084,1,572,1,79713705,53119504,26594201,0.0376021825209187
1747351734313621,53321644,1,573,1,79808436,53212064,26596372,0.0375991131421984
1747351734408058,53414204,1,574,1,79902873,53304624,26598249,0.0375964598271111
1747351734501363,53506764,1,575,1,79996178,53397184,26598994,0.0375954068037309
1747351734592364,53599324,1,576,1,80087179,53489744,26597435,0.0375976104462704
1747351734685737,53691884,1,577,1,80180552,53582304,26598248,0.037596461240605
1747351734796476,53784444,1,578,1,80291291,53674864,26616427,0.0375707828853211
1747351734874269,53877004,1,579,1,80369084,53767424,26601660,0.0375916390180161
1747351734965150,53969564,1,580,1,80459965,53859984,26599981,0.0375940118152716
1747351735059151,54062124,1,581,1,80553966,53952544,26601422,0.0375919753462803
1747351735153160,54154684,1,582,1,80647975,54045104,26602871,0.0375899277938836
1747351735246708,54247244,1,583,1,80741523,54137664,26603859,0.0375885317990897
1747351735337837,54339804,1,584,1,80832652,54230224,26602428,0.0375905537644909
1747351735431957,54432364,1,585,1,80926772,54322784,26603988,0.0375883495361672
1747351735526142,54524924,1,586,1,81020957,54415344,26605613,0.037586053739863
1747351735619837,54617484,1,587,1,81114652,54507904,26606748,0.0375844503807831
1747351735714341,54710044,1,588,1,81209156,54600464,26608692,0.0375817045046784
1747351735804301,54802604,1,589,1,81299116,54693024,26606092,0.037585377063268
1747351735898303,54895164,1,590,1,81393118,54785584,26607534,0.0375833401171262
1747351735992028,54987724,1,591,1,81486843,54878144,26608699,0.0375816946179894
1747351736087036,55080284,1,592,1,81581851,54970704,26611147,0.0375782374205816
1747351736176698,55172844,1,593,1,81671513,55063264,26608249,0.0375823302014349
1747351736270962,55265404,1,594,1,81765777,55155824,26609953,0.0375799235722062
1747351736364995,55357964,1,595,1,81859810,55248384,26611426,0.0375778434421364
1747351736459559,55450524,1,596,1,81954374,55340944,26613430,0.0375750138182113
1747351736549568,55543084,1,597,1,82044383,55433504,26610879,0.0375786158736056
1747351736643925,55635644,1,598,1,82138740,55526064,26612676,0.037576078407147
1747351736737565,55728204,1,599,1,82232380,55618624,26613756,0.037574553550427
1747351736832432,55820764,1,600,1,82327247,55711184,26616063,0.0375712967015444
1747351736922043,55913324,1,601,1,82416858,55803744,26613114,0.0375754599781145
1747351737016619,56005884,1,602,1,82511434,55896304,26615130,0.0375726137726924
1747351737110613,56098444,1,603,1,82605428,55988864,26616564,0.0375705895020859
1747351737205192,56191012,1,604,1,82700007,56081432,26618575,0.0375677510911083
1747351737299564,56283564,1,605,1,82794379,56173984,26620395,0.037565182635344
1747351737389201,56376124,1,606,1,82884016,56266544,26617472,0.0375693078591385
1747351737483776,56468684,1,607,1,82978591,56359104,26619487,0.0375664639968456
1747351737578121,56561244,1,608,1,83072936,56451664,26621272,0.0375639451037501
1747351737671722,56653804,1,609,1,83166537,56544224,26622313,0.0375624762581673
1747351737761891,56746364,1,610,1,83256706,56636784,26619922,0.0375658501178177
1747351737856270,56838924,1,611,1,83351085,56729344,26621741,0.0375632833329721
1747351737950535,56931484,1,612,1,83445350,56821904,26623446,0.0375608777316054
1747351738044575,57024044,1,613,1,83539390,56914464,26624926,0.0375587898347586
1747351738134733,57116604,1,614,1,83629548,57007024,26622524,0.0375621785522665
1747351738228989,57209164,1,615,1,83723804,57099584,26624220,0.0375597857890296
1747351738322559,57301724,1,616,1,83817374,57192144,26625230,0.037558360998196
1747351738417289,57394284,1,617,1,83912104,57284704,26627400,0.0375553001795143
1747351738511861,57486844,1,618,1,84006676,57377264,26629412,0.0375524626679702
1747351738601999,57579404,1,619,1,84096814,57469824,26626990,0.0375558784526527
1747351738695689,57671964,1,620,1,84190504,57562384,26628120,0.0375542847185606
1747351738789872,57764524,1,621,1,84284687,57654944,26629743,0.0375519959017253
1747351738884639,57857084,1,622,1,84379454,57747504,26631950,0.0375488839532967
1747351738974323,57949644,1,623,1,84469138,57840064,26629074,0.0375529393173791
1747351739068515,58042204,1,624,1,84563330,57932624,26630706,0.0375506379740739
1747351739162670,58134764,1,625,1,84657485,58025184,26632301,0.0375483890783601
1747351739257038,58227324,1,626,1,84751853,58117744,26634109,0.0375458401856056
1747351739347390,58319892,1,627,1,84842205,58210312,26631893,0.0375489643188338
1747351739441070,58412444,1,628,1,84935885,58302864,26633021,0.0375473739911067
1747351739535649,58505004,1,629,1,85030464,58395424,26635040,0.0375445278099826
1747351739629891,58597564,1,630,1,85124706,58487984,26636722,0.0375421570266791
1747351739719732,58690124,1,631,1,85214547,58580544,26634003,0.0375459896133525
1747351739813968,58782684,1,632,1,85308783,58673104,26635679,0.0375436271025792
1747351739908190,58875244,1,633,1,85403005,58765664,26637341,0.0375412846199626
1747351740002236,58967804,1,634,1,85497051,58858224,26638827,0.0375391904455853
1747351740096342,59060364,1,635,1,85591157,58950784,26640373,0.0375370119630081
1747351740186140,59152924,1,636,1,85680955,59043344,26637611,0.0375409040998458
1747351740281167,59245484,1,637,1,85775982,59135904,26640078,0.0375374276306548
1747351740375422,59338044,1,638,1,85870237,59228464,26641773,0.0375350394284944
1747351740469506,59430604,1,639,1,85964321,59321024,26643297,0.0375328924194329
1747351740559843,59523164,1,640,1,86054658,59413584,26641074,0.0375360242608837
1747351740653710,59615724,1,641,1,86148525,59506144,26642381,0.0375341828494983
1747351740747406,59708284,1,642,1,86242221,59598704,26643517,0.037532582504029
1747351740841539,59800844,1,643,1,86336354,59691264,26645090,0.037530366758003
1747351740932471,59893404,1,644,1,86427286,59783824,26643462,0.0375326599824001
1747351741026581,59985964,1,645,1,86521396,59876384,26645012,0.0375304766235421
1747351741119936,60078524,1,646,1,86614751,59968944,26645807,0.0375293568702948
1747351741214520,60171084,1,647,1,86709335,60061504,26647831,0.0375265063786992
1747351741304562,60263644,1,648,1,86799377,60154064,26645313,0.0375300526587921
1747351741399540,60356204,1,649,1,86894355,60246624,26647731,0.0375266472030958
1747351741492979,60448764,1,650,1,86987794,60339184,26648610,0.0375254093928351
1747351741587063,60541324,1,651,1,87081878,60431744,26650134,0.0375232634852792
1747351741681501,60633884,1,652,1,87176316,60524304,26652012,0.0375206194564222
1747351741771549,60726444,1,653,1,87266364,60616864,26649500,0.037524156175538
1747351741865635,60819004,1,654,1,87360450,60709424,26651026,0.0375220075955049
1747351741960299,60911564,1,655,1,87455114,60801984,26653130,0.0375190456055255
1747351742053988,61004124,1,656,1,87548803,60894544,26654259,0.0375174564034963
1747351742144606,61096684,1,657,1,87639421,60987104,26652317,0.0375201900832861
1747351742238411,61189244,1,658,1,87733226,61079664,26653562,0.0375184374981475
1747351742333254,61281804,1,659,1,87828069,61172224,26655845,0.0375152241468991
1747351742427064,61374364,1,660,1,87921879,61264784,26657095,0.0375134649893396
1747351742517477,61466924,1,661,1,88012292,61357344,26654948,0.0375164866200451
1747351742610751,61559484,1,662,1,88105566,61449904,26655662,0.0375154817014111
1747351742705736,61652044,1,663,1,88200551,61542464,26658087,0.0375120690393125
1747351742800604,61744604,1,664,1,88295419,61635024,26660395,0.0375088216059814
1747351742890670,61837164,1,665,1,88385485,61727584,26657901,0.0375123307720289
1747351742984661,61929724,1,666,1,88479476,61820144,26659332,0.0375103172127493
1747351743078056,62022284,1,667,1,88572871,61912704,26660167,0.0375091423845919
1747351743172498,62114852,1,668,1,88667313,62005272,26662041,0.0375065059722922
1747351743267170,62207404,1,669,1,88761985,62097824,26664161,0.0375035239248667
1747351743357002,62299964,1,670,1,88851817,62190384,26661433,0.0375073612884948
1747351743450949,62392524,1,671,1,88945764,62282944,26662820,0.0375054101554149
1747351743545353,62485084,1,672,1,89040168,62375504,26664664,0.0375028164615162
1747351743639318,62577644,1,673,1,89134133,62468064,26666069,0.0375008404875874
1747351743729062,62670204,1,674,1,89223877,62560624,26663253,0.0375048010833486
1747351743823678,62762764,1,675,1,89318493,62653184,26665309,0.037501909315958
1747351743917525,62855324,1,676,1,89412340,62745744,26666596,0.0375000993752633
1747351744012060,62947884,1,677,1,89506875,62838304,26668571,0.0374973222224767
1747351744102669,63040444,1,678,1,89597484,62930864,26666620,0.0375000656251148
1747351744195838,63133004,1,679,1,89690653,63023424,26667229,0.0374992092354252
1747351744290213,63225564,1,680,1,89785028,63115984,26669044,0.037496657173013
1747351744384312,63318124,1,681,1,89879127,63208544,26670583,0.0374944934649535
1747351744475236,63410684,1,682,1,89970051,63301104,26668947,0.037496793555441
1747351744569119,63503244,1,683,1,90063934,63393664,26670270,0.0374949334971112
1747351744663113,63595804,1,684,1,90157928,63486224,26671704,0.0374929175878676
1747351744757716,63688364,1,685,1,90252531,63578784,26673747,0.0374900459241815
1747351744851745,63780924,1,686,1,90346560,63671344,26675216,0.0374879813531781
1747351744942202,63873484,1,687,1,90437017,63763904,26673113,0.0374909370346085
1747351745036021,63966044,1,688,1,90530836,63856464,26674372,0.0374891675050494
1747351745130016,64058604,1,689,1,90624831,63949024,26675807,0.0374871508104703
1747351745224255,64151164,1,690,1,90719070,64041584,26677486,0.0374847914829755
1747351745314541,64243732,1,691,1,90809356,64134152,26675204,0.0374879982173707
1747351745408871,64336284,1,692,1,90903686,64226704,26676982,0.0374854996715895
1747351745502653,64428844,1,693,1,90997468,64319264,26678204,0.0374837826414401
1747351745596655,64521404,1,694,1,91091470,64411824,26679646,0.037481756691974
1747351745687773,64613964,1,695,1,91182588,64504384,26678204,0.0374837826414401
1747351745780842,64706524,1,696,1,91275657,64596944,26678713,0.0374830674927984
1747351745875857,64799084,1,697,1,91370672,64689504,26681168,0.0374796185834143
1747351745970151,64891644,1,698,1,91464966,64782064,26682902,0.0374771829540879
1747351746060273,64984204,1,699,1,91555088,64874624,26680464,0.037480607533662
1747351746154349,65076764,1,700,1,91649164,64967184,26681980,0.0374784779840176
1747351746248708,65169324,1,701,1,91743523,65059744,26683779,0.0374759512136568
1747351746342277,65261884,1,702,1,91837092,65152304,26684788,0.0374745341802977
1747351746436444,65354444,1,703,1,91931259,65244864,26686395,0.0374722775406719
1747351746526867,65447004,1,704,1,92021682,65337424,26684258,0.0374752784956583
1747351746621194,65539564,1,705,1,92116009,65429984,26686025,0.0374727970913614
1747351746715324,65632124,1,706,1,92210139,65522544,26687595,0.0374705926105368
1747351746809764,65724684,1,707,1,92304579,65615104,26689475,0.037467953191286
1747351746899359,65817244,1,708,1,92394174,65707664,26686510,0.0374721160616356
1747351746993459,65909804,1,709,1,92488274,65800224,26688050,0.037469953780812
1747351747087962,66002364,1,710,1,92582777,65892784,26689993,0.0374672260123859
1747351747181882,66094924,1,711,1,92676697,65985344,26691353,0.0374653169511489
1747351747272647,66187484,1,712,1,92767462,66077904,26689558,0.0374678366723045
1747351747366584,66280044,1,713,1,92861399,66170464,26690935,0.0374659036860267
1747351747460507,66372604,1,714,1,92955322,66263024,26692298,0.0374639905488841
1747351747554677,66465164,1,715,1,93049492,66355584,26693908,0.0374617309687288
1747351747644629,66557724,1,716,1,93139444,66448144,26691300,0.0374653913447452
1747351747739154,66650284,1,717,1,93233969,66540704,26693265,0.0374626333646333
1747351747833004,66742844,1,718,1,93327819,66633264,26694555,0.0374608230030431
1747351747927467,66835404,1,719,1,93422282,66725824,26696458,0.0374581526882704
1747351748021593,66927964,1,720,1,93516408,66818384,26698024,0.0374559555418783
1747351748111834,67020524,1,721,1,93606649,66910944,26695705,0.0374592092623139
1747351748206539,67113084,1,722,1,93701354,67003504,26697850,0.0374561996565266
1747351748300561,67205644,1,723,1,93795376,67096064,26699312,0.0374541486312456
1747351748394390,67298204,1,724,1,93889205,67188624,26700581,0.037452368545838
1747351748484642,67390764,1,725,1,93979457,67281184,26698273,0.0374556062109335
1747351748578633,67483324,1,726,1,94073448,67373744,26699704,0.0374535987365253
1747351748672732,67575884,1,727,1,94167547,67466304,26701243,0.0374514399947597
1747351748766896,67668444,1,728,1,94261711,67558864,26702847,0.0374491903428874
1747351748857583,67761004,1,729,1,94352398,67651424,26700974,0.0374518173007471
1747351748951447,67853564,1,730,1,94446262,67743984,26702278,0.0374499883493086
1747351749045648,67946124,1,731,1,94540463,67836544,26703919,0.0374476869855694
1747351749139808,68038692,1,732,1,94634623,67929112,26705511,0.0374454546104734
1747351749229947,68131244,1,733,1,94724762,68021664,26703098,0.03744883833329
1747351749324300,68223804,1,734,1,94819115,68114224,26704891,0.0374463239711407
1747351749418450,68316364,1,735,1,94913265,68206784,26706481,0.0374440945626644
1747351749512053,68408924,1,736,1,95006868,68299344,26707524,0.037442632270966
1747351749606123,68501484,1,737,1,95100938,68391904,26709034,0.0374405154450737
1747351749697385,68594044,1,738,1,95192200,68484464,26707736,0.0374423350597744
1747351749790878,68686604,1,739,1,95285693,68577024,26708669,0.0374410271062178
1747351749885615,68779164,1,740,1,95380430,68669584,26710846,0.0374379755699239
1747351749979768,68871724,1,741,1,95474583,68762144,26712439,0.0374357429510648
1747351750069316,68964284,1,742,1,95564131,68854704,26709427,0.0374399645488463
1747351750163590,69056844,1,743,1,95658405,68947264,26711141,0.0374375621018959
1747351750258111,69149404,1,744,1,95752926,69039824,26713102,0.0374348138228199
1747351750352495,69241964,1,745,1,95847310,69132384,26714926,0.0374322579070591
1747351750442468,69334524,1,746,1,95937283,69224944,26712339,0.0374358830950745
1747351750536822,69427084,1,747,1,96031637,69317504,26714133,0.0374333690709707
1747351750630734,69519644,1,748,1,96125549,69410064,26715485,0.0374314746672201
1747351750724982,69612204,1,749,1,96219797,69502624,26717173,0.0374291097340276
1747351750814864,69704764,1,750,1,96309679,69595184,26714495,0.037432861822767
1747351750909033,69797324,1,751,1,96403848,69687744,26716104,0.0374306073969468
1747351751003926,69889884,1,752,1,96498741,69780304,26718437,0.0374273390318453
1747351751097432,69982444,1,753,1,96592247,69872864,26719383,0.0374260139165638
1747351751191908,70075004,1,754,1,96686723,69965424,26721299,0.0374233303553094
1747351751281651,70167572,1,755,1,96776466,70057992,26718474,0.0374272872021059
1747351751376475,70260124,1,756,1,96871290,70150544,26720746,0.0374241048509648
1747351751490286,70352684,1,757,1,96985101,70243104,26741997,0.0373943651253868
1747351751564704,70445244,1,758,1,97059519,70335664,26723855,0.0374197510052348
1747351751655013,70537804,1,759,1,97149828,70428224,26721604,0.0374229032059602
1747351751748303,70630364,1,760,1,97243118,70520784,26722334,0.037421880888099
1747351751842558,70722924,1,761,1,97337373,70613344,26724029,0.03741950736545
1747351751937446,70815484,1,762,1,97432261,70705904,26726357,0.0374162479383179
1747351752027797,70908044,1,763,1,97522612,70798464,26724148,0.0374193407400677
1747351752121096,71000604,1,764,1,97615911,70891024,26724887,0.0374183060156624
1747351752215859,71093164,1,765,1,97710674,70983584,26727090,0.0374152217843394
1747351752309579,71185724,1,766,1,97804394,71076144,26728250,0.0374135979721829
1747351752404606,71278284,1,767,1,97899421,71168704,26730717,0.0374101450402546
1747351752493923,71370844,1,768,1,97988738,71261264,26727474,0.0374146842309153
1747351752588684,71463404,1,769,1,98083499,71353824,26729675,0.0374116033958512
1747351752682285,71555964,1,770,1,98177100,71446384,26730716,0.0374101464397736
1747351752776971,71648524,1,771,1,98271786,71538944,26732842,0.0374071712988839
1747351752867231,71741084,1,772,1,98362046,71631504,26730542,0.0374103899576746
1747351752961168,71833644,1,773,1,98455983,71724064,26731919,0.0374084628941154
1747351753054685,71926204,1,774,1,98549500,71816624,26732876,0.0374071237228646
1747351753149453,72018764,1,775,1,98644268,71909184,26735084,0.0374040343392973
1747351753239446,72111324,1,776,1,98734261,72001744,26732517,0.0374076260757638
1747351753333701,72203884,1,777,1,98828516,72094304,26734212,0.0374052543609663
1747351753428352,72296444,1,778,1,98923167,72186864,26736303,0.0374023289607392
1747351753522436,72389004,1,779,1,99017251,72279424,26737827,0.0374001971065187
1747351753611986,72481564,1,780,1,99106801,72371984,26734817,0.0374044078925245
1747351753706679,72574124,1,781,1,99201494,72464544,26736950,0.0374014238722068
1747351753800653,72666684,1,782,1,99295468,72557104,26738364,0.037399445979567
1747351753894963,72759244,1,783,1,99389778,72649664,26740114,0.0373969983822806
1747351753989301,72851804,1,784,1,99484116,72742224,26741892,0.0373945119515103
1747351754079493,72944364,1,785,1,99574308,72834784,26739524,0.0373978235364249
1747351754173560,73036924,1,786,1,99668375,72927344,26741031,0.0373957159692159
1747351754267360,73129484,1,787,1,99762175,73019904,26742271,0.0373939819845517
1747351754361789,73222044,1,788,1,99856604,73112464,26744140,0.0373913687260087
1747351754451989,73314604,1,789,1,99946804,73205024,26741780,0.037394668567313
1747351754546568,73407164,1,790,1,100041383,73297584,26743799,0.0373918454891169
1747351754640170,73499724,1,791,1,100134985,73390144,26744841,0.0373903886734641
1747351754734143,73592284,1,792,1,100228958,73482704,26746254,0.0373884133456595
1747351754824327,73684844,1,793,1,100319142,73575264,26743878,0.0373917350355845
1747351754918525,73777404,1,794,1,100413340,73667824,26745516,0.0373894450194941
1747351755012958,73869964,1,795,1,100507773,73760384,26747389,0.0373868268039172
1747351755106980,73962532,1,796,1,100601795,73852952,26748843,0.0373847945498053
1747351755197341,74055084,1,797,1,100692156,73945504,26746652,0.0373878569923443
1747351755291435,74147644,1,798,1,100786250,74038064,26748186,0.0373857128105808
1747351755385527,74240204,1,799,1,100880342,74130624,26749718,0.0373835716698022
1747351755480085,74332764,1,800,1,100974900,74223184,26751716,0.0373807796105491
1747351755574190,74425324,1,801,1,101069005,74315744,26753261,0.0373786208716761
1747351755664165,74517884,1,802,1,101158980,74408304,26750676,0.0373822328826381
1747351755758699,74610444,1,803,1,101253514,74500864,26752650,0.0373794745567261
1747351755852552,74703004,1,804,1,101347367,74593424,26753943,0.0373776680319607
1747351755947079,74795564,1,805,1,101441894,74685984,26755910,0.0373749201578268
1747351756037017,74888124,1,806,1,101531832,74778544,26753288,0.0373785831483591
1747351756130929,74980684,1,807,1,101625744,74871104,26754640,0.0373766942855519
1747351756225675,75073244,1,808,1,101720490,74963664,26756826,0.0373736406552855
1747351756319693,75165804,1,809,1,101814508,75056224,26758284,0.0373716042478658
1747351756410224,75258364,1,810,1,101905039,75148784,26756255,0.0373744382388342
1747351756503910,75350924,1,811,1,101998725,75241344,26757381,0.0373728654534612
1747351756597656,75443484,1,812,1,102092471,75333904,26758567,0.0373712090038304
1747351756692268,75536044,1,813,1,102187083,75426464,26760619,0.0373683433854799
1747351756782735,75628604,1,814,1,102277550,75519024,26758526,0.0373712662648159
1747351756876158,75721164,1,815,1,102370973,75611584,26759389,0.0373700610279255
1747351756970462,75813724,1,816,1,102465277,75704144,26761133,0.0373676256532187
1747351757065102,75906284,1,817,1,102559917,75796704,26763213,0.0373647214928939
1747351757159484,75998844,1,818,1,102654299,75889264,26765035,0.0373621779310208
1747351757249386,76091412,1,819,1,102744201,75981832,26762369,0.0373658998573706
1747351757343881,76183964,1,820,1,102838696,76074384,26764312,0.0373631872173661
1747351757438106,76276524,1,821,1,102932921,76166944,26765977,0.0373608630090356
1747351757532104,76369084,1,822,1,103026919,76259504,26767415,0.0373588559074531
1747351757622271,76461644,1,823,1,103117086,76352064,26765022,0.03736219607815
1747351757716349,76554204,1,824,1,103211164,76444624,26766540,0.0373600771709754
1747351757810509,76646764,1,825,1,103305324,76537184,26768140,0.0373578440638759
1747351757904392,76739324,1,826,1,103399207,76629744,26769463,0.0373559977650653
1747351757994510,76831884,1,827,1,103489325,76722304,26767021,0.0373594058150886
1747351758088600,76924444,1,828,1,103583415,76814864,26768551,0.0373572704775839
1747351758183409,77017004,1,829,1,103678224,76907424,26770800,0.0373541321140944
1747351758276852,77109564,1,830,1,103771667,76999984,26771683,0.0373529000772943
1747351758368032,77202124,1,831,1,103862847,77092544,26770303,0.0373548256065685
1747351758461799,77294684,1,832,1,103956614,77185104,26771510,0.0373531414552261
1747351758555759,77387244,1,833,1,104050574,77277664,26772910,0.0373511881973233
1747351758649606,77479804,1,834,1,104144421,77370224,26774197,0.0373493927754397
1747351758743881,77572364,1,835,1,104238696,77462784,26775912,0.037347000542876
1747351758834408,77664924,1,836,1,104329223,77555344,26773879,0.0373498363834392
1747351758928768,77757484,1,837,1,104423583,77647904,26775679,0.0373473255337427
1747351759022633,77850044,1,838,1,104517448,77740464,26776984,0.0373455053787984
1747351759117169,77942604,1,839,1,104611984,77833024,26778960,0.0373427496810929
1747351759206812,78035164,1,840,1,104701627,77925584,26776043,0.037346817825173
1747351759301435,78127724,1,841,1,104796250,78018144,26778106,0.0373439406058068
1747351759395452,78220284,1,842,1,104890267,78110704,26779563,0.0373419088280118
1747351759489474,78312844,1,843,1,104984289,78203264,26781025,0.0373398702999605
1747351759580078,78405404,1,844,1,105074893,78295824,26779069,0.0373425976832876
1747351759673859,78497964,1,845,1,105168674,78388384,26780290,0.0373408951135331
1747351759767879,78590524,1,846,1,105262694,78480944,26781750,0.037338859484537
1747351759861957,78683084,1,847,1,105356772,78573504,26783268,0.0373367432234184
1747351759952777,78775644,1,848,1,105447592,78666064,26781528,0.0373391689973775
1747351760046657,78868204,1,849,1,105541472,78758624,26782848,0.0373373287262056
1747351760140154,78960764,1,850,1,105634969,78851184,26783785,0.0373360225225822
1747351760235059,79053324,1,851,1,105729874,78943744,26786130,0.0373327539289923
1747351760329517,79145884,1,852,1,105824332,79036304,26788028,0.0373301088083079
1747351760419262,79238444,1,853,1,105914077,79128864,26785213,0.037334032027298
1747351760513726,79331004,1,854,1,106008541,79221424,26787117,0.0373313783637111
1747351760607489,79423564,1,855,1,106102304,79313984,26788320,0.0373297018999325
1747351760701505,79516124,1,856,1,106196320,79406544,26789776,0.0373276730645302
1747351760792544,79608684,1,857,1,106287359,79499104,26788255,0.0373297924780841
1747351760886402,79701244,1,858,1,106381217,79591664,26789553,0.037327983785321
1747351760980652,79793804,1,859,1,106475467,79684224,26791243,0.037325629124412
1747351761074468,79886372,1,860,1,106569283,79776792,26792491,0.0373238904885701
1747351761164903,79978924,1,861,1,106659718,79869344,26790374,0.0373268398567336
1747351761259277,80071484,1,862,1,106754092,79961904,26792188,0.0373243125944025
1747351761353059,80164044,1,863,1,106847874,80054464,26793410,0.0373226102985771
1747351761447220,80256604,1,864,1,106942035,80147024,26795011,0.0373203802752684
1747351761537279,80349164,1,865,1,107032094,80239584,26792510,0.0373238640202056
1747351761631378,80441724,1,866,1,107126193,80332144,26794049,0.037321720207349
1747351761726359,80534284,1,867,1,107221174,80424704,26796470,0.037318348274978
1747351761819965,80626844,1,868,1,107314780,80517264,26797516,0.0373168916104015
1747351761914211,80719404,1,869,1,107409026,80609824,26799202,0.037314543918136
1747351762004209,80811964,1,870,1,107499024,80702384,26796640,0.0373181115244299
1747351762098226,80904524,1,871,1,107593041,80794944,26798097,0.0373160825561606
1747351762192944,80997084,1,872,1,107687759,80887504,26800255,0.0373130778046701
1747351762286490,81089644,1,873,1,107781305,80980064,26801241,0.0373117050811191
1747351762376889,81182204,1,874,1,107871704,81072624,26799080,0.0373147137886823
1747351762472494,81274764,1,875,1,107967309,81165184,26802125,0.0373104744493207
1747351762565219,81367324,1,876,1,108060034,81257744,26802290,0.0373102447589366
1747351762659253,81459884,1,877,1,108154068,81350304,26803764,0.0373081929836421
1747351762749896,81552444,1,878,1,108244711,81442864,26801847,0.0373108614492128
1747351762843531,81645004,1,879,1,108338346,81535424,26802922,0.0373093650013233
1747351762938134,81737564,1,880,1,108432949,81627984,26804965,0.0373065213851239
1747351763032454,81830124,1,881,1,108527269,81720544,26806725,0.0373040720192414
1747351763122376,81922684,1,882,1,108617191,81813104,26804087,0.0373077434049516
1747351763217147,82015252,1,883,1,108711962,81905672,26806290,0.0373046773723629
1747351763310344,82107804,1,884,1,108805159,81998224,26806935,0.037303779786835
1747351763404845,82200364,1,885,1,108899660,82090784,26808876,0.0373010789411685
1747351763499098,82292924,1,886,1,108993913,82183344,26810569,0.0372987234996765
1747351763589240,82385484,1,887,1,109084055,82275904,26808151,0.0373020877120544
1747351763684138,82478044,1,888,1,109178953,82368464,26810489,0.0372988347955906
1747351763777323,82570604,1,889,1,109272138,82461024,26811114,0.0372979653139366
1747351763872084,82663164,1,890,1,109366899,82553584,26813315,0.0372949036700609
1747351763962326,82755724,1,891,1,109457141,82646144,26810997,0.0372981280778182
1747351764056338,82848284,1,892,1,109551153,82738704,26812449,0.0372961082368865
1747351764150611,82940844,1,893,1,109645426,82831264,26814162,0.0372937256066402
1747351764244616,83033404,1,894,1,109739431,82923824,26815607,0.0372917159771919
1747351764335271,83125964,1,895,1,109830086,83016384,26813702,0.0372943653957219
1747351764429010,83218524,1,896,1,109923825,83108944,26814881,0.0372927256324575
1747351764522931,83311084,1,897,1,110017746,83201504,26816242,0.0372908329213317
1747351764617591,83403644,1,898,1,110112406,83294064,26818342,0.0372879128769407
1747351764712068,83496204,1,899,1,110206883,83386624,26820259,0.0372852476927981
1747351764802057,83588764,1,900,1,110296872,83479184,26817688,0.0372888222131602
1747351764896468,83681324,1,901,1,110391283,83571744,26819539,0.0372862486562502
1747351764989856,83773884,1,902,1,110484671,83664304,26820367,0.0372850975529156
1747351765084065,83866444,1,903,1,110578880,83756864,26822016,0.0372828052895054
1747351765174960,83959004,1,904,1,110669775,83849424,26820351,0.0372851197957849
1747351765268957,84051564,1,905,1,110763772,83941984,26821788,0.0372831222139254
1747351765363049,84144124,1,906,1,110857864,84034544,26823320,0.0372809928077508
1747351765456814,84236684,1,907,1,110951629,84127104,26824525,0.0372793180867135
1747351765547293,84329244,1,908,1,111042108,84219664,26822444,0.0372822103757584
1747351765641639,84421804,1,909,1,111136454,84312224,26824230,0.0372797280667515
1747351765735395,84514364,1,910,1,111230210,84404784,26825426,0.0372780659662217
1747351765829882,84606924,1,911,1,111324697,84497344,26827353,0.0372753882949242
1747351765919670,84699484,1,912,1,111414485,84589904,26824581,0.0372792402610128
1747351766014685,84792044,1,913,1,111509500,84682464,26827036,0.0372758287572283
1747351766108785,84884604,1,914,1,111603600,84775024,26828576,0.0372736890694459
1747351766202181,84977164,1,915,1,111696996,84867584,26829412,0.0372725276275156
1747351766296223,85069724,1,916,1,111791038,84960144,26830894,0.0372704688856062
1747351766387318,85162284,1,917,1,111882133,85052704,26829429,0.0372725040104282
1747351766480752,85254844,1,918,1,111975567,85145264,26830303,0.0372712898546095
1747351766575369,85347404,1,919,1,112070184,85237824,26832360,0.0372684325940767
1747351766669428,85439964,1,920,1,112164243,85330384,26833859,0.0372663506952168
1747351766759513,85532524,1,921,1,112254328,85422944,26831384,0.0372697882449895
1747351766853659,85625084,1,922,1,112348474,85515504,26832970,0.0372675853623359
1747351766948283,85717644,1,923,1,112443098,85608064,26835034,0.037264718949117
1747351767042191,85810212,1,924,1,112537006,85700632,26836374,0.0372628582385981
1747351767132630,85902764,1,925,1,112627445,85793184,26834261,0.037265792413661
1747351767226191,85995324,1,926,1,112721006,85885744,26835262,0.0372644023374916
1747351767321005,86087884,1,927,1,112815820,85978304,26837516,0.0372612726155431
1747351767414796,86180444,1,928,1,112909611,86070864,26838747,0.0372595635705347
1747351767505322,86273004,1,929,1,113000137,86163424,26836713,0.0372623875360592
1747351767599103,86365564,1,930,1,113093918,86255984,26837934,0.0372606922723634
1747351767693100,86458124,1,931,1,113187915,86348544,26839371,0.037258697307027
1747351767787588,86550684,1,932,1,113282403,86441104,26841299,0.0372560210293846
1747351767882019,86643244,1,933,1,113376834,86533664,26843170,0.0372534242416227
1747351767972279,86735804,1,934,1,113467094,86626224,26840870,0.037256616495665
1747351768066440,86828364,1,935,1,113561255,86718784,26842471,0.0372543943513993
1747351768160549,86920924,1,936,1,113655364,86811344,26844020,0.0372522446340004
1747351768254335,87013484,1,937,1,113749150,86903904,26845246,0.0372505433550506
1747351768344663,87106044,1,938,1,113839478,86996464,26843014,0.0372536407424292
1747351768438636,87198604,1,939,1,113933451,87089024,26844427,0.0372516798365634
1747351768533466,87291164,1,940,1,114028281,87181584,26846697,0.0372485300519464
1747351768627385,87383724,1,941,1,114122200,87274144,26848056,0.0372466445987746
1747351768717168,87476284,1,942,1,114211983,87366704,26845279,0.0372504975642085
1747351768812067,87568844,1,943,1,114306882,87459264,26847618,0.0372472522515777
1747351768905451,87661404,1,944,1,114400266,87551824,26848442,0.0372461091038355
1747351769000182,87753964,1,945,1,114494997,87644384,26850613,0.0372430975784426
1747351769090475,87846524,1,946,1,114585290,87736944,26848346,0.0372462422824854
1747351769184760,87939092,1,947,1,114679575,87829512,26850063,0.0372438604706439
1747351769278278,88031644,1,948,1,114773093,87922064,26851029,0.0372425205752822
1747351769372575,88124204,1,949,1,114867390,88014624,26852766,0.0372401115028522
1747351769466787,88216764,1,950,1,114961602,88107184,26854418,0.037237820607395
1747351769556790,88309324,1,951,1,115051605,88199744,26851861,0.0372413666225964
1747351769650694,88401884,1,952,1,115145509,88292304,26853205,0.037239502696233
1747351769745051,88494444,1,953,1,115239866,88384864,26855002,0.0372370108183198
1747351769839779,88587004,1,954,1,115334594,88477424,26857170,0.0372340049230801
1747351769929493,88679564,1,955,1,115424308,88569984,26854324,0.0372379509534479
1747351770023697,88772124,1,956,1,115518512,88662544,26855968,0.0372356714157538
1747351770117822,88864684,1,957,1,115612637,88755104,26857533,0.0372335016771644
1747351770212547,88957244,1,958,1,115707362,88847664,26859698,0.0372305005067443
1747351770302260,89049804,1,959,1,115797075,88940224,26856851,0.0372344471807212
1747351770396717,89142364,1,960,1,115891532,89032784,26858748,0.0372318173579796
1747351770490311,89234924,1,961,1,115985126,89125344,26859782,0.0372303840738543
1747351770584962,89327484,1,962,1,116079777,89217904,26861873,0.0372274859612358
1747351770674824,89420044,1,963,1,116169639,89310464,26859175,0.037231225456478
1747351770769099,89512604,1,964,1,116263914,89403024,26860890,0.0372288483367453
1747351770863892,89605164,1,965,1,116358707,89495584,26863123,0.0372257536847074
1747351770957249,89697724,1,966,1,116452064,89588144,26863920,0.0372246492693545
1747351771051735,89790284,1,967,1,116546550,89680704,26865846,0.0372219806515677
1747351771141579,89882844,1,968,1,116636394,89773264,26863130,0.0372257439844128
1747351771235825,89975404,1,969,1,116730640,89865824,26864816,0.0372234077463996
1747351771330220,90067964,1,970,1,116825035,89958384,26866651,0.0372208653769314
1747351771424142,90160524,1,971,1,116918957,90050944,26868013,0.0372189785675628
1747351771514781,90253084,1,972,1,117009596,90143504,26866092,0.037221639827631
1747351771608860,90345644,1,973,1,117103675,90236064,26867611,0.0372195354473458
1747351771702893,90438204,1,974,1,117197708,90328624,26869084,0.0372174950214156
1747351771797006,90530764,1,975,1,117291821,90421184,26870637,0.0372153440203148
1747351771885615,90623324,1,976,1,117380430,90513744,26866686,0.0372208168882459
1747351771981756,90715884,1,977,1,117476571,90606304,26870267,0.0372158564706483
1747351772075659,90808444,1,978,1,117570474,90698864,26871610,0.0372139964817887
1747351772169731,90901004,1,979,1,117664546,90791424,26873122,0.0372119026587234
1747351772259796,90993564,1,980,1,117754611,90883984,26870627,0.0372153578701382
1747351772354941,91086124,1,981,1,117849756,90976544,26873212,0.0372117780338278
1747351772448777,91178684,1,982,1,117943592,91069104,26874488,0.0372100112195625
1747351772543011,91271244,1,983,1,118037826,91161664,26876162,0.0372076935687469
1747351772637196,91363804,1,984,1,118132011,91254224,26877787,0.0372054440345107
1747351772727424,91456364,1,985,1,118222239,91346784,26875455,0.0372086723741049
1747351772821544,91548924,1,986,1,118316359,91439344,26877015,0.0372065127023964
1747351772915737,91641484,1,987,1,118410552,91531904,26878648,0.0372042522376869
1747351773010311,91734052,1,988,1,118505126,91624472,26880654,0.0372014758271878
1747351773099727,91826604,1,989,1,118594542,91717024,26877518,0.0372058164001601
1747351773194524,91919164,1,990,1,118689339,91809584,26879755,0.0372027200396729
1747351773288636,92011724,1,991,1,118783451,91902144,26881307,0.0372005721299191
1747351773382102,92104284,1,992,1,118876917,91994704,26882213,0.0371993183745698
1747351773473255,92196844,1,993,1,118968070,92087264,26880806,0.0372012654680071
1747351773567560,92289404,1,994,1,119062375,92179824,26882551,0.0371988506596714
1747351773661267,92381964,1,995,1,119156082,92272384,26883698,0.0371972635609877
1747351773754861,92474524,1,996,1,119249676,92364944,26884732,0.0371958329359578
1747351773845621,92567084,1,997,1,119340436,92457504,26882932,0.0371983234566824
1747351773939297,92659644,1,998,1,119434112,92550064,26884048,0.0371967792945467
1747351774033533,92752204,1,999,1,119528348,92642624,26885724,0.0371944605248495
1747351774127563,92844764,1,1000,1,119622378,92735184,26887194,0.0371924269970306
1747351774221772,92938364,1,1001,1,119716587,92828784,26887803,0.0371915846006458
1747351774316461,93031964,1,1002,1,119811276,92922384,26888892,0.0371900783416438
1747351774410370,93125564,1,1003,1,119905185,93015984,26889201,0.0371896509680596
1747351774505010,93219164,1,1004,1,119999825,93109584,26890241,0.0371882126307458
1747351774598831,93312764,1,1005,1,120093646,93203184,26890462,0.0371879069983996
1747351774693463,93406364,1,1006,1,120188278,93296784,26891494,0.0371864798586497
1747351774787199,93499964,1,1007,1,120282014,93390384,26891630,0.0371862917941381
1747351774881114,93593564,1,1008,1,120375929,93483984,26891945,0.0371858562108467
1747351774975746,93687164,1,1009,1,120470561,93577584,26892977,0.0371844292284933
1747351775069649,93780764,1,1010,1,120564464,93671184,26893280,0.0371840102806351
1747351775164048,93874364,1,1011,1,120658863,93764784,26894079,0.0371829055756101
1747351775258257,93967964,1,1012,1,120753072,93858384,26894688,0.0371820636104795
1747351775351947,94061564,1,1013,1,120846762,93951984,26894778,0.0371819391853689
1747351775446630,94155164,1,1014,1,120941445,94045584,26895861,0.0371804420018381
1747351775540536,94248764,1,1015,1,121035351,94139184,26896167,0.0371800189967589
1747351775634737,94342364,1,1016,1,121129552,94232784,26896768,0.0371791882206813
1747351775728751,94435964,1,1017,1,121223566,94326384,26897182,0.0371786159605865
1747351775823405,94529572,1,1018,1,121318220,94419992,26898228,0.03717717018385
1747351775917329,94623164,1,1019,1,121412144,94513584,26898560,0.0371767113183754
1747351776011525,94716764,1,1020,1,121506340,94607184,26899156,0.0371758876003395
1747351776105889,94810364,1,1021,1,121600704,94700784,26899920,0.0371748317467115
1747351776204194,94903964,1,1022,1,121699009,94794384,26904625,0.0371683307238067
1747351776298210,94997564,1,1023,1,121793025,94887984,26905041,0.0371677560350121
1747351776392641,95091164,1,1024,1,121887456,94981584,26905872,0.0371666080920923
1747351776487087,95184764,1,1025,1,121981902,95075184,26906718,0.0371654395010197
1747351776581438,95278364,1,1026,1,122076253,95168784,26907469,0.0371644021962823
1747351776674839,95371964,1,1027,1,122169654,95262384,26907270,0.0371646770556804
1747351776769380,95465564,1,1028,1,122264195,95355984,26908211,0.037163377379492
1747351776863455,95559164,1,1029,1,122358270,95449584,26908686,0.0371627213606788
1747351776958032,95652764,1,1030,1,122452847,95543184,26909663,0.0371613721063693
1747351777051694,95746364,1,1031,1,122546509,95636784,26909725,0.0371612864865768
1747351777145793,95839964,1,1032,1,122640608,95730384,26910224,0.0371605973997094
1747351777240449,95933564,1,1033,1,122735264,95823984,26911280,0.0371591392159718
1747351777334978,96027164,1,1034,1,122829793,95917584,26912209,0.0371578564955407
1747351777428590,96120764,1,1035,1,122923405,96011184,26912221,0.0371578399270725
1747351777523386,96214364,1,1036,1,123018201,96104784,26913417,0.0371561886771939
1747351777617752,96307964,1,1037,1,123112567,96198384,26914183,0.0371551311812065
1747351777711100,96401564,1,1038,1,123205915,96291984,26913931,0.0371554790714147
1747351777805402,96495164,1,1039,1,123300217,96385584,26914633,0.0371545099648953
1747351777899665,96588764,1,1040,1,123394480,96479184,26915296,0.0371535947440444
1747351777994094,96682364,1,1041,1,123488909,96572784,26916125,0.037152450436309
1747351778112355,96775964,1,1042,1,123607170,96666384,26940786,0.0371184419044047
1747351778182307,96869564,1,1043,1,123677122,96759984,26917138,0.0371510522403979
1747351778276638,96963164,1,1044,1,123771453,96853584,26917869,0.037150043341098
1747351778371268,97056764,1,1045,1,123866083,96947184,26918899,0.0371486218659983
1747351778464866,97150364,1,1046,1,123959681,97040784,26918897,0.0371486246260387
1747351778559014,97243964,1,1047,1,124053829,97134384,26919445,0.0371478683903029
1747351778653666,97337564,1,1048,1,124148481,97227984,26920497,0.0371464167247729
1747351778747723,97431164,1,1049,1,124242538,97321584,26920954,0.0371457861411597
1747351778841845,97524772,1,1050,1,124336660,97415192,26921468,0.0371450769326546
1747351778936121,97618364,1,1051,1,124430936,97508784,26922152,0.0371441332030218
1747351779030669,97711964,1,1052,1,124525484,97602384,26923100,0.0371428253061497
1747351779124862,97805564,1,1053,1,124619677,97695984,26923693,0.0371420072276117
1747351779218631,97899164,1,1054,1,124713446,97789584,26923862,0.0371417740887247
1747351779312967,97992764,1,1055,1,124807782,97883184,26924598,0.0371407587961016
1747351779407262,98086364,1,1056,1,124902077,97976784,26925293,0.037139800112853
1747351779501552,98179964,1,1057,1,124996367,98070384,26925983,0.0371388483755634
1747351779595291,98273564,1,1058,1,125090106,98163984,26926122,0.037138656654679
1747351779690117,98367164,1,1059,1,125184932,98257584,26927348,0.037136965734613
1747351779784291,98460764,1,1060,1,125279106,98351184,26927922,0.037136174116963
1747351779878541,98554364,1,1061,1,125373356,98444784,26928572,0.0371352777265723
1747351779972536,98647964,1,1062,1,125467351,98538384,26928967,0.0371347330181659
1747351780066348,98741564,1,1063,1,125561163,98631984,26929179,0.0371344406749273
1747351780160858,98835164,1,1064,1,125655673,98725584,26930089,0.0371331858576479
1747351780254917,98928764,1,1065,1,125749732,98819184,26930548,0.0371325529655022
1747351780348743,99022364,1,1066,1,125843558,98912784,26930774,0.0371322413533305
1747351780443359,99115964,1,1067,1,125938174,99006384,26931790,0.0371308405419766
1747351780537068,99209564,1,1068,1,126031883,99099984,26931899,0.037130690264359
1747351780631229,99303164,1,1069,1,126126044,99193584,26932460,0.0371299168364122
1747351780729594,99396764,1,1070,1,126224409,99287184,26937225,0.0371233488230506
1747351780823813,99490364,1,1071,1,126318628,99380784,26937844,0.0371224957721189
1747351780917816,99583964,1,1072,1,126412631,99474384,26938247,0.0371219404143112
1747351781012569,99677564,1,1073,1,126507384,99567984,26939400,0.0371203516039704
1747351781106894,99771164,1,1074,1,126601709,99661584,26940125,0.0371193526384899
1747351781200395,99864764,1,1075,1,126695210,99755184,26940026,0.0371194890457789
1747351781295369,99958364,1,1076,1,126790184,99848784,26941400,0.0371175959675443
1747351781389115,100051964,1,1077,1,126883930,99942384,26941546,0.0371173948221085
1747351781483919,100146604,1,1078,1,126978734,100037024,26941710,0.0371171688805202
1747351781577503,100241244,1,1079,1,127072318,100131664,26940654,0.037118623772088
1747351781676123,100335884,1,1080,1,127170938,100226304,26944634,0.0371131409689959
1747351781770218,100430524,1,1081,1,127265033,100320944,26944089,0.0371138916591316
1747351781864596,100525164,1,1082,1,127359411,100415584,26943827,0.0371142525521708
1747351781963082,100619804,1,1083,1,127457897,100510224,26947673,0.0371089555673322
1747351782057412,100714444,1,1084,1,127552227,100604864,26947363,0.037109382465364
1747351782151667,100809084,1,1085,1,127646482,100699504,26946978,0.0371099126588517
1747351782245384,100903724,1,1086,1,127740199,100794144,26946055,0.0371111838077967
1747351782343556,100998364,1,1087,1,127838371,100888784,26949587,0.0371063200337726
1747351782437969,101093004,1,1088,1,127932784,100983424,26949360,0.0371066325879353
1747351782529054,101187644,1,1089,1,128023869,101078064,26945805,0.0371115281209821
1747351782630048,101282284,1,1090,1,128124863,101172704,26952159,0.037102779038963
1747351782724332,101376924,1,1091,1,128219147,101267344,26951803,0.0371032691208079
1747351782818822,101471564,1,1092,1,128313637,101361984,26951653,0.0371034756198441
1747351782913097,101566204,1,1093,1,128407912,101456624,26951288,0.0371039781104339
1747351783011218,101660844,1,1094,1,128506033,101551264,26954769,0.0370991864185517
1747351783105693,101755484,1,1095,1,128600508,101645904,26954604,0.0370994135176313
1747351783199336,101850132,1,1096,1,128694151,101740552,26953599,0.0371007968175233
1747351783293432,101944764,1,1097,1,128788247,101835184,26953063,0.037101534619646
1747351783391864,102039404,1,1098,1,128886679,101929824,26956855,0.0370963155753888
1747351783486510,102134044,1,1099,1,128981325,102024464,26956861,0.0370963073185709
1747351783580696,102228684,1,1100,1,129075511,102119104,26956407,0.0370969320948448
1747351783679126,102323324,1,1101,1,129173941,102213744,26960197,0.0370917170968743
1747351783773128,102417964,1,1102,1,129267943,102308384,26959559,0.0370925948751609
1747351783867568,102512604,1,1103,1,129362383,102403024,26959359,0.0370928700493212
1747351783961557,102607244,1,1104,1,129456372,102497664,26958708,0.0370937657694871
1747351784059742,102701884,1,1105,1,129554557,102592304,26962253,0.0370888886770701
1747351784153600,102796524,1,1106,1,129648415,102686944,26961471,0.037089964416259
1747351784248516,102891164,1,1107,1,129743331,102781584,26961747,0.0370895847364786
1747351784342410,102985804,1,1108,1,129837225,102876224,26961001,0.0370906109902966
1747351784440763,103080444,1,1109,1,129935578,102970864,26964714,0.0370855036697218
1747351784535515,103175084,1,1110,1,130030330,103065504,26964826,0.0370853496328884
1747351784629000,103269724,1,1111,1,130123815,103160144,26963671,0.0370869381991791
1747351784727139,103364364,1,1112,1,130221954,103254784,26967170,0.0370821261556181
1747351784821391,103459004,1,1113,1,130316206,103349424,26966782,0.0370826596959177
1747351784915678,103553644,1,1114,1,130410493,103444064,26966429,0.0370831451209205
1747351785010835,103648292,1,1115,1,130505650,103538712,26966938,0.0370824451778692
1747351785108556,103742924,1,1116,1,130603371,103633344,26970027,0.0370781979565685
1747351785202434,103837564,1,1117,1,130697249,103727984,26969265,0.0370792455782536
1747351785297161,103932204,1,1118,1,130791976,103822624,26969352,0.03707912596491
1747351785395272,104026844,1,1119,1,130890087,103917264,26972823,0.0370743544344616
1747351785489236,104121484,1,1120,1,130984051,104011904,26972147,0.0370752836249928
1747351785583352,104216124,1,1121,1,131078167,104106544,26971623,0.0370760039171539
1747351785677439,104310764,1,1122,1,131172254,104201184,26971070,0.0370767641031668
1747351785776042,104405404,1,1123,1,131270857,104295824,26975033,0.0370713170211877
1747351785870563,104500044,1,1124,1,131365378,104390464,26974914,0.037071480561532
1747351785963598,104594684,1,1125,1,131458413,104485104,26973309,0.037073686435728
1747351786058775,104689324,1,1126,1,131553590,104579744,26973846,0.0370729483663545
1747351786156859,104783964,1,1127,1,131651674,104674384,26977290,0.0370682155249841
1747351786251130,104878604,1,1128,1,131745945,104769024,26976921,0.0370687225573296
1747351786344708,104973244,1,1129,1,131839523,104863664,26975859,0.0370701818985634
1747351786443121,105067884,1,1130,1,131937936,104958304,26979632,0.0370649977731349
1747351786537818,105162524,1,1131,1,132032633,105052944,26979689,0.0370649194658989
1747351786631966,105257164,1,1132,1,132126781,105147584,26979197,0.0370655953918865
1747351786725866,105351804,1,1133,1,132220681,105242224,26978457,0.0370666120749604
1747351786824156,105446444,1,1134,1,132318971,105336864,26982107,0.0370615978952273
1747351786918159,105541084,1,1135,1,132412974,105431504,26981470,0.0370624728749026
1747351787013153,105635724,1,1136,1,132507968,105526144,26981824,0.0370619866173613
1747351787111207,105730364,1,1137,1,132606022,105620784,26985238,0.0370572977714704
1747351787205034,105825004,1,1138,1,132699849,105715424,26984425,0.0370584142519249
1747351787299667,105919644,1,1139,1,132794482,105810064,26984418,0.0370584238652099
1747351787393525,106014284,1,1140,1,132888340,105904704,26983636,0.0370594978378747
1747351787491855,106108924,1,1141,1,132986670,105999344,26987326,0.0370544306612667
1747351787586249,106203564,1,1142,1,133081064,106093984,26987080,0.0370547684299301
1747351787680503,106298204,1,1143,1,133175318,106188624,26986694,0.0370552984370742
1747351787774277,106392844,1,1144,1,133269092,106283264,26985828,0.0370564875756267
1747351787873239,106487484,1,1145,1,133368054,106377904,26990150,0.0370505536278975
1747351787966790,106582124,1,1146,1,133461605,106472544,26989061,0.0370520486059148
1747351788061142,106676764,1,1147,1,133555957,106567184,26988773,0.037052443992174
1747351788159623,106771404,1,1148,1,133654438,106661824,26992614,0.0370471714966175
1747351788253946,106866044,1,1149,1,133748761,106756464,26992297,0.0370476065819815
1747351788347564,106960684,1,1150,1,133842379,106851104,26991275,0.037049009355801
1747351788442700,107055324,1,1151,1,133937515,106945744,26991771,0.0370483285442811
1747351788540557,107149964,1,1152,1,134035372,107040384,26994988,0.0370439134849772
1747351788634831,107244604,1,1153,1,134129646,107135024,26994622,0.0370444157358454
1747351788728821,107339244,1,1154,1,134223636,107229664,26993972,0.0370453077450032
1747351788823223,107433884,1,1155,1,134318038,107324304,26993734,0.0370456343683315
1747351788921393,107528524,1,1156,1,134416208,107418944,26997264,0.037040790503808
1747351789015865,107623164,1,1157,1,134510680,107513584,26997096,0.0370410210046295
1747351789109515,107717804,1,1158,1,134604330,107608224,26996106,0.0370423793713063
1747351789207845,107812444,1,1159,1,134702660,107702864,26999796,0.0370373168745423
1747351789302305,107907092,1,1160,1,134797120,107797512,26999608,0.0370375747677521
1747351789396015,108001724,1,1161,1,134890830,107892144,26998686,0.0370388395938972
1747351789490465,108096364,1,1162,1,134985280,107986784,26998496,0.0370391002521029
1747351789589324,108191004,1,1163,1,135084139,108081424,27002715,0.037033313131661
1747351789683001,108285644,1,1164,1,135177816,108176064,27001752,0.0370346339007928
1747351789777262,108380284,1,1165,1,135272077,108270704,27001373,0.0370351537308862
1747351789875756,108474924,1,1166,1,135370571,108365344,27005227,0.0370298683288239
1747351789970074,108569564,1,1167,1,135464889,108459984,27004905,0.0370303098640783
1747351790064515,108664204,1,1168,1,135559330,108554624,27004706,0.0370305827436151
1747351790158182,108758844,1,1169,1,135652997,108649264,27003733,0.0370319170316192
1747351790256930,108853484,1,1170,1,135751745,108743904,27007841,0.0370262843297988
1747351790350282,108948124,1,1171,1,135845097,108838544,27006553,0.0370280501921144
1747351790445204,109042764,1,1172,1,135940019,108933184,27006835,0.0370276635525784
1747351790538749,109137404,1,1173,1,136033564,109027824,27005740,0.0370291649108671
1747351790637761,109232044,1,1174,1,136132576,109122464,27010112,0.0370231711738181
1747351790732201,109326684,1,1175,1,136227016,109217104,27009912,0.0370234453188888
1747351790825894,109421324,1,1176,1,136320709,109311744,27008965,0.0370247434509245
1747351790923687,109515964,1,1177,1,136418502,109406384,27012118,0.0370204217233169
1747351791018407,109610604,1,1178,1,136513222,109501024,27012198,0.0370203120827116
1747351791112993,109705252,1,1179,1,136607808,109595672,27012136,0.0370203970541241
1747351791207195,109799884,1,1180,1,136702010,109690304,27011706,0.0370209863827186
1747351791305064,109894524,1,1181,1,136799879,109784944,27014935,0.0370165613946507
1747351791399543,109989164,1,1182,1,136894358,109879584,27014774,0.0370167820023221
1747351791493729,110083804,1,1183,1,136988544,109974224,27014320,0.0370174041027129
1747351791591199,110178444,1,1184,1,137086014,110068864,27017150,0.0370135265932935
1747351791685522,110273084,1,1185,1,137180337,110163504,27016833,0.037013960888754
1747351791780058,110367724,1,1186,1,137274873,110258144,27016729,0.0370141033727658
1747351791873863,110462364,1,1187,1,137368678,110352784,27015894,0.0370152473947373
1747351791972105,110557004,1,1188,1,137466920,110447424,27019496,0.0370103128496549
1747351792066728,110651644,1,1189,1,137561543,110542064,27019479,0.0370103361356449
1747351792160818,110746284,1,1190,1,137655633,110636704,27018929,0.0370110895217201
1747351792255095,110840924,1,1191,1,137749910,110731344,27018566,0.037011586773332
1747351792352924,110935564,1,1192,1,137847739,110825984,27021755,0.0370072188131377
1747351792447831,111030204,1,1193,1,137942646,110920624,27022022,0.0370068531511076
1747351792541636,111124844,1,1194,1,138036451,111015264,27021187,0.0370079967249403
1747351792639030,111219484,1,1195,1,138133845,111109904,27023941,0.0370042252534521
1747351792734224,111314124,1,1196,1,138229039,111204544,27024495,0.0370034666697749
1747351792829076,111408764,1,1197,1,138323891,111299184,27024707,0.0370031763896644
1747351792923327,111503404,1,1198,1,138418142,111393824,27024318,0.0370037090297708
1747351793021608,111598044,1,1199,1,138516423,111488464,27027959,0.0369987241729943
1747351793115578,111692684,1,1200,1,138610393,111583104,27027289,0.0369996413624762
1747351793209706,111787324,1,1201,1,138704521,111677744,27026777,0.0370003422901665
1747351793307696,111881964,1,1202,1,138802511,111772384,27030127,0.036995756623711
1747351793401610,111976604,1,1203,1,138896425,111867024,27029401,0.0369967503164424
1747351793495500,112071244,1,1204,1,138990315,111961664,27028651,0.0369977769145785
1747351793590481,112165884,1,1205,1,139085296,112056304,27028992,0.036997310147563
1747351793688683,112260524,1,1206,1,139183498,112150944,27032554,0.0369924351210026
1747351793782663,112355164,1,1207,1,139277478,112245584,27031894,0.0369933383136231
1747351793877414,112449804,1,1208,1,139372229,112340224,27032005,0.036993186409961
1747351793971588,112544444,1,1209,1,139466403,112434864,27031539,0.0369938241400166
1747351794070052,112639084,1,1210,1,139564867,112529504,27035363,0.0369885915717129
1747351794163545,112733724,1,1211,1,139658360,112624144,27034216,0.0369901609131183
1747351794258122,112828364,1,1212,1,139752937,112718784,27034153,0.0369902471144555
1747351794356375,112923004,1,1213,1,139851190,112813424,27037766,0.0369853041852644
1747351794450790,113017644,1,1214,1,139945605,112908064,27037541,0.0369856119681889
1747351794545394,113112284,1,1215,1,140040209,113002704,27037505,0.0369856612139322
1747351794638643,113206924,1,1216,1,140133458,113097344,27036114,0.0369875641151683
1747351794736730,113301564,1,1217,1,140231545,113191984,27039561,0.0369828489449218
1747351794831746,113396204,1,1218,1,140326561,113286624,27039937,0.0369823346851732
1747351794925173,113490844,1,1219,1,140419988,113381264,27038724,0.0369839937713037
1747351795020277,113585484,1,1220,1,140515092,113475904,27039188,0.0369833591156657
1747351795118478,113680124,1,1221,1,140613293,113570544,27042749,0.0369784891321514
1747351795211987,113774764,1,1222,1,140706802,113665184,27041618,0.0369800357360273
1747351795306088,113869404,1,1223,1,140800903,113759824,27041079,0.0369807728456397
1747351795404655,113964052,1,1224,1,140899470,113854472,27044998,0.0369754140858135
1747351795499294,114058684,1,1225,1,140994109,113949104,27045005,0.0369754045155473
1747351795593413,114153324,1,1226,1,141088228,114043744,27044484,0.0369761168303303
1747351795687615,114247964,1,1227,1,141182430,114138384,27044046,0.0369767156881777
1747351795785747,114342604,1,1228,1,141280562,114233024,27047538,0.0369719417715579
1747351795880116,114437244,1,1229,1,141374931,114327664,27047267,0.0369723122118031
1747351795974355,114531884,1,1230,1,141469170,114422304,27046866,0.03697286036763
1747351796072664,114626524,1,1231,1,141567479,114516944,27050535,0.0369678455527774
1747351796166199,114721164,1,1232,1,141661014,114611584,27049430,0.0369693557313407
1747351796260823,114815804,1,1233,1,141755638,114706224,27049414,0.0369693775990858
1747351796355529,114910444,1,1234,1,141850344,114800864,27049480,0.0369692873948038
1747351796453656,115005084,1,1235,1,141948471,114895504,27052967,0.0369645222278207
1747351796547428,115099724,1,1236,1,142042243,114990144,27052099,0.0369657082801597
1747351796641459,115194364,1,1237,1,142136274,115084784,27051490,0.0369665404752196
1747351796736354,115289004,1,1238,1,142231169,115179424,27051745,0.0369661920146001
1747351796834223,115383644,1,1239,1,142329038,115274064,27054974,0.0369617801148136
1747351796928126,115478284,1,1240,1,142422941,115368704,27054237,0.0369627870118828
1747351797022744,115572924,1,1241,1,142517559,115463344,27054215,0.0369628170693549
1747351797120342,115667564,1,1242,1,142615157,115557984,27057173,0.03695877614413
1747351797214992,115762212,1,1243,1,142709807,115652632,27057175,0.0369587734122279
1747351797308993,115856844,1,1244,1,142803808,115747264,27056544,0.0369596353473673
1747351797403430,115951484,1,1245,1,142898245,115841904,27056341,0.0369599126504208
1747351797502144,116046124,1,1246,1,142996959,115936544,27060415,0.0369543482611039
1747351797595844,116140764,1,1247,1,143090659,116031184,27059475,0.036955631992121
1747351797689928,116235404,1,1248,1,143184743,116125824,27058919,0.0369563913473409
1747351797788865,116330044,1,1249,1,143283680,116220464,27063216,0.036950523544578
1747351797883044,116424684,1,1250,1,143377859,116315104,27062755,0.0369511529775885
1747351797976958,116519324,1,1251,1,143471773,116409744,27062029,0.0369521442756565
1747351798071747,116613964,1,1252,1,143566562,116504384,27062178,0.0369519408230926
1747351798169530,116708604,1,1253,1,143664345,116599024,27065321,0.0369476497249007
1747351798263573,116803244,1,1254,1,143758388,116693664,27064724,0.0369484647247834
1747351798357719,116897884,1,1255,1,143852534,116788304,27064230,0.0369491391404817
1747351798451725,116992524,1,1256,1,143946540,116882944,27063596,0.0369500047222106
1747351798550151,117087164,1,1257,1,144044966,116977584,27067382,0.0369448364086338
1747351798644867,117181804,1,1258,1,144139682,117072224,27067458,0.0369447326749338
1747351798738967,117276444,1,1259,1,144233782,117166864,27066918,0.0369454697428055
1747351798836969,117371084,1,1260,1,144331784,117261504,27070280,0.0369408812912167
1747351798931230,117465724,1,1261,1,144426045,117356144,27069901,0.0369413984927392
1747351799025918,117560364,1,1262,1,144520733,117450784,27069949,0.036941332988843
1747351799119516,117655004,1,1263,1,144614331,117545424,27068907,0.0369427550214716
1747351799217695,117749644,1,1264,1,144712510,117640064,27072446,0.0369379257419148
1747351799312030,117844284,1,1265,1,144806845,117734704,27072141,0.0369383418917624
1747351799406656,117938924,1,1266,1,144901471,117829344,27072127,0.0369383609939477
1747351799500157,118033564,1,1267,1,144994972,117923984,27070988,0.036939915159358
1747351799598515,118128204,1,1268,1,145093330,118018624,27074706,0.0369348424318993
1747351799693313,118222844,1,1269,1,145188128,118113264,27074864,0.0369346268923086
1747351799787387,118317484,1,1270,1,145282202,118207904,27074298,0.0369353990267817
1747351799886082,118412124,1,1271,1,145380897,118302544,27078353,0.0369298679280826
1747351799980091,118506764,1,1272,1,145474906,118397184,27077722,0.0369307285154932
1747351800074250,118601404,1,1273,1,145569065,118491824,27077241,0.0369313845528058
1747351800168023,118696044,1,1274,1,145662838,118586464,27076374,0.0369325671155229
1747351800266770,118790684,1,1275,1,145761585,118681104,27080481,0.0369269659575101
1747351800360479,118885324,1,1276,1,145855294,118775744,27079550,0.0369282355135148
1747351800454539,118979964,1,1277,1,145949354,118870384,27078970,0.0369290264733112
1747351800553313,119074604,1,1278,1,146048128,118965024,27083104,0.0369233895789788
1747351800647021,119169244,1,1279,1,146141836,119059664,27082172,0.0369246602525085
1747351800741772,119263884,1,1280,1,146236587,119154304,27082283,0.0369245089123394
1747351800836044,119358524,1,1281,1,146330859,119248944,27081915,0.0369250106574812
1747351800934088,119453164,1,1282,1,146428903,119343584,27085319,0.036920370035147
1747351801028366,119547804,1,1283,1,146523181,119438224,27084957,0.0369208634889101
1747351801122025,119642444,1,1284,1,146616840,119532864,27083976,0.0369222007876539
1747351801216115,119737084,1,1285,1,146710930,119627504,27083426,0.0369229505897813
1747351801315049,119831724,1,1286,1,146809864,119722144,27087720,0.0369170974891943
1747351801409150,119926364,1,1287,1,146903965,119816784,27087181,0.0369178320918666
1747351801503757,120021012,1,1288,1,146998572,119911432,27087140,0.0369178879719305
1747351801601222,120115644,1,1289,1,147096037,120006064,27089973,0.0369140271937517
1747351801695138,120210284,1,1290,1,147189953,120100704,27089249,0.0369150137753911
1747351801789745,120304924,1,1291,1,147284560,120195344,27089216,0.0369150587451478
1747351801884374,120399564,1,1292,1,147379189,120289984,27089205,0.0369150737350911
1747351801982773,120494204,1,1293,1,147477588,120384624,27092964,0.0369099519712941
1747351802080414,120591964,1,1294,1,147575229,120482384,27092845,0.0369101140910081
1747351802175086,120686612,1,1295,1,147669901,120577032,27092869,0.0369100813944805
1747351802272805,120784364,1,1296,1,147767620,120674784,27092836,0.0369101263522209
1747351802371596,120882124,1,1297,1,147866411,120772544,27093867,0.036908721815162
1747351802470503,120979884,1,1298,1,147965318,120870304,27095014,0.0369071593762601
1747351802564654,121074524,1,1299,1,148059469,120964944,27094525,0.0369078254739656
1747351802662845,121169164,1,1300,1,148157660,121059584,27098076,0.0369029889797342
1747351802756697,121263804,1,1301,1,148251512,121154224,27097288,0.0369040621334504
1747351802851316,121358444,1,1302,1,148346131,121248864,27097267,0.0369040907335784
1747351802949066,121453084,1,1303,1,148443881,121343504,27100377,0.0368998556735945
1747351803043790,121547724,1,1304,1,148538605,121438144,27100461,0.0368997412996037
1747351803138387,121642364,1,1305,1,148633202,121532784,27100418,0.0368997998481056
1747351803231523,121737004,1,1306,1,148726338,121627424,27098914,0.0369018478009856
1747351803330181,121831644,1,1307,1,148824996,121722064,27102932,0.0368963771152139
1747351803424582,121926284,1,1308,1,148919397,121816704,27102693,0.036896702478975
1747351803518547,122020924,1,1309,1,149013362,121911344,27102018,0.0368976214243529
1747351803613163,122115564,1,1310,1,149107978,122005984,27101994,0.0368976540988091
1747351803710525,122210204,1,1311,1,149205340,122100624,27104716,0.0368939486397865
1747351803804783,122304844,1,1312,1,149299598,122195264,27104334,0.0368944686115512
1747351803898969,122399484,1,1313,1,149393784,122289904,27103880,0.0368950866075263
1747351803997774,122494124,1,1314,1,149492589,122384544,27108045,0.0368894178831413
1747351804091712,122588764,1,1315,1,149586527,122479184,27107343,0.0368903732099453
1747351804186371,122683412,1,1316,1,149681186,122573832,27107354,0.0368903582400554
1747351804280527,122778044,1,1317,1,149775342,122668464,27106878,0.0368910060391314
1747351804378554,122872684,1,1318,1,149873369,122763104,27110265,0.0368863970898108
1747351804472570,122967324,1,1319,1,149967385,122857744,27109641,0.0368872461276783
1747351804566940,123061964,1,1320,1,150061755,122952384,27109371,0.0368876135119475
1747351804664893,123156604,1,1321,1,150159708,123047024,27112684,0.0368831060768458
1747351804760145,123251244,1,1322,1,150254960,123141664,27113296,0.0368822735531674
1747351804853651,123345884,1,1323,1,150348466,123236304,27112162,0.036883816200272
1747351804947445,123440524,1,1324,1,150442260,123330944,27111316,0.0368849671480351
1747351805046020,123535164,1,1325,1,150540835,123425584,27115251,0.0368796143542982
1747351805140172,123629804,1,1326,1,150634987,123520224,27114763,0.0368802780979498
1747351805234923,123724444,1,1327,1,150729738,123614864,27114874,0.0368801271213725
1747351805328488,123819084,1,1328,1,150823303,123709504,27113799,0.0368815893339033
1747351805427144,123913724,1,1329,1,150921959,123804144,27117815,0.0368761273723565
1747351805521746,124008364,1,1330,1,151016561,123898784,27117777,0.0368761790466821
1747351805615704,124103004,1,1331,1,151110519,123993424,27117095,0.0368771064894672
1747351805713912,124197644,1,1332,1,151208727,124088064,27120663,0.0368722549297559
1747351805807637,124292284,1,1333,1,151302452,124182704,27119748,0.0368734989720405
1747351805902545,124386924,1,1334,1,151397360,124277344,27120016,0.0368731345881211
1747351805996604,124481572,1,1335,1,151491419,124371992,27119427,0.036873935426438
1747351806095047,124576204,1,1336,1,151589862,124466624,27123238,0.0368687543869209
1747351806188506,124670844,1,1337,1,151683321,124561264,27122057,0.0368703597960877
1747351806282864,124765484,1,1338,1,151777679,124655904,27121775,0.0368707431574814
1747351806377113,124860124,1,1339,1,151871928,124750544,27121384,0.0368712747107596
1747351806475719,124954764,1,1340,1,151970534,124845184,27125350,0.0368658837581819
1747351806569897,125049404,1,1341,1,152064712,124939824,27124888,0.0368665116700205
1747351806664094,125144044,1,1342,1,152158909,125034464,27124445,0.0368671137787335
1747351806762061,125238684,1,1343,1,152256876,125129104,27127772,0.0368625923278918
1747351806855971,125333324,1,1344,1,152350786,125223744,27127042,0.0368635843156065
1747351806950665,125427964,1,1345,1,152445480,125318384,27127096,0.0368635109338647
1747351807045269,125522604,1,1346,1,152540084,125413024,27127060,0.0368635598549935
1747351807143098,125617244,1,1347,1,152637913,125507664,27130249,0.0368592267619806
1747351807237037,125711884,1,1348,1,152731852,125602304,27129548,0.03686017916701
1747351807331193,125806524,1,1349,1,152826008,125696944,27129064,0.0368608367763812
1747351807429763,125901164,1,1350,1,152924578,125791584,27132994,0.0368554977751441
1747351807523700,125995804,1,1351,1,153018515,125886224,27132291,0.0368564527042703
1747351807617925,126090444,1,1352,1,153112740,125980864,27131876,0.036857016448107
1747351807712123,126185084,1,1353,1,153206938,126075504,27131434,0.036857616888219
1747351807810667,126279724,1,1354,1,153305482,126170144,27135338,0.0368523141300101
1747351807904670,126374364,1,1355,1,153399485,126264784,27134701,0.0368531792555959
1747351807998870,126469004,1,1356,1,153493685,126359424,27134261,0.0368537768542876
1747351808093691,126563644,1,1357,1,153588506,126454064,27134442,0.0368535310215702
1747351808191896,126658284,1,1358,1,153686711,126548704,27138007,0.0368486897361328
1747351808285634,126752924,1,1359,1,153780449,126643344,27137105,0.0368499145358357
1747351808380053,126847564,1,1360,1,153874868,126737984,27136884,0.0368502146377601
1747351808477786,126942204,1,1361,1,153972601,126832624,27139977,0.0368460150132035
1747351808572976,127036844,1,1362,1,154067791,126927264,27140527,0.036845268332483
1747351808666836,127131484,1,1363,1,154161651,127021904,27139747,0.0368463272704789
1747351808760799,127226124,1,1364,1,154255614,127116544,27139070,0.0368472464236983
1747351808859460,127320764,1,1365,1,154354275,127211184,27143091,0.03684178784207
1747351808953020,127415404,1,1366,1,154447835,127305824,27142011,0.0368432538031172
1747351809048033,127510044,1,1367,1,154542848,127400464,27142384,0.0368427474904194
1747351809145750,127604684,1,1368,1,154640565,127495104,27145461,0.0368385712808487
1747351809240001,127699324,1,1369,1,154734816,127589744,27145072,0.0368390991926637
1747351809334099,127793964,1,1370,1,154828914,127684384,27144530,0.0368398347659731
1747351809428268,127888604,1,1371,1,154923083,127779024,27144059,0.0368404740057483
1747351809526277,127983244,1,1372,1,155021092,127873664,27147428,0.0368359020972447
1747351809620930,128077884,1,1373,1,155115745,127968304,27147441,0.0368358844577652
1747351809715216,128172524,1,1374,1,155210031,128062944,27147087,0.0368363648003927
1747351809809692,128267164,1,1375,1,155304507,128157584,27146923,0.0368365873362517
1747351809907695,128361804,1,1376,1,155402510,128252224,27150286,0.0368320245318962
1747351810001760,128456444,1,1377,1,155496575,128346864,27149711,0.0368328045922846
1747351810095983,128551084,1,1378,1,155590798,128441504,27149294,0.0368333703263149
1747351810194637,128645724,1,1379,1,155689452,128536144,27153308,0.0368279253489114
1747351810289040,128740372,1,1380,1,155783855,128630792,27153063,0.0368282576444506
1747351810382595,128835004,1,1381,1,155877410,128725424,27151986,0.0368297184596368
1747351810477509,128929644,1,1382,1,155972324,128820064,27152260,0.0368293468020709
1747351810575701,129024284,1,1383,1,156070516,128914704,27155812,0.036824529496669
1747351810669206,129118924,1,1384,1,156164021,129009344,27154677,0.0368260686731792
1747351810764168,129213564,1,1385,1,156258983,129103984,27154999,0.0368256319950518
1747351810857834,129308204,1,1386,1,156352649,129198624,27154025,0.0368269529102959
1747351810955971,129402844,1,1387,1,156450786,129293264,27157522,0.0368222108040637
1747351811050347,129497484,1,1388,1,156545162,129387904,27157258,0.0368225687585985
1747351811144538,129592124,1,1389,1,156639353,129482544,27156809,0.0368231775684691
1747351811242591,129686764,1,1390,1,156737406,129577184,27160222,0.0368185503049275
1747351811337618,129781404,1,1391,1,156832433,129671824,27160609,0.0368180256930174
1747351811430907,129876044,1,1392,1,156925722,129766464,27159258,0.0368198571551549
1747351811525555,129970684,1,1393,1,157020370,129861104,27159266,0.0368198463095431
1747351811624005,130065324,1,1394,1,157118820,129955744,27163076,0.0368146818129139
1747351811717829,130159964,1,1395,1,157212644,130050384,27162260,0.0368157877879086
1747351811812359,130254604,1,1396,1,157307174,130145024,27162150,0.0368159368827578
1747351811910279,130349244,1,1397,1,157405094,130239664,27165430,0.0368114916642217
1747351812004513,130443884,1,1398,1,157499328,130334304,27165024,0.0368120418373272
1747351812099338,130538532,1,1399,1,157594153,130428952,27165201,0.036811801981513
1747351812193287,130633164,1,1400,1,157688102,130523584,27164518,0.0368127275440705
1747351812290989,130727804,1,1401,1,157785804,130618224,27167580,0.0368085784600615
1747351812385257,130822444,1,1402,1,157880072,130712864,27167208,0.0368090824791417
1747351812479726,130917084,1,1403,1,157974541,130807504,27167037,0.0368093141699626
1747351812573804,131011724,1,1404,1,158068619,130902144,27166475,0.0368100756539079
1747351812671820,131106364,1,1405,1,158166635,130996784,27169851,0.0368055018041872
1747351812766453,131201004,1,1406,1,158261268,131091424,27169844,0.0368055112867044
1747351812861240,131295644,1,1407,1,158356055,131186064,27169991,0.0368053121548696
1747351812958662,131390284,1,1408,1,158453477,131280704,27172773,0.0368015439572545
1747351813053137,131484924,1,1409,1,158547952,131375344,27172608,0.0368017674269617
1747351813147155,131579564,1,1410,1,158641970,131469984,27171986,0.036802609864439
1747351813241782,131674204,1,1411,1,158736597,131564624,27171973,0.0368026274720646
1747351813339983,131768844,1,1412,1,158834798,131659264,27175534,0.0367978049667763
1747351813434597,131863484,1,1413,1,158929412,131753904,27175508,0.0367978401728497
1747351813528294,131958124,1,1414,1,159023109,131848544,27174565,0.0367991171155821
1747351813626310,132052764,1,1415,1,159121125,131943184,27177941,0.0367945459886015
1747351813720806,132147404,1,1416,1,159215621,132037824,27177797,0.0367947409423949
1747351813814720,132242044,1,1417,1,159309535,132132464,27177071,0.0367957238659015
1747351813909259,132336684,1,1418,1,159404074,132227104,27176970,0.0367958606128644
1747351814007430,132431324,1,1419,1,159502245,132321744,27180501,0.0367910804881779
1747351814101508,132525964,1,1420,1,159596323,132416384,27179939,0.0367918412178923
1747351814195380,132620604,1,1421,1,159690195,132511024,27179171,0.0367928808424657
1747351814290284,132715244,1,1422,1,159785099,132605664,27179435,0.0367925234648917
1747351814388704,132809884,1,1423,1,159883519,132700304,27183215,0.0367874072290566
1747351814483142,132904524,1,1424,1,159977957,132794944,27183013,0.0367876806003808
1747351814576566,132999164,1,1425,1,160071381,132889584,27181797,0.0367893263274683
1747351814675306,133093804,1,1426,1,160170121,132984224,27185897,0.0367837780007773
1747351814769379,133188444,1,1427,1,160264194,133078864,27185330,0.0367845451940439
1747351814863913,133283084,1,1428,1,160358728,133173504,27185224,0.0367846886234963
1747351814954028,133377724,1,1429,1,160448843,133268144,27180699,0.0367908124805767
1747351815056112,133472364,1,1430,1,160550927,133362784,27188143,0.0367807393097792
1747351815149956,133567004,1,1431,1,160644771,133457424,27187347,0.0367818161882437
1747351815243910,133661644,1,1432,1,160738725,133552064,27186661,0.0367827443024356
1747351815343277,133756284,1,1433,1,160838092,133646704,27191388,0.0367763499237332
1747351815437040,133850924,1,1434,1,160931855,133741344,27190511,0.0367775361044152
1747351815531385,133945564,1,1435,1,161026200,133835984,27190216,0.0367779351219571
1747351815625567,134040204,1,1436,1,161120382,133930624,27189758,0.0367785546307547
1747351815723151,134134844,1,1437,1,161217966,134025264,27192702,0.0367745728247233
1747351815817429,134229484,1,1438,1,161312244,134119904,27192340,0.0367750623888933
1747351815911949,134324124,1,1439,1,161406764,134214544,27192220,0.0367752246782351
1747351816006446,134418764,1,1440,1,161501261,134309184,27192077,0.0367754180749046
1747351816104555,134513404,1,1441,1,161599370,134403824,27195546,0.0367707270889137
1747351816198468,134608044,1,1442,1,161693283,134498464,27194819,0.0367717100819829
1747351816292914,134702684,1,1443,1,161787729,134593104,27194625,0.0367719724026347
1747351816390967,134797332,1,1444,1,161885782,134687752,27198030,0.0367673688131088
1747351816485659,134891964,1,1445,1,161980474,134782384,27198090,0.0367672877029232
1747351816579175,134986604,1,1446,1,162073990,134877024,27196966,0.0367688072265119
1747351816673894,135081244,1,1447,1,162168709,134971664,27197045,0.0367687004231525
1747351816771974,135175884,1,1448,1,162266789,135066304,27200485,0.0367640503468963
1747351816866763,135270524,1,1449,1,162361578,135160944,27200634,0.0367638489602852
1747351816960200,135365164,1,1450,1,162455015,135255584,27199431,0.0367654749836494
1747351817055256,135459804,1,1451,1,162550071,135350224,27199847,0.0367649126849867
1747351817153035,135554444,1,1452,1,162647850,135444864,27202986,0.0367606703175894
1747351817247320,135649084,1,1453,1,162742135,135539504,27202631,0.0367611500519931
1747351817341933,135743724,1,1454,1,162836748,135634144,27202604,0.0367611865393474
1747351817439706,135838364,1,1455,1,162934521,135728784,27205737,0.0367569531382296
1747351817533878,135933004,1,1456,1,163028693,135823424,27205269,0.0367575854515535
1747351817628389,136027644,1,1457,1,163123204,135918064,27205140,0.0367577597468713
1747351817722548,136122284,1,1458,1,163217363,136012704,27204659,0.0367584096532876
1747351817820935,136216924,1,1459,1,163315750,136107344,27208406,0.0367533474765114
1747351817914632,136311564,1,1460,1,163409447,136201984,27207463,0.0367546213331246
1747351818009397,136406204,1,1461,1,163504212,136296624,27207588,0.0367544524711268
1747351818107403,136500844,1,1462,1,163602218,136391264,27210954,0.0367499059386157
1747351818201476,136595492,1,1463,1,163696291,136485912,27210379,0.0367506825244881
1747351818295879,136690124,1,1464,1,163790694,136580544,27210150,0.0367509918173916
1747351818389774,136784764,1,1465,1,163884589,136675184,27209405,0.0367519980683149
1747351818488523,136879404,1,1466,1,163983338,136769824,27213514,0.0367464488415571
1747351818582598,136974044,1,1467,1,164077413,136864464,27212949,0.0367472117777459
1747351818676432,137068684,1,1468,1,164171247,136959104,27212143,0.0367483001981872
1747351818770343,137163324,1,1469,1,164265158,137053744,27211414,0.036749284693548
1747351818869321,137257964,1,1470,1,164364136,137148384,27215752,0.036743427115297
1747351818962877,137352604,1,1471,1,164457692,137243024,27214668,0.0367448906596986
1747351819057200,137447244,1,1472,1,164552015,137337664,27214351,0.0367453186739599
1747351819155545,137541884,1,1473,1,164650360,137432304,27218056,0.0367403167955859
1747351819249533,137636524,1,1474,1,164744348,137526944,27217404,0.0367411969194416
1747351819343945,137731164,1,1475,1,164838760,137621584,27217176,0.0367415047027656
1747351819438836,137825804,1,1476,1,164933651,137716224,27217427,0.0367411658714102
1747351819536454,137920444,1,1477,1,165031269,137810864,27220405,0.0367371462694989
1747351819630536,138015084,1,1478,1,165125351,137905504,27219847,0.0367378993717341
1747351819725219,138109724,1,1479,1,165220034,138000144,27219890,0.036737841335876
1747351819823492,138204364,1,1480,1,165318307,138094784,27223523,0.0367329386428053
1747351819917738,138299004,1,1481,1,165412553,138189424,27223129,0.0367334702781594
1747351820011515,138393644,1,1482,1,165506330,138284064,27222266,0.0367346348022607
1747351820106372,138488284,1,1483,1,165601187,138378704,27222483,0.0367343419775484
1747351820204213,138582924,1,1484,1,165699028,138473344,27225684,0.0367300230179708
1747351820298951,138677564,1,1485,1,165793766,138567984,27225782,0.0367298908071768
1747351820392515,138772204,1,1486,1,165887330,138662624,27224706,0.0367313424798783
1747351820486620,138866844,1,1487,1,165981435,138757264,27224171,0.0367320643115266
1747351820585063,138961484,1,1488,1,166079878,138851904,27227974,0.0367269338511929
1747351820681320,139056124,1,1489,1,166176135,138946544,27229591,0.0367247528616937
1747351820773313,139150764,1,1490,1,166268128,139041184,27226944,0.0367283232374518
1747351820871726,139245404,1,1491,1,166366541,139135824,27230717,0.0367232342798759
1747351820966114,139340044,1,1492,1,166460929,139230464,27230465,0.0367235741291968
1747351821060291,139434684,1,1493,1,166555106,139325104,27230002,0.0367241985512891
1747351821154798,139529324,1,1494,1,166649613,139419744,27229869,0.0367243779248442
1747351821253038,139623964,1,1495,1,166747853,139514384,27233469,0.0367195233188985
1747351821346619,139718604,1,1496,1,166841434,139609024,27232410,0.0367209512488979
1747351821441768,139813244,1,1497,1,166936583,139703664,27232919,0.0367202649117415
1747351821535283,139907884,1,1498,1,167030098,139798304,27231794,0.0367217818994958
1747351821634065,140002524,1,1499,1,167128880,139892944,27235936,0.0367161973063822
1747351821728048,140097164,1,1500,1,167222863,139987584,27235279,0.0367170830157458
1747352159869185,109580,1,1,25,0,0,0,0.0
1747352159959450,197404,1,2,25,90265,87824,2441,10241.704219582138
1747352160049394,285804,1,3,25,180209,176224,3985,6273.525721455459
1747352160135529,374204,1,4,25,266344,264624,1720,14534.883720930233
1747352160224771,462604,1,5,25,355586,353024,2562,9758.001561280247
1747352160315031,551004,1,6,25,445846,441424,4422,5653.550429669833
1747352160405537,639404,1,7,25,536352,529824,6528,3829.656862745098
1747352160491708,727804,1,8,25,622523,618224,4299,5815.305885089556
1747352160582034,816204,1,9,25,712849,706624,6225,4016.064257028113
1747352160671262,904604,1,10,25,802077,795024,7053,3544.590954203885
1747352160761497,994044,1,11,25,892312,884464,7848,3185.5249745158
1747352160852230,1083484,1,12,25,983045,973904,9141,2734.930532764468
1747352160946432,1173964,1,13,25,1077247,1064384,12863,1943.559045323797
1747352161036094,1264444,1,14,25,1166909,1154864,12045,2075.5500207555
1747352161125869,1354924,1,15,25,1256684,1245344,11340,2204.5855379188715
1747352161220810,1445404,1,16,25,1351625,1335824,15801,1582.1783431428391
1747352161310573,1535884,1,17,25,1441388,1426304,15084,1657.3853089366216
1747352161400703,1626364,1,18,25,1531518,1516784,14734,1696.755802904846
1747352161494525,1716844,1,19,25,1625340,1607264,18076,1383.0493472007083
1747352161580411,1807324,1,20,25,1711226,1697744,13482,1854.3242842308264
1747352161674747,1897804,1,21,25,1805562,1788224,17338,1441.9194832160572
1747352161765618,1988284,1,22,25,1896433,1878704,17729,1410.1190140447852
1747352161855245,2078764,1,23,25,1986060,1969184,16876,1481.3936951884334
1747352161945253,2169244,1,24,25,2076068,2059664,16404,1524.01853206535
1747352162039564,2259724,1,25,25,2170379,2150144,20235,1235.4830738818878
1747352162129624,2350204,1,26,25,2260439,2240624,19815,1261.6704516780217
1747352162219985,2440684,1,27,25,2350800,2331104,19696,1269.293257514216
1747352162310461,2531164,1,28,25,2441276,2421584,19692,1269.5510867357302
1747352162404117,2621644,1,29,25,2534932,2512064,22868,1093.2307154101802
1747352162494883,2712124,1,30,25,2625698,2602544,23154,1079.7270450030232
1747352162588018,2802604,1,31,25,2718833,2693024,25809,968.6543453833934
1747352162674957,2893084,1,32,25,2805772,2783504,22268,1122.6872642356743
1747352162769006,2983564,1,33,25,2899821,2873984,25837,967.60459805705
1747352162859143,3074044,1,34,25,2989958,2964464,25494,980.622891660783
1747352162949590,3164524,1,35,25,3080405,3054944,25461,981.8938769097836
1747352163039130,3255004,1,36,25,3169945,3145424,24521,1019.534276742384
1747352163133158,3345484,1,37,25,3263973,3235904,28069,890.6622964836653
1747352163223496,3435964,1,38,25,3354311,3326384,27927,895.1910337666058
1747352163313093,3526444,1,39,25,3443908,3416864,27044,924.419464576246
1747352163403929,3616924,1,40,25,3534744,3507344,27400,912.4087591240876
1747352163498283,3707404,1,41,25,3629098,3597824,31274,799.3860714970901
1747352163588157,3797884,1,42,25,3718972,3688304,30668,815.1819486109299
1747352163678469,3888364,1,43,25,3809284,3778784,30500,819.672131147541
1747352163768757,3978844,1,44,25,3899572,3869264,30308,824.8647221855615
1747352163864068,4069324,1,45,25,3994883,3959744,35139,711.4602009163608
1747352163952506,4159804,1,46,25,4083321,4050224,33097,755.3554702843157
1747352164046231,4250284,1,47,25,4177046,4140704,36342,687.909306037092
1747352164132393,4340772,1,48,25,4263208,4231192,32016,780.8595702148925
1747352164227135,4431244,1,49,25,4357950,4321664,36286,688.9709529846222
1747352164317068,4521724,1,50,25,4447883,4412144,35739,699.5159349729987
1747352164407083,4612204,1,51,25,4537898,4502624,35274,708.7373136020865
1747352164497144,4702684,1,52,25,4627959,4593104,34855,717.2572084349448
1747352164591685,4793164,1,53,25,4722500,4683584,38916,642.4092918079967
1747352164681016,4883644,1,54,25,4811831,4774064,37767,661.9535573384171
1747352164771300,4974124,1,55,25,4902115,4864544,37571,665.4068297357004
1747352164866026,5064604,1,56,25,4996841,4955024,41817,597.8429825190711
1747352164956001,5155084,1,57,25,5086816,5045504,41312,605.151045701007
1747352165045919,5245564,1,58,25,5176734,5135984,40750,613.4969325153374
1747352165136084,5336044,1,59,25,5266899,5226464,40435,618.2762458266353
1747352165226271,5426524,1,60,25,5357086,5316944,40142,622.7890986996164
1747352165320737,5517004,1,61,25,5451552,5407424,44128,566.5337200870196
1747352165410137,5607484,1,62,25,5540952,5497904,43048,580.7470730347519
1747352165500174,5697964,1,63,25,5630989,5588384,42605,586.7855885459453
1747352165590521,5788444,1,64,25,5721336,5678864,42472,588.6230928611791
1747352165684638,5878924,1,65,25,5815453,5769344,46109,542.1934980155718
1747352165774785,5969404,1,66,25,5905600,5859824,45776,546.1377140859839
1747352165865196,6059884,1,67,25,5996011,5950304,45707,546.9621720961778
1747352165955448,6150364,1,68,25,6086263,6040784,45479,549.7042591085996
1747352166049522,6240844,1,69,25,6180337,6131264,49073,509.44511238359183
1747352166139237,6331324,1,70,25,6270052,6221744,48308,517.5126273081064
1747352166229326,6421804,1,71,25,6360141,6312224,47917,521.735500970428
1747352166319307,6512284,1,72,25,6450122,6402704,47418,527.2259479522544
1747352166414211,6602772,1,73,25,6545026,6493192,51834,482.30890921017095
1747352166503840,6693244,1,74,25,6634655,6583664,50991,490.2825988900002
1747352166594329,6783724,1,75,25,6725144,6674144,51000,490.1960784313726
1747352166687746,6874204,1,76,25,6818561,6764624,53937,463.5037172998128
1747352166778110,6964684,1,77,25,6908925,6855104,53821,464.5027034057338
1747352166868732,7055164,1,78,25,6999547,6945584,53963,463.2803958267703
1747352166962581,7145644,1,79,25,7093396,7036064,57332,436.0566524802902
1747352167052784,7236124,1,80,25,7183599,7126544,57055,438.1736920515292
1747352167142670,7326604,1,81,25,7273485,7217024,56461,442.7835142841962
1747352167232547,7417084,1,82,25,7363362,7307504,55858,447.563464499266
1747352167327048,7507564,1,83,25,7457863,7397984,59879,417.5086424288983
1747352167417548,7598044,1,84,25,7548363,7488464,59899,417.3692382176664
1747352167507311,7688524,1,85,25,7638126,7578944,59182,422.4257375553378
1747352167601007,7779004,1,86,25,7731822,7669424,62398,400.65386711112535
1747352167687725,7869484,1,87,25,7818540,7759904,58636,426.3592332355549
1747352167782218,7959964,1,88,25,7913033,7850384,62649,399.0486679755463
1747352167876122,8050444,1,89,25,8006937,7940864,66073,378.36937932287015
1747352167966403,8140924,1,90,25,8097218,8031344,65874,379.51240246531256
1747352168055805,8231404,1,91,25,8186620,8121824,64796,385.8262855731835
1747352168146035,8321884,1,92,25,8276850,8212304,64546,387.3206705295448
1747352168236035,8412364,1,93,25,8366850,8302784,64066,390.2225829613212
1747352168326224,8502844,1,94,25,8457039,8393264,63775,392.0031360250882
1747352168416638,8593324,1,95,25,8547453,8483744,63709,392.40923574377246
1747352168511084,8683804,1,96,25,8641899,8574224,67675,369.4126339120798
1747352168600999,8774284,1,97,25,8731814,8664704,67110,372.52272388615705
1747352168695138,8864764,1,98,25,8825953,8755184,70769,353.26202150659185
1747352168784813,8955244,1,99,25,8915628,8845664,69964,357.3266251214911
1747352168875339,9045724,1,100,25,9006154,8936144,70010,357.09184402228254
1747352168969632,9137244,1,101,25,9100447,9027664,72783,343.4868032370196
1747352169059668,9228764,1,102,25,9190483,9119184,71299,350.63605380159606
1747352169150124,9320284,1,103,25,9280939,9210704,70235,355.9478892290168
1747352169244021,9411804,1,104,25,9374836,9302224,72612,344.29570869828683
1747352169333979,9503324,1,105,25,9464794,9393744,71050,351.8648838845883
1747352169428187,9594844,1,106,25,9559002,9485264,73738,339.0382163877512
1747352169518600,9686364,1,107,25,9649415,9576784,72631,344.20564221888725
1747352169612645,9777884,1,108,25,9743460,9668304,75156,332.6414391399223
1747352169703085,9869404,1,109,25,9833900,9759824,74076,337.49122522814406
1747352169797061,9960924,1,110,25,9927876,9851344,76532,326.6607432185229
1747352169891190,10052444,1,111,25,10022005,9942864,79141,315.8918891598539
1747352169981037,10145004,1,112,25,10111852,10035424,76428,327.10524938504216
1747352170075531,10237564,1,113,25,10206346,10127984,78362,319.0321839667185
1747352170169654,10330132,1,114,25,10300469,10220552,79917,312.82455547630667
1747352170263315,10422684,1,115,25,10394130,10313104,81026,308.54293683509
1747352170358148,10515244,1,116,25,10488963,10405664,83299,300.123650944189
1747352170447992,10607804,1,117,25,10578807,10498224,80583,310.2391323231947
1747352170542305,10700364,1,118,25,10673120,10590784,82336,303.6338904003109
1747352170636314,10792924,1,119,25,10767129,10683344,83785,298.38276541146985
1747352170730397,10885484,1,120,25,10861212,10775904,85308,293.0557509260562
1747352170820505,10978044,1,121,25,10951320,10868464,82856,301.7282997006855
1747352170915547,11070604,1,122,25,11046362,10961024,85338,292.9527291476247
1747352171009263,11163164,1,123,25,11140078,11053584,86494,289.03738987675445
1747352171103755,11255724,1,124,25,11234570,11146144,88426,282.72227625359056
1747352171197652,11348284,1,125,25,11328467,11238704,89763,278.5111905796375
1747352171287716,11440844,1,126,25,11418531,11331264,87267,286.4771333952124
1747352171386434,11533404,1,127,25,11517249,11423824,93425,267.5943270002676
1747352171480358,11625964,1,128,25,11611173,11516384,94789,263.743683338784
1747352171566576,11718524,1,129,25,11697391,11608944,88447,282.655149411512
1747352171663923,11811084,1,130,25,11794738,11701504,93234,268.1425231138855
1747352171754243,11903644,1,131,25,11885058,11794064,90994,274.7433896740444
1747352171848945,11996204,1,132,25,11979760,11886624,93136,268.4246693008074
1747352171942721,12088764,1,133,25,12073536,11979184,94352,264.9652365609632
1747352172033114,12181324,1,134,25,12163929,12071744,92185,271.1937950859684
1747352172127712,12273884,1,135,25,12258527,12164304,94223,265.3279984717107
1747352172221931,12366444,1,136,25,12352746,12256864,95882,260.7371560876911
1747352172315984,12459004,1,137,25,12446799,12349424,97375,256.73940949935815
1747352172405990,12551564,1,138,25,12536805,12441984,94821,263.654675652018
1747352172500707,12644124,1,139,25,12631522,12534544,96978,257.79042669471426
1747352172594065,12736684,1,140,25,12724880,12627104,97776,255.6864670266732
1747352172688518,12829244,1,141,25,12819333,12719664,99669,250.83024812128147
1747352172778681,12921804,1,142,25,12909496,12812224,97272,257.0112673739617
1747352172873207,13014364,1,143,25,13004022,12904784,99238,251.91962756202253
1747352172967299,13106924,1,144,25,13098114,12997344,100770,248.0897092388608
1747352173060942,13199484,1,145,25,13191757,13089904,101853,245.45177854358727
1747352173155401,13292044,1,146,25,13286216,13182464,103752,240.9592104248593
1747352173245306,13384604,1,147,25,13376121,13275024,101097,247.28725877127903
1747352173339320,13477164,1,148,25,13470135,13367584,102551,243.78114304102348
1747352173434309,13569724,1,149,25,13565124,13460144,104980,238.14059820918268
1747352173527765,13662284,1,150,25,13658580,13552704,105876,236.1252786278288
1747352173618266,13754844,1,151,25,13749081,13645264,103817,240.80834545402004
1747352173712270,13847404,1,152,25,13843085,13737824,105261,237.50486884981143
1747352173806429,13939964,1,153,25,13937244,13830384,106860,233.9509638779712
1747352173901205,14032524,1,154,25,14032020,13922944,109076,229.19799039202024
1747352173991348,14125092,1,155,25,14122163,14015512,106651,234.40942888486748
1747352174085618,14217644,1,156,25,14216433,14108064,108369,230.6932794433833
1747352174179118,14310204,1,157,25,14309933,14200624,109309,228.7094383811031
1747352174273587,14402764,1,158,25,14404402,14293184,111218,224.78375802478016
1747352174363630,14495324,1,159,25,14494445,14385744,108701,229.9886845567198
1747352174457420,14587884,1,160,25,14588235,14478304,109931,227.41537873757176
1747352174552075,14680444,1,161,25,14682890,14570864,112026,223.16248013853928
1747352174645967,14773004,1,162,25,14776782,14663424,113358,220.5402353605392
1747352174740561,14865564,1,163,25,14871376,14755984,115392,216.65280088740988
1747352174830645,14958124,1,164,25,14961460,14848544,112916,221.4035212016012
1747352174924559,15050684,1,165,25,15055374,14941104,114270,218.78008226131087
1747352175018564,15143244,1,166,25,15149379,15033664,115715,216.04804908611675
1747352175113070,15235804,1,167,25,15243885,15126224,117661,212.47482173362457
1747352175203240,15328364,1,168,25,15334055,15218784,115271,216.88022139133
1747352175297623,15420924,1,169,25,15428438,15311344,117094,213.50368080345703
1747352175391624,15513484,1,170,25,15522439,15403904,118535,210.9081705825284
1747352175485636,15606044,1,171,25,15616451,15496464,119987,208.35590522306583
1747352175580101,15698604,1,172,25,15710916,15589024,121892,205.09959636399435
1747352175670269,15791164,1,173,25,15801084,15681584,119500,209.2050209205021
1747352175764679,15883724,1,174,25,15895494,15774144,121350,206.01565718994644
1747352175858140,15976284,1,175,25,15988955,15866704,122251,204.4973047255237
1747352175948149,16068844,1,176,25,16078964,15959264,119700,208.85547201336675
1747352176042485,16161404,1,177,25,16173300,16051824,121476,205.8019691132405
1747352176137384,16253972,1,178,25,16268199,16144392,123807,201.9271931312446
1747352176231492,16346524,1,179,25,16362307,16236944,125363,199.4208817593708
1747352176324927,16439084,1,180,25,16455742,16329504,126238,198.03862545350847
1747352176419508,16531644,1,181,25,16550323,16422064,128259,194.91809541630604
1747352176509666,16624204,1,182,25,16640481,16514624,125857,198.63813693318608
1747352176603752,16716764,1,183,25,16734567,16607184,127383,196.25852743301687
1747352176698156,16809324,1,184,25,16828971,16699744,129227,193.4580234780657
1747352176792715,16901884,1,185,25,16923530,16792304,131226,190.5110267782299
1747352176882114,16994444,1,186,25,17012929,16884864,128065,195.2133682114551
1747352176976683,17087004,1,187,25,17107498,16977424,130074,192.1982871288651
1747352177070482,17179564,1,188,25,17201297,17069984,131313,190.38480576942115
1747352177160759,17272124,1,189,25,17291574,17162544,129030,193.7533906843369
1747352177255529,17364684,1,190,25,17386344,17255104,131240,190.4907040536422
1747352177349077,17457244,1,191,25,17479892,17347664,132228,189.06736848473847
1747352177443686,17549804,1,192,25,17574501,17440224,134277,186.18229480849288
1747352177533552,17642364,1,193,25,17664367,17532784,131583,189.99414818023604
1747352177627339,17734924,1,194,25,17758154,17625344,132810,188.23883743694
1747352177722457,17827484,1,195,25,17853272,17717904,135368,184.6817563973761
1747352177816020,17920044,1,196,25,17946835,17810464,136371,183.32343386790447
1747352177910190,18012604,1,197,25,18041005,17903024,137981,181.18436596342977
1747352178000754,18105164,1,198,25,18131569,17995584,135985,183.8438063021657
1747352178094075,18197724,1,199,25,18224890,18088144,136746,182.82070407909555
1747352178189100,18290284,1,200,25,18319915,18180704,139211,179.58350992378476
1747352178282750,18382844,1,201,25,18413565,18273264,140301,178.1883236755262
1747352178372870,18475404,1,202,25,18503685,18365824,137861,181.34207643931205
1747352178467446,18567964,1,203,25,18598261,18458384,139877,178.72845428483595
1747352178561822,18660524,1,204,25,18692637,18550944,141693,176.43779156345053
1747352178655838,18753084,1,205,25,18786653,18643504,143149,174.6432039343621
1747352178745840,18845644,1,206,25,18876655,18736064,140591,177.82077088860598
1747352178840012,18938204,1,207,25,18970827,18828624,142203,175.8050111460377
1747352178934781,19030764,1,208,25,19065596,18921184,144412,173.11580755061905
1747352179029021,19123324,1,209,25,19159836,19013744,146092,171.12504449251156
1747352179119158,19215884,1,210,25,19249973,19106304,143669,174.01109494741385
1747352179216621,19308444,1,211,25,19347436,19198864,148572,168.26858358237084
1747352179307241,19401004,1,212,25,19438056,19291424,146632,170.49484423591028
1747352179401363,19493564,1,213,25,19532178,19383984,148194,168.6977880346033
1747352179495808,19586124,1,214,25,19626623,19476544,150079,166.57893509418375
1747352179585709,19678684,1,215,25,19716524,19569104,147420,169.58350291683627
1747352179679816,19771244,1,216,25,19810631,19661664,148967,167.82240361959362
1747352179773636,19863804,1,217,25,19904451,19754224,150227,166.41482556397983
1747352179868077,19956364,1,218,25,19998892,19846784,152108,164.35690430483604
1747352179958876,20048932,1,219,25,20089691,19939352,150339,166.2908493471421
1747352180052694,20141484,1,220,25,20183509,20031904,151605,164.9022129876983
1747352180146740,20234044,1,221,25,20277555,20124464,153091,163.30156573541225
1747352180240352,20326604,1,222,25,20371167,20217024,154143,162.18706006759956
1747352180331659,20419164,1,223,25,20462474,20309584,152890,163.51625351559946
1747352180425508,20511724,1,224,25,20556323,20402144,154179,162.149190226944
1747352180519627,20604284,1,225,25,20650442,20494704,155738,160.52601163492534
1747352180613502,20696844,1,226,25,20744317,20587264,157053,159.18193221396598
1747352180703598,20789404,1,227,25,20834413,20679824,154589,161.71913913667854
1747352180797623,20881964,1,228,25,20928438,20772384,156054,160.20095607930588
1747352180892332,20974524,1,229,25,21023147,20864944,158203,158.02481621713872
1747352180986683,21067084,1,230,25,21117498,20957504,159994,156.2558595947348
1747352181080341,21159644,1,231,25,21211156,21050064,161092,155.1908226355126
1747352181171161,21252204,1,232,25,21301976,21142624,159352,156.8853858125408
1747352181265234,21344764,1,233,25,21396049,21235184,160865,155.40981568395858
1747352181358638,21437324,1,234,25,21489453,21327744,161709,154.59869271345443
1747352181453643,21529884,1,235,25,21584458,21420304,164154,152.29601471788686
1747352181543836,21622444,1,236,25,21674651,21512864,161787,154.52415830690973
1747352181637555,21715004,1,237,25,21768370,21605424,162946,153.4250610631743
1747352181732176,21807564,1,238,25,21862991,21697984,165007,151.5087238723206
1747352181825532,21900124,1,239,25,21956347,21790544,165803,150.78134895026025
1747352181916464,21992684,1,240,25,22047279,21883104,164175,152.27653418608193
1747352182013928,22085244,1,241,25,22144743,21975664,169079,147.85987615256772
1747352182104479,22177812,1,242,25,22235294,22068232,167062,149.64504196046977
1747352182198921,22270364,1,243,25,22329736,22160784,168952,147.9710213551778
1747352182292360,22362924,1,244,25,22423175,22253344,169831,147.205162779469
1747352182382672,22455484,1,245,25,22513487,22345904,167583,149.1798094078755
1747352182477537,22548044,1,246,25,22608352,22438464,169888,147.15577321529477
1747352182571846,22640604,1,247,25,22702661,22531024,171637,145.6562396219929
1747352182665367,22733164,1,248,25,22796182,22623584,172598,144.84524733774435
1747352182756162,22825724,1,249,25,22886977,22716144,170833,146.34174895951014
1747352182849388,22918284,1,250,25,22980203,22808704,171499,145.77344474311803
1747352182943914,23010844,1,251,25,23074729,22901264,173465,144.12129247975096
1747352183037895,23103404,1,252,25,23168710,22993824,174886,142.9502647438903
1747352183128585,23195964,1,253,25,23259400,23086384,173016,144.49530679243537
1747352183222600,23288524,1,254,25,23353415,23178944,174471,143.29028893053862
1747352183316439,23381084,1,255,25,23447254,23271504,175750,142.2475106685633
1747352183410639,23473644,1,256,25,23541454,23364064,177390,140.9324088167315
1747352183501059,23566204,1,257,25,23631874,23456624,175250,142.65335235378032
1747352183595726,23658764,1,258,25,23726541,23549184,177357,140.9586314608389
1747352183689873,23751324,1,259,25,23820688,23641744,178944,139.7085121602289
1747352183783604,23843884,1,260,25,23914419,23734304,180115,138.8002109763207
1747352183877604,23936444,1,261,25,24008419,23826864,181555,137.69931976536037
1747352183967924,24029004,1,262,25,24098739,23919424,179315,139.41945737947188
1747352184061919,24121564,1,263,25,24192734,24011984,180750,138.31258644536652
1747352184156455,24214124,1,264,25,24287270,24104544,182726,136.8168733513567
1747352184250541,24306684,1,265,25,24381356,24197104,184252,135.6837374899594
1747352184340735,24399244,1,266,25,24471550,24289664,181886,137.44873162310458
1747352184435116,24491804,1,267,25,24565931,24382224,183707,136.08626780688817
1747352184529188,24584364,1,268,25,24660003,24474784,185219,134.9753535004508
1747352184622838,24676924,1,269,25,24753653,24567344,186309,134.18568077763285
1747352184713424,24769484,1,270,25,24844239,24659904,184335,135.6226435565682
1747352184807578,24862044,1,271,25,24938393,24752464,185929,134.45992825218227
1747352184902017,24954604,1,272,25,25032832,24845024,187808,133.1146703015846
1747352184996336,25047164,1,273,25,25127151,24937584,189567,131.879493793751
1747352185085393,25139724,1,274,25,25216208,25030144,186064,134.3623699372259
1747352185180146,25232284,1,275,25,25310961,25122704,188257,132.79718682439432
1747352185274402,25324844,1,276,25,25405217,25215264,189953,131.61150389833273
1747352185368983,25417404,1,277,25,25499798,25307824,191974,130.22596809984685
1747352185462882,25509964,1,278,25,25593697,25400384,193313,129.3239461391629
1747352185553053,25602524,1,279,25,25683868,25492944,190924,130.94215499361002
1747352185646844,25695084,1,280,25,25777659,25585504,192155,130.10330202180532
1747352185741267,25787644,1,281,25,25872082,25678064,194018,128.8540238534569
1747352185835916,25880204,1,282,25,25966731,25770624,196107,127.48142595623816
1747352185925428,25972772,1,283,25,26056243,25863192,193051,129.49945869226266
1747352186019991,26065324,1,284,25,26150806,25955744,195062,128.16437850529573
1747352186114303,26157884,1,285,25,26245118,26048304,196814,127.02348410174072
1747352186208253,26250444,1,286,25,26339068,26140864,198204,126.13267138907388
1747352186298174,26343004,1,287,25,26428989,26233424,195565,127.8347352542633
1747352186393071,26435564,1,288,25,26523886,26325984,197902,126.3251508322301
1747352186486457,26528124,1,289,25,26617272,26418544,198728,125.80008856326236
1747352186581508,26620684,1,290,25,26712323,26511104,201219,124.24274049667278
1747352186670721,26713244,1,291,25,26801536,26603664,197872,126.34430338804884
1747352186765760,26805804,1,292,25,26896575,26696224,200351,124.78100932862826
1747352186859738,26898364,1,293,25,26990553,26788784,201769,123.90406851399372
1747352186953801,26990924,1,294,25,27084616,26881344,203272,122.9879176669684
1747352187048186,27083484,1,295,25,27179001,26973904,205097,121.89354305523727
1747352187137754,27176044,1,296,25,27268569,27066464,202105,123.69807773187205
1747352187232374,27268604,1,297,25,27363189,27159024,204165,122.44997918350352
1747352187325776,27361164,1,298,25,27456591,27251584,205007,121.94705546639872
1747352187420040,27453724,1,299,25,27550855,27344144,206711,120.94179796914533
1747352187510899,27546284,1,300,25,27641714,27436704,205010,121.94527096239209
1747352187604758,27638844,1,301,25,27735573,27529264,206309,121.17745711529793
1747352187699549,27731404,1,302,25,27830364,27621824,208540,119.88107797065312
1747352187793107,27823964,1,303,25,27923922,27714384,209538,119.31010127041397
1747352187883094,27916524,1,304,25,28013909,27806944,206965,120.7933708598072
1747352187977209,28009084,1,305,25,28108024,27899504,208520,119.89257625167848
1747352188072059,28101652,1,306,25,28202874,27992072,210802,118.59470024003568
1747352188165590,28194204,1,307,25,28296405,28084624,211781,118.0464725353077
1747352188255792,28286764,1,308,25,28386607,28177184,209423,119.37561776882195
1747352188350791,28379324,1,309,25,28481606,28269744,211862,118.00134049522804
1747352188444802,28471884,1,310,25,28575617,28362304,213313,117.19867049828188
1747352188539109,28564444,1,311,25,28669924,28454864,215060,116.24662884776342
1747352188633160,28657004,1,312,25,28763975,28547424,216551,115.4462459189752
1747352188723191,28749564,1,313,25,28854006,28639984,214022,116.81042135855192
1747352188817636,28842124,1,314,25,28948451,28732544,215907,115.79059502470972
1747352188911862,28934684,1,315,25,29042677,28825104,217573,114.90396326750104
1747352189005910,29027244,1,316,25,29136725,28917664,219061,114.12346332756628
1747352189096173,29119804,1,317,25,29226988,29010224,216764,115.33280434020408
1747352189189684,29212364,1,318,25,29320499,29102784,217715,114.82901958983076
1747352189284012,29304924,1,319,25,29414827,29195344,219483,113.90403812595964
1747352189378633,29397484,1,320,25,29509448,29287904,221544,112.84440111219442
1747352189468047,29490044,1,321,25,29598862,29380464,218398,114.46991272813852
1747352189566783,29582604,1,322,25,29697598,29473024,224574,111.32188053826356
1747352189657169,29675164,1,323,25,29787984,29565584,222400,112.41007194244604
1747352189751068,29767724,1,324,25,29881883,29658144,223739,111.7373368076196
1747352189841456,29860284,1,325,25,29972271,29750704,221567,112.83268717814477
1747352189935702,29952844,1,326,25,30066517,29843264,223253,111.98057808853632
1747352190029785,30045404,1,327,25,30160600,29935824,224776,111.22183863045876
1747352190123466,30137964,1,328,25,30254281,30028384,225897,110.669907081546
1747352190217838,30230524,1,329,25,30348653,30120944,227709,109.78924855846716
1747352190307984,30323084,1,330,25,30438799,30213504,225295,110.96562285004106
1747352190401952,30415644,1,331,25,30532767,30306064,226703,110.27644098225431
1747352190496160,30508204,1,332,25,30626975,30398624,228351,109.48058033466025
1747352190590383,30600764,1,333,25,30721198,30491184,230014,108.68903631952838
1747352190681372,30693324,1,334,25,30812187,30583744,228443,109.4364896276095
1747352190774469,30785884,1,335,25,30905284,30676304,228980,109.17984103415148
1747352190869161,30878444,1,336,25,30999976,30768864,231112,108.17266087438124
1747352190963059,30971004,1,337,25,31093874,30861424,232450,107.55001075500108
1747352191053226,31063564,1,338,25,31184041,30953984,230057,108.66872122995603
1747352191147469,31156124,1,339,25,31278284,31046544,231740,107.87952015189435
1747352191241986,31248684,1,340,25,31372801,31139104,233697,106.9761272074524
1747352191335972,31341244,1,341,25,31466787,31231664,235123,106.3273265482322
1747352191429795,31433804,1,342,25,31560610,31324224,236386,105.75922431954514
1747352191520640,31526364,1,343,25,31651455,31416784,234671,106.53212369657948
1747352191614292,31618924,1,344,25,31745107,31509344,235763,106.0386913977172
1747352191708565,31711484,1,345,25,31839380,31601904,237476,105.27379608886793
1747352191803456,31804044,1,346,25,31934271,31694464,239807,104.25050144491196
1747352191893626,31896612,1,347,25,32024441,31787032,237409,105.3035057643139
1747352191987138,31989164,1,348,25,32117953,31879584,238369,104.87940965477894
1747352192081454,32081724,1,349,25,32212269,31972144,240125,104.1124414367517
1747352192175465,32174284,1,350,25,32306280,32064704,241576,103.48710136768553
1747352192266013,32266844,1,351,25,32396828,32157264,239564,104.35624718238132
1747352192360477,32359404,1,352,25,32491292,32249824,241468,103.53338744678383
1747352192454660,32451964,1,353,25,32585475,32342384,243091,102.842145533977
1747352192549109,32544524,1,354,25,32679924,32434944,244980,102.04914686913216
1747352192638558,32637084,1,355,25,32769373,32527504,241869,103.36173713869904
1747352192733410,32729644,1,356,25,32864225,32620064,244161,102.39145481874664
1747352192827700,32822204,1,357,25,32958515,32712624,245891,101.67106563477311
1747352192921892,32914764,1,358,25,33052707,32805184,247523,101.0007150850628
1747352193015778,33007324,1,359,25,33146593,32897744,248849,100.4625294857524
1747352193106017,33099884,1,360,25,33236832,32990304,246528,101.40835929387332
1747352193199886,33192444,1,361,25,33330701,33082864,247837,100.87275104201552
1747352193294381,33285004,1,362,25,33425196,33175424,249772,100.0912832503243
1747352193388554,33377564,1,363,25,33519369,33267984,251385,99.44905225053203
1747352193478737,33470124,1,364,25,33609552,33360544,249008,100.39838077491486
1747352193572780,33562684,1,365,25,33703595,33453104,250491,99.80398497351202
1747352193667374,33655244,1,366,25,33798189,33545664,252525,99.000099000099
1747352193760889,33747804,1,367,25,33891704,33638224,253480,98.62711062016729
1747352193850673,33840364,1,368,25,33981488,33730784,250704,99.71919075882316
1747352193945456,33932924,1,369,25,34076271,33823344,252927,98.842749093612
1747352194038923,34025492,1,370,25,34169738,33915912,253826,98.49266820577876
1747352194133711,34118044,1,371,25,34264526,34008464,256062,97.63260460357256
1747352194224112,34210604,1,372,25,34354927,34101024,253903,98.46279878536292
1747352194318080,34303164,1,373,25,34448895,34193584,255311,97.91979194002607
1747352194412282,34395724,1,374,25,34543097,34286144,256953,97.29405766813386
1747352194506496,34488284,1,375,25,34637311,34378704,258607,96.67178382642388
1747352194600446,34580844,1,376,25,34731261,34471264,259997,96.15495563410347
1747352194690862,34673404,1,377,25,34821677,34563824,257853,96.95446630444478
1747352194784253,34765964,1,378,25,34915068,34656384,258684,96.64300845819608
1747352194878826,34858524,1,379,25,35009641,34748944,260697,95.8967690460573
1747352194973577,34951084,1,380,25,35104392,34841504,262888,95.0975320288488
1747352195063773,35043644,1,381,25,35194588,34934064,260524,95.96044894136432
1747352195157321,35136204,1,382,25,35288136,35026624,261512,95.59790755299947
1747352195251417,35228764,1,383,25,35382232,35119184,263048,95.03968857394848
1747352195345841,35321324,1,384,25,35476656,35211744,264912,94.37096092287253
1747352195436365,35413884,1,385,25,35567180,35304304,262876,95.1018731264931
1747352195530373,35506444,1,386,25,35661188,35396864,264324,94.58089314629017
1747352195624085,35599004,1,387,25,35754900,35489424,265476,94.17047115370129
1747352195718244,35691564,1,388,25,35849059,35581984,267075,93.60666479453336
1747352195808234,35784124,1,389,25,35939049,35674544,264505,94.51617171698078
1747352195902696,35876684,1,390,25,36033511,35767104,266407,93.84137804186828
1747352195997505,35969244,1,391,25,36128320,35859664,268656,93.05580370436545
1747352196091574,36061804,1,392,25,36222389,35952224,270165,92.5360427886662
1747352196185817,36154364,1,393,25,36316632,36044784,271848,91.96315588122776
1747352196275503,36246924,1,394,25,36406318,36137344,268974,92.94578658160268
1747352196369700,36339484,1,395,25,36500515,36229904,270611,92.38353208110536
1747352196464298,36432044,1,396,25,36595113,36322464,272649,91.69298255265927
1747352196557538,36524604,1,397,25,36688353,36415024,273329,91.46486468687918
1747352196647922,36617164,1,398,25,36778737,36507584,271153,92.19886927306725
1747352196742690,36709724,1,399,25,36873505,36600144,273361,91.45415768891684
1747352196836725,36802284,1,400,25,36967540,36692704,274836,90.96333813619758
1747352196930439,36894844,1,401,25,37061254,36785264,275990,90.58299213739627
1747352197021347,36987404,1,402,25,37152162,36877824,274338,91.12846197027024
1747352197115630,37079964,1,403,25,37246445,36970384,276061,90.55969513984228
1747352197209842,37172524,1,404,25,37340657,37062944,277713,90.02099289554324
1747352197303988,37265084,1,405,25,37434803,37155504,279299,89.50980848481376
1747352197393617,37357644,1,406,25,37524432,37248064,276368,90.45909801424187
1747352197488424,37450204,1,407,25,37619239,37340624,278615,89.72955512086571
1747352197582548,37542764,1,408,25,37713363,37433184,280179,89.22867167061057
1747352197676347,37635324,1,409,25,37807162,37525744,281418,88.83582428984641
1747352197770154,37727884,1,410,25,37900969,37618304,282665,88.44391771177897
1747352197860259,37820452,1,411,25,37991074,37710872,280202,89.22134745647783
1747352197954863,37913004,1,412,25,38085678,37803424,282254,88.57270401836644
1747352198049194,38005564,1,413,25,38180009,37895984,284025,88.02042073761112
1747352198142925,38098124,1,414,25,38273740,37988544,285196,87.65901345039902
1747352198232988,38190684,1,415,25,38363803,38081104,282699,88.43328062709809
1747352198327463,38283244,1,416,25,38458278,38173664,284614,87.83826515912781
1747352198421647,38375804,1,417,25,38552462,38266224,286238,87.33990595238927
1747352198516256,38468364,1,418,25,38647071,38358784,288287,86.71913752614581
1747352198605736,38560924,1,419,25,38736551,38451344,285207,87.65563257563805
1747352198700107,38653484,1,420,25,38830922,38543904,287018,87.10255105951543
1747352198794010,38746044,1,421,25,38924825,38636464,288361,86.69688342043482
1747352198888660,38838604,1,422,25,39019475,38729024,290451,86.07303813724174
1747352198982073,38931164,1,423,25,39112888,38821584,291304,85.82099799522149
1747352199072518,39023724,1,424,25,39203333,38914144,289189,86.44865468603578
1747352199167209,39116284,1,425,25,39298024,39006704,291320,85.81628449814636
1747352199261817,39208844,1,426,25,39392632,39099264,293368,85.21720160344687
1747352199355250,39301404,1,427,25,39486065,39191824,294241,84.9643659449227
1747352199445811,39393964,1,428,25,39576626,39284384,292242,85.54554102421966
1747352199539752,39486524,1,429,25,39670567,39376944,293623,85.14319382337214
1747352199633843,39579084,1,430,25,39764658,39469504,295154,84.70154563380471
1747352199727841,39671644,1,431,25,39858656,39562064,296592,84.29087770405135
1747352199818314,39764204,1,432,25,39949129,39654624,294505,84.888202237653
1747352199912397,39856764,1,433,25,40043212,39747184,296028,84.45147080681556
1747352200006885,39949332,1,434,25,40137700,39839752,297948,83.9072589847893
1747352200100556,40041884,1,435,25,40231371,39932304,299067,83.59330852283935
1747352200191010,40134444,1,436,25,40321825,40024864,296961,84.186138920599
1747352200285225,40227004,1,437,25,40416040,40117424,298616,83.71955956814102
1747352200379634,40319564,1,438,25,40510449,40209984,300465,83.20436656515734
1747352200473831,40412124,1,439,25,40604646,40302544,302102,82.75350709363063
1747352200567747,40504684,1,440,25,40698562,40395104,303458,82.38372361249333
1747352200658096,40597244,1,441,25,40788911,40487664,301247,82.98837830750182
1747352200752651,40689804,1,442,25,40883466,40580224,303242,82.44240573535328
1747352200846027,40782364,1,443,25,40976842,40672784,304058,82.22115517434173
1747352200940306,40874924,1,444,25,41071121,40765344,305777,81.75892889262435
1747352201031096,40967484,1,445,25,41161911,40857904,304007,82.23494853736919
1747352201124760,41060044,1,446,25,41255575,40950464,305111,81.93739327654525
1747352201219169,41152604,1,447,25,41349984,41043024,306960,81.44383633046651
1747352201313367,41245164,1,448,25,41444182,41135584,308598,81.0115425245789
1747352201403861,41337724,1,449,25,41534676,41228144,306532,81.55755353437813
1747352201498021,41430284,1,450,25,41628836,41320704,308132,81.13405942907585
1747352201592000,41522844,1,451,25,41722815,41413264,309551,80.76213612619568
1747352201685573,41615404,1,452,25,41816388,41505824,310564,80.49870558081426
1747352201776047,41707964,1,453,25,41906862,41598384,308478,81.0430565550866
1747352201870262,41800524,1,454,25,42001077,41690944,310133,80.61057675255455
1747352201964920,41893084,1,455,25,42095735,41783504,312231,80.06892332920178
1747352202058870,41985644,1,456,25,42189685,41876064,313621,79.71404976069843
1747352202153358,42078204,1,457,25,42284173,41968624,315549,79.2269980256632
1747352202242843,42170764,1,458,25,42373658,42061184,312474,80.00665655382528
1747352202337589,42263324,1,459,25,42468404,42153744,314660,79.45083582279285
1747352202431285,42355884,1,460,25,42562100,42246304,315796,79.16503058936782
1747352202525117,42448444,1,461,25,42655932,42338864,317068,78.84743966593916
1747352202615962,42541004,1,462,25,42746777,42431424,315353,79.27623964255929
1747352202710049,42633564,1,463,25,42840864,42523984,316880,78.89421863165867
1747352202804271,42726124,1,464,25,42935086,42616544,318542,78.48258628375537
1747352202898350,42818684,1,465,25,43029165,42709104,320061,78.11011026023165
1747352202988949,42911244,1,466,25,43119764,42801664,318100,78.59163784973279
1747352203079918,43003804,1,467,25,43210733,42894224,316509,78.98669548101319
1747352203177166,43096364,1,468,25,43307981,42986784,321197,77.83385274457731
1747352203271134,43188924,1,469,25,43401949,43079344,322605,77.49414919173603
1747352203360788,43281484,1,470,25,43491603,43171904,319699,78.1985555162825
1747352203459792,43374044,1,471,25,43590607,43264464,326143,76.65349248642467
1747352203549739,43466604,1,472,25,43680554,43357024,323530,77.27258677711495
1747352203643262,43559164,1,473,25,43774077,43449584,324493,77.0432644155652
1747352203738303,43651724,1,474,25,43869118,43542144,326974,76.45867867169866
1747352203827951,43744292,1,475,25,43958766,43634712,324054,77.14763588784585
1747352203922698,43836844,1,476,25,44053513,43727264,326249,76.62858736731759
1747352204016503,43929404,1,477,25,44147318,43819824,327494,76.3372764081174
1747352204110285,44021964,1,478,25,44241100,43912384,328716,76.05349298482581
1747352204200269,44114524,1,479,25,44331084,44004944,326140,76.6541975838597
1747352204295265,44207084,1,480,25,44426080,44097504,328576,76.08589793533308
1747352204389282,44299644,1,481,25,44520097,44190064,330033,75.7500007575
1747352204483574,44392204,1,482,25,44614389,44282624,331765,75.35454312540503
1747352204573292,44484764,1,483,25,44704107,44375184,328923,76.00563049710722
1747352204668076,44577324,1,484,25,44798891,44467744,331147,75.49517283864868
1747352204761634,44669884,1,485,25,44892449,44560304,332145,75.2683316021617
1747352204856491,44762444,1,486,25,44987306,44652864,334442,74.75137692036287
1747352204946262,44855004,1,487,25,45077077,44745424,331653,75.3799905322732
1747352205040072,44947564,1,488,25,45170887,44837984,332903,75.09695016266
1747352205134593,45040124,1,489,25,45265408,44930544,334864,74.65717425581728
1747352205228218,45132684,1,490,25,45359033,45023104,335929,74.42048766257156
1747352205322716,45225244,1,491,25,45453531,45115664,337867,73.99361287133695
1747352205413114,45317804,1,492,25,45543929,45208224,335705,74.47014491890202
1747352205507663,45410364,1,493,25,45638478,45300784,337694,74.03151965981036
1747352205601144,45502924,1,494,25,45731959,45393344,338615,73.83016109741152
1747352205695812,45595484,1,495,25,45826627,45485904,340723,73.37338541865387
1747352205785668,45688044,1,496,25,45916483,45578464,338019,73.96033950754247
1747352205880256,45780604,1,497,25,46011071,45671024,340047,73.51924880972336
1747352205974393,45873172,1,498,25,46105208,45763592,341616,73.18158400074938
1747352206067886,45965724,1,499,25,46198701,45856144,342557,72.98055506090957
1747352206158666,46058284,1,500,25,46289481,45948704,340777,73.36175856938702
1747352206253024,46150844,1,501,25,46383839,46041264,342575,72.97672042618404
1747352206346723,46243404,1,502,25,46477538,46133824,343714,72.73489005394019
1747352206440920,46335964,1,503,25,46571735,46226384,345351,72.39011903831174
1747352206530729,46428524,1,504,25,46661544,46318944,342600,72.97139521307648
1747352206624960,46521084,1,505,25,46755775,46411504,344271,72.61721144098689
1747352206719660,46613644,1,506,25,46850475,46504064,346411,72.16860896449593
1747352206813994,46706204,1,507,25,46944809,46596624,348185,71.80091043554432
1747352206908000,46798764,1,508,25,47038815,46689184,349631,71.50395702898197
1747352206998469,46891324,1,509,25,47129284,46781744,347540,71.93416585141279
1747352207092117,46983884,1,510,25,47222932,46874304,348628,71.70967334809596
1747352207186012,47076444,1,511,25,47316827,46966864,349963,71.43612324731471
1747352207281085,47169004,1,512,25,47411900,47059424,352476,70.92681487533903
1747352207371105,47261564,1,513,25,47501920,47151984,349936,71.44163504183622
1747352207464943,47354124,1,514,25,47595758,47244544,351214,71.1816727123634
1747352207559610,47446684,1,515,25,47690425,47337104,353321,70.75718680746404
1747352207653448,47539244,1,516,25,47784263,47429664,354599,70.50217287696807
1747352207744139,47631804,1,517,25,47874954,47522224,352730,70.8757406514898
1747352207837916,47724364,1,518,25,47968731,47614784,353947,70.63204378056601
1747352207932222,47816924,1,519,25,48063037,47707344,355693,70.28533032699548
1747352208026458,47909484,1,520,25,48157273,47799904,357369,69.95570404819668
1747352208120279,48002044,1,521,25,48251094,47892464,358630,69.70972868973594
1747352208210429,48094604,1,522,25,48341244,47985024,356220,70.18134860479479
1747352208304324,48187164,1,523,25,48435139,48077584,357555,69.91931311266798
1747352208399209,48279724,1,524,25,48530024,48170144,359880,69.46760031121485
1747352208493189,48372284,1,525,25,48624004,48262704,361300,69.1945751453086
1747352208583590,48464844,1,526,25,48714405,48355264,359141,69.61054293439068
1747352208676885,48557404,1,527,25,48807700,48447824,359876,69.4683724393958
1747352208771560,48649964,1,528,25,48902375,48540384,361991,69.06249050390755
1747352208866056,48742524,1,529,25,48996871,48632944,363927,68.69509544496562
1747352208955789,48835084,1,530,25,49086604,48725504,361100,69.23289947382997
1747352209050490,48927644,1,531,25,49181305,48818064,363241,68.82482979619591
1747352209144344,49020204,1,532,25,49275159,48910624,364535,68.58052038898872
1747352209238438,49112764,1,533,25,49369253,49003184,366069,68.29313599348757
1747352209328802,49205324,1,534,25,49459617,49095744,363873,68.70529003251134
1747352209422474,49297884,1,535,25,49553289,49188304,364985,68.49596558762688
1747352209516757,49390444,1,536,25,49647572,49280864,366708,68.17413309772353
1747352209611432,49483004,1,537,25,49742247,49373424,368823,67.78319139533055
1747352209704798,49575564,1,538,25,49835613,49465984,369629,67.6353857516591
1747352209795783,49668132,1,539,25,49926598,49558552,368046,67.92629182221788
1747352209889436,49760684,1,540,25,50020251,49651104,369147,67.72369814735052
1747352209983929,49853244,1,541,25,50114744,49743664,371080,67.37091732241026
1747352210077622,49945804,1,542,25,50208437,49836224,372213,67.16584321342887
1747352210168611,50038364,1,543,25,50299426,49928784,370642,67.45053177999255
1747352210262347,50130924,1,544,25,50393162,50021344,371818,67.23719669300571
1747352210356567,50223484,1,545,25,50487382,50113904,373478,66.93834710478262
1747352210451060,50316044,1,546,25,50581875,50206464,375411,66.5936799933939
1747352210541203,50408604,1,547,25,50672018,50299024,372994,67.02520683978831
1747352210635433,50501164,1,548,25,50766248,50391584,374664,66.72645356906455
1747352210728888,50593724,1,549,25,50859703,50484144,375559,66.56743680753225
1747352210823198,50686284,1,550,25,50954013,50576704,377309,66.25868982717083
1747352210913347,50778844,1,551,25,51044162,50669264,374898,66.6848049336086
1747352211007854,50871404,1,552,25,51138669,50761824,376845,66.34027252583954
1747352211102179,50963964,1,553,25,51232994,50854384,378610,66.03100816143261
1747352211196455,51056524,1,554,25,51327270,50946944,380326,65.73308161945279
1747352211290168,51149084,1,555,25,51420983,51039504,381479,65.53440687429715
1747352211380747,51241644,1,556,25,51511562,51132064,379498,65.87650000790518
1747352211474858,51334204,1,557,25,51605673,51224624,381049,65.60836007967478
1747352211569214,51426764,1,558,25,51700029,51317184,382845,65.30057856312607
1747352211662907,51519324,1,559,25,51793722,51409744,383978,65.10789680658787
1747352211752974,51611884,1,560,25,51883789,51502304,381485,65.53337614847241
1747352211847695,51704444,1,561,25,51978510,51594864,383646,65.16423995037091
1747352211942046,51797012,1,562,25,52072861,51687432,385429,64.86278925560867
1747352212035052,51889564,1,563,25,52165867,51779984,385883,64.7864767299933
1747352212126126,51982124,1,564,25,52256941,51872544,384397,65.03692796770007
1747352212220081,52074684,1,565,25,52350896,51965104,385792,64.80175846051758
1747352212313827,52167244,1,566,25,52444642,52057664,386978,64.60315573495134
1747352212408178,52259804,1,567,25,52538993,52150224,388769,64.30553876466489
1747352212499094,52352364,1,568,25,52629909,52242784,387125,64.57862447529868
1747352212593319,52444924,1,569,25,52724134,52335344,388790,64.30206538234007
1747352212687400,52537484,1,570,25,52818215,52427904,390311,64.05148714742859
1747352212781230,52630044,1,571,25,52912045,52520464,391581,63.84375135667971
1747352212875475,52722604,1,572,25,53006290,52613024,393266,63.57020439092116
1747352212965485,52815164,1,573,25,53096300,52705584,390716,63.98509403249419
1747352213059401,52907724,1,574,25,53190216,52798144,392072,63.763798485992375
1747352213154392,53000284,1,575,25,53285207,52890704,394503,63.370874239232656
1747352213248398,53092844,1,576,25,53379213,52983264,395949,63.139444726467296
1747352213338118,53185404,1,577,25,53468933,53075824,393109,63.59559307978195
1747352213432130,53277964,1,578,25,53562945,53168384,394561,63.36155879572487
1747352213526668,53370524,1,579,25,53657483,53260944,396539,63.04550119912544
1747352213620628,53463084,1,580,25,53751443,53353504,397939,62.82369910966254
1747352213711160,53555644,1,581,25,53841975,53446064,395911,63.14550492408648
1747352213805151,53648204,1,582,25,53935966,53538624,397342,62.91809071278647
1747352213899501,53740764,1,583,25,54030316,53631184,399132,62.63591994628344
1747352213993776,53833324,1,584,25,54124591,53723744,400847,62.36793589574077
1747352214084166,53925884,1,585,25,54214981,53816304,398677,62.707404741181456
1747352214178321,54018444,1,586,25,54309136,53908864,400272,62.45752888036135
1747352214272173,54111004,1,587,25,54402988,54001424,401564,62.256576784771546
1747352214366438,54203564,1,588,25,54497253,54093984,403269,61.993359271354855
1747352214460488,54296124,1,589,25,54591303,54186544,404759,61.76514913812911
1747352214550731,54388684,1,590,25,54681546,54279104,402442,62.12075280413078
1747352214644729,54481244,1,591,25,54775544,54371664,403880,61.89957413092998
1747352214738955,54573804,1,592,25,54869770,54464224,405546,61.64528808076026
1747352214833108,54666364,1,593,25,54963923,54556784,407139,61.404090494892415
1747352214923863,54758924,1,594,25,55054678,54649344,405334,61.67753013564122
1747352215017697,54851484,1,595,25,55148512,54741904,406608,61.48427969936646
1747352215111648,54944044,1,596,25,55242463,54834464,407999,61.27465998691173
1747352215205808,55036604,1,597,25,55336623,54927024,409599,61.035305261975736
1747352215296191,55129164,1,598,25,55427006,55019584,407422,61.36143850847524
1747352215390617,55221724,1,599,25,55521432,55112144,409288,61.08168331346143
1747352215484172,55314284,1,600,25,55614987,55204704,410283,60.93355074424239
1747352215578301,55406844,1,601,25,55709116,55297264,411852,60.701417013878775
1747352215668244,55499404,1,602,25,55799059,55389824,409235,61.089593998558286
1747352215762795,55591972,1,603,25,55893610,55482392,411218,60.79500410974228
1747352215857463,55684524,1,604,25,55988278,55574944,413334,60.48377341326869
1747352215951249,55777084,1,605,25,56082064,55667504,414560,60.30490158240062
1747352216045919,55869644,1,606,25,56176734,55760064,416670,59.99952000383997
1747352216136089,55962204,1,607,25,56266904,55852624,414280,60.34565994013711
1747352216230256,56054764,1,608,25,56361071,55945184,415887,60.11248247721136
1747352216324138,56147324,1,609,25,56454953,56037744,417209,59.92200551761827
1747352216418639,56239884,1,610,25,56549454,56130304,419150,59.64451866873434
1747352216508762,56332444,1,611,25,56639577,56222864,416713,59.993328741843904
1747352216602574,56425004,1,612,25,56733389,56315424,417965,59.81362075771895
1747352216696589,56517564,1,613,25,56827404,56407984,419420,59.60612274092794
1747352216790590,56610124,1,614,25,56921405,56500544,420861,59.40203535133928
1747352216881587,56702684,1,615,25,57012402,56593104,419298,59.6234658882227
1747352216974954,56795244,1,616,25,57105769,56685664,420105,59.50893229073684
1747352217069317,56887804,1,617,25,57200132,56778224,421908,59.254624230874974
1747352217162952,56980364,1,618,25,57293767,56870784,422983,59.1040301856103
1747352217253656,57072924,1,619,25,57384471,56963344,421127,59.3645147425836
1747352217347669,57165484,1,620,25,57478484,57055904,422580,59.1603956647262
1747352217441605,57258044,1,621,25,57572420,57148464,423956,58.96838351149648
1747352217536167,57350604,1,622,25,57666982,57241024,425958,58.69123246892886
1747352217630344,57443164,1,623,25,57761159,57333584,427575,58.46927439630475
1747352217720662,57535724,1,624,25,57851477,57426144,425333,58.77747553093693
1747352217814556,57628284,1,625,25,57945371,57518704,426667,58.593704223668574
1747352217909378,57720852,1,626,25,58040193,57611272,428921,58.2857915560208
1747352218002946,57813404,1,627,25,58133761,57703824,429937,58.14805424980869
1747352218093479,57905964,1,628,25,58224294,57796384,427910,58.4235002687481
1747352218187439,57998524,1,629,25,58318254,57888944,429310,58.232978500384334
1747352218281633,58091084,1,630,25,58412448,57981504,430944,58.01217791638821
1747352218375695,58183644,1,631,25,58506510,58074064,432446,57.8106861897208
1747352218466323,58276204,1,632,25,58597138,58166624,430514,58.070120832307424
1747352218560349,58368764,1,633,25,58691164,58259184,431980,57.87304967822585
1747352218654440,58461324,1,634,25,58785255,58351744,433511,57.66866354025619
1747352218748968,58553884,1,635,25,58879783,58444304,435479,57.408049527072485
1747352218842587,58646444,1,636,25,58973402,58536864,436538,57.26878301545341
1747352218932742,58739004,1,637,25,59063557,58629424,434133,57.586039301320106
1747352219026756,58831564,1,638,25,59157571,58721984,435587,57.39381570157053
1747352219121343,58924124,1,639,25,59252158,58814544,437614,57.127971225783455
1747352219214964,59016684,1,640,25,59345779,58907104,438675,56.989798826010144
1747352219305899,59109244,1,641,25,59436714,58999664,437050,57.20169317011784
1747352219399423,59201804,1,642,25,59530238,59092224,438014,57.07580123009767
1747352219494211,59294364,1,643,25,59625026,59184784,440242,56.78694899623389
1747352219588112,59386924,1,644,25,59718927,59277344,441583,56.61449829363902
1747352219678588,59479484,1,645,25,59809403,59369904,439499,56.88295081445009
1747352219772794,59572044,1,646,25,59903609,59462464,441145,56.67070917725464
1747352219866884,59664604,1,647,25,59997699,59555024,442675,56.474840458575706
1747352219961263,59757164,1,648,25,60092078,59647584,444494,56.2437288242361
1747352220051374,59849724,1,649,25,60182189,59740144,442045,56.55532807745818
1747352220145343,59942284,1,650,25,60276158,59832704,443454,56.37563309835969
1747352220239763,60034844,1,651,25,60370578,59925264,445314,56.14016177349017
1747352220333218,60127404,1,652,25,60464033,60017824,446209,56.02755659343491
1747352220427741,60219964,1,653,25,60558556,60110384,448172,55.782155065465936
1747352220518084,60312524,1,654,25,60648899,60202944,445955,56.05946788353085
1747352220612770,60405084,1,655,25,60743585,60295504,448081,55.79348376744383
1747352220706580,60497644,1,656,25,60837395,60388064,449331,55.63827111861857
1747352220800657,60590204,1,657,25,60931472,60480624,450848,55.45106111150543
1747352220891195,60682764,1,658,25,61022010,60573184,448826,55.70087294408078
1747352220985431,60775324,1,659,25,61116246,60665744,450502,55.49364930677333
1747352221078848,60867884,1,660,25,61209663,60758304,451359,55.38828294107351
1747352221172835,60960444,1,661,25,61303650,60850864,452786,55.213721272300816
1747352221262970,61053004,1,662,25,61393785,60943424,450361,55.5110233790226
1747352221357863,61145564,1,663,25,61488678,61035984,452694,55.224942234710426
1747352221451664,61238124,1,664,25,61582479,61128544,453935,55.0739643341007
1747352221546456,61330684,1,665,25,61677271,61221104,456167,54.80449046073039
1747352221635730,61423244,1,666,25,61766545,61313664,452881,55.20213919329802
1747352221730407,61515812,1,667,25,61861222,61406232,454990,54.94626255522099
1747352221824906,61608364,1,668,25,61955721,61498784,456937,54.71213755944474
1747352221918995,61700924,1,669,25,62049810,61591344,458466,54.52967068441281
1747352222012917,61793484,1,670,25,62143732,61683904,459828,54.368155049279295
1747352222103424,61886044,1,671,25,62234239,61776464,457775,54.61198186882202
1747352222196983,61978604,1,672,25,62327798,61869024,458774,54.49306194335337
1747352222291714,62071164,1,673,25,62422529,61961584,460945,54.2364056449251
1747352222385657,62163724,1,674,25,62516472,62054144,462328,54.07416379713104
1747352222476554,62256284,1,675,25,62607369,62146704,460665,54.26937145213984
1747352222569982,62348844,1,676,25,62700797,62239264,461533,54.167307646473816
1747352222664419,62441404,1,677,25,62795234,62331824,463410,53.94790790013163
1747352222759025,62533964,1,678,25,62889840,62424384,465456,53.71076965384484
1747352222848761,62626524,1,679,25,62979576,62516944,462632,54.03863113662696
1747352222942409,62719084,1,680,25,63073224,62609504,463720,53.91184335374795
1747352223037483,62811644,1,681,25,63168298,62702064,466234,53.62114303118177
1747352223130907,62904204,1,682,25,63261722,62794624,467098,53.52195898933415
1747352223221170,62996764,1,683,25,63351985,62887184,464801,53.78645915133573
1747352223315771,63089324,1,684,25,63446586,62979744,466842,53.55130857977646
1747352223409657,63181884,1,685,25,63540472,63072304,468168,53.39963431930418
1747352223504146,63274444,1,686,25,63634961,63164864,470097,53.18051380885222
1747352223598363,63367004,1,687,25,63729178,63257424,471754,52.99372130389991
1747352223688712,63459564,1,688,25,63819527,63349984,469543,53.24325993572474
1747352223786412,63552124,1,689,25,63917227,63442544,474683,52.66672705784703
1747352223876408,63644692,1,690,25,64007223,63535112,472111,52.95364861229668
1747352223970306,63737244,1,691,25,64101121,63627664,473457,52.80310566746294
1747352224060935,63829804,1,692,25,64191750,63720224,471526,53.0193456988586
1747352224155186,63922364,1,693,25,64286001,63812784,473217,52.829885654995486
1747352224249224,64014924,1,694,25,64380039,63905344,474695,52.66539567511771
1747352224343195,64107484,1,695,25,64474010,63997904,476106,52.50931515250806
1747352224433388,64200044,1,696,25,64564203,64090464,473739,52.77167385416865
1747352224527761,64292604,1,697,25,64658576,64183024,475552,52.570486508310346
1747352224621461,64385164,1,698,25,64752276,64275584,476692,52.44476517331946
1747352224716464,64477724,1,699,25,64847279,64368144,479135,52.177361286485024
1747352224806572,64570284,1,700,25,64937387,64460704,476683,52.44575535523608
1747352224899962,64662844,1,701,25,65030777,64553264,477513,52.354595581690965
1747352224994958,64755404,1,702,25,65125773,64645824,479949,52.08886777553448
1747352225088299,64847964,1,703,25,65219114,64738384,480730,52.00424354627338
1747352225183485,64940524,1,704,25,65314300,64830944,483356,51.72171236107548
1747352225273528,65033084,1,705,25,65404343,64923504,480839,51.99245485495145
1747352225367283,65125644,1,706,25,65498098,65016064,482034,51.863561491513046
1747352225461287,65218204,1,707,25,65592102,65108624,483478,51.70866099388183
1747352225555287,65310764,1,708,25,65686102,65201184,484918,51.55510828634944
1747352225645857,65403324,1,709,25,65776672,65293744,482928,51.76755127058278
1747352225739755,65495884,1,710,25,65870570,65386304,484266,51.62452040820541
1747352225834740,65588444,1,711,25,65965555,65478864,486691,51.36729464896619
1747352225928167,65681004,1,712,25,66058982,65571424,487558,51.27595075867897
1747352226018423,65773564,1,713,25,66149238,65663984,485254,51.5194104530823
1747352226112781,65866124,1,714,25,66243596,65756544,487052,51.329221520494734
1747352226206824,65958684,1,715,25,66337639,65849104,488535,51.17340620426377
1747352226301569,66051244,1,716,25,66432384,65941664,490720,50.94554939680469
1747352226395632,66143804,1,717,25,66526447,66034224,492223,50.78998746503109
1747352226485101,66236364,1,718,25,66615916,66126784,489132,51.11094755607893
1747352226579875,66328924,1,719,25,66710690,66219344,491346,50.8806421544085
1747352226674244,66421484,1,720,25,66805059,66311904,493155,50.694000871936815
1747352226768557,66514044,1,721,25,66899372,66404464,494908,50.51443904725727
1747352226858086,66606604,1,722,25,66988901,66497024,491877,50.82571455872098
1747352226952203,66699164,1,723,25,67083018,66589584,493434,50.665337208218325
1747352227046486,66791724,1,724,25,67177301,66682144,495157,50.48903681054696
1747352227140953,66884284,1,725,25,67271768,66774704,497064,50.29533420243671
1747352227230648,66976844,1,726,25,67361463,66867264,494199,50.5869093219533
1747352227325594,67069404,1,727,25,67456409,66959824,496585,50.3438484851536
1747352227418919,67161964,1,728,25,67549734,67052384,497350,50.26641198351262
1747352227513282,67254524,1,729,25,67644097,67144944,499153,50.08484372527061
1747352227603957,67347084,1,730,25,67734772,67237504,497268,50.274700966078655
1747352227698066,67439652,1,731,25,67828881,67330072,498809,50.119384373577866
1747352227791962,67532204,1,732,25,67922777,67422624,500153,49.98470468036781
1747352227886301,67624764,1,733,25,68017116,67515184,501932,49.80754365133125
1747352227980693,67717324,1,734,25,68111508,67607744,503764,49.626412367695984
1747352228070766,67809884,1,735,25,68201581,67700304,501277,49.87262531494563
1747352228164888,67902444,1,736,25,68295703,67792864,502839,49.71770288303015
1747352228259028,67995004,1,737,25,68389843,67885424,504419,49.56197129767119
1747352228353329,68087564,1,738,25,68484144,67977984,506160,49.39149675991781
1747352228443778,68180124,1,739,25,68574593,68070544,504049,49.598352541122
1747352228537816,68272684,1,740,25,68668631,68163104,505527,49.4533427492498
1747352228631905,68365244,1,741,25,68762720,68255664,507056,49.30421886339971
1747352228725440,68457804,1,742,25,68856255,68348224,508031,49.20959547744133
1747352228815916,68550364,1,743,25,68946731,68440784,505947,49.41229022012187
1747352228910531,68642924,1,744,25,69041346,68533344,508002,49.21240467557215
1747352229004140,68735484,1,745,25,69134955,68625904,509051,49.11099280818621
1747352229098227,68828044,1,746,25,69229042,68718464,510578,48.964115179267424
1747352229188376,68920604,1,747,25,69319191,68811024,508167,49.19642558450273
1747352229282692,69013164,1,748,25,69413507,68903584,509923,49.02700996032734
1747352229376682,69105724,1,749,25,69507497,68996144,511353,48.88990579892951
1747352229471310,69198284,1,750,25,69602125,69088704,513421,48.692982951612805
1747352229565791,69290844,1,751,25,69696606,69181264,515342,48.51147393381483
1747352229655199,69383404,1,752,25,69786014,69273824,512190,48.8100119096429
1747352229749395,69475964,1,753,25,69880210,69366384,513826,48.65460292005465
1747352229843456,69568532,1,754,25,69974271,69458952,515319,48.51363912450346
1747352229937676,69661084,1,755,25,70068491,69551504,516987,48.35711536266869
1747352230028662,69753644,1,756,25,70159477,69644064,515413,48.50479130328494
1747352230122749,69846204,1,757,25,70253564,69736624,516940,48.36151197431037
1747352230216085,69938764,1,758,25,70346900,69829184,517716,48.28902332552983
1747352230310967,70031324,1,759,25,70441782,69921744,520038,48.073410020037
1747352230400656,70123884,1,760,25,70531471,70014304,517167,48.34028466626834
1747352230494654,70216444,1,761,25,70625469,70106864,518605,48.20624560118009
1747352230589014,70309004,1,762,25,70719829,70199424,520405,48.03950769112518
1747352230683159,70401564,1,763,25,70813974,70291984,521990,47.89363780915344
1747352230774251,70494124,1,764,25,70905066,70384544,520522,48.02870964147529
1747352230867530,70586684,1,765,25,70998345,70477104,521241,47.9624588242291
1747352230961917,70679244,1,766,25,71092732,70569664,523068,47.794932972386
1747352231056289,70771804,1,767,25,71187104,70662224,524880,47.62993446121018
1747352231150523,70864364,1,768,25,71281338,70754784,526554,47.4785112258192
1747352231240219,70956924,1,769,25,71371034,70847344,523690,47.73816570872081
1747352231334692,71049484,1,770,25,71465507,70939904,525603,47.56441648925139
1747352231428525,71142044,1,771,25,71559340,71032464,526876,47.44949475777982
1747352231523089,71234604,1,772,25,71653904,71125024,528880,47.26970201179852
1747352231613182,71327164,1,773,25,71743997,71217584,526413,47.491228370120034
1747352231707354,71419724,1,774,25,71838169,71310144,528025,47.34624307561195
1747352231801958,71512284,1,775,25,71932773,71402704,530069,47.163671144700025
1747352231896050,71604844,1,776,25,72026865,71495264,531601,47.02775201702028
1747352231986186,71697404,1,777,25,72117001,71587824,529177,47.24317194435888
1747352232080206,71789964,1,778,25,72211021,71680384,530637,47.113186604024975
1747352232174324,71882524,1,779,25,72305139,71772944,532195,46.97526282659552
1747352232268254,71975084,1,780,25,72399069,71865504,533565,46.85464751248677
1747352232358961,72067644,1,781,25,72489776,71958064,531712,47.01793452094367
1747352232453349,72160204,1,782,25,72584164,72050624,533540,46.856842973347824
1747352232546757,72252764,1,783,25,72677572,72143184,534388,46.78248763071027
1747352232641682,72345324,1,784,25,72772497,72235744,536753,46.57635821318185
1747352232735491,72437884,1,785,25,72866306,72328304,538002,46.46822874264408
1747352232825999,72530444,1,786,25,72956814,72420864,535950,46.64614236402649
1747352232920167,72623004,1,787,25,73050982,72513424,537558,46.50660951934489
1747352233014151,72715564,1,788,25,73144966,72605984,538982,46.383738232445616
1747352233108327,72808124,1,789,25,73239142,72698544,540598,46.24508414755511
1747352233198609,72900684,1,790,25,73329424,72791104,538320,46.44077871897756
1747352233292824,72993244,1,791,25,73423639,72883664,539975,46.29843974258068
1747352233386597,73085804,1,792,25,73517412,72976224,541188,46.19466802663769
1747352233480619,73178364,1,793,25,73611434,73068784,542650,46.07021100156639
1747352233571303,73270924,1,794,25,73702118,73161344,540774,46.23003324863991
1747352233665527,73363492,1,795,25,73796342,73253912,542430,46.0888962631123
1747352233759253,73456044,1,796,25,73890068,73346464,543604,45.98935990169315
1747352233853180,73548604,1,797,25,73983995,73439024,544971,45.87400063489617
1747352233943958,73641164,1,798,25,74074773,73531584,543189,46.02449607779244
1747352234037478,73733724,1,799,25,74168293,73624144,544149,45.9432986185769
1747352234131634,73826284,1,800,25,74262449,73716704,545745,45.80894007274459
1747352234226300,73918844,1,801,25,74357115,73809264,547851,45.63284542695003
1747352234320906,74011404,1,802,25,74451721,73901824,549897,45.46305944567801
1747352234411098,74103964,1,803,25,74541913,73994384,547529,45.659681952919385
1747352234505315,74196524,1,804,25,74636130,74086944,549186,45.52191789302714
1747352234598897,74289084,1,805,25,74729712,74179504,550208,45.43736187041991
1747352234693091,74381644,1,806,25,74823906,74272064,551842,45.30282218461081
1747352234783466,74474204,1,807,25,74914281,74364624,549657,45.48291025130218
1747352234877398,74566764,1,808,25,75008213,74457184,551029,45.36966293970009
1747352234972057,74659324,1,809,25,75102872,74549744,553128,45.19749497403856
1747352235066143,74751884,1,810,25,75196958,74642304,554654,45.07314469921789
1747352235156320,74844444,1,811,25,75287135,74734864,552271,45.26763128971104
1747352235250596,74937004,1,812,25,75381411,74827424,553987,45.12741273712199
1747352235344841,75029564,1,813,25,75475656,74919984,555672,44.99056997653292
1747352235439035,75122124,1,814,25,75569850,75012544,557306,44.85865933616362
1747352235532558,75214684,1,815,25,75663373,75105104,558269,44.78127927576133
1747352235622698,75307244,1,816,25,75753513,75197664,555849,44.97624354815786
1747352235716754,75399804,1,817,25,75847569,75290224,557345,44.8555203688918
1747352235811020,75492372,1,818,25,75941835,75382792,559043,44.7192791967702
1747352235905409,75584924,1,819,25,76036224,75475344,560880,44.57281414919412
1747352235995740,75677484,1,820,25,76126555,75567904,558651,44.75065828218333
1747352236090086,75770044,1,821,25,76220901,75660464,560437,44.608046934802665
1747352236184383,75862604,1,822,25,76315198,75753024,562174,44.47021740599886
1747352236278425,75955164,1,823,25,76409240,75845584,563656,44.353293498162
1747352236368489,76047724,1,824,25,76499304,75938144,561160,44.55057381139069
1747352236463021,76140284,1,825,25,76593836,76030704,563132,44.39456468465653
1747352236556813,76232844,1,826,25,76687628,76123264,564364,44.29765187006967
1747352236650524,76325404,1,827,25,76781339,76215824,565515,44.2074922857926
1747352236740725,76417964,1,828,25,76871540,76308384,563156,44.39267272301103
1747352236835380,76510524,1,829,25,76966195,76400944,565251,44.22813935755974
1747352236929179,76603084,1,830,25,77059994,76493504,566490,44.13140567353351
1747352237023642,76695644,1,831,25,77154457,76586064,568393,43.98365215616659
1747352237117501,76788204,1,832,25,77248316,76678624,569692,43.88336153570702
1747352237207707,76880764,1,833,25,77338522,76771184,567338,44.06544246992093
1747352237302548,76973324,1,834,25,77433363,76863744,569619,43.88898544465687
1747352237396321,77065884,1,835,25,77527136,76956304,570832,43.795722734534856
1747352237490887,77158444,1,836,25,77621702,77048864,572838,43.64235612860879
1747352237580542,77251004,1,837,25,77711357,77141424,569933,43.86480516130843
1747352237674819,77343564,1,838,25,77805634,77233984,571650,43.733053441791306
1747352237769636,77436124,1,839,25,77900451,77326544,573907,43.56106477181844
1747352237863501,77528684,1,840,25,77994316,77419104,575212,43.462236531922144
1747352237953709,77621244,1,841,25,78084524,77511664,572860,43.64068009635862
1747352238047130,77713804,1,842,25,78177945,77604224,573721,43.57518724257958
1747352238141762,77806364,1,843,25,78272577,77696784,575793,43.41838125854257
1747352238235788,77898924,1,844,25,78366603,77789344,577259,43.30811646072214
1747352238325826,77991484,1,845,25,78456641,77881904,574737,43.498156548125486
1747352238420492,78084044,1,846,25,78551307,77974464,576843,43.33934883495162
1747352238514752,78176604,1,847,25,78645567,78067024,578543,43.21199979949632
1747352238609068,78269164,1,848,25,78739883,78159584,580299,43.08123915429804
1747352238703153,78361724,1,849,25,78833968,78252144,581824,42.968320316796834
1747352238792672,78454284,1,850,25,78923487,78344704,578783,43.19408137419378
1747352238887320,78546844,1,851,25,79018135,78437264,580871,43.0388158472363
1747352238981576,78639404,1,852,25,79112391,78529824,582567,42.91351896005095
1747352239076107,78731964,1,853,25,79206922,78622384,584538,42.768819135796136
1747352239165465,78824524,1,854,25,79296280,78714944,581336,43.00438988811978
1747352239260392,78917084,1,855,25,79391207,78807504,583703,42.83000087373202
1747352239354484,79009644,1,856,25,79485299,78900064,585235,42.71788255999727
1747352239447605,79102204,1,857,25,79578420,78992624,585796,42.67697287110189
1747352239538379,79194764,1,858,25,79669194,79085184,584010,42.80748617318197
1747352239632377,79287332,1,859,25,79763192,79177752,585440,42.70292429625581
1747352239727285,79379884,1,860,25,79858100,79270304,587796,42.5317627203996
1747352239821210,79472444,1,861,25,79952025,79362864,589161,42.43322283722106
1747352239911216,79565004,1,862,25,80042031,79455424,586607,42.61797080498528
1747352240005477,79657564,1,863,25,80136292,79547984,588308,42.49474764919056
1747352240100039,79750124,1,864,25,80230854,79640544,590310,42.35062933035185
1747352240193590,79842684,1,865,25,80324405,79733104,591301,42.2796511421425
1747352240287548,79935244,1,866,25,80418363,79825664,592699,42.17992606702559
1747352240378291,80027804,1,867,25,80509106,79918224,590882,42.30963204159206
1747352240472061,80120364,1,868,25,80602876,80010784,592092,42.2231680211859
1747352240566470,80212924,1,869,25,80697285,80103344,593941,42.09172291523905
1747352240660906,80305484,1,870,25,80791721,80195904,595817,41.95919216806502
1747352240751262,80398044,1,871,25,80882077,80288464,593613,42.11498063553191
1747352240845157,80490604,1,872,25,80975972,80381024,594948,42.02047910069451
1747352240939442,80583164,1,873,25,81070257,80473584,596673,41.89899660282936
1747352241033508,80675724,1,874,25,81164323,80566144,598179,41.793509969423866
1747352241123386,80768284,1,875,25,81254201,80658704,595497,41.98173962253378
1747352241217855,80860844,1,876,25,81348670,80751264,597406,41.84758773765245
1747352241311306,80953404,1,877,25,81442121,80843824,598297,41.78526718335542
1747352241406008,81045964,1,878,25,81536823,80936384,600439,41.63620284491847
1747352241496739,81138524,1,879,25,81627554,81028944,598610,41.76341858639181
1747352241590273,81231084,1,880,25,81721088,81121504,599584,41.69557559908203
1747352241688592,81323644,1,881,25,81819407,81214064,605343,41.2988999625006
1747352241778592,81416212,1,882,25,81909407,81306632,602775,41.474845506200495
1747352241873370,81508764,1,883,25,82004185,81399184,605001,41.322245748354135
1747352241966868,81601324,1,884,25,82097683,81491744,605939,41.25827847357572
1747352242057085,81693884,1,885,25,82187900,81584304,603596,41.41843219636976
1747352242151726,81786444,1,886,25,82282541,81676864,605677,41.27612572377687
1747352242245230,81879004,1,887,25,82376045,81769424,606621,41.21189342274666
1747352242335968,81971564,1,888,25,82466783,81861984,604799,41.3360471826177
1747352242429627,82064124,1,889,25,82560442,81954544,605898,41.26107034517361
1747352242524321,82156684,1,890,25,82655136,82047104,608032,41.1162570391032
1747352242617782,82249244,1,891,25,82748597,82139664,608933,41.055419890201385
1747352242708535,82341804,1,892,25,82839350,82232224,607126,41.1776138725734
1747352242802521,82434364,1,893,25,82933336,82324784,608552,41.0811237166257
1747352242896883,82526924,1,894,25,83027698,82417344,610354,40.95983642279727
1747352242991338,82619484,1,895,25,83122153,82509904,612249,40.83305975183299
1747352243085414,82712044,1,896,25,83216229,82602464,613765,40.732202064308
1747352243174967,82804604,1,897,25,83305782,82695024,610758,40.932742591992245
1747352243269594,82897164,1,898,25,83400409,82787584,612825,40.79468037367928
1747352243363737,82989724,1,899,25,83494552,82880144,614408,40.68957435450059
1747352243457805,83082284,1,900,25,83588620,82972704,615916,40.58995057767618
1747352243548163,83174844,1,901,25,83678978,83065264,613714,40.73558693463079
1747352243642565,83267404,1,902,25,83773380,83157824,615556,40.61368908758911
1747352243736928,83359964,1,903,25,83867743,83250384,617359,40.495076608585926
1747352243830730,83452524,1,904,25,83961545,83342944,618601,40.41377236700232
1747352243920867,83545084,1,905,25,84051682,83435504,616178,40.57269165728085
1747352244014865,83637644,1,906,25,84145680,83528064,617616,40.47822595269552
1747352244109139,83730204,1,907,25,84239954,83620624,619330,40.36620218623351
1747352244203414,83822764,1,908,25,84334229,83713184,621045,40.25473194373999
1747352244293439,83915324,1,909,25,84424254,83805744,618510,40.4197183554025
1747352244387350,84007884,1,910,25,84518165,83898304,619861,40.331622734774406
1747352244481802,84100444,1,911,25,84612617,83990864,621753,40.20889324217173
1747352244576259,84193004,1,912,25,84707074,84083424,623650,40.08658702798044
1747352244670413,84285564,1,913,25,84801228,84175984,625244,39.98439009410726
1747352244760692,84378124,1,914,25,84891507,84268544,622963,40.1307942847328
1747352244854830,84470684,1,915,25,84985645,84361104,624541,40.02939758958979
1747352244949109,84563244,1,916,25,85079924,84453664,626260,39.91952224315779
1747352245043212,84655804,1,917,25,85174027,84546224,627803,39.82140894516274
1747352245133200,84748364,1,918,25,85264015,84638784,625231,39.98522146214759
1747352245227381,84840924,1,919,25,85358196,84731344,626852,39.88182218450288
1747352245321476,84933484,1,920,25,85452291,84823904,628387,39.78440037747439
1747352245416173,85026044,1,921,25,85546988,84916464,630524,39.64956131725359
1747352245506083,85118604,1,922,25,85636898,85009024,627874,39.81690593972676
1747352245600442,85211172,1,923,25,85731257,85101592,629665,39.70365194190561
1747352245694651,85303724,1,924,25,85825466,85194144,631322,39.5994437070148
1747352245788810,85396284,1,925,25,85919625,85286704,632921,39.49940039910194
1747352245878914,85488844,1,926,25,86009729,85379264,630465,39.65327179145551
1747352245973102,85581404,1,927,25,86103917,85471824,632093,39.551141999674094
1747352246066877,85673964,1,928,25,86197692,85564384,633308,39.47526322105516
1747352246160956,85766524,1,929,25,86291771,85656944,634827,39.38080768461329
1747352246255175,85859084,1,930,25,86385990,85749504,636486,39.278161656344366
1747352246345597,85951644,1,931,25,86476412,85842064,634348,39.41054436996727
1747352246439638,86044204,1,932,25,86570453,85934624,635829,39.31874765070483
1747352246533538,86136764,1,933,25,86664353,86027184,637169,39.236058251421525
1747352246628236,86229324,1,934,25,86759051,86119744,639307,39.104843213041626
1747352246718389,86321884,1,935,25,86849204,86212304,636900,39.25262992620505
1747352246812370,86414444,1,936,25,86943185,86304864,638321,39.16524757919605
1747352246906233,86507004,1,937,25,87037048,86397424,639624,39.08546270934174
1747352247000298,86599564,1,938,25,87131113,86489984,641129,38.99371265377171
1747352247090957,86692124,1,939,25,87221772,86582544,639228,39.109676046731366
1747352247185371,86784684,1,940,25,87316186,86675104,641082,38.99657142144063
1747352247279170,86877244,1,941,25,87409985,86767664,642321,38.92134929420025
1747352247373285,86969804,1,942,25,87504100,86860224,643876,38.82735185035628
1747352247463598,87062364,1,943,25,87594413,86952784,641629,38.96332615888621
1747352247557463,87154924,1,944,25,87688278,87045344,642934,38.884240061965926
1747352247651821,87247484,1,945,25,87782636,87137904,644732,38.77580141826371
1747352247745771,87340052,1,946,25,87876586,87230472,646114,38.69286225031496
1747352247840306,87432604,1,947,25,87971121,87323024,648097,38.57447264838442
1747352247930345,87525164,1,948,25,88061160,87415584,645576,38.72510750089842
1747352248024321,87617724,1,949,25,88155136,87508144,646992,38.64035413111754
1747352248118694,87710284,1,950,25,88249509,87600704,648805,38.53237875787024
1747352248213057,87802844,1,951,25,88343872,87693264,650608,38.425595750436514
1747352248303176,87895404,1,952,25,88433991,87785824,648167,38.57030672650721
1747352248397650,87987964,1,953,25,88528465,87878384,650081,38.45674615932476
1747352248491582,88080524,1,954,25,88622397,87970944,651453,38.37575389168521
1747352248585636,88173084,1,955,25,88716451,88063504,652947,38.28794680119519
1747352248676306,88265644,1,956,25,88807121,88156064,651057,38.39909562449985
1747352248770127,88358204,1,957,25,88900942,88248624,652318,38.32486609291787
1747352248864563,88450764,1,958,25,88995378,88341184,654194,38.21496375692837
1747352248958446,88543324,1,959,25,89089261,88433744,655517,38.13783624223323
1747352249048840,88635884,1,960,25,89179655,88526304,653351,38.264271425313495
1747352249146511,88728444,1,961,25,89277326,88618864,658462,37.96726310705857
1747352249236684,88821004,1,962,25,89367499,88711424,656075,38.10539953511413
1747352249331584,88913564,1,963,25,89462399,88803984,658415,37.96997334507872
1747352249425474,89006124,1,964,25,89556289,88896544,659745,37.89342852162578
1747352249515315,89098684,1,965,25,89646130,88989104,657026,38.050244586972205
1747352249609447,89191244,1,966,25,89740262,89081664,658598,37.95942289530184
1747352249703582,89283804,1,967,25,89834397,89174224,660173,37.86886164687135
1747352249798607,89376364,1,968,25,89929422,89266784,662638,37.72799024505085
1747352249888565,89468924,1,969,25,90019380,89359344,660036,37.87672187577648
1747352249982774,89561484,1,970,25,90113589,89451904,661685,37.78232844933768
1747352250077124,89654044,1,971,25,90207939,89544464,663475,37.68039489053845
1747352250170696,89746604,1,972,25,90301511,89637024,664487,37.62300842604896
1747352250265402,89839164,1,973,25,90396217,89729584,666633,37.5018938456392
1747352250355183,89931724,1,974,25,90485998,89822144,663854,37.658882826645616
1747352250449724,90024284,1,975,25,90580539,89914704,665835,37.54683968250393
1747352250543723,90116844,1,976,25,90674538,90007264,667274,37.46586859371113
1747352250634374,90209404,1,977,25,90765189,90099824,665365,37.57336198928408
1747352250728030,90301964,1,978,25,90858845,90192384,666461,37.51157232006074
1747352250822235,90394524,1,979,25,90953050,90284944,668106,37.41921192146157
1747352250916249,90487084,1,980,25,91047064,90377504,669560,37.33795328275285
1747352251010628,90579644,1,981,25,91141443,90470064,671379,37.23679173760276
1747352251100390,90672204,1,982,25,91231205,90562624,668581,37.39262707136458
1747352251194770,90764764,1,983,25,91325585,90655184,670401,37.2911138259042
1747352251289078,90857324,1,984,25,91419893,90747744,672149,37.194134038732486
1747352251382818,90949884,1,985,25,91513633,90840304,673329,37.128951819986966
1747352251473339,91042444,1,986,25,91604154,90932864,671290,37.241728612075256
1747352251567953,91135012,1,987,25,91698768,91025432,673336,37.12856582746207
1747352251661282,91227564,1,988,25,91792097,91117984,674113,37.08577048655048
1747352251755679,91320124,1,989,25,91886494,91210544,675950,36.984984096456834
1747352251845963,91412684,1,990,25,91976778,91303104,673674,37.10993744748944
1747352251940210,91505244,1,991,25,92071025,91395664,675361,37.01723966885858
1747352252034254,91597804,1,992,25,92165069,91488224,676845,36.9360784226817
1747352252128778,91690364,1,993,25,92259593,91580784,678809,36.82921116249195
1747352252223160,91782924,1,994,25,92353975,91673344,680631,36.73062202573788
1747352252312554,91875484,1,995,25,92443369,91765904,677465,36.902275394300815
1747352252406936,91968044,1,996,25,92537751,91858464,679287,36.803295219840805
1747352252501753,92060604,1,997,25,92632568,91951024,681544,36.68141748735224
1747352252595882,92153164,1,998,25,92726697,92043584,683113,36.59716620822616
1747352252685715,92245724,1,999,25,92816530,92136144,680386,36.74384834491009
1747352252780249,92338284,1,1000,25,92911064,92228704,682360,36.63755202532388
1747352252874509,92431884,1,1001,25,93005324,92322304,683020,36.602149278205616
1747352252968565,92525484,1,1002,25,93099380,92415904,683476,36.57772913752641
1747352253063049,92619084,1,1003,25,93193864,92509504,684360,36.53048103337425
1747352253160547,92712684,1,1004,25,93291362,92603104,688258,36.32358795684176
1747352253255026,92806284,1,1005,25,93385841,92696704,689137,36.27725691698458
1747352253345862,92899884,1,1006,25,93476677,92790304,686373,36.42334415835121
1747352253443958,92993484,1,1007,25,93574773,92883904,690869,36.18631028458362
1747352253537651,93087084,1,1008,25,93668466,92977504,690962,36.18143978974242
1747352253632495,93180684,1,1009,25,93763310,93071104,692206,36.116416211359045
1747352253726392,93274284,1,1010,25,93857207,93164704,692503,36.10092663858496
1747352253820575,93367884,1,1011,25,93951390,93258304,693086,36.07055978623144
1747352253914568,93461484,1,1012,25,94045383,93351904,693479,36.05011831648832
1747352254008239,93555084,1,1013,25,94139054,93445504,693550,36.04642779900512
1747352254102763,93648684,1,1014,25,94233578,93539104,694474,35.99846790520595
1747352254201440,93742284,1,1015,25,94332255,93632704,699551,35.737208580932624
1747352254290444,93835884,1,1016,25,94421259,93726304,694955,35.97355224438993
1747352254385443,93929492,1,1017,25,94516258,93819912,696346,35.901692549393545
1747352254479351,94023084,1,1018,25,94610166,93913504,696662,35.88540784483724
1747352254574200,94116684,1,1019,25,94705015,94007104,697911,35.821186369035594
1747352254668439,94210284,1,1020,25,94799254,94100704,698550,35.78841886765443
1747352254762582,94303884,1,1021,25,94893397,94194304,699093,35.76062126212106
1747352254856690,94397484,1,1022,25,94987505,94287904,699601,35.73465446733209
1747352254950910,94491084,1,1023,25,95081725,94381504,700221,35.703013762797745
1747352255045112,94584684,1,1024,25,95175927,94475104,700823,35.67234522839576
1747352255139266,94678284,1,1025,25,95270081,94568704,701377,35.64416854273807
1747352255233443,94771884,1,1026,25,95364258,94662304,701954,35.61486935041328
1747352255327664,94865484,1,1027,25,95458479,94755904,702575,35.58338967370032
1747352255421305,94959084,1,1028,25,95552120,94849504,702616,35.581313263574984
1747352255515477,95052684,1,1029,25,95646292,94943104,703188,35.55237006319789
1747352255610001,95146284,1,1030,25,95740816,95036704,704112,35.505714999886386
1747352255703990,95239884,1,1031,25,95834805,95130304,704501,35.4861100268133
1747352255798074,95333484,1,1032,25,95928889,95223904,704985,35.46174741306553
1747352255892991,95427084,1,1033,25,96023806,95317504,706302,35.39562396821756
1747352255991311,95520684,1,1034,25,96122126,95411104,711022,35.16065606971373
1747352256080988,95614284,1,1035,25,96211803,95504704,707099,35.35572812293611
1747352256174969,95707884,1,1036,25,96305784,95598304,707480,35.33668796291061
1747352256273733,95801484,1,1037,25,96404548,95691904,712644,35.080629318425466
1747352256363825,95895084,1,1038,25,96494640,95785504,709136,35.25416845287787
1747352256457998,95988684,1,1039,25,96588813,95879104,709709,35.225705183392066
1747352256552183,96082284,1,1040,25,96682998,95972704,710294,35.19669320028045
1747352256650374,96175884,1,1041,25,96781189,96066304,714885,34.97065961658169
1747352256740316,96269484,1,1042,25,96871131,96159904,711227,35.15052156343896
1747352256834586,96363084,1,1043,25,96965401,96253504,711897,35.117439741985145
1747352256933275,96456684,1,1044,25,97064090,96347104,716986,34.86818431601175
1747352257022734,96550284,1,1045,25,97153549,96440704,712845,35.07073767789632
1747352257117655,96643884,1,1046,25,97248470,96534304,714166,35.005866983306404
1747352257210863,96737484,1,1047,25,97341678,96627904,713774,35.02509197589153
1747352257309610,96831084,1,1048,25,97440425,96721504,718921,34.77433542767564
1747352257399572,96924692,1,1049,25,97530387,96815112,715275,34.95159204501765
1747352257498053,97018284,1,1050,25,97628868,96908704,720164,34.71431507267789
1747352257588717,97111884,1,1051,25,97719532,97002304,717228,34.85641943705488
1747352257682073,97205484,1,1052,25,97812888,97095904,716984,34.868281579505265
1747352257776957,97299084,1,1053,25,97907772,97189504,718268,34.805949868294284
1747352257874681,97392684,1,1054,25,98005496,97283104,722392,34.60724924971483
1747352257969537,97486284,1,1055,25,98100352,97376704,723648,34.5471831608738
1747352258063222,97579884,1,1056,25,98194037,97470304,723733,34.543125710724816
1747352258157340,97673484,1,1057,25,98288155,97563904,724251,34.51841971913052
1747352258251325,97767084,1,1058,25,98382140,97657504,724636,34.50008004018569
1747352258346366,97860684,1,1059,25,98477181,97751104,726077,34.43160987057847
1747352258439875,97954284,1,1060,25,98570690,97844704,725986,34.435925761653806
1747352258534357,98047884,1,1061,25,98665172,97938304,726868,34.39414033909871
1747352258628614,98141484,1,1062,25,98759429,98031904,727525,34.363080306518675
1747352258722456,98235084,1,1063,25,98853271,98125504,727767,34.351653757315184
1747352258817266,98328684,1,1064,25,98948081,98219104,728977,34.29463481015176
1747352258911273,98422284,1,1065,25,99042088,98312704,729384,34.27549822864225
1747352259005676,98515884,1,1066,25,99136491,98406304,730187,34.23780483629536
1747352259099842,98609484,1,1067,25,99230657,98499904,730753,34.21128616646117
1747352259193968,98703084,1,1068,25,99324783,98593504,731279,34.18667840865114
1747352259288056,98796684,1,1069,25,99418871,98687104,731767,34.16388003285199
1747352259382248,98890284,1,1070,25,99513063,98780704,732359,34.13626377227562
1747352259476175,98983884,1,1071,25,99606990,98874304,732686,34.12102865347502
1747352259570592,99077484,1,1072,25,99701407,98967904,733503,34.08302351864955
1747352259664703,99171084,1,1073,25,99795518,99061504,734014,34.059295871740865
1747352259758451,99264684,1,1074,25,99889266,99155104,734162,34.05242984518404
1747352259852671,99358284,1,1075,25,99983486,99248704,734782,34.02369682436423
1747352259946651,99451884,1,1076,25,100077466,99342304,735162,34.00611021788395
1747352260041797,99545484,1,1077,25,100172612,99435904,736708,33.93474755262601
1747352260135403,99639084,1,1078,25,100266218,99529504,736714,33.93447117877494
1747352260230063,99732684,1,1079,25,100360878,99623104,737774,33.88571567986944
1747352260323779,99826284,1,1080,25,100454594,99716704,737890,33.880388675818885
1747352260417939,99919892,1,1081,25,100548754,99810312,738442,33.85506241519307
1747352260512544,100013484,1,1082,25,100643359,99903904,739455,33.80868342225017
1747352260610291,100108124,1,1083,25,100741106,99998544,742562,33.667222400284416
1747352260704517,100202764,1,1084,25,100835332,100093184,742148,33.686003330872005
1747352260799413,100297404,1,1085,25,100930228,100187824,742404,33.6743875302396
1747352260893543,100392044,1,1086,25,101024358,100282464,741894,33.69753630572561
1747352260991216,100486684,1,1087,25,101122031,100377104,744927,33.560335442264815
1747352261089696,100581324,1,1088,25,101220511,100471744,748767,33.38822357288716
1747352261180111,100675964,1,1089,25,101310926,100566384,744542,33.577689371452514
1747352261277952,100770604,1,1090,25,101408767,100661024,747743,33.43394722518298
1747352261372531,100865244,1,1091,25,101503346,100755664,747682,33.43667495004561
1747352261466892,100959884,1,1092,25,101597707,100850304,747403,33.44915661296516
1747352261561221,101054524,1,1093,25,101692036,100944944,747092,33.46308085215743
1747352261658689,101149164,1,1094,25,101789504,101039584,749920,33.33688926818861
1747352261753910,101243804,1,1095,25,101884725,101134224,750501,33.31108153087072
1747352261847418,101338444,1,1096,25,101978233,101228864,749369,33.36140139237145
1747352261945856,101433084,1,1097,25,102076671,101323504,753167,33.19316964232368
1747352262040109,101527724,1,1098,25,102170924,101418144,752780,33.21023406572969
1747352262134394,101622364,1,1099,25,102265209,101512784,752425,33.22590291391168
1747352262228595,101717012,1,1100,25,102359410,101607432,751978,33.24565346326621
1747352262327288,101811644,1,1101,25,102458103,101702064,756039,33.06707722749752
1747352262420854,101906284,1,1102,25,102551669,101796704,754965,33.11411787301398
1747352262515208,102000924,1,1103,25,102646023,101891344,754679,33.12666709952178
1747352262610092,102095564,1,1104,25,102740907,101985984,754923,33.11596017077238
1747352262707663,102190204,1,1105,25,102838478,102080624,757854,32.98788420988739
1747352262802152,102284844,1,1106,25,102932967,102175264,757703,32.9944582507922
1747352262896426,102379484,1,1107,25,103027241,102269904,757337,33.01040355878558
1747352262994858,102474124,1,1108,25,103125673,102364544,761129,32.84594332892322
1747352263088299,102568764,1,1109,25,103219114,102459184,759930,32.897766899582855
1747352263183466,102663404,1,1110,25,103314281,102553824,760457,32.874968604404984
1747352263277544,102758044,1,1111,25,103408359,102648464,759895,32.899282137663754
1747352263375109,102852684,1,1112,25,103505924,102743104,762820,32.773131276054634
1747352263469910,102947324,1,1113,25,103600725,102837744,762981,32.76621567247415
1747352263564042,103041964,1,1114,25,103694857,102932384,762473,32.7880462652448
1747352263658141,103136604,1,1115,25,103788956,103027024,761932,32.81132699505992
1747352263756419,103231244,1,1116,25,103887234,103121664,765570,32.65540708230469
1747352263850947,103325884,1,1117,25,103981762,103216304,765458,32.66018514405754
1747352263944944,103420524,1,1118,25,104075759,103310944,764815,32.68764341703549
1747352264042724,103515172,1,1119,25,104173539,103405592,767947,32.5543299212055
1747352264136784,103609804,1,1120,25,104267599,103500224,767375,32.57859586251833
1747352264231123,103704444,1,1121,25,104361938,103594864,767074,32.59137971043211
1747352264325366,103799084,1,1122,25,104456181,103689504,766677,32.60825614959103
1747352264424145,103893724,1,1123,25,104554960,103784144,770816,32.43316174028562
1747352264522288,103988364,1,1124,25,104653103,103878784,774319,32.28643491894168
1747352264616474,104083004,1,1125,25,104747289,103973424,773865,32.30537626071731
1747352264710939,104177644,1,1126,25,104841754,104068064,773690,32.31268337447815
1747352264804363,104272284,1,1127,25,104935178,104162704,772474,32.36354880552614
1747352264899576,104366924,1,1128,25,105030391,104257344,773047,32.33956020785282
1747352264993005,104461564,1,1129,25,105123820,104351984,771836,32.39030053016444
1747352265091688,104556204,1,1130,25,105222503,104446624,775879,32.221519077072585
1747352265185675,104650844,1,1131,25,105316490,104541264,775226,32.24866039064737
1747352265284447,104745484,1,1132,25,105415262,104635904,779358,32.07768445310114
1747352265374599,104840124,1,1133,25,105505414,104730544,774870,32.26347645411489
1747352265472824,104934764,1,1134,25,105603639,104825184,778455,32.11489424565325
1747352265570636,105029404,1,1135,25,105701451,104919824,781627,31.98456552805878
1747352265661035,105124044,1,1136,25,105791850,105014464,777386,32.15905611883929
1747352265759068,105218684,1,1137,25,105889883,105109104,780779,32.01930379787366
1747352265853010,105313324,1,1138,25,105983825,105203744,780081,32.04795399452108
1747352265947526,105407964,1,1139,25,106078341,105298384,779957,32.053049078346625
1747352266041441,105502604,1,1140,25,106172256,105393024,779232,32.082871339986035
1747352266140117,105597244,1,1141,25,106270932,105487664,783268,31.91755567698413
1747352266234092,105691884,1,1142,25,106364907,105582304,782603,31.944676930704325
1747352266332909,105786524,1,1143,25,106463724,105676944,786780,31.775083250718115
1747352266427052,105881164,1,1144,25,106557867,105771584,786283,31.7951678975636
1747352266520685,105975804,1,1145,25,106651500,105866224,785276,31.83594048461942
1747352266614875,106070444,1,1146,25,106745690,105960864,784826,31.854194432906148
1747352266709825,106165084,1,1147,25,106840640,106055504,785136,31.84161724847669
1747352266807826,106259724,1,1148,25,106938641,106150144,788497,31.705891081386486
1747352266902068,106354364,1,1149,25,107032883,106244784,788099,31.72190295889222
1747352266996149,106449004,1,1150,25,107126964,106339424,787540,31.744419331081595
1747352267090181,106543644,1,1151,25,107220996,106434064,786932,31.76894572847464
1747352267188057,106638284,1,1152,25,107318872,106528704,790168,31.63884136031832
1747352267282529,106732924,1,1153,25,107413344,106623344,790000,31.645569620253163
1747352267377017,106827564,1,1154,25,107507832,106717984,789848,31.65165955981404
1747352267475111,106922204,1,1155,25,107605926,106812624,793302,31.513849706669088
1747352267569482,107016844,1,1156,25,107700297,106907264,793033,31.524539331906745
1747352267664166,107111484,1,1157,25,107794981,107001904,793077,31.52279034696505
1747352267758180,107206124,1,1158,25,107888995,107096544,792451,31.547691907764644
1747352267856159,107300764,1,1159,25,107986974,107191184,795790,31.4153231380138
1747352267950462,107395404,1,1160,25,108081277,107285824,795453,31.428632489914552
1747352268044055,107490044,1,1161,25,108174870,107380464,794406,31.470054355077885
1747352268142597,107584684,1,1162,25,108273412,107475104,798308,31.31623383456009
1747352268236671,107679324,1,1163,25,108367486,107569744,797742,31.338452782979964
1747352268330960,107773972,1,1164,25,108461775,107664392,797383,31.35256206866713
1747352268425522,107868604,1,1165,25,108556337,107759024,797313,31.35531466312477
1747352268523444,107963244,1,1166,25,108654259,107853664,800595,31.226775086029768
1747352268617964,108057884,1,1167,25,108748779,107948304,800475,31.23145632280833
1747352268712454,108152524,1,1168,25,108843269,108042944,800325,31.23730984287633
1747352268806449,108247164,1,1169,25,108937264,108137584,799680,31.262505002000804
1747352268904709,108341804,1,1170,25,109035524,108232224,803300,31.12162330387153
1747352268998750,108436444,1,1171,25,109129565,108326864,802701,31.14484720960856
1747352269093159,108531084,1,1172,25,109223974,108421504,802470,31.153812603586427
1747352269191558,108625724,1,1173,25,109322373,108516144,806229,31.008559602792754
1747352269285496,108720364,1,1174,25,109416311,108610784,805527,31.035582916525456
1747352269380158,108815004,1,1175,25,109510973,108705424,805549,31.03473531715637
1747352269473680,108909644,1,1176,25,109604495,108800064,804431,31.07786746159708
1747352269571722,109004284,1,1177,25,109702537,108894704,807833,30.94699028140717
1747352269666149,109098924,1,1178,25,109796964,108989344,807620,30.95515217552809
1747352269760803,109193564,1,1179,25,109891618,109083984,807634,30.954615580820025
1747352269859276,109288204,1,1180,25,109990091,109178624,811467,30.80840009513634
1747352269952634,109382844,1,1181,25,110083449,109273264,810185,30.85714991020569
1747352270047308,109477484,1,1182,25,110178123,109367904,810219,30.85585502191383
1747352270141457,109572132,1,1183,25,110272272,109462552,809720,30.874870325544634
1747352270239827,109666764,1,1184,25,110370642,109557184,813458,30.73299420498661
1747352270333807,109761404,1,1185,25,110464622,109651824,812798,30.75794969967938
1747352270428205,109856044,1,1186,25,110559020,109746464,812556,30.767110205327388
1747352270522768,109950684,1,1187,25,110653583,109841104,812479,30.770026056058065
1747352270620418,110045324,1,1188,25,110751233,109935744,815489,30.6564527541144
1747352270714412,110139964,1,1189,25,110845227,110030384,814843,30.680756906545188
1747352270809413,110234604,1,1190,25,110940228,110125024,815204,30.667170426052863
1747352270907704,110329244,1,1191,25,111038519,110219664,818855,30.530435791440485
1747352271001448,110423884,1,1192,25,111132263,110314304,817959,30.56387911863553
1747352271096405,110518524,1,1193,25,111227220,110408944,818276,30.5520386764368
1747352271194489,110613164,1,1194,25,111325304,110503584,821720,30.4239887066154
1747352271287997,110707804,1,1195,25,111418812,110598224,820588,30.465958556547257
1747352271382682,110802444,1,1196,25,111513497,110692864,820633,30.464287933826693
1747352271476361,110897084,1,1197,25,111607176,110787504,819672,30.500004880000784
1747352271574773,110991724,1,1198,25,111705588,110882144,823444,30.360291653105737
1747352271669332,111086364,1,1199,25,111800147,110976784,823363,30.363278408186915
1747352271763945,111181004,1,1200,25,111894760,111071424,823336,30.364274123808507
1747352271857210,111275644,1,1201,25,111988025,111166064,821961,30.41506835482462
1747352271956406,111370284,1,1202,25,112087221,111260704,826517,30.24741172897836
1747352272050503,111464924,1,1203,25,112181318,111355344,825974,30.26729654928605
1747352272143883,111559564,1,1204,25,112274698,111449984,824714,30.31353899654911
1747352272238861,111654204,1,1205,25,112369676,111544624,825052,30.30112041422844
1747352272336955,111748844,1,1206,25,112467770,111639264,828506,30.174796561521585
1747352272430891,111843484,1,1207,25,112561706,111733904,827802,30.20045856376283
1747352272525026,111938124,1,1208,25,112655841,111828544,827297,30.21889357751812
1747352272623108,112032764,1,1209,25,112753923,111923184,830739,30.093687668449416
1747352272717829,112127404,1,1210,25,112848644,112017824,830820,30.090753713199007
1747352272811564,112222044,1,1211,25,112942379,112112464,829915,30.1235668713061
1747352272906486,112316684,1,1212,25,113037301,112207104,830197,30.11333454589694
1747352273004396,112411324,1,1213,25,113135211,112301744,833467,29.99518877172102
1747352273098234,112505964,1,1214,25,113229049,112396384,832665,30.02407931160791
1747352273193036,112600604,1,1215,25,113323851,112491024,832827,30.018239082066263
1747352273287223,112695244,1,1216,25,113418038,112585664,832374,30.03457580366518
1747352273384946,112789884,1,1217,25,113515761,112680304,835457,29.9237423350334
1747352273479539,112884524,1,1218,25,113610354,112774944,835410,29.925425838809687
1747352273573289,112979164,1,1219,25,113704104,112869584,834520,29.957340746776588
1747352273671737,113073804,1,1220,25,113802552,112964224,838328,29.82126327642641
1747352273766073,113168444,1,1221,25,113896888,113058864,838024,29.83208118144588
1747352273860848,113263084,1,1222,25,113991663,113153504,838159,29.827276208929334
1747352273954473,113357724,1,1223,25,114085288,113248144,837144,29.86344045946695
1747352274053368,113452364,1,1224,25,114184183,113342784,841399,29.712419434774706
1747352274147082,113547004,1,1225,25,114277897,113437424,840473,29.74515540653893
1747352274241235,113641644,1,1226,25,114372050,113532064,839986,29.76240080191813
1747352274339642,113736284,1,1227,25,114470457,113626704,843753,29.629524280209967
1747352274433385,113830932,1,1228,25,114564200,113721352,842848,29.661338699267244
1747352274528025,113925564,1,1229,25,114658840,113815984,842856,29.66105716753514
1747352274622262,114020204,1,1230,25,114753077,113910624,842453,29.67524597811392
1747352274720191,114114844,1,1231,25,114851006,114005264,845742,29.559842126795168
1747352274815253,114209484,1,1232,25,114946068,114099904,846164,29.545100004254493
1747352274909066,114304124,1,1233,25,115039881,114194544,845337,29.57400421370412
1747352275003534,114398764,1,1234,25,115134349,114289184,845165,29.580022835777623
1747352275101263,114493404,1,1235,25,115232078,114383824,848254,29.47230428621616
1747352275196061,114588044,1,1236,25,115326876,114478464,848412,29.466815650886595
1747352275290053,114682684,1,1237,25,115420868,114573104,847764,29.4893390141596
1747352275388385,114777324,1,1238,25,115519200,114667744,851456,29.36147023451593
1747352275482065,114871964,1,1239,25,115612880,114762384,850496,29.39461208518324
1747352275576641,114966604,1,1240,25,115707456,114857024,850432,29.39682420228777
1747352275670807,115061244,1,1241,25,115801622,114951664,849958,29.41321806489261
1747352275769221,115155884,1,1242,25,115900036,115046304,853732,29.283194257682737
1747352275863349,115250524,1,1243,25,115994164,115140944,853220,29.30076650805185
1747352275957528,115345164,1,1244,25,116088343,115235584,852759,29.316606450357018
1747352276052134,115439804,1,1245,25,116182949,115330224,852725,29.317775367205137
1747352276149802,115534444,1,1246,25,116280617,115424864,855753,29.21403722803192
1747352276244377,115629092,1,1247,25,116375192,115519512,855680,29.216529543754675
1747352276338826,115723724,1,1248,25,116469641,115614144,855497,29.222779273334684
1747352276436771,115818364,1,1249,25,116567586,115708784,858802,29.110318792923167
1747352276531134,115913004,1,1250,25,116661949,115803424,858525,29.119711132465568
1747352276625548,116007644,1,1251,25,116756363,115898064,858299,29.127378687380503
1747352276719294,116102284,1,1252,25,116850109,115992704,857405,29.157749255019507
1747352276817130,116196924,1,1253,25,116947945,116087344,860601,29.049466593694408
1747352276911608,116291564,1,1254,25,117042423,116181984,860439,29.05493591062237
1747352277006400,116386204,1,1255,25,117137215,116276624,860591,29.049804146220445
1747352277104368,116480844,1,1256,25,117235183,116371264,863919,28.93789811313329
1747352277198389,116575484,1,1257,25,117329204,116465904,863300,28.95864705200973
1747352277292782,116670124,1,1258,25,117423597,116560544,863053,28.96693482323797
1747352277387138,116764764,1,1259,25,117517953,116655184,862769,28.97646994734396
1747352277484468,116859404,1,1260,25,117615283,116749824,865459,28.88640594181816
1747352277578892,116954044,1,1261,25,117709707,116844464,865243,28.89361716881848
1747352277673390,117048684,1,1262,25,117804205,116939104,865101,28.898359844688656
1747352277768048,117143324,1,1263,25,117898863,117033744,865119,28.89775857425395
1747352277866280,117237964,1,1264,25,117997095,117128384,868711,28.77827033386247
1747352277960170,117332604,1,1265,25,118090985,117223024,867961,28.80313746815813
1747352278054846,117427244,1,1266,25,118185661,117317664,867997,28.801942863857825
1747352278152357,117521884,1,1267,25,118283172,117412304,870868,28.70699118580543
1747352278246716,117616524,1,1268,25,118377531,117506944,870587,28.7162569622565
1747352278340699,117711164,1,1269,25,118471514,117601584,869930,28.737944432310645
1747352278435367,117805804,1,1270,25,118566182,117696224,869958,28.737019488297136
1747352278533818,117900444,1,1271,25,118664633,117790864,873769,28.61168111938052
1747352278627649,117995084,1,1272,25,118758464,117885504,872960,28.63819648093842
1747352278722008,118089724,1,1273,25,118852823,117980144,872679,28.647417893635577
1747352278820634,118184364,1,1274,25,118951449,118074784,876665,28.517164481301293
1747352278914734,118279004,1,1275,25,119045549,118169424,876125,28.534741047225
1747352279008447,118373644,1,1276,25,119139262,118264064,875198,28.56496472798156
1747352279103258,118468284,1,1277,25,119234073,118358704,875369,28.559384670921634
1747352279201403,118562924,1,1278,25,119332218,118453344,878874,28.44548820422495
1747352279295320,118657564,1,1279,25,119426135,118547984,878151,28.46890796685308
1747352279389329,118752204,1,1280,25,119520144,118642624,877520,28.48937915944936
1747352279483416,118846844,1,1281,25,119614231,118737264,876967,28.507344061977246
1747352279581838,118941484,1,1282,25,119712653,118831904,880749,28.384931461744493
1747352279675866,119036124,1,1283,25,119806681,118926544,880137,28.40466881860437
1747352279770938,119130764,1,1284,25,119901753,119021184,880569,28.390733718765933
1747352279869061,119225404,1,1285,25,119999876,119115824,884052,28.278879522924
1747352279963416,119320044,1,1286,25,120094231,119210464,883767,28.28799898615812
1747352280057323,119414684,1,1287,25,120188138,119305104,883034,28.311480645139373
1747352280151127,119509324,1,1288,25,120281942,119399744,882198,28.33830954048864
1747352280249307,119603964,1,1289,25,120380122,119494384,885738,28.225050748641245
1747352280343515,119698604,1,1290,25,120474330,119589024,885306,28.2388236383804
1747352280438044,119793244,1,1291,25,120568859,119683664,885195,28.24236467670965
1747352280536291,119887892,1,1292,25,120667106,119778312,888794,28.128002664284413
1747352280630440,119982524,1,1293,25,120761255,119872944,888311,28.14329666074157
1747352280724368,120077164,1,1294,25,120855183,119967584,887599,28.165872201298107
1747352280818926,120171804,1,1295,25,120949741,120062224,887517,28.16847451936132
1747352280917718,120266444,1,1296,25,121048533,120156864,891669,28.03730980890891
1747352281011320,120361084,1,1297,25,121142135,120251504,890631,28.06998633553065
1747352281105798,120455724,1,1298,25,121236613,120346144,890469,28.07509301278316
1747352281200119,120550364,1,1299,25,121330934,120440784,890150,28.08515418749649
1747352281298245,120645004,1,1300,25,121429060,120535424,893636,27.975596327811324
1747352281392282,120739644,1,1301,25,121523097,120630064,893033,27.994486205996868
1747352281486449,120834284,1,1302,25,121617264,120724704,892560,28.00932150219593
1747352281584773,120928924,1,1303,25,121715588,120819344,896244,27.8941895287444
1747352281679294,121023564,1,1304,25,121810109,120913984,896125,27.89789370902497
1747352281773035,121118204,1,1305,25,121903850,121008624,895226,27.92590921175212
1747352281867595,121212844,1,1306,25,121998410,121103264,895146,27.92840497527777
1747352281966136,121307484,1,1307,25,122096951,121197904,899047,27.807222536752803
1747352282059761,121402124,1,1308,25,122190576,121292544,898032,27.8386516293406
1747352282154237,121496764,1,1309,25,122285052,121387184,897868,27.8437364957878
1747352282252355,121591404,1,1310,25,122383170,121481824,901346,27.736296605299188
1747352282347289,121686052,1,1311,25,122478104,121576472,901632,27.72749858035208
1747352282445187,121780684,1,1312,25,122576002,121671104,904898,27.627423201288984
1747352282535646,121875324,1,1313,25,122666461,121765744,900717,27.755665764052416
1747352282633823,121969964,1,1314,25,122764638,121860384,904254,27.64709915576818
1747352282727985,122064604,1,1315,25,122858800,121955024,903776,27.661721488510427
1747352282822569,122159244,1,1316,25,122953384,122049664,903720,27.66343557739123
1747352282916171,122253884,1,1317,25,123046986,122144304,902682,27.69524594486209
1747352283013944,122348524,1,1318,25,123144759,122238944,905815,27.59945463477641
1747352283108651,122443164,1,1319,25,123239466,122333584,905882,27.597413349641567
1747352283203266,122537804,1,1320,25,123334081,122428224,905857,27.5981749878844
1747352283300842,122632444,1,1321,25,123431657,122522864,908793,27.50901470411854
1747352283395475,122727084,1,1322,25,123526290,122617504,908786,27.50922659459983
1747352283489388,122821724,1,1323,25,123620203,122712144,908059,27.531250722695333
1747352283584573,122916364,1,1324,25,123715388,122806784,908604,27.51473689307993
1747352283682518,123011004,1,1325,25,123813333,122901424,911909,27.415016191308563
1747352283776406,123105644,1,1326,25,123907221,122996064,911157,27.43764246995853
1747352283870463,123200284,1,1327,25,124001278,123090704,910574,27.45520957110569
1747352283964968,123294924,1,1328,25,124095783,123185344,910439,27.459280632749696
1747352284062593,123389564,1,1329,25,124193408,123279984,913424,27.36954579691359
1747352284156709,123484204,1,1330,25,124287524,123374624,912900,27.38525577828897
1747352284251314,123578844,1,1331,25,124382129,123469264,912865,27.386305751671934
1747352284349334,123673484,1,1332,25,124480149,123563904,916245,27.28527850083766
1747352284444684,123768124,1,1333,25,124575499,123658544,916955,27.26415145781418
1747352284538298,123862764,1,1334,25,124669113,123753184,915929,27.294692055825287
1747352284632507,123957404,1,1335,25,124763322,123847824,915498,27.30754190615381
1747352284730430,124052044,1,1336,25,124861245,123942464,918781,27.209966248757866
1747352284824801,124146684,1,1337,25,124955616,124037104,918512,27.21793509502325
1747352284923134,124241324,1,1338,25,125053949,124131744,922205,27.108939986228656
1747352285017104,124335964,1,1339,25,125147919,124226384,921535,27.128649481571507
1747352285111007,124430604,1,1340,25,125241822,124321024,920798,27.15036305465477
1747352285205902,124525244,1,1341,25,125336717,124415664,921053,27.14284628571863
1747352285299672,124619884,1,1342,25,125430487,124510304,920183,27.16850887269163
1747352285397827,124714524,1,1343,25,125528642,124604944,923698,27.06512301639713
1747352285492453,124809164,1,1344,25,125623268,124699584,923684,27.06553323430957
1747352285586521,124903804,1,1345,25,125717336,124794224,923112,27.082304205773514
1747352285684784,124998444,1,1346,25,125815599,124888864,926735,26.97642799721603
1747352285778792,125093084,1,1347,25,125909607,124983504,926103,26.994837507275108
1747352285873118,125187724,1,1348,25,126003933,125078144,925789,27.00399335053668
1747352285971199,125282364,1,1349,25,126102014,125172784,929230,26.90399578145346
1747352286065688,125377004,1,1350,25,126196503,125267424,929079,26.90836839493735
1747352286159519,125471644,1,1351,25,126290334,125362064,928270,26.93181940599179
1747352286254186,125566284,1,1352,25,126385001,125456704,928297,26.93103608004765
1747352286450243,125758684,1,1354,25,126581058,125649104,931954,26.825358333136617
1747352286544980,125853324,1,1355,25,126675795,125743744,932051,26.822566576292505
1747352286639311,125947964,1,1356,25,126770126,125838384,931742,26.83146192830204
1747352286733139,126042604,1,1357,25,126863954,125933024,930930,26.854865564542983
1747352286831926,126137244,1,1358,25,126962741,126027664,935077,26.735766145461817
1747352286925930,126231884,1,1359,25,127056745,126122304,934441,26.75396306454876
1747352287020063,126326524,1,1360,25,127150878,126216944,933934,26.76848685239
1747352287114529,126421164,1,1361,25,127245344,126311584,933760,26.77347498286497
1747352287212749,126515804,1,1362,25,127343564,126406224,937340,26.671218554633324
1747352287305467,126610452,1,1363,25,127436282,126500872,935410,26.72624838306197
1747352287405140,126705084,1,1364,25,127535955,126595504,940451,26.582990501365835
1747352287495156,126799724,1,1365,25,127625971,126690144,935827,26.71433929561768
1747352287593204,126894364,1,1366,25,127724019,126784784,939235,26.617406719298152
1747352287691271,126989004,1,1367,25,127822086,126879424,942662,26.520640484075948
1747352287781748,127083644,1,1368,25,127912563,126974064,938499,26.63828091452415
1747352287879644,127178284,1,1369,25,128010459,127068704,941755,26.54618239350999
1747352287974036,127272924,1,1370,25,128104851,127163344,941507,26.553174856904945
1747352288068043,127367564,1,1371,25,128198858,127257984,940874,26.57103926774468
1747352288162893,127462204,1,1372,25,128293708,127352624,941084,26.565110022059667
1747352288261071,127556844,1,1373,25,128391886,127447264,944622,26.465612700106497
1747352288355005,127651484,1,1374,25,128485820,127541904,943916,26.4854075998288
1747352288449097,127746124,1,1375,25,128579912,127636544,943368,26.50079290372368
1747352288547886,127840764,1,1376,25,128678701,127731184,947517,26.384750880459137
1747352288641966,127935404,1,1377,25,128772781,127825824,946957,26.400353975946107
1747352288736190,128030044,1,1378,25,128867005,127920464,946541,26.411956798490504
1747352288830186,128124684,1,1379,25,128961001,128015104,945897,26.42993898912884
1747352288928048,128219324,1,1380,25,129058863,128109744,949119,26.340216558724457
1747352289022273,128313964,1,1381,25,129153088,128204384,948704,26.35173879313253
1747352289121423,128408612,1,1382,25,129252238,128299032,953206,26.227279307935536
1747352289210998,128503244,1,1383,25,129341813,128393664,948149,26.367163810751265
1747352289309452,128597884,1,1384,25,129440267,128488304,951963,26.261524870189284
1747352289403705,128692524,1,1385,25,129534520,128582944,951576,26.272205267892424
1747352289497938,128787164,1,1386,25,129628753,128677584,951169,26.28344700048046
1747352289595738,128881804,1,1387,25,129726553,128772224,954329,26.19641653978869
1747352289689931,128976444,1,1388,25,129820746,128866864,953882,26.208692479782613
1747352289784064,129071084,1,1389,25,129914879,128961504,953375,26.22263012980202
1747352289879140,129165724,1,1390,25,130009955,129056144,953811,26.210643408390133
1747352289977092,129260364,1,1391,25,130107907,129150784,957123,26.11994487646833
1747352290070877,129355004,1,1392,25,130201692,129245424,956268,26.14329874052044
1747352290165150,129449644,1,1393,25,130295965,129340064,955901,26.153335962615376
1747352290263571,129544284,1,1394,25,130394386,129434704,959682,26.050295827159413
1747352290358072,129638924,1,1395,25,130488887,129529344,959543,26.054069489329816
1747352290455780,129733564,1,1396,25,130586595,129623984,962611,25.97103087332266
1747352290546049,129828204,1,1397,25,130676864,129718624,958240,26.08949741192185
1747352290644968,129922844,1,1398,25,130775783,129813264,962519,25.97351325012805
1747352290738676,130017484,1,1399,25,130869491,129907904,961587,25.998687586250647
1747352290836861,130112124,1,1400,25,130967676,130002544,965132,25.903192516671297
1747352290931498,130206764,1,1401,25,131062313,130097184,965129,25.90327303396748
1747352291025950,130301404,1,1402,25,131156765,130191824,964941,25.908319783282085
1747352291120072,130396044,1,1403,25,131250887,130286464,964423,25.9222353676758
1747352291218143,130490684,1,1404,25,131348958,130381104,967854,25.830342179708925
1747352291311940,130585324,1,1405,25,131442755,130475744,967011,25.8528599984902
1747352291406930,130679964,1,1406,25,131537745,130570384,967361,25.843506198823395
1747352291500120,130774604,1,1407,25,131630935,130665024,965911,25.88230178556824
1747352291595343,130869244,1,1408,25,131726158,130759664,966494,25.866689291397567
1747352291692849,130963884,1,1409,25,131823664,130854304,969360,25.7902120987043
1747352291787409,131058524,1,1410,25,131918224,130948944,969280,25.7923407065038
1747352291885594,131153164,1,1411,25,132016409,131043584,972825,25.698352735589648
1747352291980119,131247804,1,1412,25,132110934,131138224,972710,25.70139095927872
1747352292074269,131342444,1,1413,25,132205084,131232864,972220,25.714344489930262
1747352292172822,131437084,1,1414,25,132303637,131327504,976133,25.611264038814383
1747352292262298,131531724,1,1415,25,132393113,131422144,970969,25.747474945132133
1747352292360519,131626364,1,1416,25,132491334,131516784,974550,25.65286542506798
1747352292459003,131721004,1,1417,25,132589818,131611424,978394,25.55207820162429
1747352292557429,131815644,1,1418,25,132688244,131706064,982180,25.45358284632145
1747352292647848,131910284,1,1419,25,132778663,131800704,977959,25.56344386625615
1747352292745886,132004924,1,1420,25,132876701,131895344,981357,25.474929103272306
1747352292835967,132099564,1,1421,25,132966782,131989984,976798,25.59382799719082
1747352292930096,132194204,1,1422,25,133060911,132084624,976287,25.607224105206768
1747352293028648,132288844,1,1423,25,133159463,132179264,980199,25.505025000025505
1747352293122649,132383484,1,1424,25,133253464,132273904,979560,25.521662787373923
1747352293221170,132478124,1,1425,25,133351985,132368544,983441,25.42094543546588
1747352293315493,132572764,1,1426,25,133446308,132463184,983124,25.429142203831866
1747352293409405,132667412,1,1427,25,133540220,132557832,982388,25.44819358542653
1747352293503646,132762044,1,1428,25,133634461,132652464,981997,25.458326247432527
1747352293597439,132856684,1,1429,25,133728254,132747104,981150,25.48030372522041
1747352293691617,132951324,1,1430,25,133822432,132841744,980688,25.49230744130651
1747352293790470,133045964,1,1431,25,133921285,132936384,984901,25.38326187099008
1747352293888650,133140604,1,1432,25,134019465,133031024,988441,25.292354323626803
1747352293982489,133235244,1,1433,25,134113304,133125664,987640,25.31286703657203
1747352294080511,133329884,1,1434,25,134211326,133220304,991022,25.226483367674987
1747352294171249,133424524,1,1435,25,134302064,133314944,987120,25.326201474997973
1747352294264907,133519164,1,1436,25,134395722,133409584,986138,25.35142140349525
1747352294359641,133613804,1,1437,25,134490456,133504224,986232,25.349005102247748
1747352294457406,133708444,1,1438,25,134588221,133598864,989357,25.2689372996805
1747352294551667,133803084,1,1439,25,134682482,133693504,988978,25.278620960223584
1747352294650696,133897724,1,1440,25,134781511,133788144,993367,25.1669322616918
1747352294744527,133992364,1,1441,25,134875342,133882784,992558,25.18744496543275
1747352294838959,134087004,1,1442,25,134969774,133977424,992350,25.19272434121026
1747352294937262,134181644,1,1443,25,135068077,134072064,996013,25.100073995018136
1747352295030928,134276284,1,1444,25,135161743,134166704,995039,25.124643355687567
1747352295125053,134370924,1,1445,25,135255868,134261344,994524,25.137653792165903
1747352295220034,134465572,1,1446,25,135350849,134355992,994857,25.129239679672555
1747352295317902,134560204,1,1447,25,135448717,134450624,998093,25.047766089933504
1747352295412390,134654844,1,1448,25,135543205,134545264,997941,25.051581205702544
1747352295518569,134752604,1,1449,25,135649384,134643024,1006360,24.84200484915935
1747352295604934,134847244,1,1450,25,135735749,134737664,998085,25.04796685653025
1747352295703135,134941884,1,1451,25,135833950,134832304,1001646,24.958917621594853
1747352295797120,135036524,1,1452,25,135927935,134926944,1000991,24.97524952771803
1747352295890518,135131172,1,1453,25,136021333,135021592,999741,25.006476677459464
1747352295989743,135225804,1,1454,25,136120558,135116224,1004334,24.89211756248419
1747352296083344,135320444,1,1455,25,136214159,135210864,1003295,24.91789553421476
1747352296177578,135415084,1,1456,25,136308393,135305504,1002889,24.92798305694848
1747352296276445,135509724,1,1457,25,136407260,135400144,1007116,24.82335699164744
1747352296366102,135604364,1,1458,25,136496917,135494784,1002133,24.946788500129227
1747352296464214,135699004,1,1459,25,136595029,135589424,1005605,24.860656022991133
1747352296558641,135793644,1,1460,25,136689456,135684064,1005392,24.86592294348871
1747352296652680,135888284,1,1461,25,136783495,135778704,1004791,24.88079610585684
1747352296747364,135982924,1,1462,25,136878179,135873344,1004835,24.87970661849956
1747352296841512,136077564,1,1463,25,136972327,135967984,1004343,24.891894502177045
1747352296943747,136172204,1,1464,25,137074562,136062624,1011938,24.705070864025267
1747352297038444,136266844,1,1465,25,137169259,136157264,1011995,24.70367936600477
1747352297132550,136361484,1,1466,25,137263365,136251904,1011461,24.71672165313344
1747352297226145,136456124,1,1467,25,137356960,136346544,1010416,24.742284366043293
1747352297320138,136550764,1,1468,25,137450953,136441184,1009769,24.75813775229781
1747352297414789,136645404,1,1469,25,137545604,136535824,1009780,24.75786805046644
1747352297513021,136740044,1,1470,25,137643836,136630464,1013372,24.67011127206988
1747352297607257,136834684,1,1471,25,137738072,136725104,1012968,24.679950403171667
1747352297704735,136929324,1,1472,25,137835550,136819744,1015806,24.610998556811044
1747352297799800,137023964,1,1473,25,137930615,136914384,1016231,24.600705941857704
1747352297890509,137118604,1,1474,25,138021324,137009024,1012300,24.696236293588857
1747352297987925,137213244,1,1475,25,138118740,137103664,1015076,24.628697752680587
1747352298082731,137307884,1,1476,25,138213546,137198304,1015242,24.62467076815183
1747352298176515,137402524,1,1477,25,138307330,137292944,1014386,24.645450548410565
1747352298275002,137497164,1,1478,25,138405817,137387584,1018233,24.55233723519077
1747352298368837,137591804,1,1479,25,138499652,137482224,1017428,24.57176330904988
1747352298467082,137686444,1,1480,25,138597897,137576864,1021033,24.48500685090492
1747352298558034,137781084,1,1481,25,138688849,137671504,1017345,24.57376799414161
1747352298655383,137875724,1,1482,25,138786198,137766144,1020054,24.508506412405616
1747352298749489,137970364,1,1483,25,138880304,137860784,1019520,24.52134337727558
1747352298844439,138065004,1,1484,25,138975254,137955424,1019830,24.513889569830265
1747352298937932,138159644,1,1485,25,139068747,138050064,1018683,24.5414913177112
1747352299037217,138254284,1,1486,25,139168032,138144704,1023328,24.43009474967948
1747352299130579,138348924,1,1487,25,139261394,138239344,1022050,24.460642825693466
1747352299228754,138443564,1,1488,25,139359569,138333984,1025585,24.376331557111307
1747352299322953,138538204,1,1489,25,139453768,138428624,1025144,24.386817851931045
1747352299417359,138632844,1,1490,25,139548174,138523264,1024910,24.392385672888352
1747352299516197,138727484,1,1491,25,139647012,138617904,1029108,24.292882768378053
1747352299606212,138822124,1,1492,25,139737027,138712544,1024483,24.40255231175139
1747352299704584,138916764,1,1493,25,139835399,138807184,1028215,24.313981025369205
1747352299798457,139011404,1,1494,25,139929272,138901824,1027448,24.332131650458223
1747352299896991,139106044,1,1495,25,140027806,138996464,1031342,24.24026171725771
1747352400409688,109580,1,1,50,0,0,0,0.0
1747352400589891,288924,1,3,50,180203,179344,859,58207.217694994186
1747352400671489,377324,1,4,50,261801,267744,-5943,0.0
1747352400761928,465724,1,5,50,352240,356144,-3904,0.0
1747352400851490,554124,1,6,50,441802,444544,-2742,0.0
1747352400941624,642524,1,7,50,531936,532944,-1008,0.0
1747352401031542,730924,1,8,50,621854,621344,510,98039.2156862745
1747352401118375,819324,1,9,50,708687,709744,-1057,0.0
1747352401228589,907724,1,10,50,818901,798144,20757,2408.8259382377028
1747352401679229,1370524,1,15,50,1269541,1260944,8597,5815.982319413749
1747352401769466,1461004,1,16,50,1359778,1351424,8354,5985.156811108451
1747352401858946,1551484,1,17,50,1449258,1441904,7354,6799.020940984498
1747352401949840,1641964,1,18,50,1540152,1532384,7768,6436.663233779609
1747352402039263,1732444,1,19,50,1629575,1622864,6711,7450.454477723141
1747352402133515,1822924,1,20,50,1723827,1713344,10483,4769.627015167414
1747352402223528,1913404,1,21,50,1813840,1803824,10016,4992.012779552715
1747352402314275,2003884,1,22,50,1904587,1894304,10283,4862.3942429252165
1747352402408072,2094364,1,23,50,1998384,1984784,13600,3676.470588235294
1747352402498343,2184844,1,24,50,2088655,2075264,13391,3733.8510940183705
1747352402588859,2275324,1,25,50,2179171,2165744,13427,3723.840023832576
1747352402682801,2365804,1,26,50,2273113,2256224,16889,2960.506838770797
1747352402773017,2456284,1,27,50,2363329,2346704,16625,3007.518796992481
1747352402863271,2546764,1,28,50,2453583,2437184,16399,3048.966400390268
1747352402952976,2637244,1,29,50,2543288,2527664,15624,3200.2048131080387
1747352403047217,2727724,1,30,50,2637529,2618144,19385,2579.3139025019345
1747352403133159,2818204,1,31,50,2723471,2708624,14847,3367.6837071462246
1747352403227071,2908684,1,32,50,2817383,2799104,18279,2735.379397122381
1747352403317969,2999164,1,33,50,2908281,2889584,18697,2674.225811627534
1747352403416206,3089644,1,34,50,3006518,2980064,26454,1890.073334845392
1747352403497172,3180124,1,35,50,3087484,3070544,16940,2951.59386068477
1747352403592018,3270604,1,36,50,3182330,3161024,21306,2346.7567821271005
1747352403689833,3361084,1,37,50,3280145,3251504,28641,1745.7491009392131
1747352403776575,3451564,1,38,50,3366887,3341984,24903,2007.79022607718
1747352403866253,3542052,1,39,50,3456565,3432472,24093,2075.291578466775
1747352403960169,3632524,1,40,50,3550481,3522944,27537,1815.7388241275376
1747352404046427,3723004,1,41,50,3636739,3613424,23315,2144.542140253056
1747352404140062,3813484,1,42,50,3730374,3703904,26470,1888.930865130336
1747352404230718,3903964,1,43,50,3821030,3794384,26646,1876.4542520453351
1747352404320899,3994444,1,44,50,3911211,3884864,26347,1897.7492693665315
1747352404419107,4084924,1,45,50,4009419,3975344,34075,1467.3514306676448
1747352404505256,4175404,1,46,50,4095568,4065824,29744,1681.0112963959118
1747352404591437,4265884,1,47,50,4181749,4156304,25445,1965.0225977598743
1747352404685190,4356364,1,48,50,4275502,4246784,28718,1741.068319520858
1747352404783807,4446844,1,49,50,4374119,4337264,36855,1356.66802333469
1747352404869843,4537324,1,50,50,4460155,4427744,32411,1542.686125080991
1747352404955100,4627804,1,51,50,4545412,4518224,27188,1839.0466382227453
1747352405057607,4718284,1,52,50,4647919,4608704,39215,1275.0223128904756
1747352405156019,4808764,1,53,50,4746331,4699184,47147,1060.5128640210403
1747352405238803,4899244,1,54,50,4829115,4789664,39451,1267.3949963245543
1747352405328587,4989724,1,55,50,4918899,4880144,38755,1290.1561088891756
1747352405426573,5080204,1,56,50,5016885,4970624,46261,1080.8240202330255
1747352405521068,5170684,1,57,50,5111380,5061104,50276,994.5103031267404
1747352405615067,5261164,1,58,50,5205379,5151584,53795,929.4544102611768
1747352405693060,5351644,1,59,50,5283372,5242064,41308,1210.4192892417934
1747352405782871,5442124,1,60,50,5373183,5332544,40639,1230.3452348729054
1747352405869050,5532604,1,61,50,5459362,5423024,36338,1375.9700588915184
1747352405959083,5623084,1,62,50,5549395,5513504,35891,1393.106907024045
1747352406052819,5713564,1,63,50,5643131,5603984,39147,1277.2370807469283
1747352406143843,5804052,1,64,50,5734155,5694472,39683,1259.9853841695435
1747352406237643,5894524,1,65,50,5827955,5784944,43011,1162.493315663435
1747352406331685,5985004,1,66,50,5921997,5875424,46573,1073.583406694866
1747352406418179,6075484,1,67,50,6008491,5965904,42587,1174.0672036067344
1747352406516221,6165964,1,68,50,6106533,6056384,50149,997.0288540150352
1747352406601720,6256444,1,69,50,6192032,6146864,45168,1106.9783917817924
1747352406704854,6346924,1,70,50,6295166,6237344,57822,864.7227698799765
1747352406786050,6437404,1,71,50,6376362,6327824,48538,1030.1207301495735
1747352406880828,6527884,1,72,50,6471140,6418304,52836,946.3244757362404
1747352407159473,6805564,1,75,50,6749785,6695984,53801,929.3507555621644
1747352407253131,6896044,1,76,50,6843443,6786464,56979,877.5162779269555
1747352407360163,6986524,1,77,50,6950475,6876944,73531,679.9853123172539
1747352407445534,7077004,1,78,50,7035846,6967424,68422,730.7591125661337
1747352407531941,7167484,1,79,50,7122253,7057904,64349,777.0128517925687
1747352407609456,7257964,1,80,50,7199768,7148384,51384,973.065545695158
1747352407699899,7348444,1,81,50,7290211,7238864,51347,973.7667244434924
1747352407793598,7438924,1,82,50,7383910,7329344,54566,916.3215188945496
1747352407884199,7529404,1,83,50,7474511,7419824,54687,914.2940735458152
1747352407973757,7619884,1,84,50,7564069,7510304,53765,929.9730307821072
1747352408064193,7710364,1,85,50,7654505,7600784,53721,930.7347219895386
1747352408157870,7800852,1,86,50,7748182,7691272,56910,878.5802143735723
1747352408265419,7891324,1,87,50,7855731,7781744,73987,675.7943963128658
1747352408338791,7981804,1,88,50,7929103,7872224,56879,879.0590551873275
1747352408429237,8072284,1,89,50,8019549,7962704,56845,879.5848359574281
1747352408522886,8162764,1,90,50,8113198,8053184,60014,833.1389342486754
1747352408613389,8253244,1,91,50,8203701,8143664,60037,832.8197611472925
1747352408703360,8343724,1,92,50,8293672,8234144,59528,839.9408681628813
1747352408813208,8434204,1,93,50,8403520,8324624,78896,633.7456905293044
1747352408891286,8524684,1,94,50,8481598,8415104,66494,751.9475441393208
1747352408977187,8615164,1,95,50,8567499,8505584,61915,807.5587498990552
1747352409067623,8705644,1,96,50,8657935,8596064,61871,808.1330510255208
1747352409161854,8796124,1,97,50,8752166,8686544,65622,761.9395934290329
1747352409248005,8886604,1,98,50,8838317,8777024,61293,815.7538381218084
1747352409354317,8977084,1,99,50,8944629,8867504,77125,648.2982171799027
1747352409432384,9067564,1,100,50,9022696,8957984,64712,772.6542217826677
1747352409530371,9159084,1,101,50,9120683,9049504,71179,702.4543755883054
1747352409620815,9250604,1,102,50,9211127,9141024,70103,713.2362381067858
1747352409714547,9342124,1,103,50,9304859,9232544,72315,691.4194842010647
1747352409813564,9433644,1,104,50,9403876,9324064,79812,626.472209692778
1747352409895066,9525164,1,105,50,9485378,9415584,69794,716.3939593661347
1747352409992911,9616684,1,106,50,9583223,9507104,76119,656.8662226251001
1747352410091860,9708204,1,107,50,9682172,9598624,83548,598.4583712356969
1747352410178057,9799724,1,108,50,9768369,9690144,78225,639.1818472355385
1747352410271861,9891244,1,109,50,9862173,9781664,80509,621.048578419804
1747352410362158,9982764,1,110,50,9952470,9873184,79286,630.6283580960069
1747352410464475,10074284,1,111,50,10054787,9964704,90083,555.0436819377685
1747352410558257,10166844,1,112,50,10148569,10057264,91305,547.6151360823613
1747352410636500,10259404,1,113,50,10226812,10149824,76988,649.451862627942
1747352410746731,10351964,1,114,50,10337043,10242384,94659,528.2117918000401
1747352410836968,10444524,1,115,50,10427280,10334944,92336,541.5006064806793
1747352410914495,10537084,1,116,50,10504807,10427504,77303,646.8054279911518
1747352411021801,10629644,1,117,50,10612113,10520064,92049,543.1889537094373
1747352411123289,10722204,1,118,50,10713601,10612624,100977,495.1622646741337
1747352411201800,10814764,1,119,50,10792112,10705184,86928,575.188661881097
1747352411287549,10907324,1,120,50,10877861,10797744,80117,624.0872723641675
1747352411385850,10999884,1,121,50,10976162,10890304,85858,582.3569149060075
1747352411479655,11092444,1,122,50,11069967,10982864,87103,574.0330413418596
1747352411570146,11185004,1,123,50,11160458,11075424,85034,588.0000940800151
1747352411660264,11277564,1,124,50,11250576,11167984,82592,605.3855094924448
1747352411766446,11370124,1,125,50,11356758,11260544,96214,519.6748913879477
1747352411857264,11462692,1,126,50,11447576,11353112,94464,529.3021680216801
1747352411942572,11555244,1,127,50,11532884,11445664,87220,573.2630130703967
1747352412040513,11647804,1,128,50,11630825,11538224,92601,539.9509724517013
1747352412127161,11740364,1,129,50,11717473,11630784,86689,576.7744465849185
1747352412221844,11832924,1,130,50,11812156,11723344,88812,562.9869837409359
1747352412339957,11925484,1,131,50,11930269,11815904,114365,437.1966947929874
1747352412409634,12018044,1,132,50,11999946,11908464,91482,546.5556065674122
1747352412500066,12110604,1,133,50,12090378,12001024,89354,559.57203930434
1747352412594223,12203164,1,134,50,12184535,12093584,90951,549.7465668326901
1747352412700121,12295724,1,135,50,12290433,12186144,104289,479.43694924680455
1747352412782829,12388284,1,136,50,12373141,12278704,94437,529.453498099262
1747352412892891,12480844,1,137,50,12483203,12371264,111939,446.6718480601042
1747352412970931,12573404,1,138,50,12561243,12463824,97419,513.2469025549431
1747352413057270,12665964,1,139,50,12647582,12556384,91198,548.2576372288866
1747352413159259,12758524,1,140,50,12749571,12648944,100627,496.8845339719956
1747352413269995,12851084,1,141,50,12860307,12741504,118803,420.8647929766083
1747352413343402,12943644,1,142,50,12933714,12834064,99650,501.7561465127948
1747352413528067,13131884,1,144,50,13118379,13022304,96075,520.4267499349467
1747352413630709,13224444,1,145,50,13221021,13114864,106157,471.0004992605292
1747352413729066,13317004,1,146,50,13319378,13207424,111954,446.6120013577005
1747352413811030,13409564,1,147,50,13401342,13299984,101358,493.3009727895183
1747352413909257,13502124,1,148,50,13499569,13392544,107025,467.1805652884841
1747352414007468,13594684,1,149,50,13597780,13485104,112676,443.7502218751109
1747352414100939,13687244,1,150,50,13691251,13577664,113587,440.1912190655621
1747352414183688,13779804,1,151,50,13774000,13670224,103776,481.8069688559976
1747352414281951,13872364,1,152,50,13872263,13762784,109479,456.70859251545954
1747352414372175,13964924,1,153,50,13962487,13855344,107143,466.66604444527405
1747352414465624,14057492,1,154,50,14055936,13947912,108024,462.8601051618159
1747352414568536,14150044,1,155,50,14158848,14040464,118384,422.3543722124612
1747352414761119,14338284,1,157,50,14351431,14228704,122727,407.4083127592135
1747352414850330,14430844,1,158,50,14440642,14321264,119378,418.8376417765418
1747352415047826,14619084,1,160,50,14638138,14509504,128634,388.6997216909993
1747352415232001,14807324,1,162,50,14822313,14697744,124569,401.3839719352327
1747352415318219,14899884,1,163,50,14908531,14790304,118227,422.915239327734
1747352415600474,15183804,1,166,50,15190786,15074224,116562,428.9562636193614
1747352415887834,15467724,1,169,50,15478146,15358144,120002,416.65972233796106
1747352416173604,15751644,1,172,50,15763916,15642064,121852,410.3338476184224
1747352416288248,15844204,1,173,50,15878560,15734624,143936,347.3766118274789
1747352416550920,16128124,1,176,50,16141232,16018544,122688,407.5378195096505
1747352416849558,16412044,1,179,50,16439870,16302464,137406,363.88512874255855
1747352426753414,26263964,1,282,50,26343726,26154384,189342,264.07241922024696
1747352426847250,26356524,1,283,50,26437562,26246944,190618,262.3047141403225
1747352426941602,26449084,1,284,50,26531914,26339504,192410,259.8617535471129
1747352427035687,26541644,1,285,50,26625999,26432064,193935,257.81834119679274
1747352427125423,26634204,1,286,50,26715735,26524624,191111,261.62805908608084
1747352427219906,26726764,1,287,50,26810218,26617184,193034,259.0217267424391
1747352427314478,26819324,1,288,50,26904790,26709744,195046,256.3497841534817
1747352427408053,26911884,1,289,50,26998365,26802304,196061,255.0226715154977
1747352427498234,27004444,1,290,50,27088546,26894864,193682,258.155120248655
1747352427592314,27097004,1,291,50,27182626,26987424,195202,256.1449165479862
1747352427686738,27189564,1,292,50,27277050,27079984,197066,253.7221032547472
1747352427780742,27282124,1,293,50,27371054,27172544,198510,251.87647977431868
1747352427874627,27374684,1,294,50,27464939,27265104,199835,250.2064202967448
1747352427964888,27467244,1,295,50,27555200,27357664,197536,253.1184189211081
1747352428059486,27559804,1,296,50,27649798,27450224,199574,250.5336366460561
1747352428153165,27652364,1,297,50,27743477,27542784,200693,249.1367411917705
1747352428247274,27744924,1,298,50,27837586,27635344,202242,247.22856775546128
1747352428338179,27837484,1,299,50,27928491,27727904,200587,249.26839725405927
1747352428432564,27930044,1,300,50,28022876,27820464,202412,247.0209276129873
1747352428526293,28022604,1,301,50,28116605,27913024,203581,245.602487461993
1747352428620914,28115164,1,302,50,28211226,28005584,205642,243.1409925987882
1747352428710252,28207724,1,303,50,28300564,28098144,202420,247.0111649046537
1747352428804365,28300284,1,304,50,28394677,28190704,203973,245.1304829560776
1747352428899119,28392844,1,305,50,28489431,28283264,206167,242.52183909161025
1747352428993147,28485404,1,306,50,28583459,28375824,207635,240.8071856864209
1747352429083014,28577964,1,307,50,28673326,28468384,204942,243.9714650974421
1747352429177546,28670524,1,308,50,28767858,28560944,206914,241.6462878297264
1747352429271661,28763084,1,309,50,28861973,28653504,208469,239.84381370851304
1747352435243575,34692132,1,371,50,34833887,34582552,251335,198.93767282710328
1747352435337091,34784684,1,372,50,34927403,34675104,252299,198.17755916591028
1747352435431371,34877244,1,373,50,35021683,34767664,254019,196.83566977273355
1747352435526086,34969804,1,374,50,35116398,34860224,256174,195.17983870338128
1747352435906871,35349404,1,378,50,35497183,35239824,257359,194.28114035258145
1747352436001287,35441964,1,379,50,35591599,35332384,259215,192.8900719479969
1747352436090990,35534524,1,380,50,35681302,35424944,256358,195.0397491008668
1747352436185089,35627084,1,381,50,35775401,35517504,257897,193.8758496609112
1747352436280014,35719644,1,382,50,35870326,35610064,260262,192.11410040651344
1747352436372984,35812204,1,383,50,35963296,35702624,260672,191.8119322366805
1747352436463858,35904764,1,384,50,36054170,35795184,258986,193.0606287598557
1747352436557675,35997324,1,385,50,36147987,35887744,260243,192.1281264049369
1747352436652116,36089892,1,386,50,36242428,35980312,262116,190.75523813883927
1747352436746424,36182444,1,387,50,36336736,36072864,263872,189.4858113024497
1747352436840995,36275004,1,388,50,36431307,36165424,265883,188.0526396949034
1747352436931000,36367564,1,389,50,36521312,36257984,263328,189.87726333697896
1747352437024551,36460124,1,390,50,36614863,36350544,264319,189.16536457840712
1747352437119853,36552684,1,391,50,36710165,36443104,267061,187.22314377614103
1747352437212776,36645244,1,392,50,36803088,36535664,267424,186.96900801723103
1747352437303214,36737804,1,393,50,36893526,36628224,265302,188.4644669094089
1747352437397603,36830364,1,394,50,36987915,36720784,267131,187.1740831277538
1747352437492312,36922924,1,395,50,37082624,36813344,269280,185.68033273915623
1747352437586546,37015484,1,396,50,37176858,36905904,270954,184.5331679916148
1747352437676445,37108044,1,397,50,37266757,36998464,268293,186.3634161159628
1747352437770421,37200604,1,398,50,37360733,37091024,269709,185.38498900667017
1747352437863971,37293164,1,399,50,37454283,37183584,270699,184.70699928703087
1747352437958579,37385724,1,400,50,37548891,37276144,272747,183.3200731813732
1747352438048662,37478284,1,401,50,37638974,37368704,270270,185.00018500018496
1747352438142929,37570844,1,402,50,37733241,37461264,271977,183.83907462763395
1747352438236989,37663404,1,403,50,37827301,37553824,273477,182.8307316520219
1747352438332218,37755964,1,404,50,37922530,37646384,276146,181.06364024827445
1747352438425500,37848524,1,405,50,38015812,37738944,276868,180.5914731930017
1747352438515676,37941084,1,406,50,38105988,37831504,274484,182.15998018099413
1747352438610328,38033644,1,407,50,38200640,37924064,276576,180.7821358324656
1747352438704086,38126204,1,408,50,38294398,38016624,277774,180.00244803329323
1747352438799036,38218772,1,409,50,38389348,38109192,280156,178.4719941746741
1747352438888162,38311324,1,410,50,38478474,38201744,276730,180.6815307339284
1747352438982768,38403884,1,411,50,38573080,38294304,278776,179.35546818951414
1747352439076891,38496444,1,412,50,38667203,38386864,280339,178.35549103050235
1747352439171264,38589004,1,413,50,38761576,38479424,282152,177.20944739005924
1747352439260845,38681564,1,414,50,38851157,38571984,279173,179.100414438359
1747352439355131,38774124,1,415,50,38945443,38664544,280899,177.99992168003445
1747352439449692,38866684,1,416,50,39040004,38757104,282900,176.74089784376105
1747352439543431,38959244,1,417,50,39133743,38849664,284079,176.00737822929537
1747352439638152,39051804,1,418,50,39228464,38942224,286240,174.678591391839
1747352439728145,39144364,1,419,50,39318457,39034784,283673,176.2592844578088
1747352439822159,39236924,1,420,50,39412471,39127344,285127,175.36045341198832
1747352439917021,39329484,1,421,50,39507333,39219904,287429,173.95600304770915
1747352440010883,39422044,1,422,50,39601195,39312464,288731,173.1715679992796
1747352440100813,39514604,1,423,50,39691125,39405024,286101,174.76345766005713
1747352440195049,39607164,1,424,50,39785361,39497584,287777,173.74564332799355
1747352440288863,39699724,1,425,50,39879175,39590144,289031,172.99182440637856
1747352440383803,39792284,1,426,50,39974115,39682704,291411,171.57897265374336
1747352440473554,39884844,1,427,50,40063866,39775264,288602,173.24897263359227
1747352440567925,39977404,1,428,50,40158237,39867824,290413,172.1686012678496
1747352440661639,40069964,1,429,50,40251951,39960384,291567,171.48717104473414
1747352440756127,40162524,1,430,50,40346439,40052944,293495,170.36065350346684
1747352440846524,40255084,1,431,50,40436836,40145504,291332,171.62549943020335
1747352440939951,40347644,1,432,50,40530263,40238064,292199,171.1162598092396
1747352441035221,40440204,1,433,50,40625533,40330624,294909,169.54382538342338
1747352441129172,40532764,1,434,50,40719484,40423184,296300,168.74789065136684
1747352441223465,40625324,1,435,50,40813777,40515744,298033,167.76665671251172
1747352441312790,40717884,1,436,50,40903102,40608304,294798,169.60766355266995
1747352441407670,40810444,1,437,50,40997982,40700864,297118,168.28330831521484
1747352441501416,40903004,1,438,50,41091728,40793424,298304,167.61424586998498
1747352441595841,40995564,1,439,50,41186153,40885984,300169,166.57283063874016
1747352441685504,41088124,1,440,50,41275816,40978544,297272,168.19613014343767
1747352441779930,41180684,1,441,50,41370242,41071104,299138,167.146935528084
1747352441874352,41273244,1,442,50,41464664,41163664,301000,166.11295681063123
1747352441968423,41365804,1,443,50,41558735,41256224,302511,165.28324589849626
1747352442059063,41458364,1,444,50,41649375,41348784,300591,166.33897887827646
1747352442152490,41550924,1,445,50,41742802,41441344,301458,165.86058422732188
1747352442246637,41643484,1,446,50,41836949,41533904,303045,164.99199788810242
1747352442341102,41736044,1,447,50,41931414,41626464,304950,163.96130513198884
1747352442431106,41828604,1,448,50,42021418,41719024,302394,165.34719604224952
1747352442525917,41921164,1,449,50,42116229,41811584,304645,164.12545749971278
1747352442620026,42013732,1,450,50,42210338,41904152,306186,163.29943237117308
1747352442713393,42106284,1,451,50,42303705,41996704,307001,162.86591900352116
1747352442808169,42198844,1,452,50,42398481,42089264,309217,161.69874230718233
1747352442898643,42291404,1,453,50,42488955,42181824,307131,162.79698239513434
1747352442992790,42383964,1,454,50,42583102,42274384,308718,161.96010598669335
1747352443086517,42476524,1,455,50,42676829,42366944,309885,161.350178291947
1747352443180816,42569084,1,456,50,42771128,42459504,311624,160.4497728031217
1747352443271336,42661644,1,457,50,42861648,42552064,309584,161.50705462814614
1747352443365494,42754204,1,458,50,42955806,42644624,311182,160.677674158531
1747352443458908,42846764,1,459,50,43049220,42737184,312036,160.237921265495
1747352443552961,42939324,1,460,50,43143273,42829744,313529,159.47488111147612
1747352443643175,43031884,1,461,50,43233487,42922304,311183,160.67715781389086
1747352443738301,43124444,1,462,50,43328613,43014864,313749,159.3630577308613
1747352443831832,43217004,1,463,50,43422144,43107424,314720,158.8713777325877
1747352443925913,43309564,1,464,50,43516225,43199984,316241,158.10726629374432
1747352444016101,43402124,1,465,50,43606413,43292544,313869,159.30212923225932
1747352444110705,43494684,1,466,50,43701017,43385104,315913,158.27142282843695
1747352444204702,43587244,1,467,50,43795014,43477664,317350,157.5547502757208
1747352444299234,43679804,1,468,50,43889546,43570224,319322,156.5817575989127
1747352444393125,43772364,1,469,50,43983437,43662784,320653,155.9318016672228
1747352444483717,43864924,1,470,50,44074029,43755344,318685,156.89473931939062
1747352444577782,43957484,1,471,50,44168094,43847904,320190,156.15728161404166
1747352444671976,44050044,1,472,50,44262288,43940464,321824,155.36442279009646
1747352444765510,44142612,1,473,50,44355822,44033032,322790,154.89947024381175
1747352444856336,44235164,1,474,50,44446648,44125584,321064,155.73219046669823
1747352444949635,44327724,1,475,50,44539947,44218144,321803,155.3745614553003
1747352445043987,44420284,1,476,50,44634299,44310704,323595,154.5141303172175
1747352445138483,44512844,1,477,50,44728795,44403264,325531,153.59520291462258
1747352445228344,44605404,1,478,50,44818656,44495824,322832,154.87931803538683
1747352445322905,44697964,1,479,50,44913217,44588384,324833,153.92524774268625
1747352445417520,44790524,1,480,50,45007832,44680944,326888,152.95758792002152
1747352445511509,44883084,1,481,50,45101821,44773504,328317,152.29183989863455
1747352445601217,44975644,1,482,50,45191529,44866064,325465,153.62634999155054
1747352445695258,45068204,1,483,50,45285570,44958624,326946,152.9304533470359
1747352445789423,45160764,1,484,50,45379735,45051184,328551,152.18337487939468
1747352445883969,45253324,1,485,50,45474281,45143744,330537,151.26899560412298
1747352445978154,45345884,1,486,50,45568466,45236304,332162,150.52895876108644
1747352446067714,45438444,1,487,50,45658026,45328864,329162,151.90088770878776
1747352446162942,45531004,1,488,50,45753254,45421424,331830,150.6795648374167
1747352446257035,45623564,1,489,50,45847347,45513984,333363,149.98665118804425
1747352446350513,45716124,1,490,50,45940825,45606544,334281,149.57475896027594
1747352446441364,45808684,1,491,50,46031676,45699104,332572,150.34338428971773
1747352446535346,45901244,1,492,50,46125658,45791664,333994,149.70328808301946
1747352446629348,45993804,1,493,50,46219660,45884224,335436,149.05973121549266
1747352446723438,46086364,1,494,50,46313750,45976784,336966,148.38292290616857
1747352446813922,46178924,1,495,50,46404234,46069344,334890,149.30275612887812
1747352446907390,46271484,1,496,50,46497702,46161904,335798,148.89904049458306
1747352447002052,46364044,1,497,50,46592364,46254464,337900,147.9727730097662
1747352447096617,46456604,1,498,50,46686929,46347024,339905,147.09992497903826
1747352447186415,46549164,1,499,50,46776727,46439584,337143,148.3050219046517
1747352447280971,46641724,1,500,50,46871283,46532144,339139,147.43217382843022
1747352447375151,46734284,1,501,50,46965463,46624704,340759,146.7312675527279
1747352447469427,46826844,1,502,50,47059739,46717264,342475,145.99605810643115
1747352447563654,46919404,1,503,50,47153966,46809824,344142,145.28886331804895
1747352447653751,47011964,1,504,50,47244063,46902384,341679,146.33618103541627
1747352447747518,47104524,1,505,50,47337830,46994944,342886,145.8210600607782
1747352447841676,47197084,1,506,50,47431988,47087504,344484,145.1446221014619
1747352447935473,47289644,1,507,50,47525785,47180064,345721,144.62529033527034
1747352448026210,47382204,1,508,50,47616522,47272624,343898,145.39194761237346
1747352448120154,47474764,1,509,50,47710466,47365184,345282,144.80917047514785
1747352448214516,47567324,1,510,50,47804828,47457744,347084,144.05734634843438
1747352448308224,47659884,1,511,50,47898536,47550304,348232,143.58243929334466
1747352448399034,47752444,1,512,50,47989346,47642864,346482,144.30764080096512
1747352448492747,47845004,1,513,50,48083059,47735424,347635,143.8290160657011
1747352448587349,47937572,1,514,50,48177661,47827992,349669,142.99237278683557
1747352448681750,48030124,1,515,50,48272062,47920544,351518,142.24022667402522
1747352448771494,48122684,1,516,50,48361806,48013104,348702,143.38891087518854
1747352448865530,48215244,1,517,50,48455842,48105664,350178,142.7845267264077
1747352448959845,48307804,1,518,50,48550157,48198224,351933,142.07249675364346
1747352449054383,48400364,1,519,50,48644695,48290784,353911,141.2784570132039
1747352449148655,48492924,1,520,50,48738967,48383344,355623,140.5983302542299
1747352449238647,48585484,1,521,50,48828959,48475904,353055,141.62099389613516
1747352449332177,48678044,1,522,50,48922489,48568464,354025,141.2329637737448
1747352449426534,48770604,1,523,50,49016846,48661024,355822,140.51969805127283
1747352449520788,48863164,1,524,50,49111100,48753584,357516,139.85388066548072
1747352449610899,48955724,1,525,50,49201211,48846144,355067,140.81849341110268
1747352449705179,49048284,1,526,50,49295491,48938704,356787,140.13963513244596
1747352449799901,49140844,1,527,50,49390213,49031264,358949,139.29555452167298
1747352449893229,49233404,1,528,50,49483541,49123824,359717,138.9981568844397
1747352449983425,49325964,1,529,50,49573737,49216384,357353,139.91767244153542
1747352450078366,49418524,1,530,50,49668678,49308944,359734,138.99158822908038
1747352450172022,49511084,1,531,50,49762334,49401504,360830,138.56940941717707
1747352450266698,49603644,1,532,50,49857010,49494064,362946,137.76154028422962
1747352450360719,49696204,1,533,50,49951031,49586624,364407,137.20921936186738
1747352450450941,49788764,1,534,50,50041253,49679184,362069,138.09522494331193
1747352450545127,49881324,1,535,50,50135439,49771744,363695,137.47783169963844
1747352450639126,49973884,1,536,50,50229438,49864304,365134,136.93602896470884
1747352450733530,50066452,1,537,50,50323842,49956872,366970,136.2509196937079
1747352450823339,50159004,1,538,50,50413651,50049424,364227,137.27702778761596
1747352450917665,50251564,1,539,50,50507977,50141984,365993,136.61463470612824
1747352451011924,50344124,1,540,50,50602236,50234544,367692,135.9833773919476
1747352451105877,50436684,1,541,50,50696189,50327104,369085,135.4701491526342
1747352451195920,50529244,1,542,50,50786232,50419664,366568,136.40034045524976
1747352451289946,50621804,1,543,50,50880258,50512224,368034,135.85701321073597
1747352451384227,50714364,1,544,50,50974539,50604784,369755,135.22467579883977
1747352451478778,50806924,1,545,50,51069090,50697344,371746,134.50043847142942
1747352451569175,50899484,1,546,50,51159487,50789904,369583,135.28760792568923
1747352451663249,50992044,1,547,50,51253561,50882464,371097,134.73566210451713
1747352451757558,51084604,1,548,50,51347870,50975024,372846,134.10362455276442
1747352451851324,51177164,1,549,50,51441636,51067584,374052,133.671254264113
1747352451945787,51269724,1,550,50,51536099,51160144,375955,132.99464031599527
1747352452035846,51362284,1,551,50,51626158,51252704,373454,133.88529778767935
1747352452129532,51454844,1,552,50,51719844,51345264,374580,133.48283410753376
1747352452224094,51547404,1,553,50,51814406,51437824,376582,132.77320742892653
1747352452317824,51639964,1,554,50,51908136,51530384,377752,132.3619729346238
1747352452408501,51732524,1,555,50,51998813,51622944,375869,133.02506990467424
1747352452502912,51825084,1,556,50,52093224,51715504,377720,132.37318648734512
1747352452596862,51917644,1,557,50,52187174,51808064,379110,131.8878425786711
1747352452691074,52010204,1,558,50,52281386,51900624,380762,131.31562498358556
1747352452781104,52102764,1,559,50,52371416,51993184,378232,132.193997334969
1747352452874943,52195324,1,560,50,52465255,52085744,379511,131.7484868686283
1747352452969083,52287884,1,561,50,52559395,52178304,381091,131.20225877808713
1747352453064102,52380444,1,562,50,52654414,52270864,383550,130.3611002476861
1747352453153939,52473004,1,563,50,52744251,52363424,380827,131.29321187835944
1747352453248465,52565564,1,564,50,52838777,52455984,382793,130.61889846470547
1747352453341904,52658124,1,565,50,52932216,52548544,383672,130.3196480326946
1747352453435980,52750684,1,566,50,53026292,52641104,385188,129.80674371994974
1747352453530049,52843244,1,567,50,53120361,52733664,386697,129.30020144971385
1747352453621058,52935804,1,568,50,53211370,52826224,385146,129.82089908761873
1747352453714979,53028364,1,569,50,53305291,52918784,386507,129.36376314012423
1747352453808791,53120924,1,570,50,53399103,53011344,387759,128.9460721736955
1747352453903316,53213484,1,571,50,53493628,53103904,389724,128.29592224240744
1747352453993495,53306044,1,572,50,53583807,53196464,387343,129.08455813064907
1747352454088129,53398604,1,573,50,53678441,53289024,389417,128.3970653566742
1747352454181929,53491164,1,574,50,53772241,53381584,390657,127.9895150989231
1747352454275948,53583724,1,575,50,53866260,53474144,392116,127.51328688449335
1747352454366598,53676284,1,576,50,53956910,53566704,390206,128.13744534937956
1747352454459969,53768844,1,577,50,54050281,53659264,391017,127.8716782134792
1747352454554512,53861412,1,578,50,54144824,53751832,392992,127.22905300871264
1747352454648284,53953964,1,579,50,54238596,53844384,394212,126.83530689070857
1747352454739263,54046524,1,580,50,54329575,53936944,392631,127.34603227967226
1747352454833697,54139084,1,581,50,54424009,54029504,394505,126.74110594289046
1747352454927374,54231644,1,582,50,54517686,54122064,395622,126.3832648336038
1747352455021120,54324204,1,583,50,54611432,54214624,396808,126.00552408217575
1747352455115357,54416764,1,584,50,54705669,54307184,398485,125.4752374618869
1747352455205801,54509324,1,585,50,54796113,54399744,396369,126.14508198168878
1747352455299732,54601884,1,586,50,54890044,54492304,397740,125.71026298587016
1747352455393998,54694444,1,587,50,54984310,54584864,399446,125.17336511067828
1747352455488314,54787004,1,588,50,55078626,54677424,401202,124.625500371384
1747352455578169,54879564,1,589,50,55168481,54769984,398497,125.47145900721964
1747352455673066,54972124,1,590,50,55263378,54862544,400834,124.73991727248686
1747352455766754,55064684,1,591,50,55357066,54955104,401962,124.38986769893673
1747352455860859,55157244,1,592,50,55451171,55047664,403507,123.91358762053694
1747352455951530,55249804,1,593,50,55541842,55140224,401618,124.4964120134058
1747352456045583,55342364,1,594,50,55635895,55232784,403111,124.03531533498216
1747352456139777,55434924,1,595,50,55730089,55325344,404745,123.53457114973624
1747352456233759,55527484,1,596,50,55824071,55417904,406167,123.10207377753486
1747352456323663,55620044,1,597,50,55913975,55510464,403511,123.91235926653796
1747352456418134,55712604,1,598,50,56008446,55603024,405422,123.32828509553008
1747352456512619,55805164,1,599,50,56102931,55695584,407347,122.7454725332456
1747352456606650,55897724,1,600,50,56196962,55788144,408818,122.30381245444184
1747352456700974,55990292,1,601,50,56291286,55880712,410574,121.780726495102
1747352456790491,56082844,1,602,50,56380803,55973264,407539,122.6876446180611
1747352456885317,56175404,1,603,50,56475629,56065824,409805,122.00924830102124
1747352456979338,56267964,1,604,50,56569650,56158384,411266,121.5758171110668
1747352457073482,56360524,1,605,50,56663794,56250944,412850,121.10936175366356
1747352457163571,56453084,1,606,50,56753883,56343504,410379,121.83859310539768
1747352457257861,56545644,1,607,50,56848173,56436064,412109,121.32712461994278
1747352457352079,56638204,1,608,50,56942391,56528624,413767,120.8409563836652
1747352457446086,56730764,1,609,50,57036398,56621184,415214,120.4198317012432
1747352457535970,56823324,1,610,50,57126282,56713744,412538,121.20095603314118
1747352457629881,56915884,1,611,50,57220193,56806304,413889,120.80533669655392
1747352457724717,57008444,1,612,50,57315029,56898864,416165,120.14465416361298
1747352457818698,57101004,1,613,50,57409010,56991424,417586,119.73581489800902
1747352457909419,57193564,1,614,50,57499731,57083984,415747,120.26544990102154
1747352458002628,57286124,1,615,50,57592940,57176544,416396,120.0780026705348
1747352458097037,57378684,1,616,50,57687349,57269104,418245,119.54715537543784
1747352458191709,57471244,1,617,50,57782021,57361664,420357,118.94651451028533
1747352458285642,57563804,1,618,50,57875954,57454224,421730,118.5592677779622
1747352458375781,57656364,1,619,50,57966093,57546784,419309,119.24380349575137
1747352458470424,57748924,1,620,50,58060736,57639344,421392,118.6543645821468
1747352458564203,57841484,1,621,50,58154515,57731904,422611,118.3121120841625
1747352458658525,57934044,1,622,50,58248837,57824464,424373,117.82087927365784
1747352458748888,58026604,1,623,50,58339200,57917024,422176,118.43401803986964
1747352458843099,58119164,1,624,50,58433411,58009584,423827,117.97266337444287
1747352458936786,58211724,1,625,50,58527098,58102144,424954,117.65979376591348
1747352459031356,58304284,1,626,50,58621668,58194704,426964,117.10589183162983
1747352459121322,58396844,1,627,50,58711634,58287264,424370,117.82171218512148
1747352459215500,58489404,1,628,50,58805812,58379824,425988,117.37419833422538
1747352459309790,58581964,1,629,50,58900102,58472384,427718,116.89945244296476
1747352459403636,58674524,1,630,50,58993948,58564944,429004,116.54902984587557
1747352459493659,58767084,1,631,50,59083971,58657504,426467,117.24236576335332
1747352459588047,58859644,1,632,50,59178359,58750064,428295,116.74196523424276
1747352459682628,58952204,1,633,50,59272940,58842624,430316,116.1936809228567
1747352459776845,59044764,1,634,50,59367157,58935184,431973,115.74797498917756
1747352459870732,59137324,1,635,50,59461044,59027744,433300,115.39349180706208
1747352459960829,59229884,1,636,50,59551141,59120304,430837,116.05317092078906
1747352460054755,59322444,1,637,50,59645067,59212864,432203,115.68637885438092
1747352460148774,59415004,1,638,50,59739086,59305424,433662,115.2971669180145
1747352460243655,59507564,1,639,50,59833967,59397984,435983,114.68337068188438
1747352460333779,59600124,1,640,50,59924091,59490544,433547,115.32774993253328
1747352460427681,59692684,1,641,50,60017993,59583104,434889,114.97186638429577
1747352460522061,59785252,1,642,50,60112373,59675672,436701,114.49481452984996
1747352460616216,59877804,1,643,50,60206528,59768224,438304,114.07607505293127
1747352460706089,59970364,1,644,50,60296401,59860784,435617,114.779726227397
1747352460800986,60062924,1,645,50,60391298,59953344,437954,114.16724130844791
1747352460894468,60155484,1,646,50,60484780,60045904,438876,113.9273963488548
1747352460988631,60248044,1,647,50,60578943,60138464,440479,113.5127894859914
1747352461083303,60340604,1,648,50,60673615,60231024,442591,112.9711178040222
1747352461172859,60433164,1,649,50,60763171,60323584,439587,113.7431270715467
1747352461267654,60525724,1,650,50,60857966,60416144,441822,113.16774628696623
1747352461361665,60618284,1,651,50,60951977,60508704,443273,112.79730549796628
1747352461455538,60710844,1,652,50,61045850,60601264,444586,112.46418015861948
1747352461546528,60803404,1,653,50,61136840,60693824,443016,112.86274084908896
1747352461640140,60895964,1,654,50,61230452,60786384,444068,112.59536827693056
1747352461734129,60988524,1,655,50,61324441,60878944,445497,112.2342013526466
1747352461828808,61081084,1,656,50,61419120,60971504,447616,111.70288818987704
1747352461918962,61173644,1,657,50,61509274,61064064,445210,112.3065519642416
1747352462012938,61266204,1,658,50,61603250,61156624,446626,111.95049101485358
1747352462106912,61358764,1,659,50,61697224,61249184,448040,111.59717882331935
1747352462201124,61451324,1,660,50,61791436,61341744,449692,111.18721258105548
1747352462291825,61543884,1,661,50,61882137,61434304,447833,111.648761926879
1747352462386005,61636444,1,662,50,61976317,61526864,449453,111.24633721434722
1747352462480332,61729004,1,663,50,62070644,61619424,451220,110.81069101546916
1747352462574211,61821564,1,664,50,62164523,61711984,452539,110.4877148709835
1747352462668654,61914132,1,665,50,62258966,61804552,454414,110.03182120269182
1747352462758848,62006684,1,666,50,62349160,61897104,452056,110.60576565735218
1747352462852602,62099244,1,667,50,62442914,61989664,453250,110.31439602868174
1747352462947241,62191804,1,668,50,62537553,62082224,455329,109.81070830103069
1747352463041083,62284364,1,669,50,62631395,62174784,456611,109.50239919756642
1747352463131581,62376924,1,670,50,62721893,62267344,454549,109.99914200669237
1747352463225062,62469484,1,671,50,62815374,62359904,455470,109.77671416339166
1747352463319108,62562044,1,672,50,62909420,62452464,456956,109.41972531272158
1747352463413328,62654604,1,673,50,63003640,62545024,458616,109.02367121949516
1747352463504045,62747164,1,674,50,63094357,62637584,456773,109.46356286382952
1747352463598376,62839724,1,675,50,63188688,62730144,458544,109.04078997871524
1747352463692652,62932284,1,676,50,63282964,62822704,460260,108.63425020640508
1747352463786560,63024844,1,677,50,63376872,62915264,461608,108.31701356995544
1747352463876069,63117404,1,678,50,63466381,63007824,458557,109.03769869394644
1747352463970354,63209964,1,679,50,63560666,63100384,460282,108.62905783845557
1747352464063890,63302524,1,680,50,63654202,63192944,461258,108.39920391624644
1747352464159305,63395084,1,681,50,63749617,63285504,464113,107.73238413920748
1747352464252818,63487644,1,682,50,63843130,63378064,465066,107.5116220063389
1747352464342832,63580204,1,683,50,63933144,63470624,462520,108.10343336504368
1747352464437396,63672764,1,684,50,64027708,63563184,464524,107.63706503862018
1747352464531615,63765324,1,685,50,64121927,63655744,466183,107.25401827179456
1747352464625610,63857884,1,686,50,64215922,63748304,467618,106.92488313110276
1747352464716083,63950444,1,687,50,64306395,63840864,465531,107.40423301563162
1747352464810734,64043004,1,688,50,64401046,63933424,467622,106.92396850447584
1747352464904728,64135564,1,689,50,64495040,64025984,469056,106.59708009278212
1747352464998902,64228124,1,690,50,64589214,64118544,470670,106.23154226953068
1747352465089069,64320684,1,691,50,64679381,64211104,468277,106.7744091638069
1747352465182385,64413244,1,692,50,64772697,64303664,469033,106.60230730033922
1747352465277415,64505804,1,693,50,64867727,64396224,471503,106.0438639838983
1747352465371399,64598364,1,694,50,64961711,64488784,472927,105.7245621417259
1747352465461104,64690924,1,695,50,65051416,64581344,470072,106.36668425262512
1747352465555812,64783484,1,696,50,65146124,64673904,472220,105.88285121341748
1747352465649994,64876044,1,697,50,65240306,64766464,473842,105.52040553602257
1747352465743667,64968604,1,698,50,65333979,64859024,474955,105.27313113873946
1747352465838211,65061164,1,699,50,65428523,64951584,476939,104.8352095341333
1747352465928213,65153724,1,700,50,65518525,65044144,474381,105.40051140328131
1747352466022754,65246284,1,701,50,65613066,65136704,476362,104.96219261821892
1747352466116574,65338844,1,702,50,65706886,65229264,477622,104.68529506597268
1747352466210252,65431404,1,703,50,65800564,65321824,478740,104.44082382921836
1747352466300747,65523964,1,704,50,65891059,65414384,476675,104.89327109665916
1747352466395118,65616524,1,705,50,65985430,65506944,478486,104.49626530347804
1747352466489128,65709092,1,706,50,66079440,65599512,479928,104.18229401076827
1747352466583245,65801644,1,707,50,66173557,65692064,481493,103.84366958605835
1747352466673978,65894204,1,708,50,66264290,65784624,479666,104.23919977651116
1747352466768202,65986764,1,709,50,66358514,65877184,481330,103.8788357260092
1747352466861883,66079324,1,710,50,66452195,65969744,482451,103.6374678464756
1747352466956254,66171884,1,711,50,66546566,66062304,484262,103.24989365260952
1747352467046833,66264444,1,712,50,66637145,66154864,482281,103.67399918304888
1747352467140829,66357004,1,713,50,66731141,66247424,483717,103.3662244659584
1747352467235345,66449564,1,714,50,66825657,66339984,485673,102.94992721440146
1747352467328803,66542124,1,715,50,66919115,66432544,486571,102.75992609506116
1747352467423534,66634684,1,716,50,67013846,66525104,488742,102.30346481374632
1747352467513281,66727244,1,717,50,67103593,66617664,485929,102.89569052268952
1747352467607803,66819804,1,718,50,67198115,66710224,487891,102.48190681935104
1747352467701808,66912364,1,719,50,67292120,66802784,489336,102.17927967695
1747352467795703,67004924,1,720,50,67386015,66895344,490671,101.90127396972716
1747352467885614,67097484,1,721,50,67475926,66987904,488022,102.45439754765154
1747352467980270,67190044,1,722,50,67570582,67080464,490118,102.01624914816432
1747352468074889,67282604,1,723,50,67665201,67173024,492177,101.58946882930329
1747352468168270,67375164,1,724,50,67758582,67265584,492998,101.42028973748371
1747352468258967,67467724,1,725,50,67849279,67358144,491135,101.80500269783258
1747352468353418,67560284,1,726,50,67943730,67450704,493026,101.41452986252246
1747352468447226,67652844,1,727,50,68037538,67543264,494274,101.158466761351
1747352468541686,67745404,1,728,50,68131998,67635824,496174,100.77110046072546
1747352468631707,67837972,1,729,50,68222019,67728392,493627,101.291055797191
1747352468726194,67930524,1,730,50,68316506,67820944,495562,100.89554889196508
1747352468819805,68023084,1,731,50,68410117,67913504,496613,100.68202000350372
1747352468914422,68115644,1,732,50,68504734,68006064,498670,100.26670944712936
1747352469008006,68208204,1,733,50,68598318,68098624,499694,100.06123747733612
1747352469098029,68300764,1,734,50,68688341,68191184,497157,100.57185154790136
1747352469192481,68393324,1,735,50,68782793,68283744,499049,100.19056244977948
1747352469286511,68485884,1,736,50,68876823,68376304,500519,99.89630763267728
1747352469380907,68578444,1,737,50,68971219,68468864,502355,99.53120801027164
1747352469471526,68671004,1,738,50,69061838,68561424,500414,99.9172685016806
1747352469565162,68763564,1,739,50,69155474,68653984,501490,99.70288540150352
1747352469659463,68856124,1,740,50,69249775,68746544,503231,99.35794893398857
1747352470257381,69430204,1,746,50,69847693,69320624,527069,94.86423978644162
1747352470335067,69525884,1,747,50,69925379,69416304,509075,98.21735500662966
1747352470425321,69618444,1,748,50,70015633,69508864,506769,98.66428293759088
1747352470519646,69711004,1,749,50,70109958,69601424,508534,98.32184278730624
1747352470613896,69803564,1,750,50,70204208,69693984,510224,97.99617422935808
1747352470707968,69896124,1,751,50,70298280,69786544,511736,97.706629981084
1747352470798242,69988684,1,752,50,70388554,69879104,509450,98.14505839630976
1747352470892795,70081244,1,753,50,70483107,69971664,511443,97.76260502147844
1747352470987015,70173804,1,754,50,70577327,70064224,513103,97.44632169369504
1747352471080796,70266364,1,755,50,70671108,70156784,514324,97.21498510666429
1747352471174804,70358924,1,756,50,70765116,70249344,515772,96.94205966977655
1747352471264792,70451484,1,757,50,70855104,70341904,513200,97.42790335151987
1747352471358692,70544044,1,758,50,70949004,70434464,514540,97.17417499125432
1747352471555674,70732284,1,760,50,71145986,70622704,523282,95.550773770166
1747352471646283,70827964,1,761,50,71236595,70718384,518211,96.485794396491
1747352471740596,70923644,1,762,50,71330908,70814064,516844,96.74098954423386
1747352471834381,71016204,1,763,50,71424693,70906624,518069,96.51224064748132
1747352471928408,71108764,1,764,50,71518720,70999184,519536,96.23972159773336
1747352472023125,71201324,1,765,50,71613437,71091744,521693,95.84180734646624
1747352472113309,71293884,1,766,50,71703621,71184304,519317,96.28030663352057
1747352472207016,71386444,1,767,50,71797328,71276864,520464,96.06812382796888
1747352472301480,71479004,1,768,50,71891792,71369424,522368,95.717961283999
1747352472395268,71571564,1,769,50,71985580,71461984,523596,95.49347206624957
1747352472489267,71664124,1,770,50,72079579,71554544,525035,95.23174645499824
1747352472579631,71756684,1,771,50,72169943,71647104,522839,95.631733669447
1747352472673429,71849244,1,772,50,72263741,71739664,524077,95.40582776958348
1747352472767647,71941804,1,773,50,72357959,71832224,525735,95.1049483104606
1747352472862743,72034364,1,774,50,72453055,71924784,528271,94.64839069341303
1747352472952652,72126924,1,775,50,72542964,72017344,525620,95.1257562497622
1747352473047100,72219484,1,776,50,72637412,72109904,527508,94.78529235575574
1747352473140902,72312044,1,777,50,72731214,72202464,528750,94.5626477541371
1747352473234842,72404604,1,778,50,72825154,72295024,530130,94.31648840850356
1747352473325026,72497172,1,779,50,72915338,72387592,527746,94.74254660385868
1747352473419026,72589724,1,780,50,73009338,72480144,529194,94.48330857870648
1747352473513204,72682284,1,781,50,73103516,72572704,530812,94.1953083200832
1747352473607222,72774844,1,782,50,73197534,72665264,532270,93.9372874668871
1747352473698179,72867404,1,783,50,73288491,72757824,530667,94.22104634356386
1747352473792079,72959964,1,784,50,73382391,72850384,532007,93.98372577804427
1747352473886547,73052524,1,785,50,73476859,72942944,533915,93.64786529691057
1747352473980271,73145084,1,786,50,73570583,73035504,535079,93.44414563083208
1747352474074670,73237644,1,787,50,73664982,73128064,536918,93.12408971202306
1747352474165100,73330204,1,788,50,73755412,73220624,534788,93.4949924082066
1747352474259037,73422764,1,789,50,73849349,73313184,536165,93.25487489858531
1747352474353300,73515324,1,790,50,73943612,73405744,537868,92.9596109082526
1747352474447221,73607884,1,791,50,74037533,73498304,539229,92.72498326314052
1747352474537752,73700444,1,792,50,74128064,73590864,537200,93.07520476545048
1747352474631863,73793004,1,793,50,74222175,73683424,538751,92.80725232992609
1747352474725489,73885564,1,794,50,74315801,73775984,539817,92.62398183087971
1747352474819651,73978124,1,795,50,74409963,73868544,541419,92.34991753152364
1747352474909683,74070684,1,796,50,74499995,73961104,538891,92.78314167429036
1747352475004362,74163244,1,797,50,74594674,74053664,541010,92.4197334614887
1747352475098798,74255804,1,798,50,74689110,74146224,542886,92.10036729626478
1747352475192423,74348364,1,799,50,74782735,74238784,543951,91.92004426869332
1747352475287042,74440924,1,800,50,74877354,74331344,546010,91.57341440632956
1747352475377068,74533484,1,801,50,74967380,74423904,543476,92.00038272159212
1747352475471126,74626044,1,802,50,75061438,74516464,544974,91.74749621082842
1747352475565438,74718604,1,803,50,75155750,74609024,546726,91.45348858477554
1747352475660146,74811164,1,804,50,75250458,74701584,548874,91.09558842284386
1747352475750179,74903724,1,805,50,75340491,74794144,546347,91.51692971682832
1747352475844363,74996284,1,806,50,75434675,74886704,547971,91.24570460845555
1747352475937988,75088844,1,807,50,75528300,74979264,549036,91.06870951995862
1747352476032705,75181404,1,808,50,75623017,75071824,551193,90.71232762389944
1747352476122711,75273964,1,809,50,75713023,75164384,548639,91.13460763817372
1747352476216889,75366524,1,810,50,75807201,75256944,550257,90.86663141041367
1747352476311100,75459084,1,811,50,75901412,75349504,551908,90.5948092798075
1747352476404847,75551644,1,812,50,75995159,75442064,553095,90.40038329762518
1747352476495625,75644204,1,813,50,76085937,75534624,551313,90.6925829791788
1747352476589365,75736764,1,814,50,76179677,75627184,552493,90.49888414875844
1747352476683713,75829324,1,815,50,76274025,75719744,554281,90.20695279109331
1747352476777549,75921884,1,816,50,76367861,75812304,555557,89.9997660006084
1747352476872258,76014444,1,817,50,76462570,75904864,557706,89.65297127877412
1747352476961597,76107004,1,818,50,76551909,75997424,554485,90.17376484485604
1747352477056602,76199564,1,819,50,76646914,76089984,556930,89.7778895013736
1747352477150953,76292132,1,820,50,76741265,76182552,558713,89.49138466439835
1747352477244302,76384684,1,821,50,76834614,76275104,559510,89.36390770495613
1747352477334467,76477244,1,822,50,76924779,76367664,557115,89.7480771474471
1747352477428540,76569804,1,823,50,77018852,76460224,558628,89.50500153948603
1747352477523058,76662364,1,824,50,77113370,76552784,560586,89.19238083005997
1747352477617733,76754924,1,825,50,77208045,76645344,562701,88.85713727183709
1747352477707656,76847484,1,826,50,77297968,76737904,560064,89.27551137012912
1747352477801396,76940044,1,827,50,77391708,76830464,561244,89.08781207460571
1747352477896719,77032604,1,828,50,77487031,76923024,564007,88.65138198639379
1747352477989957,77125164,1,829,50,77580269,77015584,564685,88.54494098479684
1747352478080094,77217724,1,830,50,77670406,77108144,562262,88.92651468532463
1747352478174854,77310284,1,831,50,77765166,77200704,564462,88.57992212053247
1747352478269042,77402844,1,832,50,77859354,77293264,566090,88.32517797523363
1747352478363012,77495404,1,833,50,77953324,77385824,567500,88.10572687224669
1747352478457202,77587964,1,834,50,78047514,77478384,569130,87.85339026233022
1747352478547113,77680524,1,835,50,78137425,77570944,566481,88.26421362764152
1747352478641716,77773084,1,836,50,78232028,77663504,568524,87.94703477777543
1747352478735097,77865644,1,837,50,78325409,77756064,569345,87.82021445696371
1747352478829417,77958204,1,838,50,78419729,77848624,571105,87.54957494681364
1747352478919856,78050764,1,839,50,78510168,77941184,568984,87.87593324241102
1747352479013911,78143324,1,840,50,78604223,78033744,570479,87.6456451508294
1747352479108564,78235884,1,841,50,78698876,78126304,572572,87.32526215043698
1747352479202601,78328444,1,842,50,78792913,78218864,574049,87.10057852204254
1747352479293001,78421012,1,843,50,78883313,78311432,571881,87.43077668256159
1747352479386721,78513564,1,844,50,78977033,78403984,573049,87.25257351465581
1747352479480663,78606124,1,845,50,79070975,78496544,574431,87.04265612406016
1747352479575159,78698684,1,846,50,79165471,78589104,576367,86.75028237216912
1747352479664853,78791244,1,847,50,79255165,78681664,573501,87.18380613111398
1747352479759844,78883804,1,848,50,79350156,78774224,575932,86.81580464360376
1747352479853948,78976364,1,849,50,79444260,78866784,577476,86.58368486309388
1747352479947532,79068924,1,850,50,79537844,78959344,578500,86.4304235090752
1747352480042032,79161484,1,851,50,79632344,79051904,580440,86.14154779133072
1747352480132587,79254044,1,852,50,79722899,79144464,578435,86.4401358838936
1747352480226266,79346604,1,853,50,79816578,79237024,579554,86.27323769657357
1747352480320943,79439164,1,854,50,79911255,79329584,581671,85.95924500275929
1747352480415058,79531724,1,855,50,80005370,79422144,583226,85.73006004533406
1747352480505121,79624284,1,856,50,80095433,79514704,580729,86.09867941845508
1747352480598755,79716844,1,857,50,80189067,79607264,581803,85.93974249015561
1747352480693240,79809404,1,858,50,80283552,79699824,583728,85.65633308664309
1747352480788141,79901964,1,859,50,80378453,79792384,586069,85.31418655482547
1747352480877823,79994524,1,860,50,80468135,79884944,583191,85.73520510433117
1747352480971438,80087084,1,861,50,80561750,79977504,584246,85.58038908268092
1747352481065774,80179644,1,862,50,80656086,80070064,586022,85.32102890335175
1747352481159871,80272204,1,863,50,80750183,80162624,587559,85.09783698317955
1747352481250735,80364764,1,864,50,80841047,80255184,585863,85.34418456191976
1747352481344695,80457324,1,865,50,80935007,80347744,587263,85.14072911114782
1747352481438419,80549884,1,866,50,81028731,80440304,588427,84.97230752497761
1747352481532887,80642444,1,867,50,81123199,80532864,590335,84.69767166100603
1747352481627072,80735004,1,868,50,81217384,80625424,591960,84.46516656530846
1747352481717293,80827564,1,869,50,81307605,80717984,589621,84.80023608385727
1747352481811225,80920124,1,870,50,81401537,80810544,590993,84.6033709367116
1747352481905329,81012684,1,871,50,81495641,80903104,592537,84.38291617232342
1747352481999318,81105244,1,872,50,81589630,80995664,593966,84.1799025533448
1747352482089310,81197804,1,873,50,81679622,81088224,591398,84.54543302479887
1747352482184178,81290364,1,874,50,81774490,81180784,593706,84.21676722148673
1747352482278851,81382924,1,875,50,81869163,81273344,595819,83.91810264526643
1747352482372540,81475484,1,876,50,81962852,81365904,596948,83.75938942755482
1747352482462786,81568044,1,877,50,82053098,81458464,594634,84.08533652633385
1747352482557099,81660604,1,878,50,82147411,81551024,596387,83.83817890061319
1747352482651187,81753164,1,879,50,82241499,81643584,597915,83.62392647784384
1747352482745215,81845724,1,880,50,82335527,81736144,599383,83.41911599094402
1747352482835179,81938284,1,881,50,82425491,81828704,596787,83.78198586765463
1747352482929347,82030844,1,882,50,82519659,81921264,598395,83.55684790146977
1747352483023631,82123404,1,883,50,82613943,82013824,600119,83.31680883291482
1747352483117629,82215972,1,884,50,82707941,82106392,601549,83.11874843113362
1747352483212089,82308524,1,885,50,82802401,82198944,603457,82.85594499690947
1747352483302369,82401084,1,886,50,82892681,82291504,601177,83.17018116128861
1747352483396568,82493644,1,887,50,82986880,82384064,602816,82.94404926212974
1747352483490610,82586204,1,888,50,83080922,82476624,604298,82.74063458757104
1747352483585240,82678764,1,889,50,83175552,82569184,606368,82.45817721251781
1747352483675328,82771324,1,890,50,83265640,82661744,603896,82.79571316915495
1747352483768978,82863884,1,891,50,83359290,82754304,604986,82.64654058110435
1747352483863165,82956444,1,892,50,83453477,82846864,606613,82.42487384873058
1747352483957828,83049004,1,893,50,83548140,82939424,608716,82.14011131627885
1747352484047587,83141564,1,894,50,83637899,83031984,605915,82.51982538804948
1747352484142236,83234124,1,895,50,83732548,83124544,608004,82.2363010769666
1747352484236240,83326684,1,896,50,83826552,83217104,609448,82.04145390582954
1747352484330726,83419244,1,897,50,83921038,83309664,611374,81.78300025843429
1747352484424751,83511804,1,898,50,84015063,83402224,612839,81.58749687927825
1747352484515006,83604364,1,899,50,84105318,83494784,610534,81.8955209701671
1747352484609291,83696924,1,900,50,84199603,83587344,612259,81.6647856544371
1747352484703361,83789484,1,901,50,84293673,83679904,613769,81.46387321614483
1747352484797543,83882044,1,902,50,84387855,83772464,615391,81.24915703999571
1747352484886940,83974604,1,903,50,84477252,83865024,612228,81.66892072887879
1747352484981594,84067164,1,904,50,84571906,83957584,614322,81.39054111687355
1747352485075963,84159724,1,905,50,84666275,84050144,616131,81.1515732855513
1747352485170089,84252284,1,906,50,84760401,84142704,617697,80.94583590336362
1747352485260473,84344852,1,907,50,84850785,84235272,615513,81.23305275436913
1747352485354585,84437404,1,908,50,84944897,84327824,617073,81.0276904029183
1747352485448645,84529964,1,909,50,85038957,84420384,618573,80.83120343112292
1747352485542775,84622524,1,910,50,85133087,84512944,620143,80.62656516319623
1747352485632682,84715084,1,911,50,85222994,84605504,617490,80.97297122220603
1747352485726576,84807644,1,912,50,85316888,84698064,618824,80.79841764378885
1747352485821497,84900204,1,913,50,85411809,84790624,621185,80.49131901124464
1747352485915740,84992764,1,914,50,85506052,84883184,622868,80.27383008920029
1747352486009410,85085324,1,915,50,85599722,84975744,623978,80.13103026068227
1747352486099998,85177884,1,916,50,85690310,85068304,622006,80.38507667128614
1747352486194225,85270444,1,917,50,85784537,85160864,623673,80.17021740559555
1747352486288388,85363004,1,918,50,85878700,85253424,625276,79.9646875939585
1747352486381982,85455564,1,919,50,85972294,85345984,626310,79.83267072216634
1747352486472334,85548124,1,920,50,86062646,85438544,624102,80.11510938917036
1747352486566808,85640684,1,921,50,86157120,85531104,626016,79.8701630629249
1747352486660479,85733244,1,922,50,86250791,85623664,627127,79.72866739910737
1747352486754444,85825804,1,923,50,86344756,85716224,628532,79.55044452788403
1747352486845654,85918364,1,924,50,86435966,85808784,627182,79.72167568584557
1747352486939639,86010924,1,925,50,86529951,85901344,628607,79.54095325060014
1747352487033249,86103484,1,926,50,86623561,85993904,629657,79.40831277981503
1747352487127438,86196044,1,927,50,86717750,86086464,631286,79.20340384548366
1747352487217559,86288604,1,928,50,86807871,86179024,628847,79.51059637717918
1747352487311553,86381164,1,929,50,86901865,86271584,630281,79.32969580234848
1747352487406201,86473724,1,930,50,86996513,86364144,632369,79.06775948852648
1747352487500160,86566284,1,931,50,87090472,86456704,633768,78.89322275659232
1747352487594827,86658844,1,932,50,87185139,86549264,635875,78.63180656575585
1747352487684545,86751404,1,933,50,87274857,86641824,633033,78.98482385594433
1747352487778518,86843964,1,934,50,87368830,86734384,634446,78.8089136033642
1747352487872721,86936524,1,935,50,87463033,86826944,636089,78.60535239565532
1747352487966860,87029084,1,936,50,87557172,86919504,637668,78.41070902099526
1747352488057298,87121644,1,937,50,87647610,87012064,635546,78.67251150978842
1747352488151336,87214204,1,938,50,87741648,87104624,637024,78.48997839955794
1747352488246122,87306764,1,939,50,87836434,87197184,639250,78.21666014861165
1747352488340384,87399324,1,940,50,87930696,87289744,640952,78.0089616695166
1747352488429957,87491884,1,941,50,88020269,87382304,637965,78.37420548149193
1747352488524696,87584444,1,942,50,88115008,87474864,640144,78.10742582918843
1747352488618289,87677004,1,943,50,88208601,87567424,641177,77.98158698768047
1747352488712646,87769564,1,944,50,88302958,87659984,642974,77.76364207572934
1747352488802503,87862124,1,945,50,88392815,87752544,640271,78.0919329471427
1747352488896579,87954684,1,946,50,88486891,87845104,641787,77.90746774241298
1747352488991396,88047244,1,947,50,88581708,87937664,644044,77.63444733589631
1747352489085473,88139812,1,948,50,88675785,88030232,645553,77.4529744265769
1747352489179433,88232364,1,949,50,88769745,88122784,646961,77.28441127054026
1747352489270130,88324924,1,950,50,88860442,88215344,645098,77.50760349590296
1747352489364275,88417484,1,951,50,88954587,88307904,646683,77.31763476077151
1747352489457828,88510044,1,952,50,89048140,88400464,647676,77.19909337384742
1747352489552003,88602604,1,953,50,89142315,88493024,649291,77.00707386980568
1747352489642607,88695164,1,954,50,89232919,88585584,647335,77.23975993882611
1747352489736889,88787724,1,955,50,89327201,88678144,649057,77.0348366938497
1747352489831132,88880284,1,956,50,89421444,88770704,650740,76.83560254479515
1747352489924815,88972844,1,957,50,89515127,88863264,651863,76.70323365492443
1747352490014952,89065404,1,958,50,89605264,88955824,649440,76.98940625769895
1747352490108950,89157964,1,959,50,89699262,89048384,650878,76.81931176042208
1747352490203768,89250524,1,960,50,89794080,89140944,653136,76.5537345973886
1747352490297337,89343084,1,961,50,89887649,89233504,654145,76.43565264582011
1747352490388021,89435644,1,962,50,89978333,89326064,652269,76.65549029618148
1747352490772970,89815244,1,966,50,90363282,89705664,657618,76.03198209294757
1747352490866638,89907804,1,967,50,90456950,89798224,658726,75.90409365957925
1747352490956940,90000364,1,968,50,90547252,89890784,656468,76.16517484477536
1747352491051286,90092924,1,969,50,90641598,89983344,658254,75.95852057108654
1747352491145489,90185484,1,970,50,90735801,90075904,659897,75.76940037611931
1747352491239858,90278044,1,971,50,90830170,90168464,661706,75.56225876748888
1747352491330247,90370604,1,972,50,90920559,90261024,659535,75.81098804460719
1747352491424445,90463164,1,973,50,91014757,90353584,661173,75.6231727550883
1747352491518100,90555724,1,974,50,91108412,90446144,662268,75.4981367059861
1747352491612472,90648284,1,975,50,91202784,90538704,664080,75.29213347789423
1747352491702769,90740844,1,976,50,91293081,90631264,661817,75.54958545942459
1747352491797028,90833404,1,977,50,91387340,90723824,663516,75.35613308495952
1747352491894754,90925964,1,978,50,91485066,90816384,668682,74.77395832398659
1747352491985616,91018524,1,979,50,91575928,90908944,666984,74.96431698511508
1747352492083622,91114204,1,980,50,91673934,91004624,669310,74.70379943523928
1747352492177722,91206764,1,981,50,91768034,91097184,670850,74.53230975627935
1747352492267853,91299324,1,982,50,91858165,91189744,668421,74.80315549631145
1747352492362199,91391884,1,983,50,91952511,91282304,670207,74.60381643283344
1747352492460647,91487564,1,984,50,92050959,91377984,672975,74.29696496898102
1747352493418067,92444364,1,994,50,93008379,92334784,673595,74.22857948767434
1747352493513120,92536924,1,995,50,93103432,92427344,676088,73.95486978026528
1747352493607331,92629484,1,996,50,93197643,92519904,677739,73.77471268438146
1747352493700799,92722044,1,997,50,93291111,92612464,678647,73.67600534593095
1747352493794973,92814604,1,998,50,93385285,92705024,680261,73.50120027460048
1747352493886127,92907164,1,999,50,93476439,92797584,678855,73.6534311450899
1747352493979684,92999724,1,1000,50,93569996,92890144,679852,73.54541870877779
1747352494074530,93093324,1,1001,50,93664842,92983744,681098,73.41087479334838
1747352494168408,93186924,1,1002,50,93758720,93077344,681376,73.38092330812944
1747352494262120,93280524,1,1003,50,93852432,93170944,681488,73.36886342826286
1747352494356438,93374124,1,1004,50,93946750,93264544,682206,73.29164504563138
1747352494451227,93467724,1,1005,50,94041539,93358144,683395,73.16412909078937
1747352494545183,93561324,1,1006,50,94135495,93451744,683751,73.12603564747985
1747352494638873,93654924,1,1007,50,94229185,93545344,683841,73.11641156350672
1747352494737006,93748524,1,1008,50,94327318,93638944,688374,72.63493391673711
1747352494831503,93842124,1,1009,50,94421815,93732544,689271,72.54040863462993
1747352494924921,93935724,1,1010,50,94515233,93826144,689089,72.55956777716668
1747352495019765,94029324,1,1011,50,94610077,93919744,690333,72.42881334080799
1747352495113969,94122924,1,1012,50,94704281,94013344,690937,72.36549786738877
1747352495208693,94216524,1,1013,50,94799005,94106944,692061,72.24796658098057
1747352495302686,94310124,1,1014,50,94892998,94200544,692454,72.20696248415057
1747352495397323,94403724,1,1015,50,94987635,94294144,693491,72.09898902797585
1747352495491501,94497324,1,1016,50,95081813,94387744,694069,72.0389471363798
1747352495585551,94590924,1,1017,50,95175863,94481344,694519,71.99227090979512
1747352495679885,94684524,1,1018,50,95270197,94574944,695253,71.91626645264385
1747352495774036,94778124,1,1019,50,95364348,94668544,695804,71.85931670412933
1747352495867399,94871724,1,1020,50,95457711,94762144,695567,71.88380127291835
1747352495962148,94965324,1,1021,50,95552460,94855744,696716,71.76525298686983
1747352496056634,95058924,1,1022,50,95646946,94949344,697602,71.67410643891502
1747352496150665,95152524,1,1023,50,95740977,95042944,698033,71.62985131075465
1747352496244333,95246124,1,1024,50,95834645,95136544,698101,71.62287405404089
1747352496338449,95339724,1,1025,50,95928761,95230144,698617,71.56997324714399
1747352496432716,95433324,1,1026,50,96023028,95323744,699284,71.50170746077416
1747352496527800,95526932,1,1027,50,96118112,95417352,700760,71.35110451509789
1747352496621225,95620524,1,1028,50,96211537,95510944,700593,71.36811244188851
1747352496715288,95714124,1,1029,50,96305600,95604544,701056,71.32097863794047
1747352496809790,95807724,1,1030,50,96400102,95698144,701958,71.22933280908545
1747352496904445,95901324,1,1031,50,96494757,95791744,703013,71.12244012557377
1747352496997945,95994924,1,1032,50,96588257,95885344,702913,71.13255836782076
1747352497092960,96088524,1,1033,50,96683272,95978944,704328,70.98965254824458
1747352497187093,96182124,1,1034,50,96777405,96072544,704861,70.93597177315812
1747352497281127,96275724,1,1035,50,96871439,96166144,705295,70.8923216526418
1747352497375040,96369324,1,1036,50,96965352,96259744,705608,70.86087459325857
1747352497468963,96462924,1,1037,50,97059275,96353344,705931,70.82845207251134
1747352497563337,96556524,1,1038,50,97153649,96446944,706705,70.75087907967256
1747352497657228,96650124,1,1039,50,97247540,96540544,706996,70.721757973171
1747352497751898,96743724,1,1040,50,97342210,96634144,708066,70.61488618292645
1747352505099140,104037244,1,1115,50,104689452,103927664,761788,65.63505857272627
1747352505197651,104131884,1,1116,50,104787963,104022304,765659,65.30322245281516
1747352505783287,104715324,1,1122,50,105373599,104605744,767855,65.11646079012314
1747352508936995,107840532,1,1154,50,108527307,107730952,796355,62.78606902700429
1747352509036171,107935164,1,1155,50,108626483,107825584,800899,62.4298444622855
1747352509122125,108029804,1,1156,50,108712437,107920224,792213,63.11433919918002
1747352509219480,108124444,1,1157,50,108809792,108014864,794928,62.8987782541312
1747352509314604,108219084,1,1158,50,108904916,108109504,795412,62.86050499615293
1747352509412086,108313724,1,1159,50,109002398,108204144,798254,62.636704607806536
1747352509507097,108408364,1,1160,50,109097409,108298784,798625,62.60760682422914
1747352509600668,108503004,1,1161,50,109190980,108393424,797556,62.691522601547724
1747352509694705,108597644,1,1162,50,109285017,108488064,796953,62.7389570024832
1747352509793337,108692284,1,1163,50,109383649,108582704,800945,62.42625898157801
1747352509883575,108786924,1,1164,50,109473887,108677344,796543,62.77125026520853
1747352509981476,108881564,1,1165,50,109571788,108771984,799804,62.51531625248186
1747352510080711,108976204,1,1166,50,109671023,108866624,804399,62.158207556200345
1747352510174058,109070844,1,1167,50,109764370,108961264,803106,62.25828221928363
1747352510268102,109165484,1,1168,50,109858414,109055904,802510,62.3045195698496
1747352510367389,109260124,1,1169,50,109957701,109150544,807157,61.945817232583
1747352510460924,109354764,1,1170,50,110051236,109245184,806052,62.03073747103165
1747352510554693,109449404,1,1171,50,110145005,109339824,805181,62.09783887101161
1747352510649093,109544044,1,1172,50,110239405,109434464,804941,62.11635386941403
1747352510743576,109638692,1,1173,50,110333888,109529112,804776,62.12908933666014
1747352510837907,109733324,1,1174,50,110428219,109623744,804475,62.15233537400167
1747352510935624,109827964,1,1175,50,110525936,109718384,807552,61.91551751466159
1747352511034759,109922604,1,1176,50,110625071,109813024,812047,61.572790737481945
1747352511124347,110017244,1,1177,50,110714659,109907664,806995,61.95825252944566
1747352511222740,110111884,1,1178,50,110813052,110002304,810748,61.67144414787332
1747352511317313,110206524,1,1179,50,110907625,110096944,810681,61.67654108089372
1747352511419102,110301164,1,1180,50,111009414,110191584,817830,61.13740019319419
1747352511722771,110591324,1,1183,50,111313083,110481744,831339,60.14393646875703
1747352511808544,110685964,1,1184,50,111398856,110576384,822472,60.79234308280404
1747352511923107,110780604,1,1185,50,111513419,110671024,842395,59.35457831539836
1747352512008952,110875244,1,1186,50,111599264,110765664,833600,59.98080614203455
1747352512107753,110969892,1,1187,50,111698065,110860312,837753,59.68346278676412
1747352512193099,111064524,1,1188,50,111783411,110954944,828467,60.352434074018646
1747352512377857,111256924,1,1190,50,111968169,111147344,820825,60.91432400328937
1747352512574756,111449324,1,1192,50,112165068,111339744,825324,60.58226829705667
1747352512672450,111543964,1,1193,50,112262762,111434384,828378,60.35891827161031
1747352512766952,111638604,1,1194,50,112357264,111529024,828240,60.36897517627741
1747352512865209,111733244,1,1195,50,112455521,111623664,831857,60.10648464820276
1747352512971521,111827884,1,1196,50,112561833,111718304,843529,59.274784862168346
1747352513045276,111922524,1,1197,50,112635588,111812944,822644,60.77963250203004
1747352513344077,112212684,1,1200,50,112934389,112103104,831285,60.14784339907492
1747352513438248,112307324,1,1201,50,113028560,112197744,830816,60.1817971728999
1747352513548714,112401964,1,1202,50,113139026,112292384,846642,59.05683866380359
1747352513622646,112496604,1,1203,50,113212958,112387024,825934,60.53752479011641
1747352513721440,112591244,1,1204,50,113311752,112481664,830088,60.23457753876697
1747352513810902,112685884,1,1205,50,113401214,112576304,824910,60.61267289764944
1747352513925464,112780524,1,1206,50,113515776,112670944,844832,59.18336426650505
1747352514004043,112875164,1,1207,50,113594355,112765584,828771,60.33029630621728
1747352514101939,112969804,1,1208,50,113692251,112860224,832027,60.09420367367886
1747352514208612,113064444,1,1209,50,113798924,112954864,844060,59.237494964812925
1747352514296247,113159084,1,1210,50,113886559,113049504,837055,59.73323138861843
1747352514389068,113253724,1,1211,50,113979380,113144144,835236,59.86332006762161
1747352514482981,113348364,1,1212,50,114073293,113238784,834509,59.91547125315605
1747352514581633,113443004,1,1213,50,114171945,113333424,838521,59.62879880169966
1747352514675623,113537644,1,1214,50,114265935,113428064,837871,59.67505737756767
1747352514769802,113632292,1,1215,50,114360114,113522712,837402,59.70847932056528
1747352514863360,113726924,1,1216,50,114453672,113617344,836328,59.78515606317139
1747352514957897,113821564,1,1217,50,114548209,113711984,836225,59.792519955753534
1747352515052445,113916204,1,1218,50,114642757,113806624,836133,59.799098947177065
1747352515150889,114010844,1,1219,50,114741201,113901264,839937,59.52827414437035
1747352515249161,114105484,1,1220,50,114839473,113995904,843569,59.27197419535332
1747352515343208,114200124,1,1221,50,114933520,114090544,842976,59.31366966556581
1747352515437543,114294764,1,1222,50,115027855,114185184,842671,59.335137912661054
1747352515531691,114389404,1,1223,50,115122003,114279824,842179,59.36980143176213
1747352515629707,114484044,1,1224,50,115220019,114374464,845555,59.13275895713467
1747352515719701,114578684,1,1225,50,115310013,114469104,840909,59.45946588750982
1747352515817813,114673324,1,1226,50,115408125,114563744,844381,59.214975230375856
1747352515912309,114767964,1,1227,50,115502621,114658384,844237,59.22507542313355
1747352516010922,114862604,1,1228,50,115601234,114753024,848210,58.94766626189269
1747352516109251,114957244,1,1229,50,115699563,114847664,851899,58.69240367696171
1747352516198916,115051884,1,1230,50,115789228,114942304,846924,59.03717452805682
1747352516309100,115146524,1,1231,50,115899412,115036944,862468,57.97316538120835
1747352516387513,115241164,1,1232,50,115977825,115131584,846241,59.08482335410362
1747352516498169,115335804,1,1233,50,116088481,115226224,862257,57.98735179882564
1747352516583892,115430444,1,1234,50,116174204,115320864,853340,58.59329223990438
1747352516678622,115525084,1,1235,50,116268934,115415504,853430,58.587113178585234
1747352516768191,115619724,1,1236,50,116358503,115510144,848359,58.93731309504585
1747352516866455,115714364,1,1237,50,116456767,115604784,851983,58.68661698648916
1747352516973618,115809004,1,1238,50,116563930,115699424,864506,57.83649853210967
1747352517062858,115903644,1,1239,50,116653170,115794064,859106,58.20003585122208
1747352517152933,115998284,1,1240,50,116743245,115888704,854541,58.510943301725725
1747352517243058,116092924,1,1241,50,116833370,115983344,850026,58.8217301588422
1747352517349560,116187564,1,1242,50,116939872,116077984,861888,58.01217791638821
1747352517562344,116379964,1,1244,50,117152656,116270384,882272,56.67186536578289
1747352517632226,116474604,1,1245,50,117222538,116365024,857514,58.308085932124726
1747352517735000,116569244,1,1246,50,117325312,116459664,865648,57.7601981405837
1747352517923650,116761644,1,1248,50,117513962,116652064,861898,58.01150484164019
1747352518017712,116856284,1,1249,50,117608024,116746704,861320,58.05043421724795
1747352518127828,116950924,1,1250,50,117718140,116841344,876796,57.02580759948722
1747352518218449,117045564,1,1251,50,117808761,116935984,872777,57.28840242123704
1747352518300457,117140204,1,1252,50,117890769,117030624,860145,58.12973394020775
1747352518402731,117234844,1,1253,50,117993043,117125264,867779,57.618356747512905
1747352518590889,117427244,1,1255,50,118181201,117317664,863537,57.90139855038058
1747352518705560,117521884,1,1256,50,118295872,117412304,883568,56.5887401988302
1747352518787265,117616524,1,1257,50,118377577,117506944,870633,57.42947947068397
1747352518872979,117711164,1,1258,50,118463291,117601584,861707,58.02436326964966
1747352518971362,117805804,1,1259,50,118561674,117696224,865450,57.77341267548674
1747352519073884,117900444,1,1260,50,118664196,117790864,873332,57.25199580457375
1747352519160172,117995084,1,1261,50,118750484,117885504,864980,57.80480473536961
1747352519258432,118089724,1,1262,50,118848744,117980144,868600,57.56389592447616
1747352519352155,118184364,1,1263,50,118942467,118074784,867683,57.62473161281252
1747352519451043,118279004,1,1264,50,119041355,118169424,871931,57.34398708154659
1747352519540590,118373644,1,1265,50,119130902,118264064,866838,57.68090462116336
1747352519639600,118468284,1,1266,50,119229912,118358704,871208,57.391575834932645
1747352519733779,118562924,1,1267,50,119324091,118453344,870747,57.42196068433196
1747352519831668,118657564,1,1268,50,119421980,118547984,873996,57.20849981006778
1747352519929927,118752204,1,1269,50,119520239,118642624,877615,56.97259048671684
1747352520023880,118846844,1,1270,50,119614192,118737264,876928,57.01722376295431
1747352520118250,118941484,1,1271,50,119708562,118831904,876658,57.03478437429419
1747352520212241,119036124,1,1272,50,119802553,118926544,876009,57.07703916283965
1747352520315029,119130764,1,1273,50,119905341,119021184,884157,56.55104240536466
1747352520405616,119225404,1,1274,50,119995928,119115824,880104,56.81146773563125
1747352520495748,119320044,1,1275,50,120086060,119210464,875596,57.10396118757966
1747352520593558,119414684,1,1276,50,120183870,119305104,878766,56.89796828734839
1747352520687575,119509324,1,1277,50,120277887,119399744,878143,56.938334644812976
1747352520786476,119603964,1,1278,50,120376788,119494384,882404,56.66338774529581
1747352520884237,119698604,1,1279,50,120474549,119589024,885525,56.46367973800852
1747352520974501,119793244,1,1280,50,120564813,119683664,881149,56.74409208885217
1747352521072634,119887892,1,1281,50,120662946,119778312,884634,56.520549741475
1747352521162675,119982524,1,1282,50,120752987,119872944,880043,56.81540561086219
1747352521273600,120077164,1,1283,50,120863912,119967584,896328,55.78315081086388
1747352521355620,120171804,1,1284,50,120945932,120062224,883708,56.579775219869006
1747352521453539,120266444,1,1285,50,121043851,120156864,886987,56.37061197063768
1747352521547689,120361084,1,1286,50,121138001,120251504,886497,56.40177011315323
1747352521642282,120455724,1,1287,50,121232594,120346144,886450,56.40476056179142
1747352521740072,120550364,1,1288,50,121330384,120440784,889600,56.20503597122303
1747352521834501,120645004,1,1289,50,121424813,120535424,889389,56.218370139500266
1747352521925107,120739644,1,1290,50,121515419,120630064,885355,56.47452151961642
1747352522023300,120834284,1,1291,50,121613612,120724704,888908,56.248790651001
1747352522121109,120928924,1,1292,50,121711421,120819344,892077,56.04897335095513
1747352522211811,121023564,1,1293,50,121802123,120913984,888139,56.29749397335327
1747352522318836,121118204,1,1294,50,121909148,121008624,900524,55.52322869795808
1747352522403586,121212844,1,1295,50,121993898,121103264,890634,56.13978356990638
1747352522498358,121307484,1,1296,50,122088670,121197904,890766,56.13146438009534
1747352522596691,121402124,1,1297,50,122187003,121292544,894459,55.89971144568952
1747352522690769,121496764,1,1298,50,122281081,121387184,893897,55.93485602927407
1747352522793248,121591404,1,1299,50,122383560,121481824,901736,55.44860136447918
1747352522887390,121686052,1,1300,50,122477702,121576472,901230,55.47973325344252
1747352522977884,121780684,1,1301,50,122568196,121671104,897092,55.73564361291818
1747352523071490,121875324,1,1302,50,122661802,121765744,896058,55.79995937762957
1747352523166578,121969964,1,1303,50,122756890,121860384,896506,55.77207514506316
1747352523268629,122064604,1,1304,50,122858941,121955024,903917,55.31481319634435
1747352523354960,122159244,1,1305,50,122945272,122049664,895608,55.82799617689882
1747352523452695,122253884,1,1306,50,123043007,122144304,898703,55.63573282830924
1747352523550755,122348524,1,1307,50,123141067,122238944,902123,55.424814576282834
1747352523645107,122443164,1,1308,50,123235419,122333584,901835,55.44251442891438
1747352523739036,122537804,1,1309,50,123329348,122428224,901124,55.48625938272646
1747352523845794,122632444,1,1310,50,123436106,122522864,913242,54.75000054750001
1747352523931851,122727084,1,1311,50,123522163,122617504,904659,55.26944406676992
1747352524025628,122821724,1,1312,50,123615940,122712144,903796,55.322218730775525
1747352524120303,122916364,1,1313,50,123710615,122806784,903831,55.32007643021759
1747352524214247,123011004,1,1314,50,123804559,122901424,903135,55.36270878661552
1747352524317152,123105644,1,1315,50,123907464,122996064,911400,54.86065393899495
1747352524406531,123200284,1,1316,50,123996843,123090704,906139,55.17917229034398
1747352524501392,123294924,1,1317,50,124091704,123185344,906360,55.16571781632023
1747352524598834,123389564,1,1318,50,124189146,123279984,909162,54.9956993363119
1747352524688913,123484204,1,1319,50,124279225,123374624,904601,55.27298775924413
1747352524787645,123578844,1,1320,50,124377957,123469264,908693,55.024084041585006
1747352524886043,123673484,1,1321,50,124476355,123563904,912451,54.79746309664848
1747352524980232,123768124,1,1322,50,124570544,123658544,912000,54.82456140350877
1747352525078867,123862764,1,1323,50,124669179,123753184,915995,54.58545079394538
1747352525192708,123957404,1,1324,50,124783020,123847824,935196,53.46472824947925
1747352525271210,124052044,1,1325,50,124861522,123942464,919058,54.403530571519966
1747352525357060,124146684,1,1326,50,124947372,124037104,910268,54.92887808865082
1747352525455319,124241324,1,1327,50,125045631,124131744,913887,54.71135928183681
1747352525549874,124335964,1,1328,50,125140186,124226384,913802,54.716448420992734
1747352525664449,124430604,1,1329,50,125254761,124321024,933737,53.54826894510981
1747352525746479,124525244,1,1330,50,125336791,124415664,921127,54.28133145592302
1747352525844518,124619884,1,1331,50,125434830,124510304,924526,54.08176730562472
1747352525938213,124714524,1,1332,50,125528525,124604944,923581,54.13710329684132
1747352526024869,124809164,1,1333,50,125615181,124699584,915597,54.60917849228427
1747352526127368,124903804,1,1334,50,125717680,124794224,923456,54.14443135352415
1747352526225165,124998444,1,1335,50,125815477,124888864,926613,53.95995955161432
1747352526315073,125093084,1,1336,50,125905385,124983504,921881,54.2369351358798
1747352526421349,125187724,1,1337,50,126011661,125078144,933517,53.56088855371675
1747352526503505,125282364,1,1338,50,126093817,125172784,921033,54.28687137160124
1747352526597842,125377004,1,1339,50,126188154,125267424,920730,54.30473645911396
1747352526692121,125471644,1,1340,50,126282433,125362064,920369,54.32603662226781
1747352526786014,125566284,1,1341,50,126376326,125456704,919622,54.37016513306554
1747352526896880,125660924,1,1342,50,126487192,125551344,935848,53.42747967618673
1747352526983148,125755564,1,1343,50,126573460,125645984,927476,53.90975076444027
1747352527094060,125850204,1,1344,50,126684372,125740624,943748,52.98024472634644
1747352527188061,125944852,1,1345,50,126778373,125835272,943101,53.016591011991295
1747352527269908,126039484,1,1346,50,126860220,125929904,930316,53.74517905743855
1747352527363588,126134124,1,1347,50,126953900,126024544,929356,53.80069639621416
1747352527462381,126228764,1,1348,50,127052693,126119184,933509,53.56134756065555
1747352527573075,126323404,1,1349,50,127163387,126213824,949563,52.65580061565162
1747352527670615,126418044,1,1350,50,127260927,126308464,952463,52.49547751461212
1747352527753274,126512684,1,1351,50,127343586,126403104,940482,53.16422855514512
1747352527838487,126607324,1,1352,50,127428799,126497744,931055,53.70252025927577
1747352527953685,126701964,1,1353,50,127543997,126592384,951613,52.54236753806432
1747352528035289,126796604,1,1354,50,127625601,126687024,938577,53.27213430544324
1747352528130123,126891244,1,1355,50,127720435,126781664,938771,53.26112545018966
1747352528220350,126985884,1,1356,50,127810662,126876304,934358,53.51267929423197
1747352528322452,127080524,1,1357,50,127912764,126970944,941820,53.08870060096409
1747352528429092,127175164,1,1358,50,128019404,127065584,953820,52.42079218301147
1747352528527328,127269804,1,1359,50,128117640,127160224,957416,52.22390267135707
1747352528605104,127364444,1,1360,50,128195416,127254864,940552,53.16027184036608
1747352528703142,127459084,1,1361,50,128293454,127349504,943950,52.968907251443405
1747352528801041,127553724,1,1362,50,128391353,127444144,947209,52.78666059971981
1747352529091741,127843884,1,1365,50,128682053,127734304,947749,52.75658428550175
1747352529178102,127938524,1,1366,50,128768414,127828944,939470,53.22149722715999
1747352529281062,128033164,1,1367,50,128871374,127923584,947790,52.75430211333734
1747352529370722,128127804,1,1368,50,128961034,128018224,942810,53.03295467803693
1747352529567310,128320204,1,1370,50,129157622,128210624,946998,52.79842196076444
1747352529665739,128414844,1,1371,50,129256051,128305264,950787,52.58801392951312
1747352529762971,128509484,1,1372,50,129353283,128399904,953379,52.44504022010135
1747352529948498,128701884,1,1374,50,129538810,128592304,946506,52.82586692530212
1747352530042921,128796524,1,1375,50,129633233,128686944,946289,52.83798078599666
1747352530153287,128891164,1,1376,50,129743599,128781584,962015,51.97424156587995
1747352530247728,128985804,1,1377,50,129838040,128876224,961816,51.98499505102847
1747352530350062,129080444,1,1378,50,129940374,128970864,969510,51.57244381182247
1747352530530145,129272852,1,1380,50,130120457,129163272,957185,52.23650600458637
1747352530619609,129367484,1,1381,50,130209921,129257904,952017,52.52007054495876
1747352530717937,129462124,1,1382,50,130308249,129352544,955705,52.317399197451095
1747352530808443,129556764,1,1383,50,130398755,129447184,951571,52.54468662874342
1747352622474565,7109244,1,76,75,0,0,0,0.0
1747352622564533,7199724,1,77,75,89968,90480,-512,0.0
1747352622654819,7290204,1,78,75,180254,180960,-706,0.0
1747352622744008,7380684,1,79,75,269443,271440,-1997,0.0
1747352622838899,7471164,1,80,75,364334,361920,2414,31068.76553438277
1747352622929089,7561644,1,81,75,454524,452400,2124,35310.73446327684
1747352623019322,7652124,1,82,75,544757,542880,1877,39957.37879595099
1747352623108635,7742604,1,83,75,634070,633360,710,105633.8028169014
1747352623202924,7833084,1,84,75,728359,723840,4519,16596.5921664085
1747352623293711,7923564,1,85,75,819146,814320,4826,15540.82055532532
1747352623383685,8014044,1,86,75,909120,904800,4320,17361.11111111111
1747352623474052,8104524,1,87,75,999487,995280,4207,17827.430473021155
1747352623567871,8195004,1,88,75,1093306,1085760,7546,9939.04055128545
1747352623657581,8285484,1,89,75,1183016,1176240,6776,11068.476977567889
1747352623748386,8375964,1,90,75,1273821,1266720,7101,10561.892691170258
1747352623838130,8466452,1,91,75,1363565,1357208,6357,11798.01793298726
1747352623932641,8556924,1,92,75,1458076,1447680,10396,7214.313197383609
1747352624022195,8647404,1,93,75,1547630,1538160,9470,7919.746568109821
1747352624112752,8737884,1,94,75,1638187,1628640,9547,7855.870954226459
1747352624202746,8828364,1,95,75,1728181,1719120,9061,8277.232093587905
1747352624296545,8918844,1,96,75,1821980,1809600,12380,6058.158319870759
1747352624386378,9009324,1,97,75,1911813,1900080,11733,6392.227051904883
1747352624477397,9099804,1,98,75,2002832,1990560,12272,6111.4732724902215
1747352624567188,9190284,1,99,75,2092623,2081040,11583,6475.006475006475
1747352624661274,9280764,1,100,75,2186709,2171520,15189,4937.783922575548
1747352624751356,9372284,1,101,75,2276791,2263040,13751,5454.148789178969
1747352624845934,9463804,1,102,75,2371369,2354560,16809,4461.895413171515
1747352624940178,9555324,1,103,75,2465613,2446080,19533,3839.6559668253726
1747352625030022,9646844,1,104,75,2555457,2537600,17857,4200.033600268802
1747352625124215,9738364,1,105,75,2649650,2629120,20530,3653.190452995616
1747352625214198,9829884,1,106,75,2739633,2720640,18993,3948.8232506713
1747352625308791,9921404,1,107,75,2834226,2812160,22066,3398.894226411674
1747352625398999,10012924,1,108,75,2924434,2903680,20754,3613.761202659728
1747352625492705,10105484,1,109,75,3018140,2996240,21900,3424.657534246576
1747352625586607,10198052,1,110,75,3112042,3088808,23234,3228.027890160971
1747352625681135,10290604,1,111,75,3206570,3181360,25210,2975.0099166997225
1747352625771599,10383164,1,112,75,3297034,3273920,23114,3244.786709353639
1747352625865564,10475724,1,113,75,3390999,3366480,24519,3058.8523186100574
1747352625959104,10568284,1,114,75,3484539,3459040,25499,2941.291815365308
1747352626054147,10660844,1,115,75,3579582,3551600,27982,2680.294475019656
1747352626144384,10753404,1,116,75,3669819,3644160,25659,2922.9510113410497
1747352626238400,10845964,1,117,75,3763835,3736720,27115,2765.996680803983
1747352626332801,10938524,1,118,75,3858236,3829280,28956,2590.136759220887
1747352626426705,11031084,1,119,75,3952140,3921840,30300,2475.247524752476
1747352626520137,11123644,1,120,75,4045572,4014400,31172,2406.0053894520724
1747352626611212,11216204,1,121,75,4136647,4106960,29687,2526.3583386667565
1747352626705356,11308764,1,122,75,4230791,4199520,31271,2398.3882830737743
1747352626798886,11401324,1,123,75,4324321,4292080,32241,2326.2305759746905
1747352626893647,11493884,1,124,75,4419082,4384640,34442,2177.5738923407466
1747352626983965,11586444,1,125,75,4509400,4477200,32200,2329.192546583851
1747352627078064,11679004,1,126,75,4603499,4569760,33739,2222.946738196153
1747352627171732,11771564,1,127,75,4697167,4662320,34847,2152.26561827417
1747352627265922,11864124,1,128,75,4791357,4754880,36477,2056.090138991693
1747352627355906,11956684,1,129,75,4881341,4847440,33901,2212.3241202324416
1747352627450380,12049244,1,130,75,4975815,4940000,35815,2094.094653078319
1747352627545192,12141804,1,131,75,5070627,5032560,38067,1970.2104184726927
1747352627639308,12234364,1,132,75,5164743,5125120,39623,1892.8400171617493
1747352627728946,12326932,1,133,75,5254381,5217688,36693,2043.98659144796
1747352627822942,12419484,1,134,75,5348377,5310240,38137,1966.5941211946408
1747352627917757,12512044,1,135,75,5443192,5402800,40392,1856.8033273915628
1747352628011773,12604604,1,136,75,5537208,5495360,41848,1792.200344102466
1747352628105275,12697164,1,137,75,5630710,5587920,42790,1752.745968684272
1747352628196395,12789724,1,138,75,5721830,5680480,41350,1813.7847642079807
1747352628289834,12882284,1,139,75,5815269,5773040,42229,1776.0306898103197
1747352628383942,12974844,1,140,75,5909377,5865600,43777,1713.2284076113026
1747352628478677,13067404,1,141,75,6004112,5958160,45952,1632.1378830083563
1747352628568861,13159964,1,142,75,6094296,6050720,43576,1721.1308977418764
1747352628663074,13252524,1,143,75,6188509,6143280,45229,1658.228127970992
1747352628756796,13345084,1,144,75,6282231,6235840,46391,1616.6928930180422
1747352628851273,13437644,1,145,75,6376708,6328400,48308,1552.537881924319
1747352628941767,13530204,1,146,75,6467202,6420960,46242,1621.902166861295
1747352629035133,13622764,1,147,75,6560568,6513520,47048,1594.1166468287706
1747352629129834,13715324,1,148,75,6655269,6606080,49189,1524.7311390758098
1747352629224052,13807884,1,149,75,6749487,6698640,50847,1475.013275119476
1747352629314364,13900444,1,150,75,6839799,6791200,48599,1543.2416304862238
1747352629407874,13993004,1,151,75,6933309,6883760,49549,1513.653151425861
1747352629502131,14085564,1,152,75,7027566,6976320,51246,1463.5288607891348
1747352629596362,14178124,1,153,75,7121797,7068880,52917,1417.3139066840524
1747352629691020,14270684,1,154,75,7216455,7161440,55015,1363.264564209761
1747352629784595,14363244,1,155,75,7310030,7254000,56030,1338.5686239514546
1747352629875218,14455804,1,156,75,7400653,7346560,54093,1386.5010260107592
1747352629969361,14548364,1,157,75,7494796,7439120,55676,1347.0795315755445
1747352630063130,14640924,1,158,75,7588565,7531680,56885,1318.4495033840203
1747352630153275,14733484,1,159,75,7678710,7624240,54470,1376.9047181935011
1747352630247512,14826044,1,160,75,7772947,7716800,56147,1335.7792936399094
1747352630342236,14918604,1,161,75,7867671,7809360,58311,1286.2067191439007
1747352630436523,15011164,1,162,75,7961958,7901920,60038,1249.2088344048768
1747352630526893,15103724,1,163,75,8052328,7994480,57848,1296.5011754943991
1747352630620400,15196284,1,164,75,8145835,8087040,58795,1275.618675057403
1747352630715102,15288844,1,165,75,8240537,8179600,60937,1230.7793294714213
1747352630809531,15381404,1,166,75,8334966,8272160,62806,1194.1534248320224
1747352630899543,15473964,1,167,75,8424978,8364720,60258,1244.6480135417703
1747352630993707,15566524,1,168,75,8519142,8457280,61862,1212.3759335294687
1747352631087771,15659084,1,169,75,8613206,8549840,63366,1183.600037875201
1747352631181549,15751644,1,170,75,8706984,8642400,64584,1161.2783351913786
1747352631276079,15844204,1,171,75,8801514,8734960,66554,1126.9044685518527
1747352631365862,15936764,1,172,75,8891297,8827520,63777,1175.972529281716
1747352631459857,16029324,1,173,75,8985292,8920080,65212,1150.0950745261607
1747352631554595,16121892,1,174,75,9080030,9012648,67382,1113.056899468701
1747352631648356,16214444,1,175,75,9173791,9105200,68591,1093.4379145952091
1747352631738573,16307004,1,176,75,9264008,9197760,66248,1132.109648593165
1747352631833391,16399564,1,177,75,9358826,9290320,68506,1094.794616529939
1747352631927522,16492124,1,178,75,9452957,9382880,70077,1070.251295004067
1747352632021475,16584684,1,179,75,9546910,9475440,71470,1049.391353015251
1747352632111366,16677244,1,180,75,9636801,9568000,68801,1090.1004345867066
1747352632205032,16769804,1,181,75,9730467,9660560,69907,1072.853934512996
1747352632300202,16862364,1,182,75,9825637,9753120,72517,1034.2402471144696
1747352632393939,16954924,1,183,75,9919374,9845680,73694,1017.7219312291368
1747352632484540,17047484,1,184,75,10009975,9938240,71735,1045.514741757859
1747352632577820,17140044,1,185,75,10103255,10030800,72455,1035.1252501552688
1747352632672172,17232604,1,186,75,10197607,10123360,74247,1010.1418239120774
1747352632766419,17325164,1,187,75,10291854,10215920,75934,987.6998446018912
1747352632860745,17417724,1,188,75,10386180,10308480,77700,965.2509652509652
1747352632950737,17510284,1,189,75,10476172,10401040,75132,998.2430921578024
1747352633044991,17602844,1,190,75,10570426,10493600,76826,976.2320047900448
1747352633139185,17695404,1,191,75,10664620,10586160,78460,955.9010960999236
1747352633233323,17787964,1,192,75,10758758,10678720,80038,937.0548989230116
1747352633324216,17880524,1,193,75,10849651,10771280,78371,956.9866404664992
1747352633418342,17973084,1,194,75,10943777,10863840,79937,938.238863104695
1747352633512229,18065644,1,195,75,11037664,10956400,81264,922.917897223863
1747352633605729,18158204,1,196,75,11131164,11048960,82204,912.364361831541
1747352633696863,18250772,1,197,75,11222298,11141528,80770,928.562585118237
1747352633789629,18343324,1,198,75,11315064,11234080,80984,926.108861009582
1747352633884820,18435884,1,199,75,11410255,11326640,83615,896.9682473240448
1747352633979072,18528444,1,200,75,11504507,11419200,85307,879.1775586997551
1747352634069179,18621004,1,201,75,11594614,11511760,82854,905.2067492215224
1747352634163783,18713564,1,202,75,11689218,11604320,84898,883.4130368206554
1747352634257575,18806124,1,203,75,11783010,11696880,86130,870.7767328456983
1747352634352220,18898684,1,204,75,11877655,11789440,88215,850.1955449753443
1747352634445578,18991244,1,205,75,11971013,11882000,89013,842.5735566714975
1747352634535892,19083804,1,206,75,12061327,11974560,86767,864.3839247640232
1747352634630391,19176364,1,207,75,12155826,12067120,88706,845.4895948413862
1747352634724135,19268924,1,208,75,12249570,12159680,89890,834.3530982311714
1747352634818485,19361484,1,209,75,12343920,12252240,91680,818.062827225131
1747352634908603,19454044,1,210,75,12434038,12344800,89238,840.4491360182882
1747352635003435,19546604,1,211,75,12528870,12437360,91510,819.5825592831385
1747352635096968,19639164,1,212,75,12622403,12529920,92483,810.959852080923
1747352635191153,19731724,1,213,75,12716588,12622480,94108,796.9566880605262
1747352635281691,19824284,1,214,75,12807126,12715040,92086,814.4560519514367
1747352635376052,19916844,1,215,75,12901487,12807600,93887,798.8326392365291
1747352635469507,20009404,1,216,75,12994942,12900160,94782,791.2894853453187
1747352635564084,20101964,1,217,75,13089519,12992720,96799,774.8013925763696
1747352635654119,20194524,1,218,75,13179554,13085280,94274,795.5533869359526
1747352635748839,20287084,1,219,75,13274274,13177840,96434,777.7339942343987
1747352635842504,20379644,1,220,75,13367939,13270400,97539,768.9231999507889
1747352635937094,20472204,1,221,75,13462529,13362960,99569,753.246492382167
1747352636031339,20564764,1,222,75,13556774,13455520,101254,740.7114780650642
1747352636120982,20657324,1,223,75,13646417,13548080,98337,762.6834253638001
1747352636214934,20749884,1,224,75,13740369,13640640,99729,752.038023042445
1747352636309604,20842444,1,225,75,13835039,13733200,101839,736.4565637918676
1747352636403921,20935004,1,226,75,13929356,13825760,103596,723.9661763002433
1747352636494415,21027564,1,227,75,14019850,13918320,101530,738.6979217965134
1747352636587968,21120124,1,228,75,14113403,14010880,102523,731.5431659237439
1747352636682460,21212684,1,229,75,14207895,14103440,104455,718.0125412857211
1747352636776009,21305244,1,230,75,14301444,14196000,105444,711.2780243541596
1747352636866221,21397804,1,231,75,14391656,14288560,103096,727.4773027081555
1747352636960444,21490364,1,232,75,14485879,14381120,104759,715.9289416661098
1747352637055247,21582924,1,233,75,14580682,14473680,107002,700.9214781032131
1747352637149158,21675484,1,234,75,14674593,14566240,108353,692.1820346460181
1747352637243179,21768044,1,235,75,14768614,14658800,109814,682.9730271185823
1747352637332799,21860604,1,236,75,14858234,14751360,106874,701.7609521492599
1747352637427240,21953164,1,237,75,14952675,14843920,108755,689.623465587789
1747352637521469,22045732,1,238,75,15046904,14936488,110416,679.249384147225
1747352637615779,22138284,1,239,75,15141214,15029040,112174,668.6041328650133
1747352637706069,22230844,1,240,75,15231504,15121600,109904,682.4137429028971
1747352637800479,22323404,1,241,75,15325914,15214160,111754,671.1169175152567
1747352637894344,22415964,1,242,75,15419779,15306720,113059,663.3704525955474
1747352637988452,22508524,1,243,75,15513887,15399280,114607,654.4102890748384
1747352638078308,22601084,1,244,75,15603743,15491840,111903,670.2233184096941
1747352638173015,22693644,1,245,75,15698450,15584400,114050,657.6063130206051
1747352638267367,22786204,1,246,75,15792802,15676960,115842,647.4335733153779
1747352638361549,22878764,1,247,75,15886984,15769520,117464,638.4934958795886
1747352638451638,22971324,1,248,75,15977073,15862080,114993,652.2136130025306
1747352638545646,23063884,1,249,75,16071081,15954640,116441,644.1030221313798
1747352638640030,23156444,1,250,75,16165465,16047200,118265,634.1690271847124
1747352638733813,23249004,1,251,75,16259248,16139760,119488,627.6780931976433
1747352638828532,23341564,1,252,75,16353967,16232320,121647,616.5380157340502
1747352638918120,23434124,1,253,75,16443555,16324880,118675,631.9780914261639
1747352639012111,23526684,1,254,75,16537546,16417440,120106,624.4484039098796
1747352639106289,23619244,1,255,75,16631724,16510000,121724,616.1480069665802
1747352639200842,23711804,1,256,75,16726277,16602560,123717,606.2222653313611
1747352639290976,23804364,1,257,75,16816411,16695120,121291,618.3476102926021
1747352639385678,23896924,1,258,75,16911113,16787680,123433,607.6170878128215
1747352639479697,23989484,1,259,75,17005132,16880240,124892,600.5188482849181
1747352639574120,24082044,1,260,75,17099555,16972800,126755,591.692635398998
1747352639664133,24174612,1,261,75,17189568,17065368,124200,603.8647342995168
1747352639757898,24267164,1,262,75,17283333,17157920,125413,598.0241282801624
1747352639852407,24359724,1,263,75,17377842,17250480,127362,588.8726621755311
1747352639946804,24452284,1,264,75,17472239,17343040,129199,580.4998490700392
1747352640036997,24544844,1,265,75,17562432,17435600,126832,591.3334174340861
1747352640130266,24637404,1,266,75,17655701,17528160,127541,588.0461969092293
1747352640224621,24729964,1,267,75,17750056,17620720,129336,579.8849508257562
1747352640318722,24822524,1,268,75,17844157,17713280,130877,573.0571452585252
1747352640413790,24915084,1,269,75,17939225,17805840,133385,562.2821156801739
1747352640503914,25007644,1,270,75,18029349,17898400,130949,572.7420598859097
1747352640598017,25100204,1,271,75,18123452,17990960,132492,566.0719137759261
1747352640690971,25192764,1,272,75,18216406,18083520,132886,564.3935403277998
1747352640785591,25285324,1,273,75,18311026,18176080,134946,555.7778667022365
1747352640876690,25377884,1,274,75,18402125,18268640,133485,561.8608832453085
1747352640970411,25470444,1,275,75,18495846,18361200,134646,557.0161757497439
1747352641064634,25563004,1,276,75,18590069,18453760,136309,550.2204549956349
1747352641158493,25655564,1,277,75,18683928,18546320,137608,545.026451950468
1747352641248484,25748124,1,278,75,18773919,18638880,135039,555.395108079888
1747352641343245,25840684,1,279,75,18868680,18731440,137240,546.4879044010493
1747352641436993,25933244,1,280,75,18962428,18824000,138428,541.7979021585229
1747352641531890,26025804,1,281,75,19057325,18916560,140765,532.8028984477676
1747352641621693,26118364,1,282,75,19147128,19009120,138008,543.446756709756
1747352641715541,26210924,1,283,75,19240976,19101680,139296,538.42177808408
1747352641809608,26303484,1,284,75,19335043,19194240,140803,532.6591052747456
1747352641904640,26396044,1,285,75,19430075,19286800,143275,523.4688536032105
1747352641998066,26488604,1,286,75,19523501,19379360,144141,520.3238495639687
1747352642088677,26581164,1,287,75,19614112,19471920,142192,527.4558343648025
1747352642183166,26673724,1,288,75,19708601,19564480,144121,520.3960560917562
1747352642277333,26766284,1,289,75,19802768,19657040,145728,514.6574440052701
1747352642371857,26858844,1,290,75,19897292,19749600,147692,507.8135579449124
1747352642461849,26951404,1,291,75,19987284,19842160,145124,516.7994266971693
1747352642555785,27043964,1,292,75,20081220,19934720,146500,511.9453924914676
1747352642649782,27136524,1,293,75,20175217,20027280,147937,506.9725626449096
1747352642744152,27229084,1,294,75,20269587,20119840,149747,500.8447581587611
1747352642834542,27321644,1,295,75,20359977,20212400,147577,508.2092738028283
1747352642928183,27414204,1,296,75,20453618,20304960,148658,504.5137160462269
1747352643022667,27506764,1,297,75,20548102,20397520,150582,498.0674981073435
1747352643116532,27599324,1,298,75,20641967,20490080,151887,493.7881451342116
1747352643207202,27691884,1,299,75,20732637,20582640,149997,500.010000200004
1747352643300644,27784444,1,300,75,20826079,20675200,150879,497.08706977114105
1747352643394644,27877004,1,301,75,20920079,20767760,152319,492.38768636873925
1747352643488839,27969572,1,302,75,21014274,20860328,153946,487.1838177023112
1747352643583307,28062124,1,303,75,21108742,20952880,155862,481.1949031835855
1747352643674039,28154684,1,304,75,21199474,21045440,154034,486.9054883986652
1747352643767790,28247244,1,305,75,21293225,21138000,155225,483.16959252697694
1747352643861488,28339804,1,306,75,21386923,21230560,156363,479.65311486732793
1747352643956595,28432364,1,307,75,21482030,21323120,158910,471.96526335661696
1747352644046389,28524924,1,308,75,21571824,21415680,156144,480.32585305871504
1747352644140214,28617484,1,309,75,21665649,21508240,157409,476.4657675228227
1747352644234495,28710044,1,310,75,21759930,21600800,159130,471.3127631496261
1747352644328456,28802604,1,311,75,21853891,21693360,160531,467.1994817200416
1747352644419102,28895164,1,312,75,21944537,21785920,158617,472.83708555829446
1747352644513302,28987724,1,313,75,22038737,21878480,160257,467.99827776633776
1747352644607101,29080284,1,314,75,22132536,21971040,161496,464.4077871897756
1747352644701074,29172844,1,315,75,22226509,22063600,162909,460.3797211940408
1747352644792201,29265404,1,316,75,22317636,22156160,161476,464.4653075379623
1747352644886270,29357964,1,317,75,22411705,22248720,162985,460.1650458631163
1747352644980428,29450524,1,318,75,22505863,22341280,164583,455.6971254625325
1747352645074308,29543084,1,319,75,22599743,22433840,165903,452.0713911140848
1747352645168238,29635644,1,320,75,22693673,22526400,167273,448.3688341812486
1747352645259074,29728204,1,321,75,22784509,22618960,165549,453.03807331968176
1747352645352674,29820764,1,322,75,22878109,22711520,166589,450.2097977657589
1747352645447015,29913324,1,323,75,22972450,22804080,168370,445.44752628140407
1747352645541540,30005884,1,324,75,23066975,22896640,170335,440.3088032406728
1747352645631228,30098452,1,325,75,23156663,22989208,167455,447.881520408468
1747352645725295,30191004,1,326,75,23250730,23081760,168970,443.8657749896431
1747352645819255,30283564,1,327,75,23344690,23174320,170370,440.2183483007572
1747352645914353,30376124,1,328,75,23439788,23266880,172908,433.7566798528697
1747352646004468,30468684,1,329,75,23529903,23359440,170463,439.9781770824167
1747352646098432,30561244,1,330,75,23623867,23452000,171867,436.38394805285486
1747352646192231,30653804,1,331,75,23717666,23544560,173106,433.26054556167895
1747352646286909,30746364,1,332,75,23812344,23637120,175224,428.0235584166553
1747352646377147,30838924,1,333,75,23902582,23729680,172902,433.7717319637714
1747352646470737,30931484,1,334,75,23996172,23822240,173932,431.2029988731228
1747352646564725,31024044,1,335,75,24090160,23914800,175360,427.69160583941607
1747352646659834,31116604,1,336,75,24185269,24007360,177909,421.56383319562246
1747352646753201,31209164,1,337,75,24278636,24099920,178716,419.6602430672128
1747352646843847,31301724,1,338,75,24369282,24192480,176802,424.2033461159942
1747352646937421,31394284,1,339,75,24462856,24285040,177816,421.78431637198
1747352647031736,31486844,1,340,75,24557171,24377600,179571,417.6620946589371
1747352647126170,31579404,1,341,75,24651605,24470160,181445,413.3483975860454
1747352647216756,31671964,1,342,75,24742191,24562720,179471,417.89481308958
1747352647310618,31764524,1,343,75,24836053,24655280,180773,414.8849662283638
1747352647405132,31857084,1,344,75,24930567,24747840,182727,410.448373803543
1747352647498761,31949644,1,345,75,25024196,24840400,183796,408.06111123201816
1747352647589475,32042204,1,346,75,25114910,24932960,181950,412.2011541632317
1747352647682907,32134764,1,347,75,25208342,25025520,182822,410.2350920567546
1747352647777203,32227324,1,348,75,25302638,25118080,184558,406.3763153046739
1747352647871725,32319884,1,349,75,25397160,25210640,186520,402.101651297448
1747352647961239,32412444,1,350,75,25486674,25303200,183474,408.7772654436051
1747352648056295,32505004,1,351,75,25581730,25395760,185970,403.2908533634457
1747352648150179,32597564,1,352,75,25675614,25488320,187294,400.4399500250943
1747352648244660,32690124,1,353,75,25770095,25580880,189215,396.37449462251936
1747352648338160,32782684,1,354,75,25863595,25673440,190155,394.4150824327522
1747352648428526,32875244,1,355,75,25953961,25766000,187961,399.01894541952856
1747352648522458,32967804,1,356,75,26047893,25858560,189333,396.1274579708767
1747352648617388,33060364,1,357,75,26142823,25951120,191703,391.2301841911707
1747352648710869,33152924,1,358,75,26236304,26043680,192624,389.35958136057815
1747352648801533,33245484,1,359,75,26326968,26136240,190728,393.230149742041
1747352648895312,33338044,1,360,75,26420747,26228800,191947,390.7328585494954
1747352648990048,33430604,1,361,75,26515483,26321360,194123,386.35298238745537
1747352649084248,33523164,1,362,75,26609683,26413920,195763,383.1163192227336
1747352649174038,33615724,1,363,75,26699473,26506480,192993,388.6151311187453
1747352649268294,33708284,1,364,75,26793729,26599040,194689,385.2297767208214
1747352649362297,33800844,1,365,75,26887732,26691600,196132,382.3955295413293
1747352649456142,33893412,1,366,75,26981577,26784168,197409,379.9218880598149
1747352649546665,33985964,1,367,75,27072100,26876720,195380,383.86733544886886
1747352649641160,34078524,1,368,75,27166595,26969280,197315,380.10288117983936
1747352649735628,34171084,1,369,75,27261063,27061840,199223,376.46255703407735
1747352649829780,34263644,1,370,75,27355215,27154400,200815,373.47807683688967
1747352649923924,34356204,1,371,75,27449359,27246960,202399,370.5551904900716
1747352650013249,34448764,1,372,75,27538684,27339520,199164,376.5740796529493
1747352650108385,34541324,1,373,75,27633820,27432080,201740,371.7656389412115
1747352650201789,34633884,1,374,75,27727224,27524640,202584,370.2167989574695
1747352650296543,34726444,1,375,75,27821978,27617200,204778,366.250280791882
1747352650386274,34819004,1,376,75,27911709,27709760,201949,371.3808931958069
1747352650480397,34911564,1,377,75,28005832,27802320,203512,368.52863713196274
1747352650575014,35004124,1,378,75,28100449,27894880,205569,364.8410022912015
1747352650668713,35096684,1,379,75,28194148,27987440,206708,362.8306596745167
1747352650759357,35189244,1,380,75,28284792,28080000,204792,366.2252431735615
1747352650852867,35281804,1,381,75,28378302,28172560,205742,364.5342224728057
1747352650947882,35374364,1,382,75,28473317,28265120,208197,360.23573826712203
1747352651041663,35466924,1,383,75,28567098,28357680,209418,358.13540383348135
1747352651136212,35559484,1,384,75,28661647,28450240,211407,354.7659254423931
1747352651226358,35652044,1,385,75,28751793,28542800,208993,358.8636939993205
1747352651319861,35744604,1,386,75,28845296,28635360,209936,357.25173386174833
1747352651414303,35837164,1,387,75,28939738,28727920,211818,354.0775571481177
1747352651509008,35929724,1,388,75,29034443,28820480,213963,350.5278950098849
1747352651598472,36022292,1,389,75,29123907,28913048,210859,355.6879241578496
1747352651693477,36114844,1,390,75,29218912,29005600,213312,351.5976597659766
1747352651787114,36207404,1,391,75,29312549,29098160,214389,349.8313812742258
1747352651881675,36299964,1,392,75,29407110,29190720,216390,346.5964231249134
1747352651971924,36392524,1,393,75,29497359,29283280,214079,350.3379593514544
1747352652065900,36485084,1,394,75,29591335,29375840,215495,348.0359173066661
1747352652159897,36577644,1,395,75,29685332,29468400,216932,345.73045931443954
1747352652254024,36670204,1,396,75,29779459,29560960,218499,343.2509988604067
1747352652344578,36762764,1,397,75,29870013,29653520,216493,346.431524344898
1747352652438158,36855324,1,398,75,29963593,29746080,217513,344.806977054245
1747352652533692,36947884,1,399,75,30059127,29838640,220487,340.1561089769465
1747352652626277,37040444,1,400,75,30151712,29931200,220512,340.11754462342185
1747352652721005,37133004,1,401,75,30246440,30023760,222680,336.8061792707024
1747352652811113,37225564,1,402,75,30336548,30116320,220228,340.55615089816007
1747352652905785,37318124,1,403,75,30431220,30208880,222340,337.3212197535306
1747352652999727,37410684,1,404,75,30525162,30301440,223722,335.2374822324134
1747352653093723,37503244,1,405,75,30619158,30394000,225158,333.09942351593105
1747352653183399,37595804,1,406,75,30708834,30486560,222274,337.42138081826937
1747352653277665,37688364,1,407,75,30803100,30579120,223980,334.851326011251
1747352653372606,37780924,1,408,75,30898041,30671680,226361,331.32916005849063
1747352653466479,37873484,1,409,75,30991914,30764240,227674,329.41837891019617
1747352653556234,37966044,1,410,75,31081669,30856800,224869,333.52752046747213
1747352653650802,38058604,1,411,75,31176237,30949360,226877,330.5755982316409
1747352653745315,38151164,1,412,75,31270750,31041920,228830,327.7542280295416
1747352653839401,38243724,1,413,75,31364836,31134480,230356,325.5830106443939
1747352653929314,38336284,1,414,75,31454749,31227040,227709,329.3677456754015
1747352654023539,38428844,1,415,75,31548974,31319600,229374,326.97690235161787
1747352654117932,38521404,1,416,75,31643367,31412160,231207,324.3846423334934
1747352654211664,38613964,1,417,75,31737099,31504720,232379,322.7486132567917
1747352654306222,38706524,1,418,75,31831657,31597280,234377,319.99726935663483
1747352654395714,38799084,1,419,75,31921149,31689840,231309,324.2415989001725
1747352654490783,38891644,1,420,75,32016218,31782400,233818,320.76230230350103
1747352654584151,38984204,1,421,75,32109586,31874960,234626,319.65766794813874
1747352654678252,39076764,1,422,75,32203687,31967520,236167,317.57188768964335
1747352654769264,39169324,1,423,75,32294699,32060080,234619,319.66720512831444
1747352654862994,39261884,1,424,75,32388429,32152640,235789,318.0809961448583
1747352654957521,39354444,1,425,75,32482956,32245200,237756,315.44945237975065
1747352655052032,39447004,1,426,75,32577467,32337760,239707,312.8819767466115
1747352655141134,39539564,1,427,75,32666569,32430320,236249,317.4616612133808
1747352655235335,39632124,1,428,75,32760770,32522880,237890,315.2717642607928
1747352655330351,39724684,1,429,75,32855786,32615440,240346,312.05012773251894
1747352655423416,39817252,1,430,75,32948851,32708008,240843,311.4061857724742
1747352655514693,39909804,1,431,75,33040128,32800560,239568,313.0635143257864
1747352655608469,40002364,1,432,75,33133904,32893120,240784,311.4824905309323
1747352655702742,40094924,1,433,75,33228177,32985680,242497,309.2821766867219
1747352655797073,40187484,1,434,75,33322508,33078240,244268,307.03980873466844
1747352655891255,40280044,1,435,75,33416690,33170800,245890,305.0144373500346
1747352655981602,40372604,1,436,75,33507037,33263360,243677,307.78448519967003
1747352656075485,40465164,1,437,75,33600920,33355920,245000,306.12244897959187
1747352656170004,40557724,1,438,75,33695439,33448480,246959,303.69413546378144
1747352656263542,40650284,1,439,75,33788977,33541040,247937,302.4961986311039
1747352656353423,40742844,1,440,75,33878858,33633600,245258,305.80042241231683
1747352656452412,40835404,1,441,75,33977847,33726160,251687,297.9891690870009
1747352656542590,40927964,1,442,75,34068025,33818720,249305,300.836324983454
1747352656636116,41020524,1,443,75,34161551,33911280,250271,299.6751521350856
1747352656726446,41113084,1,444,75,34251881,34003840,248041,302.36936635475587
1747352656820517,41205644,1,445,75,34345952,34096400,249552,300.53856510867473
1747352656915268,41298204,1,446,75,34440703,34188960,251743,297.9228816690037
1747352657009415,41390764,1,447,75,34534850,34281520,253330,296.0565270595666
1747352657099219,41483324,1,448,75,34624654,34374080,250574,299.3127778620288
1747352657193762,41575884,1,449,75,34719197,34466640,252557,296.9626658536489
1747352657288071,41668444,1,450,75,34813506,34559200,254306,294.9202928755122
1747352657382090,41761004,1,451,75,34907525,34651760,255765,293.2379332590464
1747352657476190,41853564,1,452,75,35001625,34744320,257305,291.4828705233089
1747352657566190,41946132,1,453,75,35091625,34836888,254737,294.4213051107613
1747352657660808,42038684,1,454,75,35186243,34929440,256803,292.05266293618064
1747352657754325,42131244,1,455,75,35279760,35022000,257760,290.9683426443204
1747352657848953,42223804,1,456,75,35374388,35114560,259828,288.6524931878012
1747352657939068,42316364,1,457,75,35464503,35207120,257383,291.3945365467028
1747352658032942,42408924,1,458,75,35558377,35299680,258697,289.91445590787674
1747352658127648,42501484,1,459,75,35653083,35392240,260843,287.52928006502
1747352658221529,42594044,1,460,75,35746964,35484800,262164,286.08046871423994
1747352658311753,42686604,1,461,75,35837188,35577360,259828,288.6524931878012
1747352658405479,42779164,1,462,75,35930914,35669920,260994,287.3629278833996
1747352658499826,42871724,1,463,75,36025261,35762480,262781,285.40876242955164
1747352658594304,42964284,1,464,75,36119739,35855040,264699,283.3407001915383
1747352658684556,43056844,1,465,75,36209991,35947600,262391,285.83297445415434
1747352658778349,43149404,1,466,75,36303784,36040160,263624,284.49610050678234
1747352658872268,43241964,1,467,75,36397703,36132720,264983,283.03702501669915
1747352658966643,43334524,1,468,75,36492078,36225280,266798,281.11155256036403
1747352659061179,43427084,1,469,75,36586614,36317840,268774,279.0448480879847
1747352659151392,43519644,1,470,75,36676827,36410400,266427,281.50300082198873
1747352659245658,43612204,1,471,75,36771093,36502960,268133,279.7119340029016
1747352659340085,43704764,1,472,75,36865520,36595520,270000,277.77777777777777
1747352659434091,43797324,1,473,75,36959526,36688080,271446,276.29804823058726
1747352659523371,43889884,1,474,75,37048806,36780640,268166,279.67751318213345
1747352659617706,43982444,1,475,75,37143141,36873200,269941,277.83849063313835
1747352659712688,44075004,1,476,75,37238123,36965760,272363,275.36779959098703
1747352659806526,44167564,1,477,75,37331961,37058320,273641,274.08173482774873
1747352659896836,44260124,1,478,75,37422271,37150880,271391,276.35404269117254
1747352659991127,44352684,1,479,75,37516562,37243440,273122,274.6025585635724
1747352660084761,44445244,1,480,75,37610196,37336000,274196,273.5269661118324
1747352660178930,44537804,1,481,75,37704365,37428560,275805,271.93125577853914
1747352660268729,44630364,1,482,75,37794164,37521120,273044,274.6810037942603
1747352660363794,44722924,1,483,75,37889229,37613680,275549,272.18389469749485
1747352660460454,44815484,1,484,75,37985889,37706240,279649,268.1933423684691
1747352660552239,44908044,1,485,75,38077674,37798800,278874,268.9386604703199
1747352660646309,45000604,1,486,75,38171744,37891360,280384,267.4902990184889
1747352660735819,45093164,1,487,75,38261254,37983920,277334,270.4320422306677
1747352660830386,45185724,1,488,75,38355821,38076480,279341,268.4890510164996
1747352660924584,45278284,1,489,75,38450019,38169040,280979,266.92386263742134
1747352661019246,45370844,1,490,75,38544681,38261600,283081,264.9418364355078
1747352661109372,45463404,1,491,75,38634807,38354160,280647,267.2396284300207
1747352661203567,45555964,1,492,75,38729002,38446720,282282,265.6917550534572
1747352661296894,45648524,1,493,75,38822329,38539280,283049,264.97178933682864
1747352661391950,45741092,1,494,75,38917385,38631848,285537,262.66298238056714
1747352661481441,45833644,1,495,75,39006876,38724400,282476,265.50928220450584
1747352661575388,45926204,1,496,75,39100823,38816960,283863,264.2119614039167
1747352661670335,46018764,1,497,75,39195770,38909520,286250,262.0087336244541
1747352661763693,46111324,1,498,75,39289128,39002080,287048,261.2803433572085
1747352661854236,46203884,1,499,75,39379671,39094640,285031,263.12927365795304
1747352661948569,46296444,1,500,75,39474004,39187200,286804,261.5026289730966
1747352662042693,46389004,1,501,75,39568128,39279760,288368,260.0843366809077
1747352662136953,46481564,1,502,75,39662388,39372320,290068,258.5600617786174
1747352662231028,46574124,1,503,75,39756463,39464880,291583,257.2166415737543
1747352662321831,46666684,1,504,75,39847266,39557440,289826,258.77595522830944
1747352662415760,46759244,1,505,75,39941195,39650000,291195,257.5593674341936
1747352662509266,46851804,1,506,75,40034701,39742560,292141,256.72534837629775
1747352662603448,46944364,1,507,75,40128883,39835120,293763,255.30785020577807
1747352662693749,47036924,1,508,75,40219184,39927680,291504,257.28634941544544
1747352662787894,47129484,1,509,75,40313329,40020240,293089,255.8949670577879
1747352662882044,47222044,1,510,75,40407479,40112800,294679,254.51423413273423
1747352662977005,47314604,1,511,75,40502440,40205360,297080,252.45725057223643
1747352663066228,47407164,1,512,75,40591663,40297920,293743,255.32523328215484
1747352663161175,47499724,1,513,75,40686610,40390480,296130,253.2671461857968
1747352663254734,47592284,1,514,75,40780169,40483040,297129,252.41561745908345
1747352663349424,47684844,1,515,75,40874859,40575600,299259,250.61902900163403
1747352663443919,47777404,1,516,75,40969354,40668160,301194,249.0089444012829
1747352663533434,47869972,1,517,75,41058869,40760728,298141,251.55882619297583
1747352663627431,47962524,1,518,75,41152866,40853280,299586,250.34547675792592
1747352663722015,48055084,1,519,75,41247450,40945840,301610,248.6654951758894
1747352663816053,48147644,1,520,75,41341488,41038400,303088,247.45288497070155
1747352663906325,48240204,1,521,75,41431760,41130960,300800,249.33510638297872
1747352664000929,48332764,1,522,75,41526364,41223520,302844,247.6522566073622
1747352664095110,48425324,1,523,75,41620545,41316080,304465,246.333732941389
1747352664189034,48517884,1,524,75,41714469,41408640,305829,245.23508234994063
1747352664279248,48610444,1,525,75,41804683,41501200,303483,247.1308112810273
1747352664373885,48703004,1,526,75,41899320,41593760,305560,245.4509752585417
1747352664467096,48795564,1,527,75,41992531,41686320,306211,244.92915016116336
1747352664561907,48888124,1,528,75,42087342,41778880,308462,243.14178083524064
1747352664652115,48980684,1,529,75,42177550,41871440,306110,245.00996373852536
1747352664751033,49073244,1,530,75,42276468,41964000,312468,240.0245785168401
1747352664840392,49165804,1,531,75,42365827,42056560,309267,242.5089000766328
1747352664934393,49258364,1,532,75,42459828,42149120,310708,241.3841935193172
1747352665028323,49350924,1,533,75,42553758,42241680,312078,240.3245342510526
1747352665119027,49443484,1,534,75,42644462,42334240,310222,241.76235083262955
1747352665212984,49536044,1,535,75,42738419,42426800,311619,240.67852088608203
1747352665306936,49628604,1,536,75,42832371,42519360,313011,239.60819268332423
1747352665400993,49721164,1,537,75,42926428,42611920,314508,238.46770193445
1747352665491468,49813724,1,538,75,43016903,42704480,312423,240.0591505747016
1747352665585296,49906284,1,539,75,43110731,42797040,313691,239.08878482328151
1747352665679727,49998844,1,540,75,43205162,42889600,315562,237.67120248952665
1747352665774196,50091404,1,541,75,43299631,42982160,317471,236.2420504550022
1747352665863714,50183964,1,542,75,43389149,43074720,314429,238.5276167274647
1747352665958764,50276524,1,543,75,43484199,43167280,316919,236.65352976628097
1747352666052532,50369084,1,544,75,43577967,43259840,318127,235.754902916131
1747352666146643,50461644,1,545,75,43672078,43352400,319678,234.61107739663035
1747352666236688,50554204,1,546,75,43762123,43444960,317163,236.47146735274924
1747352666330672,50646764,1,547,75,43856107,43537520,318587,235.4145021611052
1747352666425691,50739324,1,548,75,43951126,43630080,321046,233.61138279249704
1747352666519403,50831884,1,549,75,44044838,43722640,322198,232.77611903239625
1747352666613026,50924444,1,550,75,44138461,43815200,323261,232.01066630369888
1747352666704114,51017004,1,551,75,44229549,43907760,321789,233.07198195090567
1747352666798158,51109564,1,552,75,44323593,44000320,323273,232.002053991518
1747352666892490,51202124,1,553,75,44417925,44092880,325045,230.73728253011123
1747352666986257,51294684,1,554,75,44511692,44185440,326252,229.8836482228461
1747352667076481,51387244,1,555,75,44601916,44278000,323916,231.54151076204943
1747352667170358,51479804,1,556,75,44695793,44370560,325233,230.6039055077437
1747352667264949,51572364,1,557,75,44790384,44463120,327264,229.17277794074508
1747352667359409,51664932,1,558,75,44884844,44555688,329156,227.8554849372334
1747352667449352,51757484,1,559,75,44974787,44648240,326547,229.6759731370982
1747352667543759,51850044,1,560,75,45069194,44740800,328394,228.3841970316145
1747352667636955,51942604,1,561,75,45162390,44833360,329030,227.9427407835152
1747352667731946,52035164,1,562,75,45257381,44925920,331461,226.27096400481503
1747352667821468,52127724,1,563,75,45346903,45018480,328423,228.36403053379328
1747352667915793,52220284,1,564,75,45441228,45111040,330188,227.1433244091245
1747352668010370,52312844,1,565,75,45535805,45203600,332205,225.7642118571364
1747352668104153,52405404,1,566,75,45629588,45296160,333428,224.93611814244755
1747352668198173,52497964,1,567,75,45723608,45388720,334888,223.9554716800841
1747352668289143,52590524,1,568,75,45814578,45481280,333298,225.023852528368
1747352668382924,52683084,1,569,75,45908359,45573840,334519,224.20251166600403
1747352668476821,52775644,1,570,75,46002256,45666400,335856,223.30998999571244
1747352668571245,52868204,1,571,75,46096680,45758960,337720,222.07746061826364
1747352668661886,52960764,1,572,75,46187321,45851520,335801,223.3465653765176
1747352668756042,53053324,1,573,75,46281477,45944080,337397,222.29006185591453
1747352668849425,53145884,1,574,75,46374860,46036640,338220,221.74915735320204
1747352668944260,53238444,1,575,75,46469695,46129200,340495,220.26755165274088
1747352669033588,53331004,1,576,75,46559023,46221760,337263,222.3783812632871
1747352669128409,53423564,1,577,75,46653844,46314320,339524,220.8974917826133
1747352669222160,53516124,1,578,75,46747595,46406880,340715,220.12532468485392
1747352669316464,53608684,1,579,75,46841899,46499440,342459,219.00431876516603
1747352669406948,53701244,1,580,75,46932383,46592000,340383,220.34002873233976
1747352669501229,53793812,1,581,75,47026664,46684568,342096,219.2367054861793
1747352669595194,53886364,1,582,75,47120629,46777120,343509,218.33489078888763
1747352669689218,53978924,1,583,75,47214653,46869680,344973,217.40831891191488
1747352669783033,54071484,1,584,75,47308468,46962240,346228,216.62026179280707
1747352669873255,54164044,1,585,75,47398690,47054800,343890,218.0929948530053
1747352669967904,54256604,1,586,75,47493339,47147360,345979,216.7761627150781
1747352670061615,54349164,1,587,75,47587050,47239920,347130,216.0573848414139
1747352670156118,54441724,1,588,75,47681553,47332480,349073,214.8547724974432
1747352670246338,54534284,1,589,75,47771773,47425040,346733,216.3047647613581
1747352670340257,54626844,1,590,75,47865692,47517600,348092,215.46028061546943
1747352670435264,54719404,1,591,75,47960699,47610160,350539,213.95622170428967
1747352670529397,54811964,1,592,75,48054832,47702720,352112,213.0004089607852
1747352670619744,54904524,1,593,75,48145179,47795280,349899,214.34756886987387
1747352670713641,54997084,1,594,75,48239076,47887840,351236,213.5316425423362
1747352670807627,55089644,1,595,75,48333062,47980400,352662,212.6682205624649
1747352670901178,55182204,1,596,75,48426613,48072960,353653,212.0722855454358
1747352670992363,55274764,1,597,75,48517798,48165520,352278,212.9000391736072
1747352671085698,55367324,1,598,75,48611133,48258080,353053,212.4326942413745
1747352671180033,55459884,1,599,75,48705468,48350640,354828,211.3700158950252
1747352671273979,55552444,1,600,75,48799414,48443200,356214,210.54759217773588
1747352671368264,55645004,1,601,75,48893699,48535760,357939,209.53290923872504
1747352671458778,55737564,1,602,75,48984213,48628320,355893,210.7374969443063
1747352671552648,55830124,1,603,75,49078083,48720880,357203,209.9646419542949
1747352671647271,55922684,1,604,75,49172706,48813440,359266,208.75896967706385
1747352671741510,56015244,1,605,75,49266945,48906000,360945,207.7878901217637
1747352671831255,56107804,1,606,75,49356690,48998560,358130,209.4211599139977
1747352671925495,56200364,1,607,75,49450930,49091120,359810,208.44334509880213
1747352672020480,56292924,1,608,75,49545915,49183680,362235,207.0479108865792
1747352672113736,56385484,1,609,75,49639171,49276240,362931,206.65085098820435
1747352672204391,56478044,1,610,75,49729826,49368800,361026,207.74127071180467
1747352672298915,56570604,1,611,75,49824350,49461360,362990,206.61726218353124
1747352672393151,56663164,1,612,75,49918586,49553920,364666,205.6676520432396
1747352672486482,56755724,1,613,75,50011917,49646480,365437,205.23373385836683
1747352672577451,56848284,1,614,75,50102886,49739040,363846,206.1311653831566
1747352672671605,56940844,1,615,75,50197040,49831600,365440,205.2320490367776
1747352672765526,57033404,1,616,75,50290961,49924160,366801,204.4705439734352
1747352672859733,57125964,1,617,75,50385168,50016720,368448,203.5565398645128
1747352672953429,57218524,1,618,75,50478864,50109280,369584,202.9308628079137
1747352673044219,57311084,1,619,75,50569654,50201840,367814,203.9074097233928
1747352673138583,57403644,1,620,75,50664018,50294400,369618,202.91219583461844
1747352673232226,57496204,1,621,75,50757661,50386960,370701,202.3193894810103
1747352673326578,57588772,1,622,75,50852013,50479528,372485,201.3503899485885
1747352673416950,57681324,1,623,75,50942385,50572080,370305,202.53574755944425
1747352673510398,57773884,1,624,75,51035833,50664640,371193,202.0512240263152
1747352673605341,57866444,1,625,75,51130776,50757200,373576,200.76236160781207
1747352673698816,57959004,1,626,75,51224251,50849760,374491,200.2718356382396
1747352673789078,58051564,1,627,75,51314513,50942320,372193,201.5083572232685
1747352673883798,58144124,1,628,75,51409233,51034880,374353,200.34566305065005
1747352673978012,58236684,1,629,75,51503447,51127440,376007,199.4643716739316
1747352674071833,58329244,1,630,75,51597268,51220000,377268,198.79767168166927
1747352674166204,58421804,1,631,75,51691639,51312560,379079,197.84794198570748
1747352674256530,58514364,1,632,75,51781965,51405120,376845,199.0208175775186
1747352674350471,58606924,1,633,75,51875906,51497680,378226,198.29414159788064
1747352674444622,58699484,1,634,75,51970057,51590240,379817,197.4635153244852
1747352674538784,58792044,1,635,75,52064219,51682800,381419,196.63414774827683
1747352674628374,58884604,1,636,75,52153809,51775360,378449,198.17729733728984
1747352674723504,58977164,1,637,75,52248939,51867920,381019,196.840577504009
1747352674817714,59069724,1,638,75,52343149,51960480,382669,195.99183628671256
1747352674910980,59162284,1,639,75,52436415,52053040,383375,195.63090968373
1747352675001748,59254844,1,640,75,52527183,52145600,381583,196.5496366452384
1747352675095745,59347404,1,641,75,52621180,52238160,383020,195.8122291264164
1747352675189818,59439964,1,642,75,52715253,52330720,384533,195.04177794883665
1747352675284345,59532524,1,643,75,52809780,52423280,386500,194.0491591203105
1747352675374597,59625084,1,644,75,52900032,52515840,384192,195.2148925537232
1747352675468298,59717652,1,645,75,52993733,52608408,385325,194.6408875624473
1747352675562919,59810204,1,646,75,53088354,52700960,387394,193.60134643283064
1747352675656964,59902764,1,647,75,53182399,52793520,388879,192.8620470634825
1747352675751218,59995324,1,648,75,53276653,52886080,390573,192.0255624428724
1747352675841588,60087884,1,649,75,53367023,52978640,388383,193.10834923258744
1747352675935247,60180444,1,650,75,53460682,53071200,389482,192.56345607755944
1747352676029546,60273004,1,651,75,53554981,53163760,391221,191.70750036424425
1747352676123490,60365564,1,652,75,53648925,53256320,392605,191.03169852650885
1747352676213582,60458124,1,653,75,53739017,53348880,390137,192.24016178932013
1747352676308547,60550684,1,654,75,53833982,53441440,392542,191.0623576585436
1747352676402151,60643244,1,655,75,53927586,53534000,393586,190.5555583786009
1747352676498835,60735804,1,656,75,54024270,53626560,397710,188.57961831485247
1747352676586267,60828364,1,657,75,54111702,53719120,392582,191.04289040251464
1747352676680474,60920924,1,658,75,54205909,53811680,394229,190.24475622036937
1747352676774808,61013484,1,659,75,54300243,53904240,396003,189.39250460223784
1747352676869181,61106044,1,660,75,54394616,53996800,397816,188.52937036217747
1747352676959435,61198604,1,661,75,54484870,54089360,395510,189.6285808197012
1747352677053263,61291164,1,662,75,54578698,54181920,396778,189.0225768565797
1747352677147368,61383724,1,663,75,54672803,54274480,398323,188.2894033234335
1747352677241675,61476284,1,664,75,54767110,54367040,400070,187.4671932411828
1747352677335723,61568844,1,665,75,54861158,54459600,401558,186.77252103058584
1747352677425960,61661404,1,666,75,54951395,54552160,399235,187.8592808746728
1747352677520468,61753964,1,667,75,55045903,54644720,401183,186.94710394009715
1747352677614479,61846524,1,668,75,55139914,54737280,402634,186.2733897286369
1747352677708460,61939084,1,669,75,55233895,54829840,404055,185.61829453910977
1747352677798913,62031644,1,670,75,55324348,54922400,401948,186.5913003672117
1747352677892933,62124204,1,671,75,55418368,55014960,403408,185.91599571649547
1747352677986761,62216764,1,672,75,55512196,55107520,404676,185.3334519467426
1747352678081166,62309324,1,673,75,55606601,55200080,406521,184.49231405019663
1747352678171380,62401884,1,674,75,55696815,55292640,404175,185.563184264242
1747352678266229,62494444,1,675,75,55791664,55385200,406464,184.51818611242325
1747352678360068,62587004,1,676,75,55885503,55477760,407743,183.9393931962045
1747352678453993,62679564,1,677,75,55979428,55570320,409108,183.32567439404752
1747352678544804,62772124,1,678,75,56070239,55662880,407359,184.1127850372767
1747352678638397,62864684,1,679,75,56163832,55755440,408392,183.6470841740289
1747352678732528,62957244,1,680,75,56257963,55848000,409963,182.9433387891102
1747352678826732,63049804,1,681,75,56352167,55940560,411607,182.21264458573347
1747352678920820,63142364,1,682,75,56446255,56033120,413135,181.5387222094473
1747352679011509,63234924,1,683,75,56536944,56125680,411264,182.3646125116713
1747352679105314,63327484,1,684,75,56630749,56218240,412509,181.81421496258264
1747352679199442,63420044,1,685,75,56724877,56310800,414077,181.12573265358856
1747352679293712,63512612,1,686,75,56819147,56403368,415779,180.3842906928921
1747352679383548,63605164,1,687,75,56908983,56495920,413063,181.5703657795542
1747352679477957,63697724,1,688,75,57003392,56588480,414912,180.76122165664043
1747352679572465,63790284,1,689,75,57097900,56681040,416860,179.91651873530682
1747352679666581,63882844,1,690,75,57192016,56773600,418416,179.24744751634736
1747352679757131,63975404,1,691,75,57282566,56866160,416406,180.11267849166438
1747352679850887,64067964,1,692,75,57376322,56958720,417602,179.59684101129784
1747352679944865,64160524,1,693,75,57470300,57051280,419020,178.98906973414157
1747352680038790,64253084,1,694,75,57564225,57143840,420385,178.40788800742178
1747352680129776,64345644,1,695,75,57655211,57236400,418811,179.0783909687186
1747352680223776,64438204,1,696,75,57749211,57328960,420251,178.46477462278497
1747352680317339,64530764,1,697,75,57842774,57421520,421254,178.0398524405703
1747352680411931,64623324,1,698,75,57937366,57514080,423286,177.1851655854434
1747352680506421,64715884,1,699,75,58031856,57606640,425216,176.38094521372668
1747352680596589,64808444,1,700,75,58122024,57699200,422824,177.37876752502223
1747352680690931,64901004,1,701,75,58216366,57791760,424606,176.63433865748482
1747352680784888,64993564,1,702,75,58310323,57884320,426003,176.05509820353376
1747352680878657,65086124,1,703,75,58404092,57976880,427212,175.55686638015786
1747352680968925,65178684,1,704,75,58494360,58069440,424920,176.50381248234962
1747352681062881,65271244,1,705,75,58588316,58162000,426316,175.92583904896838
1747352681157070,65363804,1,706,75,58682505,58254560,427945,175.25616609611046
1747352681251867,65456364,1,707,75,58777302,58347120,430182,174.3448121957683
1747352681341963,65548924,1,708,75,58867398,58439680,427718,175.34917866444715
1747352681436199,65641492,1,709,75,58961634,58532248,429386,174.668014327435
1747352681529643,65734044,1,710,75,59055078,58624800,430278,174.30591385104515
1747352681624623,65826604,1,711,75,59150058,58717360,432698,173.3310530670352
1747352681714374,65919164,1,712,75,59239809,58809920,429889,174.46364061420505
1747352681808130,66011724,1,713,75,59333565,58902480,431085,173.97960958975608
1747352681902726,66104284,1,714,75,59428161,58995040,433121,173.16177234537233
1747352681996938,66196844,1,715,75,59522373,59087600,434773,172.5038123342526
1747352682091095,66289404,1,716,75,59616530,59180160,436370,171.87249352613608
1747352682181019,66381964,1,717,75,59706454,59272720,433734,172.9170413202562
1747352682275348,66474524,1,718,75,59800783,59365280,435503,172.21465753393204
1747352682369756,66567084,1,719,75,59895191,59457840,437351,171.48697499262607
1747352682463826,66659644,1,720,75,59989261,59550400,438861,170.89693547615303
1747352682554563,66752204,1,721,75,60079998,59642960,437038,171.6097913682563
1747352682648525,66844764,1,722,75,60173960,59735520,438440,171.06103457713712
1747352682742915,66937324,1,723,75,60268350,59828080,440270,170.35001249233426
1747352682836516,67029884,1,724,75,60361951,59920640,441311,169.94817713585203
1747352682926524,67122444,1,725,75,60451959,60013200,438759,170.93666454705203
1747352683021041,67215004,1,726,75,60546476,60105760,440716,170.17762005463837
1747352683306981,67498924,1,729,75,60832416,60389680,442736,169.40117812872683
1747352683401494,67591484,1,730,75,60926929,60482240,444689,168.65719637769317
1747352683495503,67684044,1,731,75,61020938,60574800,446138,168.1094190586769
1747352683586734,67776604,1,732,75,61112169,60667360,444809,168.6116962561459
1747352683679818,67869164,1,733,75,61205253,60759920,445333,168.41329971055367
1747352683775067,67961724,1,734,75,61300502,60852480,448022,167.40249362754508
1747352683868501,68054284,1,735,75,61393936,60945040,448896,167.0765611633875
1747352683958667,68146844,1,736,75,61484102,61037600,446502,167.97237190426918
1747352684053640,68239404,1,737,75,61579075,61130160,448915,167.06948976977824
1747352684147405,68331964,1,738,75,61672840,61222720,450120,166.6222340709144
1747352684241406,68424524,1,739,75,61766841,61315280,451561,166.0905171172887
1747352684331309,68517084,1,740,75,61856744,61407840,448904,167.07358366154008
1747352684426009,68609644,1,741,75,61951444,61500400,451044,166.2808949902892
1747352684519901,68702204,1,742,75,62045336,61592960,452376,165.79128866252853
1747352684614586,68794764,1,743,75,62140021,61685520,454501,165.01613857835298
1747352684704315,68887324,1,744,75,62229750,61778080,451670,166.05043505213982
1747352684802219,68979884,1,745,75,62327654,61870640,457014,164.10875815620528
1747352684892921,69072444,1,746,75,62418356,61963200,455156,164.77866929140777
1747352684987258,69165004,1,747,75,62512693,62055760,456933,164.1378495315506
1747352685081235,69257564,1,748,75,62606670,62148320,458350,163.6304134395113
1747352685171439,69350124,1,749,75,62696874,62240880,455994,164.47584836642588
1747352685269998,69442684,1,750,75,62795433,62333440,461993,162.34012203648106
1747352685359441,69535244,1,751,75,62884876,62426000,458876,163.44284730515434
1747352685453938,69627804,1,752,75,62979373,62518560,460813,162.75582503097786
1747352685543916,69720364,1,753,75,63069351,62611120,458231,163.67290733276448
1747352685637830,69812924,1,754,75,63163265,62703680,459585,163.1907046574627
1747352685732501,69905484,1,755,75,63257936,62796240,461696,162.44455225949542
1747352685826830,69998044,1,756,75,63352265,62888800,463465,161.82451749323033
1747352685916935,70090604,1,757,75,63442370,62981360,461010,162.6862757857747
1747352686010550,70183164,1,758,75,63535985,63073920,462065,162.3148258361919
1747352686104464,70275724,1,759,75,63629899,63166480,463419,161.84058055453056
1747352686199115,70368292,1,760,75,63724550,63259048,465502,161.11638618094014
1747352686293455,70460844,1,761,75,63818890,63351600,467290,160.4999037000578
1747352686383470,70553404,1,762,75,63908905,63444160,464745,161.3788206435787
1747352686477956,70645964,1,763,75,64003391,63536720,466671,160.7127933812043
1747352686571855,70738524,1,764,75,64097290,63629280,468010,160.25298604730668
1747352686665721,70831084,1,765,75,64191156,63721840,469316,159.80703832812006
1747352686755892,70923644,1,766,75,64281327,63814400,466927,160.62468008917884
1747352686850167,71016204,1,767,75,64375602,63906960,468642,160.03687249542295
1747352686944691,71108764,1,768,75,64470126,63999520,470606,159.36898382086076
1747352687039121,71201324,1,769,75,64564556,64092080,472476,158.7382216239555
1747352687129381,71293884,1,770,75,64654816,64184640,470176,159.51473490777923
1747352687223663,71386444,1,771,75,64749098,64277200,471898,158.9326506999394
1747352687317761,71479004,1,772,75,64843196,64369760,473436,158.41634349732593
1747352687411495,71571564,1,773,75,64936930,64462320,474610,158.02448325993976
1747352687501324,71664124,1,774,75,65026759,64554880,471879,158.93905005308565
1747352687596310,71756684,1,775,75,65121745,64647440,474305,158.12610029411456
1747352687690510,71849244,1,776,75,65215945,64740000,475945,157.58123312567628
1747352687784152,71941804,1,777,75,65309587,64832560,477027,157.22380494185865
1747352687878610,72034364,1,778,75,65404045,64925120,478925,156.60072036331368
1747352687968863,72126924,1,779,75,65494298,65017680,476618,157.358723338187
1747352688062414,72219484,1,780,75,65587849,65110240,477609,157.03221672958423
1747352688157139,72312044,1,781,75,65682574,65202800,479774,156.32360236277916
1747352688251165,72404604,1,782,75,65776600,65295360,481240,155.84739423156844
1747352688341196,72497172,1,783,75,65866631,65387928,478703,156.67334443276937
1747352688435216,72589724,1,784,75,65960651,65480480,480171,156.19435576076023
1747352688530093,72682284,1,785,75,66055528,65573040,482488,155.44428047951453
1747352688623759,72774844,1,786,75,66149194,65665600,483594,155.08877281355848
1747352688713633,72867404,1,787,75,66239068,65758160,480908,155.9549851530854
1747352688807968,72959964,1,788,75,66333403,65850720,482683,155.3814822564706
1747352688902853,73052524,1,789,75,66428288,65943280,485008,154.63662455052287
1747352688996893,73145084,1,790,75,66522328,66035840,486488,154.16618703852922
1747352689086462,73237644,1,791,75,66611897,66128400,483497,155.11988698999167
1747352689181154,73330204,1,792,75,66706589,66220960,485629,154.43888235669615
1747352689275566,73422764,1,793,75,66801001,66313520,487481,153.85215013508218
1747352689368901,73515324,1,794,75,66894336,66406080,488256,153.60794337396774
1747352689463420,73607884,1,795,75,66988855,66498640,490215,152.99409442795508
1747352689553651,73700444,1,796,75,67079086,66591200,487886,153.72443562635533
1747352689647239,73793004,1,797,75,67172674,66683760,488914,153.4012116650372
1747352689742240,73885564,1,798,75,67267675,66776320,491355,152.6391305675123
1747352689836326,73978124,1,799,75,67361761,66868880,492881,152.166547300464
1747352689926354,74070684,1,800,75,67451789,66961440,490349,152.95228500516978
1747352690019795,74163244,1,801,75,67545230,67054000,491230,152.67797162225435
1747352690114984,74255804,1,802,75,67640419,67146560,493859,151.86520849068256
1747352690208700,74348364,1,803,75,67734135,67239120,495015,151.51056028605194
1747352690299516,74440924,1,804,75,67824951,67331680,493271,152.04623827470093
1747352690393665,74533484,1,805,75,67919100,67424240,494860,151.55801640868123
1747352690487785,74626044,1,806,75,68013220,67516800,496420,151.08174529632169
1747352690581143,74718604,1,807,75,68106578,67609360,497218,150.83926969659183
1747352690672156,74811164,1,808,75,68197591,67701920,495671,151.3100423466372
1747352690765882,74903724,1,809,75,68291317,67794480,496837,150.95494095649076
1747352690860464,74996284,1,810,75,68385899,67887040,498859,150.3430829152125
1747352690954588,75088844,1,811,75,68480023,67979600,500423,149.87320726665243
1747352691048500,75181404,1,812,75,68573935,68072160,501775,149.46938368790794
1747352691138445,75273964,1,813,75,68663880,68164720,499160,150.2524240724417
1747352691233295,75366524,1,814,75,68758730,68257280,501450,149.56625785222857
1747352691326967,75459084,1,815,75,68852402,68349840,502562,149.23531822939262
1747352691421625,75551644,1,816,75,68947060,68442400,504660,148.61490904767567
1747352691511446,75644204,1,817,75,69036881,68534960,501921,149.4259056704143
1747352691605988,75736764,1,818,75,69131423,68627520,503903,148.83816925082803
1747352691699375,75829324,1,819,75,69224810,68720080,504730,148.59429794147366
1747352691793986,75921884,1,820,75,69319421,68812640,506781,147.9929200187063
1747352691884105,76014444,1,821,75,69409540,68905200,504340,148.7092041083396
1747352691978776,76107004,1,822,75,69504211,68997760,506451,148.08935119093456
1747352692072307,76199564,1,823,75,69597742,69090320,507422,147.8059682079216
1747352692166746,76292132,1,824,75,69692181,69182888,509293,147.26297043155904
1747352692256675,76384684,1,825,75,69782110,69275440,506670,148.0253419385399
1747352692350377,76477244,1,826,75,69875812,69368000,507812,147.6924531125692
1747352692445589,76569804,1,827,75,69971024,69460560,510464,146.92515045135406
1747352692539585,76662364,1,828,75,70065020,69553120,511900,146.51299081851923
1747352692633914,76754924,1,829,75,70159349,69645680,513669,146.00842176576745
1747352692723734,76847484,1,830,75,70249169,69738240,510929,146.79143286053446
1747352692818313,76940044,1,831,75,70343748,69830800,512948,146.21365128629023
1747352692912235,77032604,1,832,75,70437670,69923360,514310,145.82644708444323
1747352693006543,77125164,1,833,75,70531978,70015920,516058,145.33250138550318
1747352693096831,77217724,1,834,75,70622266,70108480,513786,145.97517254265395
1747352693190418,77310284,1,835,75,70715853,70201040,514813,145.6839667995952
1747352693284947,77402844,1,836,75,70810382,70293600,516782,145.12889380822088
1747352693378916,77495404,1,837,75,70904351,70386160,518191,144.73427751543352
1747352693468838,77587964,1,838,75,70994273,70478720,515553,145.4748590348616
1747352693563327,77680524,1,839,75,71088762,70571280,517482,144.9325773650098
1747352693657972,77773084,1,840,75,71183407,70663840,519567,144.35096917240702
1747352693751898,77865644,1,841,75,71277333,70756400,520933,143.97244943207667
1747352693841937,77958204,1,842,75,71367372,70848960,518412,144.67257702368002
1747352693935752,78050764,1,843,75,71461187,70941520,519667,144.32319158230175
1747352694030172,78143324,1,844,75,71555607,71034080,521527,143.80847012714588
1747352694124464,78235884,1,845,75,71649899,71126640,523259,143.33246059790656
1747352694218945,78328444,1,846,75,71744380,71219200,525180,142.8081800525534
1747352694309146,78421012,1,847,75,71834581,71311768,522813,143.45473429314114
1747352694403043,78513564,1,848,75,71928478,71404320,524158,143.08662655153597
1747352694497226,78606124,1,849,75,72022661,71496880,525781,142.64494152508362
1747352694591019,78698684,1,850,75,72116454,71589440,527014,142.3112099488818
1747352694689790,78791244,1,851,75,72215225,71682000,533225,140.65357025645835
1747352694779877,78886932,1,852,75,72305312,71777688,527624,142.14668021166588
1747352694874242,78979484,1,853,75,72399677,71870240,529437,141.65991421075594
1747352694964065,79072044,1,854,75,72489500,71962800,526700,142.39605088285552
1747352695058609,79164604,1,855,75,72584044,72055360,528684,141.86167918832422
1747352695152105,79257164,1,856,75,72677540,72147920,529620,141.6109663532344
1747352695246534,79349724,1,857,75,72771969,72240480,531489,141.11298634590744
1747352695336688,79442284,1,858,75,72862123,72333040,529083,141.75469633308953
1747352695431284,79534844,1,859,75,72956719,72425600,531119,141.2112916314423
1747352695524775,79627404,1,860,75,73050210,72518160,532050,140.964195094446
1747352695619230,79719964,1,861,75,73144665,72610720,533945,140.46390545842738
1747352695713589,79812524,1,862,75,73239024,72703280,535744,139.99223509735992
1747352695803502,79905084,1,863,75,73328937,72795840,533097,140.6873420784585
1747352695897649,79997644,1,864,75,73423084,72888400,534684,140.26976681553964
1747352695992179,80090204,1,865,75,73517614,72980960,536654,139.75485135674012
1747352696086693,80182764,1,866,75,73612128,73073520,538608,139.2478388735407
1747352696176665,80275324,1,867,75,73702100,73166080,536020,139.9201522331256
1747352696270816,80367884,1,868,75,73796251,73258640,537611,139.50607409446607
1747352696364507,80460444,1,869,75,73889942,73351200,538742,139.2132040939819
1747352696458803,80553004,1,870,75,73984238,73443760,540478,138.76605523259042
1747352696549193,80645564,1,871,75,74074628,73536320,538308,139.32544194030183
1747352696643223,80738124,1,872,75,74168658,73628880,539778,138.94601113791225
1747352696737335,80830684,1,873,75,74262770,73721440,541330,138.54765115548742
1747352696831525,80923244,1,874,75,74356960,73814000,542960,138.13172241049065
1747352696925836,81015804,1,875,75,74451271,73906560,544711,137.68769127115112
1747352697015649,81108364,1,876,75,74541084,73999120,541964,138.38557542567403
1747352697110504,81200924,1,877,75,74635939,74091680,544259,137.8020391027066
1747352697204774,81293484,1,878,75,74730209,74184240,545969,137.3704367830408
1747352697300339,81386044,1,879,75,74825774,74276800,548974,136.61849195043845
1747352697388405,81478604,1,880,75,74913840,74369360,544480,137.74610637672643
1747352697483320,81571164,1,881,75,75008755,74461920,546835,137.15288889701648
1747352697576806,81663724,1,882,75,75102241,74554480,547761,136.92102942706762
1747352697671512,81756284,1,883,75,75196947,74647040,549907,136.38669811440843
1747352697760930,81848844,1,884,75,75286365,74739600,546765,137.1704479986832
1747352697855305,81941404,1,885,75,75380740,74832160,548580,136.71661380290934
1747352697949872,82033964,1,886,75,75475307,74924720,550587,136.21825433582703
1747352698044408,82126524,1,887,75,75569843,75017280,552563,135.73112930109326
1747352698134229,82219084,1,888,75,75659664,75109840,549824,136.4072866953789
1747352698227954,82311644,1,889,75,75753389,75202400,550989,136.11886988669465
1747352698322176,82404204,1,890,75,75847611,75294960,552651,135.70951649413465
1747352698416677,82496764,1,891,75,75942112,75387520,554592,135.23455080491604
1747352698510323,82589324,1,892,75,76035758,75480080,555678,134.9702525563366
1747352698601009,82681892,1,893,75,76126444,75572648,553796,135.4289305087072
1747352698695561,82774444,1,894,75,76220996,75665200,555796,134.94159727669864
1747352698789473,82867004,1,895,75,76314908,75757760,557148,134.6141420233044
1747352698883502,82959564,1,896,75,76408937,75850320,558617,134.2601460392362
1747352698973716,83052124,1,897,75,76499151,75942880,556271,134.8263705999414
1747352699068312,83144684,1,898,75,76593747,76035440,558307,134.33469399452272
1747352699162392,83237244,1,899,75,76687827,76128000,559827,133.9699585764888
1747352699256478,83329804,1,900,75,76781913,76220560,561353,133.60577034415064
1747352699346293,83422364,1,901,75,76871728,76313120,558608,134.26230916850457
1747352699440764,83514924,1,902,75,76966199,76405680,560519,133.80456327082578
1747352699534960,83607484,1,903,75,77060395,76498240,562155,133.41516129893003
1747352699629128,83700044,1,904,75,77154563,76590800,563763,133.034626252521
1747352699719480,83792604,1,905,75,77244915,76683360,561555,133.55771028661485
1747352699813490,83885164,1,906,75,77338925,76775920,563005,133.2137370005595
1747352699907301,83977724,1,907,75,77432736,76868480,564256,132.9183916520161
1747352700001461,84070284,1,908,75,77526896,76961040,565856,132.54255499632416
1747352700095644,84162844,1,909,75,77621079,77053600,567479,132.1634809393828
1747352700190272,84255404,1,910,75,77715707,77146160,569547,131.68360117777812
1747352700279975,84347964,1,911,75,77805410,77238720,566690,132.34749157387637
1747352700374839,84440524,1,912,75,77900274,77331280,568994,131.8115832504385
1747352700468886,84533084,1,913,75,77994321,77423840,570481,131.4680068223131
1747352700558524,84625644,1,914,75,78083959,77516400,567559,132.14485190085963
1747352700652950,84718204,1,915,75,78178385,77608960,569425,131.71181454976514
1747352700746944,84810772,1,916,75,78272379,77701528,570851,131.3827951602082
1747352700840947,84903324,1,917,75,78366382,77794080,572302,131.0496905479974
1747352700931863,84995884,1,918,75,78457298,77886640,570658,131.4272296191414
1747352701025728,85088444,1,919,75,78551163,77979200,571963,131.12736313362927
1747352701119546,85181004,1,920,75,78644981,78071760,573221,130.8395889194569
1747352701213639,85273564,1,921,75,78739074,78164320,574754,130.4906098957119
1747352701304391,85366124,1,922,75,78829826,78256880,572946,130.90238870678914
1747352701398281,85458684,1,923,75,78923716,78349440,574276,130.59922406647675
1747352701493095,85551244,1,924,75,79018530,78442000,576530,130.0886337224429
1747352701587102,85643804,1,925,75,79112537,78534560,577977,129.76294904468517
1747352701681108,85736364,1,926,75,79206543,78627120,579423,129.4391144293547
1747352701770906,85828924,1,927,75,79296341,78719680,576661,130.0590815054252
1747352701865282,85921484,1,928,75,79390717,78812240,578477,129.65078991904605
1747352701959275,86014044,1,929,75,79484710,78904800,579910,129.33041334000103
1747352702245793,86297964,1,932,75,79771228,79188720,582508,128.75359651712938
1747352702336300,86390524,1,933,75,79861735,79281280,580455,129.20898260847093
1747352702430846,86483084,1,934,75,79956281,79373840,582441,128.7684074438441
1747352702525179,86575644,1,935,75,80050614,79466400,584214,128.3776150520186
1747352702618651,86668204,1,936,75,80144086,79558960,585126,128.17752073912283
1747352702709669,86760764,1,937,75,80235104,79651520,583584,128.51620332291495
1747352702803654,86853324,1,938,75,80329089,79744080,585009,128.20315584888436
1747352702897897,86945884,1,939,75,80423332,79836640,586692,127.83538892638728
1747352702992134,87038444,1,940,75,80517569,79929200,588369,127.4710258358275
1747352703085045,87131004,1,941,75,80610480,80021760,588720,127.3950264981655
1747352703176530,87223564,1,942,75,80701965,80114320,587645,127.62807477303474
1747352703274759,87316124,1,943,75,80800194,80206880,593314,126.40861331436642
1747352703364597,87408684,1,944,75,80890032,80299440,590592,126.99122236671
1747352703458191,87501244,1,945,75,80983626,80392000,591626,126.76927653619008
1747352703548879,87593804,1,946,75,81074314,80484560,589754,127.17166818707462
1747352703642696,87686364,1,947,75,81168131,80577120,591011,126.9011913483844
1747352703737019,87778924,1,948,75,81262454,80669680,592774,126.52376791154808
1747352703831002,87871484,1,949,75,81356437,80762240,594197,126.22076516710788
1747352703921359,87964044,1,950,75,81446794,80854800,591994,126.69047321425556
1747352704015415,88056604,1,951,75,81540850,80947360,593490,126.37112672496588
1747352704109336,88149164,1,952,75,81634771,81039920,594851,126.08199364210532
1747352704203404,88241724,1,953,75,81728839,81132480,596359,125.7631728539353
1747352704294161,88334284,1,954,75,81819596,81225040,594556,126.14455156452884
1747352704388516,88426844,1,955,75,81913951,81317600,596351,125.76485995663629
1747352704482823,88519404,1,956,75,82008258,81410160,598098,125.39751010703932
1747352704576511,88611964,1,957,75,82101946,81502720,599226,125.16145828118272
1747352704671267,88704524,1,958,75,82196702,81595280,601422,124.70445045242776
1747352704760526,88797084,1,959,75,82285961,81687840,598121,125.39268810157142
1747352704855582,88889644,1,960,75,82381017,81780400,600617,124.87159038122464
1747352704948893,88982204,1,961,75,82474328,81872960,601368,124.71564832182624
1747352705043523,89074764,1,962,75,82568958,81965520,603438,124.28783072991756
1747352705134028,89167324,1,963,75,82659463,82058080,601383,124.71253760083007
1747352705228159,89259884,1,964,75,82753594,82150640,602954,124.38759839059033
1747352705321684,89352444,1,965,75,82847119,82243200,603919,124.18883989409176
1747352705416680,89445004,1,966,75,82942115,82335760,606355,123.68991762251488
1747352705506587,89537572,1,967,75,83032022,82428328,603694,124.23512574251194
1747352705600568,89630124,1,968,75,83126003,82520880,605123,123.9417440751715
1747352705695105,89722684,1,969,75,83220540,82613440,607100,123.5381321034426
1747352705789341,89815244,1,970,75,83314776,82706000,608776,123.1980235751738
1747352705879545,89907804,1,971,75,83404980,82798560,606420,123.67665974077372
1747352705972889,90000364,1,972,75,83498324,82891120,607204,123.51697287896656
1747352706069506,90092924,1,973,75,83594941,82983680,611261,122.69717845568422
1747352706161841,90185484,1,974,75,83687276,83076240,611036,122.74235887901858
1747352706256278,90278044,1,975,75,83781713,83168800,612913,122.366469629458
1747352706345656,90370604,1,976,75,83871091,83261360,609731,123.00506288838848
1747352706440114,90463164,1,977,75,83965549,83353920,611629,122.62335500769258
1747352706534815,90555724,1,978,75,84060250,83446480,613770,122.19561073366243
1747352706628126,90648284,1,979,75,84153561,83539040,614521,122.04627669355482
1747352706720706,90740844,1,980,75,84246141,83631600,614541,122.04230474451664
1747352706812878,90833404,1,981,75,84338313,83724160,614153,122.11940672763954
1747352706907024,90925964,1,982,75,84432459,83816720,615739,121.80485562876478
1747352707000371,91018524,1,983,75,84525806,83909280,616526,121.64937082945409
1747352707091347,91111084,1,984,75,84616782,84001840,614942,121.9627216875738
1747352707185701,91203644,1,985,75,84711136,84094400,616736,121.60794894411872
1747352707279416,91296204,1,986,75,84804851,84186960,617891,121.3806318590172
1747352707374425,91388764,1,987,75,84899860,84279520,620340,120.90144114517844
1747352707468289,91481324,1,988,75,84993724,84372080,621644,120.6478305911422
1747352707557826,91573884,1,989,75,85083261,84464640,618621,121.23739737254311
1747352707652641,91666452,1,990,75,85178076,84557208,620868,120.79862386207697
1747352707746638,91759004,1,991,75,85272073,84649760,622313,120.51813155116476
1747352707840421,91851564,1,992,75,85365856,84742320,623536,120.28174796643658
1747352707931380,91944124,1,993,75,85456815,84834880,621935,120.59138012814844
1747352708025316,92036684,1,994,75,85550751,84927440,623311,120.3251667305727
1747352708119379,92129244,1,995,75,85644814,85020000,624814,120.035722631055
1747352708213637,92221804,1,996,75,85739072,85112560,626512,119.71039660852466
1747352708303479,92314364,1,997,75,85828914,85205120,623794,120.2319996665566
1747352708397418,92406924,1,998,75,85922853,85297680,625173,119.96679319164456
1747352708492276,92499484,1,999,75,86017711,85390240,627471,119.52743632773466
1747352708586248,92592044,1,1000,75,86111683,85482800,628883,119.2590672668843
1747352708680418,92685644,1,1001,75,86205853,85576400,629453,119.151072439086
1747352708775039,92779244,1,1002,75,86300474,85670000,630474,118.95811722608704
1747352708869114,92872844,1,1003,75,86394549,85763600,630949,118.8685614843672
1747352708962714,92966444,1,1004,75,86488149,85857200,630949,118.8685614843672
1747352709057567,93060044,1,1005,75,86583002,85950800,632202,118.63296857649928
1747352709151141,93153644,1,1006,75,86676576,86044400,632176,118.63784768798564
1747352709245299,93247244,1,1007,75,86770734,86138000,632734,118.53322249159994
1747352709340005,93340844,1,1008,75,86865440,86231600,633840,118.32639151836426
1747352709434611,93434444,1,1009,75,86960046,86325200,634846,118.13888722619345
1747352709528682,93528044,1,1010,75,87054117,86418800,635317,118.0513035224935
1747352709623033,93621644,1,1011,75,87148468,86512400,636068,117.91192136689789
1747352709716866,93715244,1,1012,75,87242301,86606000,636301,117.868744509281
1747352709811343,93808844,1,1013,75,87336778,86699600,637178,117.70651215202032
1747352709904498,93902444,1,1014,75,87429933,86793200,636733,117.788774886805
1747352709999719,93996052,1,1015,75,87525154,86886808,638346,117.49114116795594
1747352710093752,94089644,1,1016,75,87619187,86980400,638787,117.410028695011
1747352710187466,94183244,1,1017,75,87712901,87074000,638901,117.38907905919696
1747352710282438,94276844,1,1018,75,87807873,87167600,640273,117.13753352085752
1747352710375858,94370444,1,1019,75,87901293,87261200,640093,117.17047366554549
1747352710470135,94464044,1,1020,75,87995570,87354800,640770,117.04667821527228
1747352710564349,94557644,1,1021,75,88089784,87448400,641384,116.93462886507928
1747352710658279,94651244,1,1022,75,88183714,87542000,641714,116.87449549176112
1747352710753128,94744844,1,1023,75,88278563,87635600,642963,116.64745871846436
1747352710847416,94838444,1,1024,75,88372851,87729200,643651,116.52277398776668
1747352710941057,94932044,1,1025,75,88466492,87822800,643692,116.51535206278778
1747352711035553,95025644,1,1026,75,88560988,87916400,644588,116.3533916237969
1747352711133618,95119244,1,1027,75,88659053,88010000,649053,115.55296716909098
1747352711227524,95212844,1,1028,75,88752959,88103600,649359,115.4985146891011
1747352711322573,95306444,1,1029,75,88848008,88197200,650808,115.24136150754138
1747352711416124,95400044,1,1030,75,88941559,88290800,650759,115.2500388008464
1747352711510961,95493644,1,1031,75,89036396,88384400,651996,115.03138056061694
1747352711604951,95587244,1,1032,75,89130386,88478000,652386,114.96261415787586
1747352711698682,95680844,1,1033,75,89224117,88571600,652517,114.93953414240548
1747352711793244,95774444,1,1034,75,89318679,88665200,653479,114.77032926842332
1747352711887626,95868044,1,1035,75,89413061,88758800,654261,114.63315099020116
1747352711981751,95961644,1,1036,75,89507186,88852400,654786,114.5412394278436
1747352712075829,96055244,1,1037,75,89601264,88946000,655264,114.45768423108856
1747352712170348,96148844,1,1038,75,89695783,89039600,656183,114.29738350429685
1747352712264190,96242444,1,1039,75,89789625,89133200,656425,114.2552462200556
1747352712358324,96336044,1,1040,75,89883759,89226800,656959,114.16237542982137
1747352712452846,96429644,1,1041,75,89978281,89320400,657881,114.00238036970212
1747352712547157,96523244,1,1042,75,90072592,89414000,658592,113.87930615616348
1747352712640976,96616844,1,1043,75,90166411,89507600,658811,113.84145073473272
1747352712735440,96710444,1,1044,75,90260875,89601200,659675,113.6923485049456
1747352712829702,96804044,1,1045,75,90355137,89694800,660337,113.57836983237348
1747352712923811,96897644,1,1046,75,90449246,89788400,660846,113.49088895143495
1747352713017792,96991252,1,1047,75,90543227,89882008,661219,113.42686764899376
1747352713112034,97084844,1,1048,75,90637469,89975600,661869,113.31547481450256
1747352713205864,97178444,1,1049,75,90731299,90069200,662099,113.27611127641032
1747352713300501,97272044,1,1050,75,90825936,90162800,663136,113.09897215654104
1747352713394481,97365644,1,1051,75,90919916,90256400,663516,113.03419962743928
1747352713489028,97459244,1,1052,75,91014463,90350000,664463,112.8731020387892
1747352713583501,97552844,1,1053,75,91108936,90443600,665336,112.7249990982
1747352713676950,97646444,1,1054,75,91202385,90537200,665185,112.750588182235
1747352713771188,97740044,1,1055,75,91296623,90630800,665823,112.6425491459442
1747352713865589,97833644,1,1056,75,91391024,90724400,666624,112.5072004608295
1747352713960130,97927244,1,1057,75,91485565,90818000,667565,112.34861024769124
1747352714054542,98020844,1,1058,75,91579977,90911600,668377,112.21211980663608
1747352714147890,98114444,1,1059,75,91673325,91005200,668125,112.25444340505146
1747352714242230,98208044,1,1060,75,91767665,91098800,668865,112.1302504989796
1747352714336369,98301644,1,1061,75,91861804,91192400,669404,112.03996390819296
1747352714430970,98395244,1,1062,75,91956405,91286000,670405,111.87267398065347
1747352714524804,98488844,1,1063,75,92050239,91379600,670639,111.83363926046653
1747352714619370,98582444,1,1064,75,92144805,91473200,671605,111.67278385360444
1747352714713748,98676044,1,1065,75,92239183,91566800,672383,111.54356966193376
1747352714807877,98769644,1,1066,75,92333312,91660400,672912,111.45588130394464
1747352714902163,98863244,1,1067,75,92427598,91754000,673598,111.34237334433892
1747352714996443,98956844,1,1068,75,92521878,91847600,674278,111.23008610691733
1747352715090826,99050444,1,1069,75,92616261,91941200,675061,111.10107086618838
1747352715184562,99144044,1,1070,75,92709997,92034800,675197,111.07869258897772
1747352715278752,99237644,1,1071,75,92804187,92128400,675787,110.98171465269382
1747352715372734,99331244,1,1072,75,92898169,92222000,676169,110.91901580817812
1747352715467097,99424844,1,1073,75,92992532,92315600,676932,110.79399407916895
1747352715565228,99518444,1,1074,75,93090663,92409200,681463,110.05733253309424
1747352715659474,99612044,1,1075,75,93184909,92502800,682109,109.95310133717632
1747352715754173,99705644,1,1076,75,93279608,92596400,683208,109.7762321284294
1747352715847604,99799244,1,1077,75,93373039,92690000,683039,109.80339336406853
1747352715942016,99892844,1,1078,75,93467451,92783600,683851,109.67301356582064
1747352716036120,99986452,1,1079,75,93561555,92877208,684347,109.5935249222982
1747352716130790,100080044,1,1080,75,93656225,92970800,685425,109.421162052741
1747352716225364,100174684,1,1081,75,93750799,93065440,685359,109.4316992991994
1747352716319044,100269324,1,1082,75,93844479,93160080,684399,109.58519810812116
1747352716417294,100363964,1,1083,75,93942729,93254720,688009,109.01020190142862
1747352716511266,100458604,1,1084,75,94036701,93349360,687341,109.11614467927856
1747352716605467,100553244,1,1085,75,94130902,93444000,686902,109.1858809553619
1747352716703774,100647884,1,1086,75,94229209,93538640,690569,108.60609149845996
1747352716797897,100742524,1,1087,75,94323332,93633280,690052,108.6874612348055
1747352716892406,100837164,1,1088,75,94417841,93727920,689921,108.70809846344726
1747352716986439,100931804,1,1089,75,94511874,93822560,689314,108.80382525235234
1747352717085335,101026444,1,1090,75,94610770,93917200,693570,108.13616505904234
1747352717178741,101121084,1,1091,75,94704176,94011840,692336,108.32890388481894
1747352717273662,101215724,1,1092,75,94799097,94106480,692617,108.28495402220852
1747352717367737,101310364,1,1093,75,94893172,94201120,692052,108.3733592273413
1747352717465600,101405004,1,1094,75,94991035,94295760,695275,107.87098630038474
1747352717559847,101499644,1,1095,75,95085282,94390400,694882,107.93199420908874
1747352717654023,101594284,1,1096,75,95179458,94485040,694418,108.0041127966153
1747352717752133,101688924,1,1097,75,95277568,94579680,697888,107.46710073822734
1747352717846485,101783572,1,1098,75,95371920,94674328,697592,107.51270083372516
1747352717940640,101878204,1,1099,75,95466075,94768960,697115,107.58626625449172
1747352718035128,101972844,1,1100,75,95560563,94863600,696963,107.60972964131524
1747352718133023,102067484,1,1101,75,95658458,94958240,700218,107.10950018422834
1747352718228001,102162124,1,1102,75,95753436,95052880,700556,107.0578226437287
1747352718321707,102256764,1,1103,75,95847142,95147520,699622,107.2007455454517
1747352718420208,102351404,1,1104,75,95945643,95242160,703483,106.61238437886917
1747352718514434,102446044,1,1105,75,96039869,95336800,703069,106.67516275073996
1747352718608321,102540684,1,1106,75,96133756,95431440,702316,106.78953633407184
1747352718702625,102635324,1,1107,75,96228060,95526080,701980,106.84065073079005
1747352718800614,102729964,1,1108,75,96326049,95620720,705329,106.33335649037542
1747352718895296,102824604,1,1109,75,96420731,95715360,705371,106.32702506907712
1747352718989400,102919244,1,1110,75,96514835,95810000,704835,106.40788269595012
1747352719083941,103013884,1,1111,75,96609376,95904640,704736,106.42283067701948
1747352719181544,103108524,1,1112,75,96706979,95999280,707699,105.97725869331454
1747352719276430,103203164,1,1113,75,96801865,96093920,707945,105.94043322574493
1747352719370906,103297804,1,1114,75,96896341,96188560,707781,105.96498069318052
1747352719468289,103392444,1,1115,75,96993724,96283200,710524,105.55589958959864
1747352719562763,103487084,1,1116,75,97088198,96377840,710358,105.58056641862272
1747352719657407,103581732,1,1117,75,97182842,96472488,710354,105.58116094229074
1747352719751623,103676364,1,1118,75,97277058,96567120,709938,105.64302798272526
1747352719849472,103771004,1,1119,75,97374907,96661760,713147,105.1676582808313
1747352719943529,103865644,1,1120,75,97468964,96756400,712564,105.25370352698144
1747352720038206,103960284,1,1121,75,97563641,96851040,712601,105.24823849531504
1747352720136708,104054924,1,1122,75,97662143,96945680,716463,104.68091164512336
1747352720229943,104149564,1,1123,75,97755378,97040320,715058,104.8865966117434
1747352720324461,104244204,1,1124,75,97849896,97134960,714936,104.90449494779952
1747352720419193,104338844,1,1125,75,97944628,97229600,715028,104.89099727563116
1747352720516830,104433484,1,1126,75,98042265,97324240,718025,104.45318756310714
1747352720611031,104528124,1,1127,75,98136466,97418880,717586,104.51708924087148
1747352720705777,104622764,1,1128,75,98231212,97513520,717692,104.50165251946518
1747352720800161,104717404,1,1129,75,98325596,97608160,717436,104.53894145261738
1747352720897857,104812044,1,1130,75,98423292,97702800,720492,104.09553471794274
1747352720991810,104906684,1,1131,75,98517245,97797440,719805,104.19488611498949
1747352721086904,105001324,1,1132,75,98612339,97892080,720259,104.12920907617956
1747352721184857,105095964,1,1133,75,98710292,97986720,723572,103.65243541762256
1747352721278463,105190604,1,1134,75,98803898,98081360,722538,103.80076895609642
1747352721373048,105285244,1,1135,75,98898483,98176000,722483,103.8086709306655
1747352721467198,105379884,1,1136,75,98992633,98270640,721993,103.87912348180662
1747352721566031,105474524,1,1137,75,99091466,98365280,726186,103.27932513157786
1747352721659496,105569164,1,1138,75,99184931,98459920,725011,103.44670632583508
1747352721753505,105663804,1,1139,75,99278940,98554560,724380,103.5368176923714
1747352721848150,105758444,1,1140,75,99373585,98649200,724385,103.53610303912976
1747352721946196,105853084,1,1141,75,99471631,98743840,727791,103.05156288000263
1747352722040491,105947724,1,1142,75,99565926,98838480,727446,103.1004363210465
1747352722134865,106042364,1,1143,75,99660300,98933120,727180,103.13815011413956
1747352722233047,106137004,1,1144,75,99758482,99027760,730722,102.6382126171102
1747352722327816,106231644,1,1145,75,99853251,99122400,730851,102.62009629869836
1747352722421809,106326284,1,1146,75,99947244,99217040,730204,102.71102322090812
1747352722515244,106420924,1,1147,75,100040679,99311680,728999,102.88079956213932
1747352722613633,106515564,1,1148,75,100139068,99406320,732748,102.35442471354408
1747352722708629,106610204,1,1149,75,100234064,99500960,733104,102.30472074903425
1747352722802092,106704844,1,1150,75,100327527,99595600,731927,102.46923531991578
1747352722900877,106799484,1,1151,75,100426312,99690240,736072,101.89220619721983
1747352722995094,106894124,1,1152,75,100520529,99784880,735649,101.95079446855767
1747352723088938,106988764,1,1153,75,100614373,99879520,734853,102.06122857224508
1747352723183378,107083404,1,1154,75,100708813,99974160,734653,102.0890134526096
1747352723281856,107178044,1,1155,75,100807291,100068800,738491,101.55844824107538
1747352723376159,107272684,1,1156,75,100901594,100163440,738154,101.60481417156852
1747352723470258,107367324,1,1157,75,100995693,100258080,737613,101.6793359119213
1747352723564276,107461964,1,1158,75,101089711,100352720,736991,101.76515045638278
1747352723662586,107556604,1,1159,75,101188021,100447360,740661,101.26090073596424
1747352723756824,107651244,1,1160,75,101282259,100542000,740259,101.315890789575
1747352723850977,107745884,1,1161,75,101376412,100636640,739772,101.38258814878098
1747352723949422,107840532,1,1162,75,101474857,100731288,743569,100.86488274793597
1747352724043499,107935164,1,1163,75,101568934,100825920,743014,100.94022454489418
1747352724138310,108029804,1,1164,75,101663745,100920560,743185,100.91699913211382
1747352724231848,108124444,1,1165,75,101757283,101015200,742083,101.06686179308782
1747352724329906,108219084,1,1166,75,101855341,101109840,745501,100.60348678271392
1747352724423988,108313724,1,1167,75,101949423,101204480,744943,100.6788438846999
1747352724518625,108408364,1,1168,75,102044060,101299120,744940,100.67924933551694
1747352724616629,108503004,1,1169,75,102142064,101393760,748304,100.22664585516048
1747352724711267,108597644,1,1170,75,102236702,101488400,748302,100.2269137326908
1747352724805006,108692284,1,1171,75,102330441,101583040,747401,100.3477383626728
1747352724899602,108786924,1,1172,75,102425037,101677680,747357,100.35364624938282
1747352724997695,108881564,1,1173,75,102523130,101772320,750810,99.8921165141647
1747352725091843,108976204,1,1174,75,102617278,101866960,750318,99.95761796998072
1747352725186458,109070844,1,1175,75,102711893,101961600,750293,99.96094858941774
1747352725280830,109165484,1,1176,75,102806265,102056240,750025,99.99666677777408
1747352725378579,109260124,1,1177,75,102904014,102150880,753134,99.58387219273064
1747352725472833,109354764,1,1178,75,102998268,102245520,752748,99.6349375886751
1747352725567421,109449404,1,1179,75,103092856,102340160,752696,99.64182086792012
1747352725665742,109544044,1,1180,75,103191177,102434800,756377,99.15690191531472
1747352725759572,109638692,1,1181,75,103285007,102529448,755559,99.26425335413911
1747352725853903,109733324,1,1182,75,103379338,102624080,755258,99.30381406089045
1747352725948354,109827964,1,1183,75,103473789,102718720,755069,99.32867062480383
1747352726046033,109922604,1,1184,75,103571468,102813360,758108,98.930495391158
1747352726140867,110017244,1,1185,75,103666302,102908000,758302,98.90518553294068
1747352726234408,110111884,1,1186,75,103759843,103002640,757203,99.04873594003192
1747352726333325,110206524,1,1187,75,103858760,103097280,761480,98.49240951830645
1747352726427136,110301164,1,1188,75,103952571,103191920,760651,98.59975205449015
1747352726521857,110395804,1,1189,75,104047292,103286560,760732,98.5892535084629
1747352726615482,110490444,1,1190,75,104140917,103381200,759717,98.7209710984485
1747352726714130,110585084,1,1191,75,104239565,103475840,763725,98.20288716488264
1747352726808093,110679724,1,1192,75,104333528,103570480,763048,98.29001583124524
1747352726902678,110774364,1,1193,75,104428113,103665120,762993,98.29710102189664
1747352726996986,110869004,1,1194,75,104522421,103759760,762661,98.33989151143167
1747352727094649,110963644,1,1195,75,104620084,103854400,765684,97.95163540050464
1747352727188960,111058284,1,1196,75,104714395,103949040,765355,97.99374146637837
1747352727283185,111152924,1,1197,75,104808620,104043680,764940,98.04690563965802
1747352727381542,111247564,1,1198,75,104906977,104138320,768657,97.57277953625608
1747352727476161,111342204,1,1199,75,105001596,104232960,768636,97.57544533433251
1747352727570340,111436844,1,1200,75,105095775,104327600,768175,97.63400266866272
1747352727663422,111531484,1,1201,75,105188857,104422240,766617,97.83242479621508
1747352727762827,111626124,1,1202,75,105288262,104516880,771382,97.22809191814171
1747352727856855,111720764,1,1203,75,105382290,104611520,770770,97.30529211048692
1747352727950849,111815404,1,1204,75,105476284,104706160,770124,97.3869143150973
1747352728045313,111910044,1,1205,75,105570748,104800800,769948,97.40917568459167
1747352728143650,112004684,1,1206,75,105669085,104895440,773645,96.94368864272371
1747352728237651,112099324,1,1207,75,105763086,104990080,773006,97.02382646447764
1747352728331798,112193964,1,1208,75,105857233,105084720,772513,97.085744835362
1747352728430083,112288604,1,1209,75,105955518,105179360,776158,96.62980990983796
1747352728523925,112383244,1,1210,75,106049360,105274000,775360,96.72926124638876
1747352728618445,112477884,1,1211,75,106143880,105368640,775240,96.744234043651
1747352728712135,112572524,1,1212,75,106237570,105463280,774290,96.86293249299358
1747352728810294,112667164,1,1213,75,106335729,105557920,777809,96.42470066558757
1747352728904909,112761804,1,1214,75,106430344,105652560,777784,96.42780000617138
1747352728999069,112856444,1,1215,75,106524504,105747200,777304,96.48734600619578
1747352729097336,112951084,1,1216,75,106622771,105841840,780931,96.03921473215944
1747352729191367,113045724,1,1217,75,106716802,105936480,780322,96.1141682536184
1747352729285869,113140364,1,1218,75,106811304,106031120,780184,96.13116905755564
1747352729380095,113235004,1,1219,75,106905530,106125760,779770,96.18220757402824
1747352729478186,113329644,1,1220,75,107003621,106220400,783221,95.7584130149728
1747352729572650,113424284,1,1221,75,107098085,106315040,783045,95.77993601900276
1747352729666911,113518924,1,1222,75,107192346,106409680,782666,95.82631671747592
1747352729760818,113613564,1,1223,75,107286253,106504320,781933,95.9161462682864
1747352729859255,113708204,1,1224,75,107384690,106598960,785730,95.4526364018174
1747352729953341,113802844,1,1225,75,107478776,106693600,785176,95.51998532813026
1747352730048059,113897492,1,1226,75,107573494,106788248,785246,95.5114702908388
1747352730146094,113992124,1,1227,75,107671529,106882880,788649,95.09934077136975
1747352730240466,114086764,1,1228,75,107765901,106977520,788381,95.13166857141408
1747352730334334,114181404,1,1229,75,107859769,107072160,787609,95.22491490066771
1747352730428556,114276044,1,1230,75,107953991,107166800,787191,95.27547952148844
1747352730526466,114370684,1,1231,75,108051901,107261440,790461,94.88134139445212
1747352730621665,114465324,1,1232,75,108147100,107356080,791020,94.8142904098506
1747352730715979,114559964,1,1233,75,108241414,107450720,790694,94.8533819657162
1747352730814187,114654604,1,1234,75,108339622,107545360,794262,94.42727966338563
1747352730907222,114749244,1,1235,75,108432657,107640000,792657,94.6184793674944
1747352731001963,114843884,1,1236,75,108527398,107734640,792758,94.60642465922766
1747352731096282,114938524,1,1237,75,108621717,107829280,792437,94.64474778436646
1747352731194880,115033164,1,1238,75,108720315,107923920,796395,94.1743732695459
1747352731288463,115127804,1,1239,75,108813898,108018560,795338,94.29953051407075
1747352731382806,115222444,1,1240,75,108908241,108113200,795041,94.33475757853998
1747352731476812,115317084,1,1241,75,109002247,108207840,794407,94.41004422166472
1747352731575202,115411724,1,1242,75,109100637,108302480,798157,93.96647526739729
1747352731669991,115506364,1,1243,75,109195426,108397120,798306,93.94893687383032
1747352731763817,115601004,1,1244,75,109289252,108491760,797492,94.04483054375468
1747352731862511,115695652,1,1245,75,109387946,108586408,801538,93.57011146071676
1747352731956170,115790284,1,1246,75,109481605,108681040,800565,93.68383579097262
1747352732050441,115884924,1,1247,75,109575876,108775680,800196,93.72703687596538
1747352732144931,115979564,1,1248,75,109670366,108870320,800046,93.74460968494311
1747352732243203,116074204,1,1249,75,109768638,108964960,803678,93.32095690064926
1747352732337291,116168844,1,1250,75,109862726,109059600,803126,93.38509773061762
1747352732431845,116263484,1,1251,75,109957280,109154240,803040,93.39509862522416
1747352732526105,116358124,1,1252,75,110051540,109248880,802660,93.43931428001892
1747352732624179,116452764,1,1253,75,110149614,109343520,806094,93.04125821554312
1747352732718225,116547404,1,1254,75,110243660,109438160,805500,93.1098696461825
1747352732813015,116642044,1,1255,75,110338450,109532800,805650,93.09253397877492
1747352732911155,116736684,1,1256,75,110436590,109627440,809150,92.6898597293456
1747352733005125,116831324,1,1257,75,110530560,109722080,808480,92.76667326340788
1747352733099047,116925964,1,1258,75,110624482,109816720,807762,92.84913130352751
1747352733193379,117020604,1,1259,75,110718814,109911360,807454,92.88454822194204
1747352733291967,117115244,1,1260,75,110817402,110006000,811402,92.43260430711288
1747352733385949,117209884,1,1261,75,110911384,110100640,810744,92.50762262810456
1747352733480253,117304524,1,1262,75,111005688,110195280,810408,92.54597684129476
1747352733578728,117399164,1,1263,75,111104163,110289920,814243,92.11009489796044
1747352733672613,117493804,1,1264,75,111198048,110384560,813488,92.19558247939736
1747352733766977,117588444,1,1265,75,111292412,110479200,813212,92.22687318927905
1747352733861755,117683084,1,1266,75,111387190,110573840,813350,92.21122517981188
1747352733959626,117777724,1,1267,75,111485061,110668480,816581,91.84636919056408
1747352734053551,117872364,1,1268,75,111578986,110763120,815866,91.92686053837272
1747352734147328,117967004,1,1269,75,111672763,110857760,815003,92.02420113790993
1747352734241628,118061644,1,1270,75,111767063,110952400,814663,92.06260748309424
1747352734342625,118156284,1,1271,75,111868060,111047040,821020,91.3497844145088
1747352734434640,118250924,1,1272,75,111960075,111141680,818395,91.6427886289628
1747352734528051,118345564,1,1273,75,112053486,111236320,817166,91.78061740209456
1747352734627243,118440204,1,1274,75,112152678,111330960,821718,91.2721882689682
1747352734720673,118534844,1,1275,75,112246108,111425600,820508,91.40678701487371
1747352734814926,118629484,1,1276,75,112340361,111520240,820121,91.44992019470298
1747352734909016,118724124,1,1277,75,112434451,111614880,819571,91.511290663042
1747352735007790,118818764,1,1278,75,112533225,111709520,823705,91.05201498109152
1747352735101852,118913404,1,1279,75,112627287,111804160,823127,91.1159517304134
1747352735196236,119008044,1,1280,75,112721671,111898800,822871,91.14429843802978
1747352735294656,119102684,1,1281,75,112820091,111993440,826651,90.72752588456314
1747352735388736,119197324,1,1282,75,112914171,112088080,826091,90.78902929580396
1747352735482398,119291964,1,1283,75,113007833,112182720,825113,90.89664082374172
1747352735576688,119386604,1,1284,75,113102123,112277360,824763,90.93521411605516
1747352735675533,119481244,1,1285,75,113200968,112372000,828968,90.47393868038333
1747352735769820,119575884,1,1286,75,113295255,112466640,828615,90.51248167122246
1747352735864018,119670524,1,1287,75,113389453,112561280,828173,90.5607886274969
1747352735957413,119765164,1,1288,75,113482848,112655920,826928,90.69713445426927
1747352736055986,119859804,1,1289,75,113581421,112750560,830861,90.26780652840849
1747352736150390,119954452,1,1290,75,113675825,112845208,830617,90.29432337647796
1747352736244706,120049084,1,1291,75,113770141,112939840,830301,90.32868803000358
1747352736342657,120143724,1,1292,75,113868092,113034480,833612,89.96991406073809
1747352736437132,120238364,1,1293,75,113962567,113129120,833447,89.98772567421803
1747352736530973,120333004,1,1294,75,114056408,113223760,832648,90.07407692085972
1747352736625466,120427644,1,1295,75,114150901,113318400,832501,90.08998187389564
1747352736723986,120522284,1,1296,75,114249421,113413040,836381,89.67205137371604
1747352736818096,120616924,1,1297,75,114343531,113507680,835851,89.72891101404437
1747352736912217,120711564,1,1298,75,114437652,113602320,835332,89.78466047032796
1747352737010584,120806204,1,1299,75,114536019,113696960,839059,89.38584771750259
1747352737104495,120900844,1,1300,75,114629930,113791600,838330,89.46357639593
1747352737198560,120995484,1,1301,75,114723995,113886240,837755,89.5249804537126
1747352737293140,121090124,1,1302,75,114818575,113980880,837695,89.5313926906571
1747352737390997,121184764,1,1303,75,114916432,114075520,840912,89.18888064387237
1747352737485847,121279404,1,1304,75,115011282,114170160,841122,89.16661316669877
1747352737579874,121374044,1,1305,75,115105309,114264800,840509,89.23164415848017
1747352737674385,121468684,1,1306,75,115199820,114359440,840380,89.24534139317927
1747352737772570,121563324,1,1307,75,115298005,114454080,843925,88.87045649791155
1747352737866569,121657964,1,1308,75,115392004,114548720,843284,88.93800902187164
1747352737960673,121752612,1,1309,75,115486108,114643368,842740,88.99541970239932
1747352738059454,121847244,1,1310,75,115584889,114738000,846889,88.55942160070565
1747352738152732,121941884,1,1311,75,115678167,114832640,845527,88.70207574684191
1747352738247455,122036524,1,1312,75,115772890,114927280,845610,88.69336928371236
1747352738341250,122131164,1,1313,75,115866685,115021920,844765,88.78208732606109
1747352738440125,122225804,1,1314,75,115965560,115116560,849000,88.33922261484099
1747352738534348,122320444,1,1315,75,116059783,115211200,848583,88.3826331661134
1747352738627988,122415084,1,1316,75,116153423,115305840,847583,88.48690924664605
1747352738722190,122509724,1,1317,75,116247625,115400480,847145,88.53265969816265
1747352738820624,122604364,1,1318,75,116346059,115495120,850939,88.1379276305352
1747352738915502,122699004,1,1319,75,116440937,115589760,851177,88.11328313617497
1747352739009470,122793644,1,1320,75,116534905,115684400,850505,88.18290309874722
1747352739107761,122888284,1,1321,75,116633196,115779040,854156,87.80597455265783
1747352739202125,122982924,1,1322,75,116727560,115873680,853880,87.83435611561343
1747352739296328,123077564,1,1323,75,116821763,115968320,853443,87.87933113283489
1747352739390191,123172204,1,1324,75,116915626,116062960,852666,87.9594120089226
1747352739488728,123266844,1,1325,75,117014163,116157600,856563,87.55923382168037
1747352739582250,123361484,1,1326,75,117107685,116252240,855445,87.67366692189445
1747352739677216,123456124,1,1327,75,117202651,116346880,855771,87.64026824933306
1747352739775526,123550764,1,1328,75,117300961,116441520,859441,87.26602524198869
1747352739868898,123645404,1,1329,75,117394333,116536160,858173,87.3949658169157
1747352739963619,123740044,1,1330,75,117489054,116630800,858254,87.38671768497439
1747352740057308,123834684,1,1331,75,117582743,116725440,857303,87.48365513709855
1747352740156423,123929324,1,1332,75,117681858,116820080,861778,87.02937415436458
1747352740250340,124023964,1,1333,75,117775775,116914720,861055,87.10244990157423
1747352740344866,124118604,1,1334,75,117870301,117009360,860941,87.11398342046668
1747352740438647,124213244,1,1335,75,117964082,117104000,860082,87.20098781278995
1747352740536747,124307884,1,1336,75,118062182,117198640,863542,86.85159494268953
1747352740631035,124402524,1,1337,75,118156470,117293280,863190,86.88701212942689
1747352740725062,124497164,1,1338,75,118250497,117387920,862577,86.94875935713564
1747352740824064,124591804,1,1339,75,118349499,117482560,866939,86.51127703333222
1747352740917500,124686444,1,1340,75,118442935,117577200,865735,86.63159049824715
1747352741012429,124781084,1,1341,75,118537864,117671840,866024,86.60268075711528
1747352741105797,124875724,1,1342,75,118631232,117766480,864752,86.73006827390975
1747352741204884,124970364,1,1343,75,118730319,117861120,869199,86.286339491877
1747352741299150,125065004,1,1344,75,118824585,117955760,868825,86.32348286478866
1747352741393147,125159644,1,1345,75,118918582,118050400,868182,86.38741646336828
1747352741490522,125254284,1,1346,75,119015957,118145040,870917,86.11612817294873
1747352741585202,125348924,1,1347,75,119110637,118239680,870957,86.11217316124677
1747352741679459,125443564,1,1348,75,119204894,118334320,870574,86.1500573185048
1747352741773477,125538204,1,1349,75,119298912,118428960,869952,86.21165305672038
1747352741871973,125632844,1,1350,75,119397408,118523600,873808,85.83121234870818
1747352741966488,125727484,1,1351,75,119491923,118618240,873683,85.84349243375458
1747352742060190,125822124,1,1352,75,119585625,118712880,872745,85.93575442998814
1747352742157259,125916764,1,1353,75,119682694,118807520,875174,85.69724420515234
1747352742252611,126011412,1,1354,75,119778046,118902168,875878,85.62836376755666
1747352742346892,126106044,1,1355,75,119872327,118996800,875527,85.66269229846709
1747352742441429,126200684,1,1356,75,119966864,119091440,875424,85.6727711371861
1747352742539882,126295324,1,1357,75,120065317,119186080,879237,85.30123277341603
1747352742633890,126389964,1,1358,75,120159325,119280720,878605,85.36259183592172
1747352742728407,126484604,1,1359,75,120253842,119375360,878482,85.37454381535422
1747352742821901,126579244,1,1360,75,120347336,119470000,877336,85.48606235239407
1747352742920314,126673884,1,1361,75,120445749,119564640,881109,85.12000217907206
1747352743014558,126768524,1,1362,75,120539993,119659280,880713,85.15827517023139
1747352743109270,126863164,1,1363,75,120634705,119753920,880785,85.15131388477324
1747352743207691,126957804,1,1364,75,120733126,119848560,884566,84.78734204118179
1747352743301512,127052444,1,1365,75,120826947,119943200,883747,84.8659175080651
1747352743395724,127147084,1,1366,75,120921159,120037840,883319,84.90703811420336
1747352743489561,127241724,1,1367,75,121014996,120132480,882516,84.98429490230205
1747352743588077,127336364,1,1368,75,121113512,120227120,886392,84.61267700972031
1747352743682226,127431004,1,1369,75,121207661,120321760,885901,84.65957257075
1747352743776223,127525644,1,1370,75,121301658,120416400,885258,84.72106436767587
1747352743871030,127620284,1,1371,75,121396465,120511040,885425,84.70508512861055
1747352743968867,127714924,1,1372,75,121494302,120605680,888622,84.40034120244603
1747352744062976,127809572,1,1373,75,121588411,120700328,888083,84.45156590093494
1747352744157970,127904204,1,1374,75,121683405,120794960,888445,84.4171558171862
1747352744255934,127998844,1,1375,75,121781369,120889600,891769,84.10249739562599
1747352744349949,128093484,1,1376,75,121875384,120984240,891144,84.16148231935578
1747352744443874,128188124,1,1377,75,121969309,121078880,890429,84.22906262037736
1747352744538329,128282764,1,1378,75,122063764,121173520,890244,84.24656610996536
1747352744636369,128377404,1,1379,75,122161804,121268160,893644,83.92603766152965
1747352744730654,128472044,1,1380,75,122256089,121362800,893289,83.95939052199232
1747352744824633,128566684,1,1381,75,122350068,121457440,892628,84.02156329400377
1747352744919129,128661324,1,1382,75,122444564,121552080,892484,84.03511995733257
1747352745017655,128755964,1,1383,75,122543090,121646720,896370,83.67080558251615
1747352745111544,128850604,1,1384,75,122636979,121741360,895619,83.74096574547882
1747352745205894,128945244,1,1385,75,122731329,121836000,895329,83.7680897189748
1747352745304416,129039884,1,1386,75,122829851,121930640,899211,83.40645299045497
1747352745398357,129134524,1,1387,75,122923792,122025280,898512,83.47133928094449
1747352745493026,129229164,1,1388,75,123018461,122119920,898541,83.46864528162877
1747352745587139,129323804,1,1389,75,123112574,122214560,898014,83.51762890110845
1747352745685323,129418444,1,1390,75,123210758,122309200,901558,83.18932337131943
1747352745778963,129513084,1,1391,75,123304398,122403840,900558,83.28169868015165
1747352745873634,129607724,1,1392,75,123399069,122498480,900589,83.27883196441441
1747352745972348,129702364,1,1393,75,123497783,122593120,904663,82.90379953640195
1747352746065670,129797004,1,1394,75,123591105,122687760,903345,83.02475798283048
1747352746160012,129891644,1,1395,75,123685447,122782400,903047,83.05215564638385
1747352746254534,129986284,1,1396,75,123779969,122877040,902929,83.06300938390505
1747352746353086,130080924,1,1397,75,123878521,122971680,906841,82.70468582695312
1747352746446846,130175564,1,1398,75,123972281,123066320,905961,82.7850205472421
1747352746541025,130270204,1,1399,75,124066460,123160960,905500,82.82716731087797
1747352746634959,130364844,1,1400,75,124160394,123255600,904794,82.89179636469738
1747352746733491,130459484,1,1401,75,124258926,123350240,908686,82.53676187373857
1747352746827837,130554124,1,1402,75,124353272,123444880,908392,82.5634747994258
1747352746921918,130648764,1,1403,75,124447353,123539520,907833,82.61431342548684
1747352747019940,130743404,1,1404,75,124545375,123634160,911215,82.30768808678522
1747352747114476,130838044,1,1405,75,124639911,123728800,911111,82.3170832094004
1747352747208714,130932684,1,1406,75,124734149,123823440,910709,82.35341914925624
1747352747302946,131027324,1,1407,75,124828381,123918080,910301,82.39033023142895
1747352747401201,131121964,1,1408,75,124926636,124012720,913916,82.0644348058246
1747352747495364,131216604,1,1409,75,125020799,124107360,913439,82.10728904721607
1747352747589539,131311244,1,1410,75,125114974,124202000,912974,82.14910829881245
1747352747687651,131405884,1,1411,75,125213086,124296640,916446,81.83788242842459
1747352747781437,131500524,1,1412,75,125306872,124391280,915592,81.91421506522556
1747352747875866,131595164,1,1413,75,125401301,124485920,915381,81.93309671055003
1747352747970322,131689804,1,1414,75,125495757,124580560,915197,81.94956932769665
1747352748069223,131784444,1,1415,75,125594658,124675200,919458,81.56979437886233
1747352748163427,131879084,1,1416,75,125688862,124769840,919022,81.60849250616415
1747352748256980,131973724,1,1417,75,125782415,124864480,917935,81.70513162696706
1747352748351465,132068372,1,1418,75,125876900,124959128,917772,81.71964278709744
1747352748449277,132163004,1,1419,75,125974712,125053760,920952,81.43746905376176
1747352748544464,132257644,1,1420,75,126069899,125148400,921499,81.38912793177204
1747352748637966,132352284,1,1421,75,126163401,125243040,920361,81.48976325593979
1747352748736556,132446924,1,1422,75,126261991,125337680,924311,81.14152054881961
1747352748830822,132541564,1,1423,75,126356257,125432320,923937,81.17436578468012
1747352748924570,132636204,1,1424,75,126450005,125526960,923045,81.25280999301226
1747352749019482,132730844,1,1425,75,126544917,125621600,923317,81.22887372375901
1747352749117265,132825484,1,1426,75,126642700,125716240,926460,80.95330613302248
1747352749211828,132920124,1,1427,75,126737263,125810880,926383,80.9600348883777
1747352749306241,133014764,1,1428,75,126831676,125905520,926156,80.97987811988477
1747352749404318,133109404,1,1429,75,126929753,126000160,929593,80.68046984002676
1747352749498252,133204044,1,1430,75,127023687,126094800,928887,80.74179098211084
1747352749592788,133298684,1,1431,75,127118223,126189440,928783,80.75083200273906
1747352749687131,133393324,1,1432,75,127212566,126284080,928486,80.77666222215521
1747352749785001,133487964,1,1433,75,127310436,126378720,931716,80.49663202091625
1747352749878885,133582604,1,1434,75,127404320,126473360,930960,80.56200051559681
1747352749973397,133677244,1,1435,75,127498832,126568000,930832,80.57307870808052
1747352750067230,133771884,1,1436,75,127592665,126662640,930025,80.64299346791753
1747352750166033,133866532,1,1437,75,127691468,126757288,934180,80.28431351559657
1747352750260035,133961164,1,1438,75,127785470,126851920,933550,80.33849284987414
1747352750354041,134055804,1,1439,75,127879476,126946560,932916,80.39309005312376
1747352750452598,134150444,1,1440,75,127978033,127041200,936833,80.05695785694995
1747352750546835,134245084,1,1441,75,128072270,127135840,936430,80.09141099708468
1747352750641104,134339724,1,1442,75,128166539,127230480,936059,80.12315463021028
1747352750735429,134434364,1,1443,75,128260864,127325120,935744,80.15012653033308
1747352750833207,134529004,1,1444,75,128358642,127419760,938882,79.88224292296583
1747352750927434,134623644,1,1445,75,128452869,127514400,938469,79.91739737807002
1747352751022233,134718284,1,1446,75,128547668,127609040,938628,79.90385967603778
1747352751115931,134812924,1,1447,75,128641366,127703680,937686,79.98413114838016
1747352751214815,134907564,1,1448,75,128740250,127798320,941930,79.62375123416814
1747352751308749,135002204,1,1449,75,128834184,127892960,941224,79.68347598446279
1747352751402682,135096844,1,1450,75,128928117,127987600,940517,79.74337518620078
1747352751500705,135191484,1,1451,75,129026140,128082240,943900,79.45756965780274
1747352751594833,135286124,1,1452,75,129120268,128176880,943388,79.5006932460451
1747352751689816,135380764,1,1453,75,129215251,128271520,943731,79.47179863753549
1747352751783577,135475404,1,1454,75,129309012,128366160,942852,79.54588843211872
1747352751881803,135570044,1,1455,75,129407238,128460800,946438,79.24449356429052
1747352751976550,135664684,1,1456,75,129501985,128555440,946545,79.2355355529848
1747352752070176,135759324,1,1457,75,129595611,128650080,945531,79.3205087934716
1747352752168610,135853964,1,1458,75,129694045,128744720,949325,79.00350248861034
1747352752263275,135948604,1,1459,75,129788710,128839360,949350,79.00142202559645
1747352752357532,136043244,1,1460,75,129882967,128934000,948967,79.03330674301635
1747352752451076,136137884,1,1461,75,129976511,129028640,947871,79.12469101808158
1747352752549328,136232524,1,1462,75,130074763,129123280,951483,78.82431950964967
1747352752643610,136327164,1,1463,75,130169045,129217920,951125,78.85398869759496
1747352752738494,136421804,1,1464,75,130263929,129312560,951369,78.8337648168061
1747352752831925,136516444,1,1465,75,130357360,129407200,950160,78.93407426117706
1747352752930179,136611084,1,1466,75,130455614,129501840,953774,78.63498061385611
1747352753025020,136705724,1,1467,75,130550455,129596480,953975,78.61841243219162
1747352753119248,136800364,1,1468,75,130644683,129691120,953563,78.65238059782101
1747352753216996,136895004,1,1469,75,130742431,129785760,956671,78.39685743583739
1747352753311801,136989644,1,1470,75,130837236,129880400,956836,78.38333841954108
1747352753405581,137084284,1,1471,75,130931016,129975040,955976,78.45385239796815
1747352753500046,137178924,1,1472,75,131025481,130069680,955801,78.46821671038218
1747352753598541,137273564,1,1473,75,131123976,130164320,959656,78.15300482672959
1747352753692081,137368204,1,1474,75,131217516,130258960,958556,78.24269004627794
1747352753786076,137462844,1,1475,75,131311511,130353600,957911,78.29537399612282
1747352753885011,137557484,1,1476,75,131410446,130448240,962206,77.94588684751498
1747352753979527,137652124,1,1477,75,131504962,130542880,962082,77.9559330701541
1747352754072985,137746764,1,1478,75,131598420,130637520,960900,78.05182641273807
1747352754167302,137841404,1,1479,75,131692737,130732160,960577,78.07807182557983
1747352754265817,137936044,1,1480,75,131791252,130826800,964452,77.76436774458449
1747352754360022,138030684,1,1481,75,131885457,130921440,964017,77.7994578933774
1747352754454407,138125332,1,1482,75,131979842,131016088,963754,77.82068868196656
1747352754548381,138219964,1,1483,75,132073816,131110720,963096,77.873856811782
1747352754646564,138314604,1,1484,75,132171999,131205360,966639,77.58842753085692
1747352754740798,138409244,1,1485,75,132266233,131300000,966233,77.62102929624635
1747352754834701,138503884,1,1486,75,132360136,131394640,965496,77.68028039474011
1747352754933750,138598524,1,1487,75,132459185,131489280,969905,77.32716090751155
1747352755027947,138693164,1,1488,75,132553382,131583920,969462,77.36249589978772
1747352755122048,138787804,1,1489,75,132647483,131678560,968923,77.40553170891805
1747352755216261,138882444,1,1490,75,132741696,131773200,968496,77.43965901769342
1747352755313956,138977084,1,1491,75,132839391,131867840,971551,77.19615336714182
1747352755408772,139071724,1,1492,75,132934207,131962480,971727,77.1821715358326
1747352755502295,139166364,1,1493,75,133027730,132057120,970610,77.2709945292136
1747352755597479,139261004,1,1494,75,133122914,132151760,971154,77.22771053818447
1747352755695537,139355644,1,1495,75,133220972,132246400,974572,76.95685901092993
1747352755788962,139450284,1,1496,75,133314397,132341040,973357,77.05292097349688
1747352755883186,139544924,1,1497,75,133408621,132435680,972941,77.08586646055619
1747352755981626,139639564,1,1498,75,133507061,132530320,976741,76.78596475421837
1747352756076206,139734204,1,1499,75,133601641,132624960,976681,76.79068191149413
1747352756169818,139828844,1,1500,75,133695253,132719600,975653,76.87159266665505
1747352847177226,841164,1,9,100,0,0,0,0.0
1747352847266470,929564,1,10,100,89244,88400,844,118483.41232227487
1747352847385795,1019004,1,11,100,208569,177840,30729,3254.254938331869
1747352847459806,1109484,1,12,100,282580,268320,14260,7012.622720897616
1747352847544904,1199964,1,13,100,367678,358800,8878,11263.798152737105
1747352847722017,1384044,1,15,100,544791,542880,1911,52328.62375719519
1747352848118960,1755324,1,19,100,941734,914160,27574,3626.60477261188
1747352848196218,1848924,1,20,100,1018992,1007760,11232,8903.133903133903
1747352848479339,2126604,1,23,100,1302113,1285440,16673,5997.720866070893
1747352848565450,2217084,1,24,100,1388224,1375920,12304,8127.43823146944
1747352848655430,2307564,1,25,100,1478204,1466400,11804,8471.704506946797
1747352849044662,2678844,1,29,100,1867436,1837680,29756,3360.666756284447
1747352849142032,2772444,1,30,100,1964806,1931280,33526,2982.759649227465
1747352849219909,2866044,1,31,100,2042683,2024880,17803,5617.030837499298
1747352849310689,2956524,1,32,100,2133463,2115360,18103,5523.946307241893
1747352849420646,3047004,1,33,100,2243420,2205840,37580,2660.989888238425
1747352850362874,3979884,1,43,100,3185648,3138720,46928,2130.923968632799
1747352850432925,4070364,1,44,100,3255699,3229200,26499,3773.7273104645456
1747352850522997,4160844,1,45,100,3345771,3319680,26091,3832.7392587482273
1747352853181386,6778524,1,73,100,6004160,5937360,66800,1497.005988023952
1747352853357002,6965724,1,75,100,6179776,6124560,55216,1811.0692552883224
1747352853443685,7059324,1,76,100,6266459,6218160,48299,2070.4362409159608
1747352853533775,7149804,1,77,100,6356549,6308640,47909,2087.290488217245
1747352853840824,7427484,1,80,100,6663598,6586320,77278,1294.029348585626
1747352854020551,7614684,1,82,100,6843325,6773520,69805,1432.562137382709
1747352854397629,7989084,1,86,100,7220403,7147920,72483,1379.6338451774898
1747352854573635,8173164,1,88,100,7396409,7332000,64409,1552.578055861759
1747352854654857,8263644,1,89,100,7477631,7422480,55151,1813.2037497053543
1747352854746037,8354124,1,90,100,7568811,7512960,55851,1790.4782367370326
1747352854835788,8444604,1,91,100,7658562,7603440,55122,1814.1576865861184
1747352854929717,8535084,1,92,100,7752491,7693920,58571,1707.3295658260915
1747352855020246,8625564,1,93,100,7843020,7784400,58620,1705.90242238144
1747352855114006,8716044,1,94,100,7936780,7874880,61900,1615.5088852988692
1747352855208181,8806524,1,95,100,8030955,7965360,65595,1524.5064410397133
1747352855294565,8897004,1,96,100,8117339,8055840,61499,1626.0426998812989
1747352855384052,8987484,1,97,100,8206826,8146320,60506,1652.728655009421
1747352855474259,9077964,1,98,100,8297033,8236800,60233,1660.21948101539
1747352855564490,9168444,1,99,100,8387264,8327280,59984,1667.111229661243
1747352855658723,9258924,1,100,100,8481497,8417760,63737,1568.9473931939062
1747352856044114,9634364,1,104,100,8866888,8793200,73688,1357.0730648138094
1747352856137856,9725884,1,105,100,8960630,8884720,75910,1317.3494928204452
1747352856609629,10201164,1,110,100,9432403,9360000,72403,1381.1582392994767
1747352856728268,10293724,1,111,100,9551042,9452560,98482,1015.4139842813915
1747352856814169,10389404,1,112,100,9636943,9548240,88703,1127.3575865528787
1747352856908224,10485084,1,113,100,9730998,9643920,87078,1148.3956912193664
1747352857002526,10580764,1,114,100,9825300,9739600,85700,1166.8611435239206
1747352857108578,10673324,1,115,100,9931352,9832160,99192,1008.145818211146
1747352858349662,11914044,1,128,100,11172436,11072880,99556,1004.4598015187432
1747352858456130,12009724,1,129,100,11278904,11168560,110344,906.2567969259768
1747352858746674,12296764,1,132,100,11569448,11455600,113848,878.3641346356545
1747352858816424,12392444,1,133,100,11639198,11551280,87918,1137.4235082690689
1747352858906341,12485004,1,134,100,11729115,11643840,85275,1172.6766344180592
1747352859000835,12577564,1,135,100,11823609,11736400,87209,1146.6706417915582
1747352859095435,12670124,1,136,100,11918209,11828960,89249,1120.4607334535965
1747352859189442,12762684,1,137,100,12012216,11921520,90696,1102.5844579694806
1747352859283602,12855244,1,138,100,12106376,12014080,92296,1083.470572939239
1747352859374088,12947804,1,139,100,12196862,12106640,90222,1108.3771142293454
1747352859475705,13040364,1,140,100,12298479,12199200,99279,1007.262361627333
1747352863428513,16963244,1,181,100,16251287,16122080,129207,773.9518756723708
1747352863518845,17058924,1,182,100,16341619,16217760,123859,807.3696703509636
1747352866229524,19734844,1,210,100,19052298,18893680,158618,630.4454727710599
1747352866315875,19830524,1,211,100,19138649,18989360,149289,669.8417164024141
1747352866402157,19923084,1,212,100,19224931,19081920,143011,699.2469110767703
1747352866492295,20015644,1,213,100,19315069,19174480,140589,711.293202170867
1747352866590464,20108204,1,214,100,19413238,19267040,146198,684.0038851420676
1747352866680082,20200764,1,215,100,19502856,19359600,143256,698.0510414921539
1747352866774547,20293324,1,216,100,19597321,19452160,145161,688.8902666694222
1747352866873456,20385884,1,217,100,19696230,19544720,151510,660.0224407629859
1747352866958593,20478444,1,218,100,19781367,19637280,144087,694.0251375904836
1747352867057127,20571004,1,219,100,19879901,19729840,150061,666.3956657625898
1747352867147131,20663564,1,220,100,19969905,19822400,147505,677.9431205721841
1747352867241536,20756124,1,221,100,20064310,19914960,149350,669.5681285570806
1747352867331322,20848684,1,222,100,20154096,20007520,146576,682.239930138631
1747352867426275,20941244,1,223,100,20249049,20100080,148969,671.280602004444
1747352867524087,21033804,1,224,100,20346861,20192640,154221,648.4201243669798
1747352867618313,21126364,1,225,100,20441087,20285200,155887,641.490310288863
1747352867707574,21218924,1,226,100,20530348,20377760,152588,655.3595302382887
1747352867798560,21311484,1,227,100,20621334,20470320,151014,662.1902605056484
1747352867896773,21404044,1,228,100,20719547,20562880,156667,638.2965142627356
1747352867986545,21496604,1,229,100,20809319,20655440,153879,649.8612546221382
1747352868085320,21589164,1,230,100,20908094,20748000,160094,624.6330280959936
1747352868179233,21681724,1,231,100,21002007,20840560,161447,619.3983164753757
1747352868265231,21774284,1,232,100,21088005,20933120,154885,645.6403137811925
1747352868359840,21866844,1,233,100,21182614,21025680,156934,637.2105471089758
1747352868454054,21959404,1,234,100,21276828,21118240,158588,630.5647337755694
1747352868552691,22055084,1,235,100,21375465,21213920,161545,619.022563372435
1747352868670937,22147644,1,236,100,21493711,21306480,187231,534.0995882092175
1747352868748315,22243324,1,237,100,21571089,21402160,168929,591.964671548402
1747352868859032,22339004,1,238,100,21681806,21497840,183966,543.5787047606623
1747352868949237,22434684,1,239,100,21772011,21593520,178491,560.2523376528789
1747352869146473,22622924,1,241,100,21969247,21781760,187487,533.3703136750815
1747352869343011,22814284,1,243,100,22165785,21973120,192665,519.0356317961227
1747352869608536,23101324,1,246,100,22431310,22260160,171150,584.28279287175
1747352869793297,23289564,1,248,100,22616071,22448400,167671,596.406057099916
1747352870473028,23956204,1,255,100,23295802,23115040,180762,553.2136179064183
1747352870575634,24051884,1,256,100,23398408,23210720,187688,532.7991134222752
1747352870862315,24335804,1,259,100,23685089,23494640,190449,525.0749544497477
1747352870960663,24431484,1,260,100,23783437,23590320,193117,517.820802932937
1747352871046862,24527164,1,261,100,23869636,23686000,183636,544.5555337733342
1747352871156587,24622844,1,262,100,23979361,23781680,197681,505.8655105953532
1747352871234432,24718524,1,263,100,24057206,23877360,179846,556.0312711986923
1747352871349171,24811084,1,264,100,24171945,23969920,202025,494.9882440292043
1747352871439343,24903644,1,265,100,24262117,24062480,199637,500.909150107445
1747352871812206,25286364,1,269,100,24634980,24445200,189780,526.9259142164611
1747352872771007,26243164,1,279,100,25593781,25402000,191781,521.4280872453476
1747352872967909,26431404,1,281,100,25790683,25590240,200443,498.8949476908647
1747352873065435,26527084,1,282,100,25888209,25685920,202289,494.3422529153834
1747352873147150,26619644,1,283,100,25969924,25778480,191444,522.345960176344
1747352873241357,26712204,1,284,100,26064131,25871040,193091,517.8905283001279
1747352873332319,26804764,1,285,100,26155093,25963600,191493,522.2123001885186
1747352873425863,26897324,1,286,100,26248637,26056160,192477,519.5425946996264
1747352873519926,26989884,1,287,100,26342700,26148720,193980,515.5170636148056
1747352873610314,27082444,1,288,100,26433088,26241280,191808,521.3546880213547
1747352873704752,27175004,1,289,100,26527526,26333840,193686,516.2995776669454
1747352873798863,27267564,1,290,100,26621637,26426400,195237,512.1979952570466
1747352873893189,27360124,1,291,100,26715963,26518960,197003,507.6064831500028
1747352873986620,27452684,1,292,100,26809394,26611520,197874,505.37210548126586
1747352874077684,27545244,1,293,100,26900458,26704080,196378,509.2220106121867
1747352874171138,27637804,1,294,100,26993912,26796640,197272,506.914311204834
1747352874265297,27730364,1,295,100,27088071,26889200,198871,502.8385234649597
1747352874359773,27822924,1,296,100,27182547,26981760,200787,498.04021176669806
1747352874450286,27915484,1,297,100,27273060,27074320,198740,503.1699708161417
1747352874544396,28008044,1,298,100,27367170,27166880,200290,499.2760497278946
1747352874638185,28100604,1,299,100,27460959,27259440,201519,496.23112460859767
1747352874732852,28193164,1,300,100,27555626,27352000,203626,491.0964218714702
1747352874831239,28285724,1,301,100,27654013,27444560,209453,477.4340782896402
1747352874917176,28378284,1,302,100,27739950,27537120,202830,493.02371444066455
1747352875010798,28470844,1,303,100,27833572,27629680,203892,490.455731465678
1747352875105248,28563404,1,304,100,27928022,27722240,205782,485.95115219018186
1747352875199209,28655964,1,305,100,28021983,27814800,207183,482.6650835251927
1747352875289379,28748524,1,306,100,28112153,27907360,204793,488.2979398709917
1747352875383610,28841084,1,307,100,28206384,27999920,206464,484.3459392436454
1747352875486609,28933644,1,308,100,28309383,28092480,216903,461.0355781155632
1747352875571890,29026204,1,309,100,28394664,28185040,209624,477.0446132122276
1747352875666699,29118764,1,310,100,28489473,28277600,211873,471.9808564564621
1747352875760709,29211324,1,311,100,28583483,28370160,213323,468.77270617795546
1747352875850730,29303884,1,312,100,28673504,28462720,210784,474.4193107636253
1747352875944656,29396444,1,313,100,28767430,28555280,212150,471.36460051850105
1747352876035544,29489004,1,314,100,28858318,28647840,210478,475.1090375241118
1747352876129694,29581564,1,315,100,28952468,28740400,212068,471.5468623271781
1747352876223627,29674124,1,316,100,29046401,28832960,213441,468.51354706921353
1747352876317255,29766692,1,317,100,29140029,28925528,214501,466.1982927818518
1747352876411464,29859244,1,318,100,29234238,29018080,216158,462.62456166322784
1747352876501510,29951804,1,319,100,29324284,29110640,213644,468.06837542828254
1747352876595658,30044364,1,320,100,29418432,29203200,215232,464.6149271483794
1747352876689950,30136924,1,321,100,29512724,29295760,216964,460.905956748585
1747352876780245,30229484,1,322,100,29603019,29388320,214699,465.7683547664405
1747352876874915,30322044,1,323,100,29697689,29480880,216809,461.2354653173992
1747352876969175,30414604,1,324,100,29791949,29573440,218509,457.6470534394464
1747352877062491,30507164,1,325,100,29885265,29666000,219265,456.0691400816364
1747352877157521,30599724,1,326,100,29980295,29758560,221735,450.9887929284957
1747352877247773,30692284,1,327,100,30070547,29851120,219427,455.7324303754779
1747352877341531,30784844,1,328,100,30164305,29943680,220625,453.257790368272
1747352877435262,30877404,1,329,100,30258036,30036240,221796,450.8647586070082
1747352877530304,30969964,1,330,100,30353078,30128800,224278,445.87520844666
1747352877620381,31062524,1,331,100,30443155,30221360,221795,450.86679140647897
1747352877714482,31155084,1,332,100,30537256,30313920,223336,447.7558476913708
1747352877808203,31247644,1,333,100,30630977,30406480,224497,445.4402508719493
1747352877902923,31340204,1,334,100,30725697,30499040,226657,441.1952862695615
1747352877997129,31432764,1,335,100,30819903,30591600,228303,438.014393152959
1747352878086869,31525324,1,336,100,30909643,30684160,225483,443.4924140622575
1747352878181420,31617884,1,337,100,31004194,30776720,227474,439.61068078110026
1747352878274755,31710444,1,338,100,31097529,30869280,228249,438.1180202322902
1747352878365090,31803004,1,339,100,31187864,30961840,226024,442.4308922946236
1747352878459775,31895572,1,340,100,31282549,31054408,228141,438.3254215594741
1747352878553970,31988124,1,341,100,31376744,31146960,229784,435.19131009992
1747352878647744,32080684,1,342,100,31470518,31239520,230998,432.90418098858
1747352878741651,32173244,1,343,100,31564425,31332080,232345,430.3944565194
1747352878832251,32265804,1,344,100,31655025,31424640,230385,434.0560366343295
1747352878925817,32358364,1,345,100,31748591,31517200,231391,432.168926189869
1747352879020517,32450924,1,346,100,31843291,31609760,233531,428.2086746513311
1747352879115213,32543484,1,347,100,31937987,31702320,235667,424.3275469200185
1747352879204389,32636044,1,348,100,32027163,31794880,232283,430.5093355949424
1747352879298787,32728604,1,349,100,32121561,31887440,234121,427.12956120980175
1747352879393568,32821164,1,350,100,32216342,31980000,236342,423.1156544329827
1747352879487232,32913724,1,351,100,32310006,32072560,237446,421.14838742282456
1747352879578185,33006284,1,352,100,32400959,32165120,235839,424.0180801309368
1747352879671760,33098844,1,353,100,32494534,32257680,236854,422.2010183488562
1747352879766627,33191404,1,354,100,32589401,32350240,239161,418.12837377331584
1747352879859895,33283964,1,355,100,32682669,32442800,239869,416.8942214291968
1747352879954847,33376524,1,356,100,32777621,32535360,242261,412.7779543550138
1747352880048352,33469084,1,357,100,32871126,32627920,243206,411.17406642928216
1747352880138799,33561644,1,358,100,32961573,32720480,241093,414.777699891743
1747352880232745,33654204,1,359,100,33055519,32813040,242479,412.4068476032976
1747352880331658,33746764,1,360,100,33154432,32905600,248832,401.8775720164609
1747352880417569,33839324,1,361,100,33240343,32998160,242183,412.9108979573298
1747352880511295,33931884,1,362,100,33334069,33090720,243349,410.932446815068
1747352880605637,34024444,1,363,100,33428411,33183280,245131,407.945139537635
1747352880703965,34117004,1,364,100,33526739,33275840,250899,398.5667539527858
1747352880790147,34209564,1,365,100,33612921,33368400,244521,408.9628293684388
1747352880888307,34302124,1,366,100,33711081,33460960,250121,399.80649365707
1747352880978344,34394684,1,367,100,33801118,33553520,247598,403.88048368726726
1747352881072709,34487244,1,368,100,33895483,33646080,249403,400.9574864777088
1747352881162268,34579804,1,369,100,33985042,33738640,246402,405.8408616813175
1747352881257366,34672364,1,370,100,34080140,33831200,248940,401.7032216598377
1747352881351167,34764924,1,371,100,34173941,33923760,250181,399.71060951870845
1747352881445651,34857484,1,372,100,34268425,34016320,252105,396.6601217746573
1747352881539288,34950044,1,373,100,34362062,34108880,253182,394.9727863750188
1747352881629806,35042604,1,374,100,34452580,34201440,251140,398.1842796846381
1747352881727444,35135164,1,375,100,34550218,34294000,256218,390.2926414225386
1747352881818112,35227724,1,376,100,34640886,34386560,254326,393.1961340956096
1747352881912055,35320284,1,377,100,34734829,34479120,255709,391.0695360742093
1747352882002262,35412844,1,378,100,34825036,34571680,253356,394.7015267055053
1747352882096262,35505404,1,379,100,34919036,34664240,254796,392.4708394166313
1747352882190907,35597964,1,380,100,35013681,34756800,256881,389.2853110973563
1747352882284775,35690532,1,381,100,35107549,34849368,258181,387.3251711008944
1747352882375776,35783084,1,382,100,35198550,34941920,256630,389.6660561898453
1747352882469901,35875644,1,383,100,35292675,35034480,258195,387.3041693293828
1747352882564300,35968204,1,384,100,35387074,35127040,260034,384.5650953336872
1747352882658380,36060764,1,385,100,35481154,35219600,261554,382.3302262630279
1747352882747786,36153324,1,386,100,35570560,35312160,258400,386.9969040247678
1747352882842098,36245884,1,387,100,35664872,35404720,260152,384.3906639195548
1747352882936904,36338444,1,388,100,35759678,35497280,262398,381.1004657047691
1747352883030411,36431004,1,389,100,35853185,35589840,263345,379.7300119614954
1747352883124283,36523564,1,390,100,35947057,35682400,264657,377.8475536260141
1747352883215296,36616124,1,391,100,36038070,35774960,263110,380.06917258941127
1747352883308956,36708684,1,392,100,36131730,35867520,264210,378.4868097346807
1747352883402650,36801244,1,393,100,36225424,35960080,265344,376.8692715870719
1747352883497548,36893804,1,394,100,36320322,36052640,267682,373.5776032755285
1747352883587684,36986364,1,395,100,36410458,36145200,265258,376.991457373576
1747352883681406,37078924,1,396,100,36504180,36237760,266420,375.3471961564448
1747352883775344,37171484,1,397,100,36598118,36330320,267798,373.4157835383386
1747352883869630,37264044,1,398,100,36692404,36422880,269524,371.0244727742242
1747352883959793,37356604,1,399,100,36782567,36515440,267127,374.3537718014278
1747352884054480,37449164,1,400,100,36877254,36608000,269254,371.3965252141101
1747352884148794,37541724,1,401,100,36971568,36700560,271008,368.9927972605975
1747352884242718,37634284,1,402,100,37065492,36793120,272372,367.1449341341988
1747352884333262,37726844,1,403,100,37156036,36885680,270356,369.8826732160559
1747352884427463,37819412,1,404,100,37250237,36978248,271989,367.6619275044212
1747352884521333,37911964,1,405,100,37344107,37070800,273307,365.8889088095072
1747352884623299,38004524,1,406,100,37446073,37163360,282713,353.7156055788025
1747352884709397,38097084,1,407,100,37532171,37255920,276251,361.98963985650727
1747352884803543,38189644,1,408,100,37626317,37348480,277837,359.92326436003844
1747352884898575,38282204,1,409,100,37721349,37441040,280309,356.7491589638578
1747352884988751,38374764,1,410,100,37811525,37533600,277925,359.8093010704327
1747352885082211,38467324,1,411,100,37904985,37626160,278825,358.6478974267014
1747352885181151,38559884,1,412,100,38003925,37718720,285205,350.6249890429691
1747352885267093,38652444,1,413,100,38089867,37811280,278587,358.9542943497005
1747352885373559,38745004,1,414,100,38196333,37903840,292493,341.88852382792066
1747352885454882,38837564,1,415,100,38277656,37996400,281256,355.5479705321842
1747352885549298,38930124,1,416,100,38372072,38088960,283112,353.2171013591794
1747352885643347,39022684,1,417,100,38466121,38181520,284601,351.36910973608667
1747352885733514,39115244,1,418,100,38556288,38274080,282208,354.3485655970064
1747352885828169,39207804,1,419,100,38650943,38366640,284303,351.73740692148874
1747352885918319,39300364,1,420,100,38741093,38459200,281893,354.7445307261975
1747352886012713,39392924,1,421,100,38835487,38551760,283727,352.45147624300824
1747352886106727,39485484,1,422,100,38929501,38644320,285181,350.6544966179373
1747352886200894,39578044,1,423,100,39023668,38736880,286788,348.6896243915366
1747352886294855,39670604,1,424,100,39117629,38829440,288189,346.994507076953
1747352886384763,39763164,1,425,100,39207537,38922000,285537,350.21730984075623
1747352886487205,39855724,1,426,100,39309979,39014560,295419,338.5022628876274
1747352886573728,39948284,1,427,100,39396502,39107120,289382,345.56399499623336
1747352886667212,40040844,1,428,100,39489986,39199680,290306,344.4641171729141
1747352886757694,40133404,1,429,100,39580468,39292240,288228,346.9475554075246
1747352886851585,40225964,1,430,100,39674359,39384800,289559,345.3527605772917
1747352886945799,40318524,1,431,100,39768573,39477360,291213,343.39126343947555
1747352887039769,40411084,1,432,100,39862543,39569920,292623,341.7366372431422
1747352887130446,40503644,1,433,100,39953220,39662480,290740,343.9499208915182
1747352887224056,40596204,1,434,100,40046830,39755040,291790,342.71222454504954
1747352887318289,40688764,1,435,100,40141063,39847600,293463,340.75846018067017
1747352887422192,40781324,1,436,100,40244966,39940160,304806,328.0775312821926
1747352887621612,40969564,1,438,100,40444386,40128400,315986,316.4697170127791
1747352887699502,41062124,1,439,100,40522276,40220960,301316,331.8774973781678
1747352887793768,41154684,1,440,100,40616542,40313520,303022,330.0090422477576
1747352887880228,41247244,1,441,100,40703002,40406080,296922,336.788786280572
1747352887978238,41339804,1,442,100,40801012,40498640,302372,330.7184527667906
1747352888068314,41432364,1,443,100,40891088,40591200,299888,333.4578242543883
1747352888161984,41524924,1,444,100,40984758,40683760,300998,332.22812111708384
1747352888256205,41617484,1,445,100,41078979,40776320,302659,330.4048450566479
1747352888346563,41710044,1,446,100,41169337,40868880,300457,332.8263278938417
1747352888440801,41802604,1,447,100,41263575,40961440,302135,330.97787412911447
1747352888551358,41895164,1,448,100,41374132,41054000,320132,312.37114690190293
1747352888633387,41990844,1,449,100,41456161,41149680,306481,326.2845005073724
1747352888743939,42086524,1,450,100,41566713,41245360,321353,311.18427399152955
1747352888846128,42179084,1,451,100,41668902,41337920,330982,302.1312337226798
1747352888919868,42274764,1,452,100,41742642,41433600,309042,323.58061363827574
1747352889018094,42367324,1,453,100,41840868,41526160,314708,317.75487118217524
1747352889104673,42459884,1,454,100,41927447,41618720,308727,323.910769061339
1747352889198646,42552444,1,455,100,42021420,41711280,310140,322.43502934158766
1747352889289126,42645004,1,456,100,42111900,41803840,308060,324.6120885541778
1747352889383031,42737564,1,457,100,42205805,41896400,309405,323.2009825309869
1747352889477331,42830124,1,458,100,42300105,41988960,311145,321.3935624869434
1747352889566764,42922684,1,459,100,42389538,42081520,308018,324.6563512521996
1747352889661783,43015244,1,460,100,42484557,42174080,310477,322.08504977824447
1747352889756008,43107804,1,461,100,42578782,42266640,312142,320.3670124494621
1747352889849775,43200364,1,462,100,42672549,42359200,313349,319.13297952123673
1747352889940154,43292924,1,463,100,42762928,42451760,311168,321.3698066639243
1747352890033906,43385484,1,464,100,42856680,42544320,312360,320.1434242540658
1747352890128151,43478052,1,465,100,42950925,42636888,314037,318.4338151236956
1747352890221966,43570604,1,466,100,43044740,42729440,315300,317.15826197272435
1747352890316627,43663164,1,467,100,43139401,42822000,317401,315.0588687496259
1747352890407262,43755724,1,468,100,43230036,42914560,315476,316.9813234604217
1747352890501359,43848284,1,469,100,43324133,43007120,317013,315.4444770403737
1747352890595463,43940844,1,470,100,43418237,43099680,318557,313.91556299186647
1747352890689027,44033404,1,471,100,43511801,43192240,319561,312.9292998832774
1747352890779781,44125964,1,472,100,43602555,43284800,317755,314.7078724174285
1747352890873609,44218524,1,473,100,43696383,43377360,319023,313.4570234747965
1747352890968067,44311084,1,474,100,43790841,43469920,320921,311.6031671345908
1747352891062044,44403644,1,475,100,43884818,43562480,322338,310.2333575315352
1747352891151947,44496204,1,476,100,43974721,43655040,319681,312.8118342973152
1747352891246279,44588764,1,477,100,44069053,43747600,321453,311.0874684635079
1747352891340672,44681324,1,478,100,44163446,43840160,323286,309.3236329442042
1747352891435004,44773884,1,479,100,44257778,43932720,325058,307.63740624750045
1747352891525452,44866444,1,480,100,44348226,44025280,322946,309.6492912127724
1747352891619502,44959004,1,481,100,44442276,44117840,324436,308.2272004339839
1747352891713750,45051564,1,482,100,44536524,44210400,326124,306.63183329040487
1747352891807380,45144124,1,483,100,44630154,44302960,327194,305.62907632780554
1747352891901489,45236684,1,484,100,44724263,44395520,328743,304.18898653355353
1747352891991479,45329244,1,485,100,44814253,44488080,326173,306.58576890177915
1747352892086514,45421804,1,486,100,44909288,44580640,328648,304.2769163360191
1747352892180589,45514364,1,487,100,45003363,44673200,330163,302.88069832173807
1747352892274619,45606932,1,488,100,45097393,44765768,331625,301.5454202789295
1747352892365028,45699484,1,489,100,45187802,44858320,329482,303.50671660363844
1747352892459058,45792044,1,490,100,45281832,44950880,330952,302.1586211897797
1747352892552552,45884604,1,491,100,45375326,45043440,331886,301.3082805541662
1747352892647099,45977164,1,492,100,45469873,45136000,333873,299.5150850772599
1747352892737248,46069724,1,493,100,45560022,45228560,331462,301.69370847940337
1747352893028235,46353644,1,496,100,45851009,45512480,338529,295.3956677271371
1747352893122518,46446204,1,497,100,45945292,45605040,340252,293.8998154309159
1747352893212513,46538772,1,498,100,46035287,45697608,337679,296.13923282170344
1747352893307039,46631324,1,499,100,46129813,45790160,339653,294.41812673522685
1747352893396742,46723884,1,500,100,46219516,45882720,336796,296.91564032826994
1747352893491032,46816444,1,501,100,46313806,45975280,338526,295.3982855083509
1747352893589283,46909004,1,502,100,46412057,46067840,344217,290.5144138726443
1747352893896447,47192924,1,505,100,46719221,46351760,367461,272.1377234590882
1747352893965652,47285484,1,506,100,46788426,46444320,344106,290.6081265656513
1747352894059896,47378044,1,507,100,46882670,46536880,345790,289.19286272014807
1747352894149850,47470612,1,508,100,46972624,46629448,343176,291.3956686947805
1747352894244145,47563164,1,509,100,47066919,46722000,344919,289.92314137522146
1747352894334360,47655724,1,510,100,47157134,46814560,342574,291.9077338034994
1747352894428515,47748284,1,511,100,47251289,46907120,344169,290.55493086245417
1747352894523405,47840844,1,512,100,47346179,46999680,346499,288.6011215039581
1747352894617426,47933404,1,513,100,47440200,47092240,347960,287.3893550982872
1747352894711671,48025964,1,514,100,47534445,47184800,349645,286.0043758669508
1747352894801444,48118524,1,515,100,47624218,47277360,346858,288.30241770407486
1747352894896143,48211084,1,516,100,47718917,47369920,348997,286.5354143445359
1747352894990152,48303644,1,517,100,47812926,47462480,350446,285.3506674352112
1747352895091925,48396204,1,518,100,47914699,47555040,359659,278.0411445285673
1747352895178617,48488764,1,519,100,48001391,47647600,353791,282.6527526138313
1747352895272259,48581324,1,520,100,48095033,47740160,354873,281.79095056541354
1747352895363041,48673884,1,521,100,48185815,47832720,353095,283.2099010181396
1747352895457178,48766444,1,522,100,48279952,47925280,354672,281.95064735868635
1747352895550695,48859004,1,523,100,48373469,48017840,355629,281.1919162947904
1747352895640777,48951564,1,524,100,48463551,48110400,353151,283.1649917457405
1747352895743792,49044124,1,525,100,48566566,48202960,363606,275.0229644175289
1747352895845328,49136684,1,526,100,48668102,48295520,372582,268.3972924081142
1747352895948676,49232364,1,527,100,48771450,48391200,380250,262.98487836949374
1747352896042124,49324924,1,528,100,48864898,48483760,381138,262.37215916544665
1747352896222895,49516284,1,530,100,49045669,48675120,370549,269.8698417753117
1747352897463278,50757004,1,543,100,50286052,49915840,370212,270.1155013883937
1747352897570430,50849564,1,544,100,50393204,50008400,384804,259.8725584973129
1747352897647948,50942124,1,545,100,50470722,50100960,369762,270.4442316949822
1747352897750828,51034684,1,546,100,50573602,50193520,380082,263.1011202845702
1747352897938878,51222924,1,548,100,50761652,50381760,379892,263.2327082433955
1747352898024708,51315484,1,549,100,50847482,50474320,373162,267.9801265938118
1747352898131450,51408044,1,550,100,50954224,50566880,387344,258.1684497500929
1747352898208940,51500604,1,551,100,51031714,50659440,372274,268.6193502635156
1747352898311045,51593164,1,552,100,51133819,50752000,381819,261.9042006814747
1747352898397048,51685724,1,553,100,51219822,50844560,375262,266.48048563403705
1747352898487533,51778284,1,554,100,51310307,50937120,373187,267.9621744594533
1747352898598057,51870844,1,555,100,51420831,51029680,391151,255.65574420108857
1747352898684142,51963404,1,556,100,51506916,51122240,384676,259.9590304568
1747352898770698,52055964,1,557,100,51593472,51214800,378672,264.08078759454094
1747352898862118,52148524,1,558,100,51684892,51307360,377532,264.878208999502
1747352898958632,52241084,1,559,100,51781406,51399920,381486,262.1328174559486
1747352899057154,52333644,1,560,100,51879928,51492480,387448,258.0991513699903
1747352899261350,52521884,1,562,100,52084124,51680720,403404,247.8904522513411
1747352899548906,52808924,1,565,100,52371680,51967760,403920,247.57377698554168
1747352899622442,52904604,1,566,100,52445216,52063440,381776,261.9336993420225
1747352900318695,53571244,1,573,100,53141469,52730080,411389,243.07893502256988
1747352900416316,53666924,1,574,100,53239090,52825760,413330,241.9374349793144
1747352900506579,53759484,1,575,100,53329353,52918320,411033,243.28946824220927
1747352900609488,53855164,1,576,100,53432262,53014000,418262,239.08459291066364
1747352900772039,54046524,1,578,100,53594813,53205360,389453,256.7703933465656
1747352900891436,54142204,1,579,100,53714210,53301040,413170,242.03112520270108
1747352900965232,54234764,1,580,100,53788006,53393600,394406,253.54583855215185
1747352901059854,54327332,1,581,100,53882628,53486168,396460,252.2322554608284
1747352901154128,54419884,1,582,100,53976902,53578720,398182,251.1414378349599
1747352901243856,54512444,1,583,100,54066630,53671280,395350,252.94043252813964
1747352901338546,54605004,1,584,100,54161320,53763840,397480,251.58498540807085
1747352901428794,54697564,1,585,100,54251568,53856400,395168,253.05692768645235
1747352901526767,54790124,1,586,100,54349541,53948960,400581,249.6374016740684
1747352901616773,54882684,1,587,100,54439547,54041520,398027,251.2392375391619
1747352901711378,54975244,1,588,100,54534152,54134080,400072,249.9550080985423
1747352901805547,55067804,1,589,100,54628321,54226640,401681,248.95377177411925
1747352901895628,55160364,1,590,100,54718402,54319200,399202,250.49974699525552
1747352901989354,55252924,1,591,100,54812128,54411760,400368,249.77021140550693
1747352902084056,55345484,1,592,100,54906830,54504320,402510,248.4410325209312
1747352902178150,55438044,1,593,100,55000924,54596880,404044,247.4977972696043
1747352902268149,55530604,1,594,100,55090923,54689440,401483,249.07654869571067
1747352902362365,55623164,1,595,100,55185139,54782000,403139,248.0534009361535
1747352902456577,55715724,1,596,100,55279351,54874560,404791,247.0410656363408
1747352902550933,55808284,1,597,100,55373707,54967120,406587,245.9498213174548
1747352902641015,55900844,1,598,100,55463789,55059680,404109,247.45798782011784
1747352902734694,55993404,1,599,100,55557468,55152240,405228,246.77465525580664
1747352902829594,56085964,1,600,100,55652368,55244800,407568,245.35782985906647
1747352902927822,56178524,1,601,100,55750596,55337360,413236,241.99246919435868
1747352903013019,56271084,1,602,100,55835793,55429920,405873,246.38248910373443
1747352903111539,56363644,1,603,100,55934313,55522480,411833,242.81686994485628
1747352903201583,56456212,1,604,100,56024357,55615048,409309,244.31419783097857
1747352903296486,56548764,1,605,100,56119260,55707600,411660,242.91891366661807
1747352903385783,56641324,1,606,100,56208557,55800160,408397,244.85978104638377
1747352903480676,56733884,1,607,100,56303450,55892720,410730,243.46894553599688
1747352903578439,56826444,1,608,100,56401213,55985280,415933,240.423337412516
1747352903672405,56919004,1,609,100,56495179,56077840,417339,239.6133598824936
1747352903762392,57011564,1,610,100,56585166,56170400,414766,241.09980085156448
1747352903856619,57104124,1,611,100,56679393,56262960,416433,240.13466752154608
1747352903951213,57196684,1,612,100,56773987,56355520,418467,238.96746935839624
1747352904041576,57289244,1,613,100,56864350,56448080,416270,240.2286977202297
1747352904139581,57381804,1,614,100,56962355,56540640,421715,237.1269696358916
1747352904226025,57474364,1,615,100,57048799,56633200,415599,240.6165558627427
1747352904324447,57566924,1,616,100,57147221,56725760,421461,237.26987787719384
1747352904414359,57659484,1,617,100,57237133,56818320,418813,238.7700477301325
1747352904511991,57752044,1,618,100,57334765,56910880,423885,235.913042452552
1747352904598910,57844604,1,619,100,57421684,57003440,418244,239.0948824131368
1747352904693143,57937164,1,620,100,57515917,57096000,419917,238.1422995496729
1747352904786515,58029724,1,621,100,57609289,57188560,420729,237.68268885672248
1747352904880738,58122284,1,622,100,57703512,57281120,422392,236.7469080853804
1747352904979469,58214844,1,623,100,57802243,57373680,428563,233.33792231247213
1747352905069033,58307404,1,624,100,57891807,57466240,425567,234.9806258473989
1747352905159918,58399964,1,625,100,57982692,57558800,423892,235.90914666943468
1747352905257414,58492524,1,626,100,58080188,57651360,428828,233.19372802149115
1747352905351643,58585084,1,627,100,58174417,57743920,430497,232.28965590933268
1747352905442562,58677644,1,628,100,58265336,57836480,428856,233.1785028074692
1747352905532688,58770204,1,629,100,58355462,57929040,426422,234.50947652794648
1747352905626958,58862764,1,630,100,58449732,58021600,428132,233.5728233348593
1747352905732959,58955324,1,631,100,58555733,58114160,441573,226.4631216129609
1747352905815056,59047884,1,632,100,58637830,58206720,431110,231.95936072000185
1747352905917609,59140444,1,633,100,58740383,58299280,441103,226.7044205094955
1747352906011479,59233004,1,634,100,58834253,58391840,442413,226.0331409791304
1747352906114142,59325564,1,635,100,58936916,58484400,452516,220.98666124512727
1747352906191726,59421244,1,636,100,59014500,58580080,434420,230.19198011141293
1747352906282148,59513804,1,637,100,59104922,58672640,432282,231.3304740886736
1747352906474376,59702044,1,639,100,59297150,58860880,436270,229.21585256836363
1747352906564431,59794604,1,640,100,59387205,58953440,433765,230.5395778820329
1747352906658947,59887164,1,641,100,59481721,59046000,435721,229.50466009212315
1747352906753305,59979724,1,642,100,59576079,59138560,437519,228.56150247189265
1747352906843158,60072284,1,643,100,59665932,59231120,434812,229.98445305097377
1747352906937153,60164844,1,644,100,59759927,59323680,436247,229.22793738409663
1747352907031305,60257404,1,645,100,59854079,59416240,437839,228.3944554961984
1747352907125166,60349964,1,646,100,59947940,59508800,439140,227.71781208726148
1747352907215584,60442524,1,647,100,60038358,59601360,436998,228.8339992402711
1747352907309307,60535084,1,648,100,60132081,59693920,438161,228.2266107663621
1747352907404444,60627644,1,649,100,60227218,59786480,440738,226.8921672286029
1747352907498356,60720204,1,650,100,60321130,59879040,442090,226.19828541699653
1747352907592259,60812764,1,651,100,60415033,59971600,443433,225.5132116915069
1747352907682451,60905324,1,652,100,60505225,60064160,441065,226.72395225193569
1747352907789307,60997884,1,653,100,60612081,60156720,455361,219.6059829453993
1747352907878900,61090444,1,654,100,60701674,60249280,452394,221.0462561395597
1747352907965159,61183012,1,655,100,60787933,60341848,446085,224.17252317383452
1747352908055467,61275564,1,656,100,60878241,60434400,443841,225.305909098078
1747352908251854,61463804,1,658,100,61074628,60622640,451988,221.24481180916308
1747352908358435,61556364,1,659,100,61181209,60715200,466009,214.5881302721621
1747352908432428,61648932,1,660,100,61255202,60807768,447434,223.4966497852197
1747352908526386,61741484,1,661,100,61349160,60900320,448840,222.79654219766508
1747352908620530,61834044,1,662,100,61443304,60992880,450424,222.01303660550948
1747352908735317,61926604,1,663,100,61558091,61085440,472651,211.5725979634022
1747352908820928,62019164,1,664,100,61643702,61178000,465702,214.72959102602093
1747352908911523,62111724,1,665,100,61734297,61270560,463737,215.63946806056012
1747352908996707,62204284,1,666,100,61819481,61363120,456361,219.1247718363313
1747352909099115,62296844,1,667,100,61921889,61455680,466209,214.49607364937185
1747352909177212,62389404,1,668,100,61999986,61548240,451746,221.3633324921527
1747352909279240,62481964,1,669,100,62102014,61640800,461214,216.81909048727923
1747352909365667,62574524,1,670,100,62188441,61733360,455081,219.74110103476085
1747352909459841,62667084,1,671,100,62282615,61825920,456695,218.9645168000525
1747352909554472,62759644,1,672,100,62377246,61918480,458766,217.9760487917588
1747352909644352,62852204,1,673,100,62467126,62011040,456086,219.2568945330486
1747352909738060,62944764,1,674,100,62560834,62103600,457234,218.70639541241465
1747352909833015,63037324,1,675,100,62655789,62196160,459629,217.5667766829334
1747352909927055,63129884,1,676,100,62749829,62288720,461109,216.8684627712753
1747352910017166,63222444,1,677,100,62839940,62381280,458660,218.02642480268608
1747352910111016,63315004,1,678,100,62933790,62473840,459950,217.4149364061311
1747352910205327,63407564,1,679,100,63028101,62566400,461701,216.590390750724
1747352910295773,63500124,1,680,100,63118547,62658960,459587,217.58665932674336
1747352910393391,63592684,1,681,100,63216165,62751520,464645,215.2180697091328
1747352910484214,63685244,1,682,100,63306988,62844080,462908,216.02564656476017
1747352910577780,63777812,1,683,100,63400554,62936648,463906,215.5609110466345
1747352912212247,65401244,1,700,100,65035021,64560080,474941,210.5524686224184
1747352912306988,65493804,1,701,100,65129762,64652640,477122,209.590000041918
1747352912405468,65586364,1,702,100,65228242,64745200,483042,207.02133561884887
1747352912495568,65678924,1,703,100,65318342,64837760,480582,208.08103507830089
1747352912585479,65771484,1,704,100,65408253,64930320,477933,209.23434874762785
1747352912679382,65864044,1,705,100,65502156,65022880,479276,208.6480441332343
1747352912777556,65956604,1,706,100,65600330,65115440,484890,206.2323413557714
1747352912867824,66049164,1,707,100,65690598,65208000,482598,207.21179946870893
1747352912962086,66141724,1,708,100,65784860,65300560,484300,206.48358455502787
1747352913056164,66234284,1,709,100,65878938,65393120,485818,205.8384003886229
1747352913150645,66326844,1,710,100,65973419,65485680,487739,205.02768898939803
1747352913244551,66419404,1,711,100,66067325,65578240,489085,204.4634368259096
1747352913334436,66511964,1,712,100,66157210,65670800,486410,205.58787853868137
1747352913429275,66604524,1,713,100,66252049,65763360,488689,204.62911995154383
1747352913519105,66697084,1,714,100,66341879,65855920,485959,205.77867680195243
1747352913609092,66789644,1,715,100,66431866,65948480,483386,206.8740095906791
1747352913719584,66882204,1,716,100,66542358,66041040,501318,199.47418604558385
1747352913801680,66974764,1,717,100,66624454,66133600,490854,203.7265663517054
1747352913891659,67067324,1,718,100,66714433,66226160,488273,204.8034603592662
1747352913986029,67159884,1,719,100,66808803,66318720,490083,204.04706957801025
1747352914075702,67252444,1,720,100,66898476,66411280,487196,205.25620078982584
1747352914170041,67345004,1,721,100,66992815,66503840,488975,204.50943299759703
1747352914264236,67437564,1,722,100,67087010,66596400,490610,203.82788773159945
1747352914362244,67530124,1,723,100,67185018,66688960,496058,201.5893302799269
1747352914452330,67622684,1,724,100,67275104,66781520,493584,202.599760121884
1747352914547227,67715244,1,725,100,67370001,66874080,495921,201.6450200737617
1747352914637309,67807804,1,726,100,67460083,66966640,493443,202.65765245428548
1747352914734908,67900364,1,727,100,67557682,67059200,498482,200.6090490729856
1747352914825748,67992924,1,728,100,67648522,67151760,496762,201.30364238810537
1747352914914996,68085484,1,729,100,67737770,67244320,493450,202.6547775863816
1747352915009438,68178044,1,730,100,67832212,67336880,495332,201.8847964597482
1747352915120646,68270604,1,731,100,67943420,67429440,513980,194.56009961477105
1747352915215026,68363164,1,732,100,68037800,67522000,515800,193.87359441644043
1747352916835975,69989724,1,749,100,69658749,69148560,510189,196.0057939312686
1747352916946943,70082284,1,750,100,69769717,69241120,528597,189.18003696577924
1747352917033162,70177964,1,751,100,69855936,69336800,519136,192.6277507242804
1747352917229630,70366204,1,753,100,70052404,69525040,527364,189.62234813146137
1747352917307765,70458764,1,754,100,70130539,69617600,512939,194.95495565749533
1747352917401859,70551324,1,755,100,70224633,69710160,514473,194.3736600365812
1747352917492237,70643884,1,756,100,70315011,69802720,512291,195.2015553659932
1747352917590256,70736444,1,757,100,70413030,69895280,517750,193.1434089811685
1747352917680595,70829004,1,758,100,70503369,69987840,515529,193.9755086522776
1747352917774176,70921564,1,759,100,70596950,70080400,516550,193.5921014422612
1747352917868953,71014124,1,760,100,70691727,70172960,518767,192.7647672269053
1747352917970950,71106684,1,761,100,70793724,70265520,528204,189.32079272402328
1747352918053174,71199244,1,762,100,70875948,70358080,517868,193.09939984706529
1747352918146810,71291804,1,763,100,70969584,70450640,518944,192.69901954738856
1747352918240957,71384364,1,764,100,71063731,70543200,520531,192.11151689332624
1747352918335826,71476924,1,765,100,71158600,70635760,522840,191.2631015224543
1747352918425704,71569484,1,766,100,71248478,70728320,520158,192.2492781039607
1747352918519978,71662044,1,767,100,71342752,70820880,521872,191.61786798295367
1747352918613630,71754604,1,768,100,71436404,70913440,522964,191.21775112627256
1747352918704229,71847164,1,769,100,71527003,71006000,521003,191.9374744483237
1747352918798226,71939724,1,770,100,71621000,71098560,522440,191.40953985146612
1747352918892252,72032292,1,771,100,71715026,71191128,523898,190.8768500738693
1747352918986767,72124844,1,772,100,71809541,71283680,525861,190.16432098976725
1747352919080817,72217404,1,773,100,71903591,71376240,527351,189.6270226092299
1747352919175404,72309964,1,774,100,71998178,71468800,529378,188.9009365708436
1747352919265377,72402524,1,775,100,72088151,71561360,526791,189.8286037536708
1747352919359447,72495084,1,776,100,72182221,71653920,528301,189.28603201583945
1747352919453468,72587644,1,777,100,72276242,71746480,529762,188.76401100871715
1747352919543919,72680204,1,778,100,72366693,71839040,527653,189.51849037151308
1747352919638259,72772764,1,779,100,72461033,71931600,529433,188.8813126495704
1747352919732502,72865324,1,780,100,72555276,72024160,531116,188.2827856814707
1747352919826600,72957884,1,781,100,72649374,72116720,532654,187.7391327203025
1747352919916439,73050444,1,782,100,72739213,72209280,529933,188.70310020323325
1747352920010730,73143004,1,783,100,72833504,72301840,531664,188.08871768635828
1747352920104836,73235564,1,784,100,72927610,72394400,533210,187.5433694041748
1747352920199422,73328124,1,785,100,73022196,72486960,535236,186.8334715901023
1747352920289202,73420684,1,786,100,73111976,72579520,532456,187.80894571570232
1747352920387585,73513244,1,787,100,73210359,72672080,538279,185.77726420685187
1747352920477389,73605804,1,788,100,73300163,72764640,535523,186.73334291897828
1747352920571179,73698364,1,789,100,73393953,72857200,536753,186.3054328527274
1747352920661749,73790924,1,790,100,73484523,72949760,534763,186.9987265386723
1747352920756002,73883484,1,791,100,73578776,73042320,536456,186.40857777711497
1747352920850081,73976044,1,792,100,73672855,73134880,537975,185.88224359868025
1747352920944032,74068604,1,793,100,73766806,73227440,539366,185.40286187857595
1747352921034559,74161172,1,794,100,73857333,73320008,537325,186.1071046387196
1747352921129024,74253724,1,795,100,73951798,73412560,539238,185.44687132583385
1747352921226885,74346284,1,796,100,74049659,73505120,544539,183.64157571817628
1747352921317583,74438844,1,797,100,74140357,73597680,542677,184.27167541650007
1747352921423457,74531404,1,798,100,74246231,73690240,555991,179.8590264950332
1747352921505685,74623964,1,799,100,74328459,73782800,545659,183.26463963757584
1747352921604252,74716524,1,800,100,74427026,73875360,551666,181.2691012315423
1747352921690073,74809084,1,801,100,74512847,73967920,544927,183.5108188803271
1747352921784216,74901644,1,802,100,74606990,74060480,546510,182.9792684488847
1747352921874059,74994204,1,803,100,74696833,74153040,543793,183.8935035941985
1747352921984775,75086764,1,804,100,74807549,74245600,561949,177.95209173786233
1747352922070777,75179324,1,805,100,74893551,74338160,555391,180.05333179687824
1747352922169332,75271884,1,806,100,74992106,74430720,561386,178.13055544669797
1747352922279245,75364444,1,807,100,75102019,74523280,578739,172.78946122518096
1747352922755085,75839724,1,812,100,75577859,74998560,579299,172.62242814159873
1747352922832443,75935404,1,813,100,75655217,75094240,560977,178.26042778937463
1747352922918098,76027964,1,814,100,75740872,75186800,554072,180.481959023376
1747352923008813,76120524,1,815,100,75831587,75279360,552227,181.08495238371177
1747352923102327,76213084,1,816,100,75925101,75371920,553181,180.77265849694768
1747352923196859,76305644,1,817,100,76019633,75464480,555153,180.13052257665905
1747352923291048,76398204,1,818,100,76113822,75557040,556782,179.6035072972905
1747352923381291,76490772,1,819,100,76204065,75649608,554457,180.35663721442785
1747352923475139,76583324,1,820,100,76297913,75742160,555753,179.9360507275714
1747352923570155,76675884,1,821,100,76392929,75834720,558209,179.1443706568687
1747352923664140,76768444,1,822,100,76486914,75927280,559634,178.68821408277554
1747352923758149,76861004,1,823,100,76580923,76019840,561083,178.22675076592947
1747352923852669,76953564,1,824,100,76675443,76112400,563043,177.606328468696
1747352923941767,77046124,1,825,100,76764541,76204960,559581,178.70513830884178
1747352924036579,77138684,1,826,100,76859353,76297520,561833,177.98883298061878
1747352924130673,77231244,1,827,100,76953447,76390080,563367,177.5041846611534
1747352924220664,77323804,1,828,100,77043438,76482640,560798,178.31732638133516
1747352924315523,77416364,1,829,100,77138297,76575200,563097,177.58929633793113
1747352924413630,77508924,1,830,100,77236404,76667760,568644,175.85695092184213
1747352924503584,77601484,1,831,100,77326358,76760320,566038,176.6665842222607
1747352924593291,77694044,1,832,100,77416065,76852880,563185,177.5615472713229
1747352924691490,77786604,1,833,100,77514264,76945440,568824,175.8013023360477
1747352924782173,77879164,1,834,100,77604947,77038000,566947,176.38333036421395
1747352924876566,77971724,1,835,100,77699340,77130560,568780,175.81490207109957
1747352924970846,78064284,1,836,100,77793620,77223120,570500,175.28483786152498
1747352925060958,78156844,1,837,100,77883732,77315680,568052,176.0402216698471
1747352925155116,78249404,1,838,100,77977890,77408240,569650,175.54638813306417
1747352925249203,78341964,1,839,100,78071977,77500800,571177,175.0770776834501
1747352925342721,78434524,1,840,100,78165495,77593360,572135,174.783923374728
1747352925433702,78527084,1,841,100,78256476,77685920,570556,175.26763367662423
1747352925527424,78619644,1,842,100,78350198,77778480,571718,174.91140737216602
1747352925621872,78712204,1,843,100,78444646,77871040,573606,174.33569383862792
1747352925716210,78804764,1,844,100,78538984,77963600,575384,173.7969773229704
1747352925805921,78897324,1,845,100,78628695,78056160,572535,174.66181106831897
1747352925900216,78989884,1,846,100,78722990,78148720,574270,174.13411809775891
1747352925994691,79082444,1,847,100,78817465,78241280,576185,173.5553685014362
1747352926088019,79175004,1,848,100,78910793,78333840,576953,173.32434357737978
1747352926178399,79267564,1,849,100,79001173,78426400,574773,173.98172843887934
1747352926272882,79360124,1,850,100,79095656,78518960,576696,173.40158419687322
1747352926366939,79452684,1,851,100,79189713,78611520,578193,172.95263000416818
1747352926461104,79545244,1,852,100,79283878,78704080,579798,172.4738615862766
1747352926551062,79637804,1,853,100,79373836,78796640,577196,173.25137388339488
1747352926650112,79730364,1,854,100,79472886,78889200,583686,171.32499323266276
1747352926747606,79822924,1,855,100,79570380,78981760,588620,169.8888926641976
1747352926834044,79915484,1,856,100,79656818,79074320,582498,171.6744091825208
1747352926928024,80008044,1,857,100,79750798,79166880,583918,171.25692306111472
1747352927018341,80100604,1,858,100,79841115,79259440,581675,171.91730777496022
1747352927112199,80193164,1,859,100,79934973,79352000,582973,171.5345307587144
1747352927207074,80285732,1,860,100,80029848,79444568,585280,170.85839256424276
1747352927300510,80378284,1,861,100,80123284,79537120,586164,170.60071925263236
1747352927390121,80470844,1,862,100,80212895,79629680,583215,171.46335399466747
1747352927489089,80563404,1,863,100,80311863,79722240,589623,169.5998968832627
1747352927579405,80655964,1,864,100,80402179,79814800,587379,170.24782976579007
1747352927673176,80748524,1,865,100,80495950,79907360,588590,169.89755177627893
1747352927764140,80841084,1,866,100,80586914,79999920,586994,170.35949260128723
1747352927862203,80933644,1,867,100,80684977,80092480,592497,168.77722587624916
1747352927952383,81026204,1,868,100,80775157,80185040,590117,169.4579210563329
1747352928045979,81118764,1,869,100,80868753,80277600,591153,169.16094479770888
1747352928140499,81211324,1,870,100,80963273,80370160,593113,168.60193588742786
1747352928230487,81303884,1,871,100,81053261,80462720,590541,169.33625269032973
1747352928325240,81396444,1,872,100,81148014,80555280,592734,168.70974163790166
1747352928427273,81489004,1,873,100,81250047,80647840,602207,166.05585786947012
1747352928513384,81581564,1,874,100,81336158,80740400,595758,167.85339013492057
1747352928607382,81674124,1,875,100,81430156,80832960,597196,167.4492126538021
1747352928697901,81766684,1,876,100,81520675,80925520,595155,168.023456074468
1747352928791911,81859244,1,877,100,81614685,81018080,596605,167.61508871028568
1747352928886139,81951804,1,878,100,81708913,81110640,598273,167.1477736752285
1747352928976341,82044364,1,879,100,81799115,81203200,595915,167.80916741481587
1747352929069753,82136924,1,880,100,81892527,81295760,596767,167.5695874604326
1747352929164152,82229484,1,881,100,81986926,81388320,598606,167.0547906302309
1747352929258305,82322044,1,882,100,82081079,81480880,600199,166.6114072166065
1747352929352703,82414612,1,883,100,82175477,81573448,602029,166.10495507691488
1747352929450855,82507164,1,884,100,82273629,81666000,607629,164.5741068974654
1747352929537010,82599724,1,885,100,82359784,81758560,601224,166.3273588546033
1747352929631169,82692284,1,886,100,82453943,81851120,602823,165.88617222634173
1747352929721259,82784844,1,887,100,82544033,81943680,600353,166.56866876654234
1747352929816043,82877404,1,888,100,82638817,82036240,602577,165.9538946889775
1747352929909897,82969964,1,889,100,82732671,82128800,603871,165.59828175222853
1747352930004192,83062524,1,890,100,82826966,82221360,605606,165.12385940694116
1747352930098514,83155084,1,891,100,82921288,82313920,607368,164.6448281766573
1747352930188662,83247644,1,892,100,83011436,82406480,604956,165.30127810948233
1747352930283023,83340204,1,893,100,83105797,82499040,606757,164.81062435208824
1747352930381045,83432764,1,894,100,83203819,82591600,612219,163.3402426255964
1747352930475105,83525324,1,895,100,83297879,82684160,613719,162.94102023890412
1747352930564831,83617884,1,896,100,83387605,82776720,610885,163.696931501019
1747352930684491,83710444,1,897,100,83507265,82869280,637985,156.74349710416388
1747352933952231,86960444,1,931,100,86775005,86119280,655725,152.50295474474817
1747352934046335,87053004,1,932,100,86869109,86211840,657269,152.14470787455366
1747352934214604,87241244,1,934,100,87037378,86400080,637298,156.91246481237977
1747352934312432,87333804,1,935,100,87135206,86492640,642566,155.62603685847057
1747352934402945,87426364,1,936,100,87225719,86585200,640519,156.12339368543323
1747352934492942,87518924,1,937,100,87315716,86677760,637956,156.75062229997053
1747352934612253,87611484,1,938,100,87435027,86770320,664707,150.44222492015277
1747352934689944,87704044,1,939,100,87512718,86862880,649838,153.88450660010648
1747352934775979,87796604,1,940,100,87598753,86955440,643313,155.44532754662194
1747352934869384,87889164,1,941,100,87692158,87048000,644158,155.24141592590638
1747352934959453,87981724,1,942,100,87782227,87140560,641667,155.84407488619487
1747352935053845,88074284,1,943,100,87876619,87233120,643499,155.40039689261366
1747352935152689,88166844,1,944,100,87975463,87325680,649783,153.8975319452802
1747352935922633,88929164,1,952,100,88745407,88088000,657407,152.11277032340698
1747352936114512,89117404,1,954,100,88937286,88276240,661046,151.27540292203568
1747352936504305,89497004,1,958,100,89327079,88655840,671239,148.978232790407
1747352936585401,89589564,1,959,100,89408175,88748400,659775,151.56682202265924
1747352936680151,89682124,1,960,100,89502925,88840960,661965,151.06538865347866
1747352936765846,89774684,1,961,100,89588620,88933520,655100,152.64845061822624
1747352936860741,89867244,1,962,100,89683515,89026080,657435,152.1062918767635
1747352936950763,89959804,1,963,100,89773537,89118640,654897,152.69576742602274
1747352937045042,90052364,1,964,100,89867816,89211200,656616,152.29601471788686
1747352937138852,90144924,1,965,100,89961626,89303760,657866,152.0066396500199
1747352937228879,90237484,1,966,100,90051653,89396320,655333,152.59417731138214
1747352937323068,90330044,1,967,100,90145842,89488880,656962,152.21580548037784
1747352937416831,90422604,1,968,100,90239605,89581440,658165,151.93758404047617
1747352937511750,90515164,1,969,100,90334524,89674000,660524,151.39495309784354
1747352938014732,90990444,1,974,100,90837506,90149280,688226,145.30110748504126
1747352938084528,91086124,1,975,100,90907302,90244960,662342,150.97940338978958
1747352938178728,91178684,1,976,100,91001502,90337520,663982,150.606492344672
1747352938273562,91271244,1,977,100,91096336,90430080,666256,150.09245695348335
1747352938420561,91363804,1,978,100,91243335,90522640,720695,138.754951817343
1747352938462015,91456364,1,979,100,91284789,90615200,669589,149.34534468158827
1747352938551588,91548924,1,980,100,91374362,90707760,666602,150.0145514114869
1747352938645722,91641484,1,981,100,91468496,90800320,668176,149.66116711764565
1747352938740358,91734052,1,982,100,91563132,90892888,670244,149.19939604084485
1747352938829810,91826604,1,983,100,91652584,90985440,667144,149.89267684338014
1747352938923473,91919164,1,984,100,91746247,91078000,668247,149.6452658971907
1747352939018526,92011724,1,985,100,91841300,91170560,670740,149.08906580791364
1747352939112849,92104284,1,986,100,91935623,91263120,672503,148.6982214205736
1747352939202802,92196844,1,987,100,92025576,91355680,669896,149.2769026834016
1747352939301477,92289404,1,988,100,92124251,91448240,676011,147.92658699340691
1747352939390731,92381964,1,989,100,92213505,91540800,672705,148.65357028712438
1747352939489962,92474524,1,990,100,92312736,91633360,679376,147.1938955747627
1747352939575503,92567084,1,991,100,92398277,91725920,672357,148.73051072570078
1747352939670158,92659644,1,992,100,92492932,91818480,674452,148.26852022086078
1747352939764135,92752204,1,993,100,92586909,91911040,675869,147.9576663525032
1747352939857708,92844764,1,994,100,92680482,92003600,676882,147.7362376307835
1747352939948077,92937324,1,995,100,92770851,92096160,674691,148.21599813840706
1747352940046218,93029884,1,996,100,92868992,92188720,680272,147.00002352000377
1747352940136944,93122444,1,997,100,92959718,92281280,678438,147.3974040369201
1747352940230765,93215004,1,998,100,93053539,92373840,679699,147.12394751206048
1747352940325342,93307564,1,999,100,93148116,92466400,681716,146.68865040574082
1747352940419431,93400124,1,1000,100,93242205,92558960,683245,146.36038317148314
1747352940513645,93493724,1,1001,100,93336419,92652560,683859,146.2289741013864
1747352940611483,93587324,1,1002,100,93434257,92746160,688097,145.3283476021549
1747352940702117,93680924,1,1003,100,93524891,92839760,685131,145.95748842192222
1747352940796234,93774524,1,1004,100,93619008,92933360,685648,145.84743191841878
1747352940890696,93868124,1,1005,100,93713470,93026960,686510,145.66430204949674
1747352940984464,93961724,1,1006,100,93807238,93120560,686678,145.6286643812675
1747352941078386,94055324,1,1007,100,93901160,93214160,687000,145.56040756914118
1747352941173276,94148924,1,1008,100,93996050,93307760,688290,145.28759679786137
1747352941267381,94242524,1,1009,100,94090155,93401360,688795,145.18107709841098
1747352941361834,94336124,1,1010,100,94184608,93494960,689648,145.00150801568336
1747352941456043,94429724,1,1011,100,94278817,93588560,690257,144.87357607383916
1747352941549385,94523324,1,1012,100,94372159,93682160,689999,144.92774627209604
1747352941644002,94616924,1,1013,100,94466776,93775760,691016,144.71444944834852
1747352941738080,94710524,1,1014,100,94560854,93869360,691494,144.6144145863883
1747352941832198,94804124,1,1015,100,94654972,93962960,692012,144.50616463298326
1747352941926225,94897724,1,1016,100,94748999,94056560,692439,144.41705334332698
1747352942020740,94991324,1,1017,100,94843514,94150160,693354,144.2264701725237
1747352942114550,95084924,1,1018,100,94937324,94243760,693564,144.18280072206747
1747352942209136,95178524,1,1019,100,95031910,94337360,694550,143.97811532647037
1747352942303632,95272124,1,1020,100,95126406,94430960,695446,143.79261653672606
1747352942398299,95365724,1,1021,100,95221073,94524560,696513,143.57233820474275
1747352942491863,95459324,1,1022,100,95314637,94618160,696477,143.5797592741756
1747352942585800,95552924,1,1023,100,95408574,94711760,696814,143.51031982709875
1747352942680080,95646524,1,1024,100,95502854,94805360,697494,143.37040892108033
1747352942774987,95740124,1,1025,100,95597761,94898960,698801,143.102256579484
1747352942869309,95833724,1,1026,100,95692083,94992560,699523,142.95455617613715
1747352942963765,95927332,1,1027,100,95786539,95086168,700371,142.78146867874312
1747352943057195,96020924,1,1028,100,95879969,95179760,700209,142.81450252710263
1747352943151426,96114524,1,1029,100,95974200,95273360,700840,142.68591975343872
1747352943245645,96208124,1,1030,100,96068419,95366960,701459,142.56000707097633
1747352943340067,96301724,1,1031,100,96162841,95460560,702281,142.3931446244452
1747352943434004,96395324,1,1032,100,96256778,95554160,702618,142.3248479259
1747352943528286,96488924,1,1033,100,96351060,95647760,703300,142.18683349921795
1747352943622559,96582524,1,1034,100,96445333,95741360,703973,142.05090252040918
1747352943717036,96676124,1,1035,100,96539810,95834960,704850,141.87415762218913
1747352943810875,96769724,1,1036,100,96633649,95928560,705089,141.82606734752636
1747352943909195,96863324,1,1037,100,96731969,96022160,709809,140.88296992571242
1747352943999409,96956924,1,1038,100,96822183,96115760,706423,141.55824484763377
1747352944093632,97050524,1,1039,100,96916406,96209360,707046,141.43351351962957
1747352944191147,97144124,1,1040,100,97013921,96302960,710961,140.65469132624716
1747352944286011,97237724,1,1041,100,97108785,96396560,712225,140.4050686229773
1747352944375641,97331324,1,1042,100,97198415,96490160,708255,141.1920847717277
1747352944474124,97424924,1,1043,100,97296898,96583760,713138,140.22531403459078
1747352944564195,97518524,1,1044,100,97386969,96677360,709609,140.9226771362821
1747352944662509,97612124,1,1045,100,97485283,96770960,714323,139.9926923814577
1747352944756809,97705724,1,1046,100,97579583,96864560,715023,139.8556410073522
1747352944850480,97799324,1,1047,100,97673254,96958160,715094,139.84175506996283
1747352944945340,97892924,1,1048,100,97768114,97051760,716354,139.59578644078206
1747352945039613,97986524,1,1049,100,97862387,97145360,717027,139.4647621358749
1747352945133716,98080124,1,1050,100,97956490,97238960,717530,139.36699510821848
1747352945227592,98173724,1,1051,100,98050366,97332560,717806,139.31340780099356
1747352945321951,98267324,1,1052,100,98144725,97426160,718565,139.16625496649573
1747352945416546,98360924,1,1053,100,98239320,97519760,719560,138.9738173328145
1747352945510691,98454524,1,1054,100,98333465,97613360,720105,138.86863721262873
1747352945604425,98548124,1,1055,100,98427199,97706960,720239,138.8428007925147
1747352945698718,98641724,1,1056,100,98521492,97800560,720932,138.70933735775358
1747352945792713,98735324,1,1057,100,98615487,97894160,721327,138.63337986793783
1747352945887197,98828924,1,1058,100,98709971,97987760,722211,138.46368997425958
1747352945981743,98922532,1,1059,100,98804517,98081368,723149,138.28408806483864
1747352946075920,99016124,1,1060,100,98898694,98174960,723734,138.17231192675763
1747352946169361,99109724,1,1061,100,98992135,98268560,723575,138.2026742217462
1747352946264389,99203324,1,1062,100,99087163,98362160,725003,137.93046373601214
1747352946370845,99296924,1,1063,100,99193619,98455760,737859,135.52724843093327
1747352946551024,99487244,1,1065,100,99373798,98646080,727718,137.4158671353464
1747352946645041,99580844,1,1066,100,99467815,98739680,728135,137.33716961827133
1747352946738897,99674444,1,1067,100,99561671,98833280,728391,137.2889011533641
1747352946833621,99768044,1,1068,100,99656395,98926880,729515,137.07737332337237
1747352946927649,99861644,1,1069,100,99750423,99020480,729943,136.99699839576516
1747352947021375,99955244,1,1070,100,99844149,99114080,730069,136.97335457333486
1747352947115591,100048844,1,1071,100,99938365,99207680,730685,136.85787993458192
1747352947210204,100143484,1,1072,100,100032978,99302320,730658,136.86293724286875
1747352947324745,100238124,1,1073,100,100147519,99396960,750559,133.23402956996054
1747352948020632,100922444,1,1080,100,100843406,100081280,762126,131.21189934472778
1747352948209519,101114844,1,1082,100,101032293,100273680,758613,131.81951798875053
1747352948987794,101896924,1,1090,100,101810568,101055760,754808,132.4840224268953
1747352949196838,102092444,1,1092,100,102019612,101251280,768332,130.15206967821203
1747352949298552,102190204,1,1093,100,102121326,101349040,772286,129.48570866233493
1747352949389168,102284844,1,1094,100,102211942,101443680,768262,130.1639284514918
1747352949467045,102379484,1,1095,100,102289819,101538320,751499,133.06737600449236
1747352949564718,102474124,1,1096,100,102387492,101632960,754532,132.53248371175775
1747352949655385,102568764,1,1097,100,102478159,101727600,750559,133.23402956996054
1747352949749346,102663404,1,1098,100,102572120,101822240,749880,133.3546700805462
1747352949950058,102855804,1,1100,100,102772832,102014640,758192,131.8927131913816
1747352951523127,104416844,1,1116,100,104345901,103575680,770221,129.8328661514033
1747352951641847,104511484,1,1117,100,104464621,103670320,794301,125.89685774032765
1747352952808775,105684604,1,1129,100,105631549,104843440,788109,126.8860018093944
1747352952911069,105782364,1,1130,100,105733843,104941200,792643,126.16020074611144
1747352952993342,105877004,1,1131,100,105816116,105035840,780276,128.15977936012385
1747352953091139,105974764,1,1132,100,105913913,105133600,780313,128.1537024245399
1747352953186275,106069404,1,1133,100,106009049,105228240,780809,128.0722942486575
1747352953284442,106164044,1,1134,100,106107216,105322880,784336,127.49637910283349
1747352953382750,106258684,1,1135,100,106205524,105417520,788004,126.90290912228872
1747352953480453,106353324,1,1136,100,106303227,105512160,791067,126.41154289080444
1747352953582683,106447964,1,1137,100,106405457,105606800,798657,125.21019661757175
1747352953758722,106643492,1,1139,100,106581496,105802328,779168,128.3420263665859
1747352953852797,106738124,1,1140,100,106675571,105896960,778611,128.43383923422607
1747352953951886,106832764,1,1141,100,106774660,105991600,783060,127.70413505989325
1747352954045572,106927404,1,1142,100,106868346,106086240,782106,127.85990645769245
1747352954139940,107022044,1,1143,100,106962714,106180880,781834,127.9043889112011
1747352954234605,107116684,1,1144,100,107057379,106275520,781859,127.90029915879974
1747352954332091,107211324,1,1145,100,107154865,106370160,784705,127.4364251534016
1747352954426327,107305964,1,1146,100,107249101,106464800,784301,127.502068721065
1747352954521019,107400604,1,1147,100,107343793,106559440,784353,127.49361575719097
1747352954619009,107495244,1,1148,100,107441783,106654080,787703,126.95140173390224
1747352954713334,107589884,1,1149,100,107536108,106748720,787388,127.00218951774728
1747352954811957,107684524,1,1150,100,107634731,106843360,791371,126.36298272238936
1747352954901754,107779164,1,1151,100,107724528,106938000,786528,127.14105537247244
1747352955007770,107873804,1,1152,100,107830544,107032640,797904,125.32836030399648
1747352955098575,107968444,1,1153,100,107921349,107127280,794069,125.93364052746044
1747352955188779,108063084,1,1154,100,108011553,107221920,789633,126.64111049056966
1747352955282248,108157724,1,1155,100,108105022,107316560,788462,126.82919405120349
1747352955380810,108252364,1,1156,100,108203584,107411200,792384,126.20143768677814
1747352955479422,108347004,1,1157,100,108302196,107505840,796356,125.57198037058804
1747352955569902,108441644,1,1158,100,108392676,107600480,792196,126.23138718196002
1747352955667166,108536284,1,1159,100,108489940,107695120,794820,125.81464985782944
1747352955761886,108630924,1,1160,100,108584660,107789760,794900,125.8019876714052
1747352955856060,108725564,1,1161,100,108678834,107884400,794434,125.87578074453008
1747352955958781,108820204,1,1162,100,108781555,107979040,802515,124.60826277390454
1747352956049161,108914844,1,1163,100,108871935,108073680,798255,125.2732522815391
1747352956143102,109009484,1,1164,100,108965876,108168320,797556,125.38304520309543
1747352956245501,109104124,1,1165,100,109068275,108262960,805315,124.17501226228246
1747352957035822,109886204,1,1173,100,109858596,109045040,813556,122.91716857843836
1747352957133484,109983964,1,1174,100,109956258,109142800,813458,122.93197681994644
1747352957219496,110078604,1,1175,100,110042270,109237440,804830,124.24984158145196
1747352957318173,110173244,1,1176,100,110140947,109332080,808867,123.62971910091522
1747352957411901,110267884,1,1177,100,110234675,109426720,807955,123.76926932811853
1747352957506152,110362524,1,1178,100,110328926,109521360,807566,123.82888828900673
1747352957617805,110457164,1,1179,100,110440579,109616000,824579,121.27400770575046
1747352957703206,110551804,1,1180,100,110525980,109710640,815340,122.64822037432238
1747352957793503,110646444,1,1181,100,110616277,109805280,810997,123.3050183909435
1747352957887646,110741084,1,1182,100,110710420,109899920,810500,123.38062924120914
1747352957982161,110835732,1,1183,100,110804935,109994568,810367,123.40087886105924
1747352958076335,110930364,1,1184,100,110899109,110089200,809909,123.47066151876322
1747352958173777,111025004,1,1185,100,110996551,110183840,812711,123.04496924490996
1747352958268162,111119644,1,1186,100,111090936,110278480,812456,123.0835885266402
1747352958362906,111214284,1,1187,100,111185680,110373120,812560,123.06783499064686
1747352958460798,111308924,1,1188,100,111283572,110467760,815812,122.57726044725992
1747352958555395,111403564,1,1189,100,111378169,110562400,815769,122.58372161727156
1747352958649502,111498204,1,1190,100,111472276,110657040,815236,122.6638666594704
1747352958743960,111592844,1,1191,100,111566734,110751680,815054,122.69125726638973
1747352958850048,111687484,1,1192,100,111672822,110846320,826502,120.99184272996315
1747352958935820,111782124,1,1193,100,111758594,110940960,817634,122.30411161962444
1747352959030016,111876764,1,1194,100,111852790,111035600,817190,122.370562537476
1747352959124014,111971404,1,1195,100,111946788,111130240,816548,122.46677476400652
1747352959222526,112066044,1,1196,100,112045300,111224880,820420,121.8887886692182
1747352959316196,112160684,1,1197,100,112138970,111319520,819450,122.03307096223077
1747352959411289,112255324,1,1198,100,112234063,111414160,819903,121.96564715582208
1747352959509681,112349964,1,1199,100,112332455,111508800,823655,121.4100563949712
1747352959603129,112444604,1,1200,100,112425903,111603440,822463,121.5860166353988
1747352959697734,112539244,1,1201,100,112520508,111698080,822428,121.59119096139722
1747352959792095,112633892,1,1202,100,112614869,111792728,822141,121.63363705252505
1747352959890437,112728524,1,1203,100,112713211,111887360,825851,121.08721791218996
1747352959984149,112823164,1,1204,100,112806923,111982000,824923,121.22343539942516
1747352960079230,112917804,1,1205,100,112902004,112076640,825364,121.15866454073596
1747352960173375,113012444,1,1206,100,112996149,112171280,824869,121.23137128441002
1747352960271273,113107084,1,1207,100,113094047,112265920,828127,120.75442534780294
1747352960369172,113201724,1,1208,100,113191946,112360560,831386,120.28107281094462
1747352960463474,113296364,1,1209,100,113286248,112455200,831048,120.3299929727284
1747352960557987,113391004,1,1210,100,113380761,112549840,830921,120.34838450346062
1747352960652469,113485644,1,1211,100,113475243,112644480,830763,120.37127315491902
1747352960746745,113580284,1,1212,100,113569519,112739120,830399,120.4240371195052
1747352960840767,113674924,1,1213,100,113663541,112833760,829781,120.5137259108126
1747352960938851,113769564,1,1214,100,113761625,112928400,833225,120.01560202826369
1747352961033002,113864204,1,1215,100,113855776,113023040,832736,120.08607770049572
1747352961127563,113958844,1,1216,100,113950337,113117680,832657,120.09747110755087
1747352961225765,114053484,1,1217,100,114048539,113212320,836219,119.58589795256984
1747352961320089,114148124,1,1218,100,114142863,113306960,835903,119.63110552300924
1747352961414539,114242764,1,1219,100,114237313,113401600,835713,119.65830374781773
1747352961512416,114337404,1,1220,100,114335190,113496240,838950,119.19661481613925
1747352961606759,114432044,1,1221,100,114429533,113590880,838653,119.2388270238108
1747352961700713,114526684,1,1222,100,114523487,113685520,837967,119.33644164985016
1747352961799038,114621324,1,1223,100,114621812,113780160,841652,118.8139516094538
1747352961889108,114715964,1,1224,100,114711882,113874800,837082,119.46260939788456
1747352961987615,114810604,1,1225,100,114810389,113969440,840949,118.91327535914785
1747352962085514,114905244,1,1226,100,114908288,114064080,844208,118.45421981312664
1747352962175755,114999884,1,1227,100,114998529,114158720,839809,119.07469436502824
1747352962282456,115094524,1,1228,100,115105230,114253360,851870,117.38880345592636
1747352962368581,115189164,1,1229,100,115191355,114348000,843355,118.57402873048716
1747352962462268,115283804,1,1230,100,115285042,114442640,842402,118.70817020852276
1747352962556454,115378444,1,1231,100,115379228,114537280,841948,118.7721807047466
1747352962655374,115473084,1,1232,100,115478148,114631920,846228,118.17146206459724
1747352962757684,115567724,1,1233,100,115580458,114726560,853898,117.11000611314232
1747352962850979,115662364,1,1234,100,115673753,114821200,852553,117.29476056034052
1747352962941997,115757004,1,1235,100,115764771,114915840,848931,117.7952036148992
1747352963039681,115851644,1,1236,100,115862455,115010480,851975,117.37433610141142
1747352963134418,115946284,1,1237,100,115957192,115105120,852072,117.36097418997456
1747352963224478,116040924,1,1238,100,116047252,115199760,847492,117.99521411411553
1747352963322702,116135564,1,1239,100,116145476,115294400,851076,117.49831977402722
1747352963420788,116230204,1,1240,100,116243562,115389040,854522,117.02448854447282
1747352963510695,116324844,1,1241,100,116333469,115483680,849789,117.6762702270799
1747352963609716,116419484,1,1242,100,116432490,115578320,854170,117.07271386258004
1747352963703669,116514124,1,1243,100,116526443,115672960,853483,117.16695001540744
1747352963809684,116608764,1,1244,100,116632458,115767600,864858,115.6259177807224
1747352963900327,116703404,1,1245,100,116723101,115862240,860861,116.16277192252872
1747352963990020,116798044,1,1246,100,116812794,115956880,855914,116.83416791873952
1747352964096792,116892692,1,1247,100,116919566,116051528,868038,115.20232985191892
1747352964178182,116987324,1,1248,100,117000956,116146160,854796,116.98697700971928
1747352964277268,117081964,1,1249,100,117100042,116240800,859242,116.3816480106885
1747352964370968,117176604,1,1250,100,117193742,116335440,858302,116.5091075169346
1747352964465409,117271244,1,1251,100,117288183,116430080,858103,116.53612678198306
1747352964563661,117365884,1,1252,100,117386435,116524720,861715,116.04764916474704
1747352964657953,117460524,1,1253,100,117480727,116619360,861367,116.09453345670312
1747352964752256,117555164,1,1254,100,117575030,116714000,861030,116.1399718941268
1747352964846037,117649804,1,1255,100,117668811,116808640,860171,116.25595375803184
1747352964940429,117744444,1,1256,100,117763203,116903280,859923,116.28948173266676
1747352965038466,117839084,1,1257,100,117861240,116997920,863320,115.83190473984156
1747352965132896,117933724,1,1258,100,117955670,117092560,863110,115.86008735850588
1747352965231341,118028364,1,1259,100,118054115,117187200,866915,115.35156272529602
1747352965325477,118123004,1,1260,100,118148251,117281840,866411,115.41866389046308
1747352965419951,118217644,1,1261,100,118242725,117376480,866245,115.4407817649741
1747352965513324,118312284,1,1262,100,118336098,117471120,864978,115.60987678299333
1747352965608261,118406924,1,1263,100,118431035,117565760,865275,115.57019444685216
1747352965706463,118501564,1,1264,100,118529237,117660400,868837,115.09638746968648
1747352965800865,118596204,1,1265,100,118623639,117755040,868599,115.12792439318947
1747352965898631,118690852,1,1266,100,118721405,117849688,871717,114.716129202482
1747352965988342,118785484,1,1267,100,118811116,117944320,866796,115.36739901891563
1747352966086782,118880124,1,1268,100,118909556,118038960,870596,114.86384040358558
1747352966181693,118974764,1,1269,100,119004467,118133600,870867,114.828096597988
1747352966275671,119069404,1,1270,100,119098445,118228240,870205,114.91545095695842
1747352966369387,119164044,1,1271,100,119192161,118322880,869281,115.03760003957294
1747352966467830,119258684,1,1272,100,119290604,118417520,873084,114.5365165322008
1747352966561839,119353324,1,1273,100,119384613,118512160,872453,114.61935485349926
1747352966656536,119447964,1,1274,100,119479310,118606800,872510,114.61186691270014
1747352966754445,119542604,1,1275,100,119577219,118701440,875779,114.18405785021108
1747352966849303,119637244,1,1276,100,119672077,118796080,875997,114.15564208553224
1747352966947253,119731884,1,1277,100,119770027,118890720,879307,113.7259228005691
1747352967050032,119826524,1,1278,100,119872806,118985360,887446,112.68291253777696
1747352967135400,119921164,1,1279,100,119958174,119080000,878174,113.8726493838351
1747352967233772,120015804,1,1280,100,120056546,119174640,881906,113.39076953779654
1747352967528688,120305964,1,1283,100,120351462,119464800,886662,112.78254847957848
1747352967618497,120400604,1,1284,100,120441271,119559440,881831,113.40041345790746
1747352967713119,120495244,1,1285,100,120535893,119654080,881813,113.40272824283608
1747352967811425,120589884,1,1286,100,120634199,119748720,885479,112.93322597147984
1747352968004458,120782284,1,1288,100,120827232,119941120,886112,112.85255137048138
1747352968097973,120876924,1,1289,100,120920747,120035760,884987,112.996010110883
1747352968192924,120971564,1,1290,100,121015698,120130400,885298,112.95631527463068
1747352968286755,121066204,1,1291,100,121109529,120225040,884489,113.05963104120006
1747352968384849,121160844,1,1292,100,121207623,120319680,887943,112.6198415889308
1747352968478743,121255484,1,1293,100,121301517,120414320,887197,112.71453803383014
1747352968576850,121350124,1,1294,100,121399624,120508960,890664,112.27578525684208
1747352968773375,121542524,1,1296,100,121596149,120701360,894789,111.7581910372166
1747352968864062,121637164,1,1297,100,121686836,120796000,890836,112.25410737778896
1747352968962225,121731804,1,1298,100,121784999,120890640,894359,111.81192339988752
1747352969056844,121826444,1,1299,100,121879618,120985280,894338,111.81454886183973
1747352969150689,121921084,1,1300,100,121973463,121079920,893543,111.91403211708894
1747352969261116,122015724,1,1301,100,122083890,121174560,909330,109.97107760658947
1747352969371481,122113484,1,1302,100,122194255,121272320,921935,108.46751669043914
1747352969446117,122208124,1,1303,100,122268891,121366960,901931,110.87322644415148
1747352969535964,122302764,1,1304,100,122358738,121461600,897138,111.46557162889098
1747352969629765,122397404,1,1305,100,122452539,121556240,896299,111.5699113800194
1747352969739923,122492044,1,1306,100,122562697,121650880,911817,109.6711291849132
1747352969831032,122586684,1,1307,100,122653806,121745520,908286,110.09748030906565
1747352969920806,122681324,1,1308,100,122743580,121840160,903420,110.69048725952491
1747352970027217,122775964,1,1309,100,122849991,121934800,915191,109.26680878636265
1747352970108914,122870604,1,1310,100,122931688,122029440,902248,110.83427173016732
1747352970198796,122965244,1,1311,100,123021570,122124080,897490,111.42185428249896
1747352970302025,123059884,1,1312,100,123124799,122218720,906079,110.36565244310928
1747352970395589,123154524,1,1313,100,123218363,122313360,905003,110.49687128108968
1747352970616481,123350052,1,1315,100,123439255,122508888,930367,107.48446580757916
1747352971378996,124132124,1,1323,100,124201770,123290960,910810,109.7923826044949
1747352971477118,124226764,1,1324,100,124299892,123385600,914292,109.37424805204463
1747352971571109,124321404,1,1325,100,124393883,123480240,913643,109.45194129435676
1747352971665408,124416044,1,1326,100,124488182,123574880,913302,109.49280741748076
1747352971759899,124510684,1,1327,100,124582673,123669520,913153,109.51067345778856
1747352971854498,124605324,1,1328,100,124677272,123764160,913112,109.51559063948343
1747352971951973,124699964,1,1329,100,124774747,123858800,915947,109.17662266484852
1747352972045973,124797724,1,1330,100,124868747,123956560,912187,109.62664453670136
1747352972140285,124892364,1,1331,100,124963059,124051200,911859,109.6660777598291
1747352972243379,124987004,1,1332,100,125066153,124145840,920313,108.65868459969596
1747352972333807,125081644,1,1333,100,125156581,124240480,916101,109.15826966677254
1747352972428028,125176284,1,1334,100,125250802,124335120,915682,109.20821857369698
1747352972525676,125270924,1,1335,100,125348450,124429760,918690,108.85064602858418
1747352972619571,125365564,1,1336,100,125442345,124524400,917945,108.93898871936771
1747352972922893,125655724,1,1339,100,125745667,124814560,931107,107.39904221534152
1747352973103763,125848124,1,1341,100,125926537,125006960,919577,108.74565153325932
1747352973218366,125942764,1,1342,100,126041140,125101600,939540,106.43506396747344
1747352973791081,126526204,1,1348,100,126613855,125685040,928815,107.66406657945878
1747352973885397,126620844,1,1349,100,126708171,125779680,928491,107.70163631096048
1747352973987848,126715484,1,1350,100,126810622,125874320,936302,106.80314684791873
1747352974077320,126810132,1,1351,100,126900094,125968968,931126,107.39685069475024
1747352974172128,126904764,1,1352,100,126994902,126063600,931302,107.3765545440684
1747352974282567,126999404,1,1353,100,127105341,126158240,947101,105.5853599563299
1747352974376917,127094044,1,1354,100,127199691,126252880,946811,105.61769983660942
1747352975544556,128267164,1,1366,100,128367330,127426000,941330,106.23267079557648
1747352975859561,128557324,1,1369,100,128682335,127716160,966175,103.50091857065232
1747352975949432,128655084,1,1370,100,128772206,127813920,958286,104.35298021676202
1747352976031833,128749724,1,1371,100,128854607,127908560,946047,105.70299361448215
1747352976126338,128844364,1,1372,100,128949112,128003200,945912,105.71807948308088
1747352976219844,128939004,1,1373,100,129042618,128097840,944778,105.84497098789345
1747352976314533,129033644,1,1374,100,129137307,128192480,944827,105.8394817252259
1747352976408025,129128284,1,1375,100,129230799,128287120,943679,105.96823708061746
1747352976502745,129222924,1,1376,100,129325519,128381760,943759,105.95925442830216
1747352976600822,129317564,1,1377,100,129423596,128476400,947196,105.57477016372536
1747352976699434,129412204,1,1378,100,129522208,128571040,951168,105.13389853317184
1747352976789571,129506844,1,1379,100,129612345,128665680,946665,105.6339887922338
1747352976887110,129601484,1,1380,100,129709884,128760320,949564,105.3114903260865
1747352976981608,129696124,1,1381,100,129804382,128854960,949422,105.327241205702
1747352977075584,129790764,1,1382,100,129898358,128949600,948758,105.40095577586698
1747352977169966,129885404,1,1383,100,129992740,129044240,948500,105.42962572482868
1747352977268796,129980044,1,1384,100,130091570,129138880,952690,104.96593855293956
1747352977362997,130074684,1,1385,100,130185771,129233520,952251,105.01432920522004
1747352977457211,130169324,1,1386,100,130279985,129328160,951825,105.06132955112548
1747352977555086,130263964,1,1387,100,130377860,129422800,955060,104.70546353108703
1747352977649383,130358604,1,1388,100,130472157,129517440,954717,104.7430809339312
1747352977743436,130453244,1,1389,100,130566210,129612080,954130,104.80752098770608
1747352977838443,130547884,1,1390,100,130661217,129706720,954497,104.7672229456981
1747352977936085,130642524,1,1391,100,130758859,129801360,957499,104.4387513720641
1747352978030640,130737172,1,1392,100,130853414,129896008,957406,104.44889628851293
1747352978124003,130831804,1,1393,100,130946777,129990640,956137,104.58752249939076
1747352978218579,130926444,1,1394,100,131041353,130085280,956073,104.59452363993128
1747352978316451,131021084,1,1395,100,131139225,130179920,959305,104.2421336279911
1747352978411219,131115724,1,1396,100,131233993,130274560,959433,104.22822646292131
1747352978505758,131210364,1,1397,100,131328532,130369200,959332,104.23919977651116
1747352978603752,131305004,1,1398,100,131426526,130463840,962686,103.8760301905294
1747352978697865,131399644,1,1399,100,131520639,130558480,962159,103.9329258469754
1747352978795861,131494284,1,1400,100,131618635,130653120,965515,103.57166900566018
1747352978886333,131588924,1,1401,100,131709107,130747760,961347,104.02071260429378
1747352978984732,131683564,1,1402,100,131807506,130842400,965106,103.61556139947322
1747352979079051,131778204,1,1403,100,131901825,130937040,964785,103.65003601838752
1747352979172771,131872844,1,1404,100,131995545,131031680,963865,103.74896899462064
1747352979271567,131967484,1,1405,100,132094341,131126320,968021,103.3035440346852
1747352979364947,132062124,1,1406,100,132187721,131220960,966761,103.43818172226642
1747352979459250,132156764,1,1407,100,132282024,131315600,966424,103.47425146726488
1747352979554290,132251404,1,1408,100,132377064,131410240,966824,103.43144150331396
1747352979651746,132346044,1,1409,100,132474520,131504880,969640,103.1310589497133
1747352979745884,132440684,1,1410,100,132568658,131599520,969138,103.18447940334606
1747352979840736,132535332,1,1411,100,132663510,131694168,969342,103.1627640193038
1747352979935161,132629964,1,1412,100,132757935,131788800,969135,103.18479881543853
1747352980033497,132724604,1,1413,100,132856271,131883440,972831,102.79277695714876
1747352980127549,132819244,1,1414,100,132950323,131978080,972243,102.85494470003898
1747352980221483,132913884,1,1415,100,133044257,132072720,971537,102.92968770103457
1747352980319507,133008524,1,1416,100,133142281,132167360,974921,102.57241355966278
1747352980414423,133103164,1,1417,100,133237197,132262000,975197,102.54338354199204
1747352980508614,133197804,1,1418,100,133331388,132356640,974748,102.59061829313832
1747352980602164,133292444,1,1419,100,133424938,132451280,973658,102.7054674228528
1747352980700989,133387084,1,1420,100,133523763,132545920,977843,102.26590567197393
1747352980794927,133481724,1,1421,100,133617701,132640560,977141,102.3393757912113
1747352980889597,133576364,1,1422,100,133712371,132735200,977171,102.33623388332236
1747352980983836,133671004,1,1423,100,133806610,132829840,976770,102.37824667014752
1747352981080788,133765644,1,1424,100,133903562,132924480,979082,102.13649112127484
1747352981175276,133860284,1,1425,100,133998050,133019120,978930,102.1523500148121
1747352981270198,133954924,1,1426,100,134092972,133113760,979212,102.12293150002247
1747352981368206,134049564,1,1427,100,134190980,133208400,982580,101.77288363288486
1747352981461976,134144204,1,1428,100,134284750,133303040,981710,101.86307565370628
1747352981556751,134238844,1,1429,100,134379525,133397680,981845,101.84906986336948
1747352981655383,134333484,1,1430,100,134478157,133492320,985837,101.43664723478628
1747352981749380,134428124,1,1431,100,134572154,133586960,985194,101.50285121509064
1747352981843236,134522764,1,1432,100,134666010,133681600,984410,101.5836897227781
1747352981937241,134617404,1,1433,100,134760015,133776240,983775,101.64925923102336
1747352982036238,134712044,1,1434,100,134859012,133870880,988132,101.2010541101796
1747352982130271,134806684,1,1435,100,134953045,133965520,987525,101.263259157996
1747352982228796,134901324,1,1436,100,135051570,134060160,991410,100.86644274316376
1747352982519507,135191484,1,1439,100,135342281,134350320,991961,100.8104149255868
1747352982612913,135286124,1,1440,100,135435687,134444960,990727,100.93597933638632
1747352982707260,135380764,1,1441,100,135530034,134539600,990434,100.965839217959
1747352982801751,135475404,1,1442,100,135624525,134634240,990285,100.98103071338048
1747352982900441,135570044,1,1443,100,135723215,134728880,994335,100.56972750632332
1747352982994527,135664684,1,1444,100,135817301,134823520,993781,100.62579179919922
1747352983088218,135759324,1,1445,100,135910992,134918160,992832,100.72197511764328
1747352983182859,135853964,1,1446,100,136005633,135012800,992833,100.72187366858272
1747352983281395,135948604,1,1447,100,136104169,135107440,996729,100.32817345537252
1747352983375571,136043244,1,1448,100,136198345,135202080,996265,100.37490025244288
1747352983469687,136137884,1,1449,100,136292461,135296720,995741,100.42772166657797
1747352983567341,136232524,1,1450,100,136390115,135391360,998755,100.12465519571867
1747352983661661,136327164,1,1451,100,136484435,135486000,998435,100.15674530640452
1747352983755652,136421804,1,1452,100,136578426,135580640,997786,100.22189126726572
1747352983850000,136516444,1,1453,100,136672774,135675280,997494,100.25122958133082
1747352983948212,136611084,1,1454,100,136770986,135769920,1001066,99.89351351459344
1747352984042734,136705724,1,1455,100,136865508,135864560,1000948,99.90528978528356
1747352984137344,136800364,1,1456,100,136960118,135959200,1000918,99.90828419510888
1747352984235142,136895004,1,1457,100,137057916,136053840,1004076,99.5940546333146
1747352984329162,136989644,1,1458,100,137151936,136148480,1003456,99.65559027999235
1747352984436366,137084284,1,1459,100,137259140,136243120,1016020,98.42325938465778
1747352984522092,137178924,1,1460,100,137344866,136337760,1007106,99.2944138948631
1747352984616304,137273564,1,1461,100,137439078,136432400,1006678,99.33662998496044
1747352984709918,137368204,1,1462,100,137532692,136527040,1005652,99.43797655650263
1747352984807347,137462844,1,1463,100,137630121,136621680,1008441,99.1629654089828
1747352984996909,137655244,1,1465,100,137819683,136814080,1005603,99.4428218690676
1747352985095538,137749884,1,1466,100,137918312,136908720,1009592,99.049913232276
1747352985189187,137844524,1,1467,100,138011961,137003360,1008601,99.14723463490516
1747352985283604,137939164,1,1468,100,138106378,137098000,1008378,99.16916077106006
1747352985381683,138033804,1,1469,100,138204457,137192640,1011817,98.83210106175326
1747352985476585,138128444,1,1470,100,138299359,137287280,1012079,98.80651609212325
1747352985570027,138223084,1,1471,100,138392801,137381920,1010881,98.92361217591387
1747352985665189,138317724,1,1472,100,138487963,137476560,1011403,98.8725562411818
1747352985763007,138412364,1,1473,100,138585781,137571200,1014581,98.5628550110834
1747352985856553,138507004,1,1474,100,138679327,137665840,1013487,98.66924785419052
1747352985950964,138601644,1,1475,100,138773738,137760480,1013258,98.69154746372593
1747352986045867,138696284,1,1476,100,138868641,137855120,1013521,98.6659378542724
1747352986143734,138790932,1,1477,100,138966508,137949768,1016740,98.35356138245766
1747352986237921,138885564,1,1478,100,139060695,138044400,1016295,98.3966269636277
1747352986332369,138980204,1,1479,100,139155143,138139040,1016103,98.41521971689878
1747352986430596,139074844,1,1480,100,139253370,138233680,1019690,98.0690209769636
1747352986525075,139169484,1,1481,100,139347849,138328320,1019529,98.0845076501012
1747352986619230,139264124,1,1482,100,139442004,138422960,1019044,98.13118962478558
1747352986712884,139358764,1,1483,100,139535658,138517600,1018058,98.22623072555788
1747352986811587,139453404,1,1484,100,139634361,138612240,1022121,97.83577482509408
1747352986905445,139548044,1,1485,100,139728219,138706880,1021339,97.91068391591824
1747352987000177,139642684,1,1486,100,139822951,138801520,1021431,97.90186512843256
1747352987098220,139737324,1,1487,100,139920994,138896160,1024834,97.57677828799592
1747352987192700,139831964,1,1488,100,140015474,138990800,1024674,97.59201463099484
1747352987286835,139926604,1,1489,100,140109609,139085440,1024169,97.6401355635642
1747352987380830,140021244,1,1490,100,140203604,139180080,1023524,97.70166600880876
1747352987478712,140115884,1,1491,100,140301486,139274720,1026766,97.3931742967726
1747352987573683,140210524,1,1492,100,140396457,139369360,1027097,97.36178764031052
1747352987671793,140305164,1,1493,100,140494567,139464000,1030567,97.0339628573397
1747352987765118,140399804,1,1494,100,140587892,139558640,1029252,97.1579360545328
1747352987860345,140494444,1,1495,100,140683119,139653280,1029839,97.1025568074233
1747352987953719,140589092,1,1496,100,140776493,139747928,1028565,97.22282986490887
1747352988048406,140683724,1,1497,100,140871180,139842560,1028620,97.21763138962882
1747352988155068,140778364,1,1498,100,140977842,139937200,1040642,96.09452626359496
1747352988241129,140873004,1,1499,100,141063903,140031840,1032063,96.89330980763772
1747352988343002,140967644,1,1500,100,141165776,140126480,1039296,96.21897900117004
1747351963754720,109580,1,1,12,0,0,0,0.0
1747351963840605,197404,1,2,12,85885,87824,-1939,0.0
1747351963930698,285804,1,3,12,175978,176224,-246,0.0
1747351964020371,374204,1,4,12,265651,264624,1027,11684.518013631938
1747351964106461,462604,1,5,12,351741,353024,-1283,0.0
1747351964197102,551004,1,6,12,442382,441424,958,12526.096033402922
1747351964286870,639404,1,7,12,532150,529824,2326,5159.071367153912
1747351964376977,727804,1,8,12,622257,618224,4033,2975.45251673692
1747351964663499,1000284,1,11,12,908779,890704,18075,663.9004149377593
1747351964753696,1090764,1,12,12,998976,981184,17792,674.4604316546763
1747351964835861,1181244,1,13,12,1081141,1071664,9477,1266.2234884457107
1747351964926166,1271724,1,14,12,1171446,1162144,9302,1290.0451515803054
1747351965015670,1362204,1,15,12,1260950,1252624,8326,1441.268316118184
1747351965106312,1452684,1,16,12,1351592,1343104,8488,1413.760603204524
1747351965208649,1543164,1,17,12,1453929,1433584,20345,589.8255099533055
1747351965290074,1633644,1,18,12,1535354,1524064,11290,1062.887511071745
1747351965385058,1724124,1,19,12,1630338,1614544,15794,759.7821957705459
1747351965479331,1814604,1,20,12,1724611,1705024,19587,612.6512482769184
1747351965576707,1905084,1,21,12,1821987,1795504,26483,453.1208699920704
1747351965663643,1995564,1,22,12,1908923,1885984,22939,523.1265530319542
1747351965752999,2086044,1,23,12,1998279,1976464,21815,550.0802200320879
1747351965847470,2176524,1,24,12,2092750,2066944,25806,465.0081376424088
1747351965937482,2267004,1,25,12,2182762,2157424,25338,473.5969689793985
1747351966027912,2357484,1,26,12,2273192,2247904,25288,474.5333755140778
1747351966109544,2447964,1,27,12,2354824,2338384,16440,729.92700729927
1747351966199573,2538444,1,28,12,2444853,2428864,15989,750.5159797360685
1747351966293707,2628924,1,29,12,2538987,2519344,19643,610.9046479661965
1747351966383977,2719404,1,30,12,2629257,2609824,19433,617.5063037101837
1747351966477963,2809892,1,31,12,2723243,2700312,22931,523.3090576076054
1747351966568441,2900364,1,32,12,2813721,2790784,22937,523.1721672407028
1747351966658265,2990844,1,33,12,2903545,2881264,22281,538.5754678874378
1747351966756861,3081324,1,34,12,3002141,2971744,30397,394.7758002434451
1747351966838786,3171804,1,35,12,3084066,3062224,21842,549.4002380734365
1747351966940694,3262284,1,36,12,3185974,3152704,33270,360.6853020739405
1747351967031096,3352764,1,37,12,3276376,3243184,33192,361.532899493854
1747351967116850,3443244,1,38,12,3362130,3333664,28466,421.5555399423874
1747351967214670,3533724,1,39,12,3459950,3424144,35806,335.1393621180808
1747351967301810,3624204,1,40,12,3547090,3514624,32466,369.6174459434485
1747351967387070,3714684,1,41,12,3632350,3605104,27246,440.43162299053074
1747351967481558,3805164,1,42,12,3726838,3695584,31254,383.95085429065085
1747351967567551,3895644,1,43,12,3812831,3786064,26767,448.3132215040909
1747351967661461,3986124,1,44,12,3906741,3876544,30197,397.3904692519124
1747351967755839,4076604,1,45,12,4001119,3967024,34095,351.9577650681918
1747351967853908,4167084,1,46,12,4099188,4057504,41684,287.8802418194031
1747351967932398,4257564,1,47,12,4177678,4147984,29694,404.1220448575469
1747351968026479,4348044,1,48,12,4271759,4238464,33295,360.4144766481454
1747351968116354,4438524,1,49,12,4361634,4328944,32690,367.0847353930866
1747351968210282,4529004,1,50,12,4455562,4419424,36138,332.06043499916984
1747351968296761,4619484,1,51,12,4542041,4509904,32137,373.4013753617326
1747351968391270,4709964,1,52,12,4636550,4600384,36166,331.8033512138473
1747351968480881,4800444,1,53,12,4726161,4690864,35297,339.97223560075923
1747351968574592,4890924,1,54,12,4819872,4781344,38528,311.4617940199336
1747351968661733,4981404,1,55,12,4907013,4871824,35189,341.0156583023104
1747351968755806,5071892,1,56,12,5001086,4962312,38774,309.48573786558
1747351968847037,5162364,1,57,12,5092317,5052784,39533,303.54387473756105
1747351968935107,5252844,1,58,12,5180387,5143264,37123,323.2497373595884
1747351969025005,5343324,1,59,12,5270285,5233744,36541,328.39823759612494
1747351969120018,5433804,1,60,12,5365298,5324224,41074,292.1556215610849
1747351969209762,5524284,1,61,12,5455042,5414704,40338,297.48624126134166
1747351969299990,5614764,1,62,12,5545270,5505184,40086,299.356383774884
1747351969389971,5705244,1,63,12,5635251,5595664,39587,303.12981534342083
1747351969484534,5795724,1,64,12,5729814,5686144,43670,274.7881841080833
1747351969578353,5886204,1,65,12,5823633,5776624,47009,255.2702673956051
1747351969664146,5976684,1,66,12,5909426,5867104,42322,283.54047540286376
1747351969767184,6067164,1,67,12,6012464,5957584,54880,218.6588921282799
1747351969860809,6157644,1,68,12,6106089,6048064,58025,206.80741059887976
1747351969951661,6248124,1,69,12,6196941,6138544,58397,205.49000804835865
1747351970037671,6338604,1,70,12,6282951,6229024,53927,222.52304040647545
1747351970131458,6429084,1,71,12,6376738,6319504,57234,209.6655833944858
1747351970225672,6519564,1,72,12,6470952,6409984,60968,196.82456370555045
1747351970308058,6610044,1,73,12,6553338,6500464,52874,226.9546468963952
1747351970406151,6700524,1,74,12,6651431,6590944,60487,198.38973663762465
1747351970496130,6791004,1,75,12,6741410,6681424,59986,200.0466775580969
1747351970582055,6881484,1,76,12,6827335,6771904,55431,216.485360177518
1747351970680017,6971964,1,77,12,6925297,6862384,62913,190.73959277096944
1747351970770738,7062444,1,78,12,7016018,6952864,63154,190.011717389239
1747351970856616,7152924,1,79,12,7101896,7043344,58552,204.9460308785353
1747351970954875,7243404,1,80,12,7200155,7133824,66331,180.91088631258387
1747351971044942,7333884,1,81,12,7290222,7224304,65918,182.0443581419339
1747351971131204,7424364,1,82,12,7376484,7314784,61700,194.48946515397083
1747351971225223,7514844,1,83,12,7470503,7405264,65239,183.9390548598231
1747351971318912,7605324,1,84,12,7564192,7495744,68448,175.3155680224404
1747351971404929,7695804,1,85,12,7650209,7586224,63985,187.5439556145972
1747351971499087,7786284,1,86,12,7744367,7676704,67663,177.34951154988693
1747351971585375,7876764,1,87,12,7830655,7767184,63471,189.0627215578768
1747351971683589,7967244,1,88,12,7928869,7857664,71205,168.52749104697702
1747351971773419,8057724,1,89,12,8018699,7948144,70555,170.0800793707037
1747351971863617,8148204,1,90,12,8108897,8038624,70273,170.76259729910493
1747351971949608,8238684,1,91,12,8194888,8129104,65784,182.41517694272164
1747351972044481,8329164,1,92,12,8289761,8219584,70177,170.9961953346538
1747351972134333,8419644,1,93,12,8379613,8310064,69549,172.54022343958937
1747351972223771,8510124,1,94,12,8469051,8400544,68507,175.1645817215759
1747351972315112,8600612,1,95,12,8560392,8491032,69360,173.01038062283737
1747351972408711,8691084,1,96,12,8653991,8581504,72487,165.54692565563482
1747351972502669,8781564,1,97,12,8747949,8671984,75965,157.9674850259988
1747351972589209,8872044,1,98,12,8834489,8762464,72025,166.60881638320026
1747351972679014,8962524,1,99,12,8924294,8852944,71350,168.18500350385426
1747351972773012,9053004,1,100,12,9018292,8943424,74868,160.28209648982207
1747351972859584,9144524,1,101,12,9104864,9034944,69920,171.62471395881008
1747351972962099,9236044,1,102,12,9207379,9126464,80915,148.30377556695296
1747351973051373,9327564,1,103,12,9296653,9217984,78669,152.53784845364757
1747351973142232,9419084,1,104,12,9387512,9309504,78008,153.8303763716542
1747351973236317,9510604,1,105,12,9481597,9401024,80573,148.9332654859568
1747351973321830,9602124,1,106,12,9567110,9492544,74566,160.93125553201193
1747351973419979,9693644,1,107,12,9665259,9584064,81195,147.79235174579716
1747351973506864,9785164,1,108,12,9752144,9675584,76560,156.7398119122257
1747351973600264,9876684,1,109,12,9845544,9767104,78440,152.9831718510964
1747351973698526,9968204,1,110,12,9943806,9858624,85182,140.87483271113618
1747351973788876,10059724,1,111,12,10034156,9950144,84012,142.836737608913
1747351973878980,10152284,1,112,12,10124260,10042704,81556,147.138162734808
1747351973977765,10247964,1,113,12,10223045,10138384,84661,141.7417701184725
1747351974067502,10340524,1,114,12,10312782,10230944,81838,146.63114934382563
1747351974357926,10624444,1,117,12,10603206,10514864,88342,135.83572932467
1747351974448568,10717004,1,118,12,10693848,10607424,86424,138.8503193557345
1747351974542477,10809564,1,119,12,10787757,10699984,87773,136.71630227974433
1747351974632556,10902124,1,120,12,10877836,10792544,85292,140.69314824368053
1747351974727003,10994684,1,121,12,10972283,10885104,87179,137.64782803198017
1747351974821633,11087244,1,122,12,11066913,10977664,89249,134.45528801443157
1747351974914897,11179804,1,123,12,11160177,11070224,89953,133.40299934410191
1747351975009875,11272364,1,124,12,11255155,11162784,92371,129.9109027725152
1747351975099247,11364924,1,125,12,11344527,11255344,89183,134.55479183252413
1747351975194068,11457484,1,126,12,11439348,11347904,91444,131.22785529941822
1747351975288154,11550044,1,127,12,11533434,11440464,92970,129.07389480477573
1747351975382354,11642604,1,128,12,11627634,11533024,94610,126.83648662932036
1747351975472306,11735164,1,129,12,11717586,11625584,92002,130.43194713158408
1747351975566647,11827724,1,130,12,11811927,11718144,93783,127.95495985413132
1747351975660488,11920284,1,131,12,11905768,11810704,95064,126.23074981065388
1747351975758787,12012844,1,132,12,12004067,11903264,100803,119.0440760691646
1747351975845573,12105404,1,133,12,12090853,11995824,95029,126.27724168411748
1747351975938879,12197964,1,134,12,12184159,12088384,95775,125.29365700861392
1747351976032776,12290524,1,135,12,12278056,12180944,97112,123.56866298706647
1747351976127651,12383084,1,136,12,12372931,12273504,99427,120.69156265400746
1747351976217457,12475644,1,137,12,12462737,12366064,96673,124.12979839251912
1747351976311957,12568204,1,138,12,12557237,12458624,98613,121.6878099236409
1747351976405976,12660772,1,139,12,12651256,12551192,100064,119.92324912056284
1747351976499857,12753324,1,140,12,12745137,12643744,101393,118.35136547887922
1747351976594431,12845884,1,141,12,12839711,12736304,103407,116.0463024746874
1747351976684242,12938444,1,142,12,12929522,12828864,100658,119.21556160464148
1747351976779156,13031004,1,143,12,13024436,12921424,103012,116.49128256902108
1747351976881220,13123564,1,144,12,13126500,13013984,112516,106.65149845355327
1747351976966720,13216124,1,145,12,13212000,13106544,105456,113.79153390987712
1747351977056935,13308684,1,146,12,13302215,13199104,103111,116.37943575370232
1747351977151365,13401244,1,147,12,13396645,13291664,104981,114.30639830064489
1747351977246100,13493804,1,148,12,13491380,13384224,107156,111.98626301840308
1747351977339785,13586364,1,149,12,13585065,13476784,108281,110.82276669037044
1747351977429599,13678924,1,150,12,13674879,13569344,105535,113.706353342493
1747351977524096,13771484,1,151,12,13769376,13661904,107472,111.65698972755696
1747351977618870,13864044,1,152,12,13864150,13754464,109686,109.40320551392156
1747351977712713,13956604,1,153,12,13957993,13847024,110969,108.13830889707936
1747351977802377,14049164,1,154,12,14047657,13939584,108073,111.0360589601473
1747351977908737,14141724,1,155,12,14154017,14032144,121873,98.46315426714696
1747351977991210,14234284,1,156,12,14236490,14124704,111786,107.34796843969728
1747351978085663,14326844,1,157,12,14330943,14217264,113679,105.56039374026864
1747351978179527,14419404,1,158,12,14424807,14309824,114983,104.3632536983728
1747351978269354,14511964,1,159,12,14514634,14402384,112250,106.90423162583518
1747351978364179,14604524,1,160,12,14609459,14494944,114515,104.7897655328996
1747351978458176,14697084,1,161,12,14703456,14587504,115952,103.49109976542016
1747351978552295,14789652,1,162,12,14797575,14680072,117503,102.1250521263287
1747351978642462,14882204,1,163,12,14887742,14772624,115118,104.24086589412605
1747351978736488,14974764,1,164,12,14981768,14865184,116584,102.93007616825638
1747351978830995,15067324,1,165,12,15076275,14957744,118531,101.23933823219242
1747351978924482,15159884,1,166,12,15169762,15050304,119458,100.45371595037588
1747351979014922,15252444,1,167,12,15260202,15142864,117338,102.26865976921373
1747351979109369,15345004,1,168,12,15354649,15235424,119225,100.65003145313484
1747351979203584,15437564,1,169,12,15448864,15327984,120880,99.27200529450695
1747351979297905,15530124,1,170,12,15543185,15420544,122641,97.84656028571196
1747351979391486,15625804,1,171,12,15636766,15516224,120542,99.55036418841566
1747351979481366,15718364,1,172,12,15726646,15608784,117862,101.81398584785596
1747351979580715,15810924,1,173,12,15825995,15701344,124651,96.26878244057409
1747351979674548,15903484,1,174,12,15919828,15793904,125924,95.29557510879576
1747351979765107,15996044,1,175,12,16010387,15886464,123923,96.8343245402387
1747351979859285,16088604,1,176,12,16104565,15979024,125541,95.5863024828542
1747351979952973,16181164,1,177,12,16198253,16071584,126669,94.73509698505552
1747351980047030,16273724,1,178,12,16292310,16164144,128166,93.62857544122464
1747351980137026,16366284,1,179,12,16382306,16256704,125602,95.53987993821757
1747351980231873,16458844,1,180,12,16477153,16349264,127889,93.83136939064345
1747351980325698,16551404,1,181,12,16570978,16441824,129154,92.91233720984252
1747351980419993,16643964,1,182,12,16665273,16534384,130889,91.68073711312638
1747351980510314,16736524,1,183,12,16755594,16626944,128650,93.27633113097552
1747351980604647,16829084,1,184,12,16849927,16719504,130423,92.0083114174647
1747351980698539,16921644,1,185,12,16943819,16812064,131755,91.0781374520891
1747351980792650,17014204,1,186,12,17037930,16904624,133306,90.01845378302552
1747351980886375,17106764,1,187,12,17131655,16997184,134471,89.23857188538793
1747351980977124,17199324,1,188,12,17222404,17089744,132660,90.45680687471732
1747351981071186,17291884,1,189,12,17316466,17182304,134162,89.44410488812034
1747351981164906,17384444,1,190,12,17410186,17274864,135322,88.67737692319061
1747351981259079,17477004,1,191,12,17504359,17367424,136935,87.6328184905247
1747351981349540,17569564,1,192,12,17594820,17459984,134836,88.99700376753982
1747351981443485,17662124,1,193,12,17688765,17552544,136221,88.09214438302463
1747351981537715,17754684,1,194,12,17782995,17645104,137891,87.02525908144838
1747351981632490,17847244,1,195,12,17877770,17737664,140106,85.64943685495267
1747351981722981,17939804,1,196,12,17968261,17830224,138037,86.93321355868355
1747351981816328,18032364,1,197,12,18061608,17922784,138824,86.44038494784763
1747351981910634,18124924,1,198,12,18155914,18015344,140570,85.36672120651633
1747351982004497,18217484,1,199,12,18249777,18107904,141873,84.5826901524603
1747351982095571,18310044,1,200,12,18340851,18200464,140387,85.47800009972433
1747351982193712,18402604,1,201,12,18438992,18293024,145968,82.20979940808945
1747351982283856,18495164,1,202,12,18529136,18385584,143552,83.5934016941596
1747351982377197,18587724,1,203,12,18622477,18478144,144333,83.14106960986054
1747351982472253,18680284,1,204,12,18717533,18570704,146829,81.72772408720348
1747351982562421,18772844,1,205,12,18807701,18663264,144437,83.08120495440919
1747351982656262,18865404,1,206,12,18901542,18755824,145718,82.35084203735984
1747351982750953,18957964,1,207,12,18996233,18848384,147849,81.16389018525658
1747351982844781,19050532,1,208,12,19090061,18940952,149109,80.47803955495644
1747351982935012,19143084,1,209,12,19180292,19033504,146788,81.75055181622476
1747351983029348,19235644,1,210,12,19274628,19126064,148564,80.7732694327024
1747351983123312,19328204,1,211,12,19368592,19218624,149968,80.01707030833245
1747351983217247,19420764,1,212,12,19462527,19311184,151343,79.29008939957579
1747351983307219,19513324,1,213,12,19552499,19403744,148755,80.66955732580418
1747351983402168,19605884,1,214,12,19647448,19496304,151144,79.3944847297941
1747351983496011,19698444,1,215,12,19741291,19588864,152427,78.72620992343876
1747351983590714,19791004,1,216,12,19835994,19681424,154570,77.63472860192792
1747351983680552,19883564,1,217,12,19925832,19773984,151848,79.0263948158685
1747351983774850,19976124,1,218,12,20020130,19866544,153586,78.13212141731668
1747351983868285,20068684,1,219,12,20113565,19959104,154461,77.68951385786704
1747351983962270,20161244,1,220,12,20207550,20051664,155886,76.97933104961318
1747351984053100,20253804,1,221,12,20298380,20144224,154156,77.8432237473728
1747351984147513,20346364,1,222,12,20392793,20236784,156009,76.91863930927062
1747351984241110,20438924,1,223,12,20486390,20329344,157046,76.41073316098469
1747351984343271,20531484,1,224,12,20588551,20421904,166647,72.00849700264632
1747351984429882,20624044,1,225,12,20675162,20514464,160698,74.6742336556771
1747351984519327,20716604,1,226,12,20764607,20607024,157583,76.15034616678194
1747351984613963,20809164,1,227,12,20859243,20699584,159659,75.1601851445894
1747351984708326,20901724,1,228,12,20953606,20792144,161462,74.32089284165934
1747351984802080,20994284,1,229,12,21047360,20884704,162656,73.77532952980523
1747351984892322,21086844,1,230,12,21137602,20977264,160338,74.84189649365715
1747351984986787,21179412,1,231,12,21232067,21069832,162235,73.96677658951522
1747351985080681,21271964,1,232,12,21325961,21162384,163577,73.35994669177207
1747351985175175,21364524,1,233,12,21420455,21254944,165511,72.50273395725964
1747351985265508,21457084,1,234,12,21510788,21347504,163284,73.49158521349305
1747351985359176,21549644,1,235,12,21604456,21440064,164392,72.9962528590199
1747351985453186,21642204,1,236,12,21698466,21532624,165842,72.3580275201698
1747351985548101,21734764,1,237,12,21793381,21625184,168197,71.34491102695054
1747351985641663,21827324,1,238,12,21886943,21717744,169199,70.92240497875284
1747351985731265,21919884,1,239,12,21976545,21810304,166241,72.1843588525093
1747351985826511,22012444,1,240,12,22071791,21902864,168927,71.03660160897903
1747351985920202,22105004,1,241,12,22165482,21995424,170058,70.5641604629009
1747351986014884,22197564,1,242,12,22260164,22087984,172180,69.69450574979672
1747351986104887,22290124,1,243,12,22350167,22180544,169623,70.74512300808263
1747351986199036,22382684,1,244,12,22444316,22273104,171212,70.08854519543023
1747351986293383,22475244,1,245,12,22538663,22365664,172999,69.36456280094104
1747351986387117,22567804,1,246,12,22632397,22458224,174173,68.89701618505738
1747351986477330,22660364,1,247,12,22722610,22550784,171826,69.83809202332591
1747351986571322,22752924,1,248,12,22816602,22643344,173258,69.2608710708885
1747351986665639,22845484,1,249,12,22910919,22735904,175015,68.56555152415507
1747351986759714,22938044,1,250,12,23004994,22828464,176530,67.97711437149493
1747351986850257,23030604,1,251,12,23095537,22921024,174513,68.76278558044386
1747351986944572,23123164,1,252,12,23189852,23013584,176268,68.0781537204711
1747351987038344,23215724,1,253,12,23283624,23106144,177480,67.6132521974307
1747351987133134,23308284,1,254,12,23378414,23198704,179710,66.77424739858661
1747351987226550,23400844,1,255,12,23471830,23291264,180566,66.457694139539
1747351987317397,23493404,1,256,12,23562677,23383824,178853,67.09420585620593
1747351987411646,23585964,1,257,12,23656926,23476384,180542,66.46652856399065
1747351987505353,23678524,1,258,12,23750633,23568944,181689,66.0469263411654
1747351987603637,23771084,1,259,12,23848917,23661504,187413,64.0297097853404
1747351987689984,23863644,1,260,12,23935264,23754064,181200,66.2251655629139
1747351987784533,23956204,1,261,12,24029813,23846624,183189,65.50611663364067
1747351987878467,24048764,1,262,12,24123747,23939184,184563,65.01844898489946
1747351987972862,24141324,1,263,12,24218142,24031744,186398,64.37837315851029
1747351988062492,24233884,1,264,12,24307772,24124304,183468,65.40650140623978
1747351988177315,24326444,1,265,12,24422595,24216864,205731,58.32859413505986
1747351988250929,24419004,1,266,12,24496209,24309424,186785,64.24498755253366
1747351988344844,24511564,1,267,12,24590124,24401984,188140,63.78228978420325
1747351988434974,24604124,1,268,12,24680254,24494544,185710,64.61687577405633
1747351988529967,24696684,1,269,12,24775247,24587104,188143,63.78127275529783
1747351988623858,24789244,1,270,12,24869138,24679664,189474,63.3332277779537
1747351988717320,24881804,1,271,12,24962600,24772224,190376,63.03315543976132
1747351988811542,24974372,1,272,12,25056822,24864792,192030,62.49023590064052
1747351988901606,25066924,1,273,12,25146886,24957344,189542,63.310506378533525
1747351988996342,25159484,1,274,12,25241622,25049904,191718,62.59193189997809
1747351989090708,25252044,1,275,12,25335988,25142464,193524,62.00781298443604
1747351989184920,25344604,1,276,12,25430200,25235024,195176,61.48296921752675
1747351989274803,25437164,1,277,12,25520083,25327584,192499,62.33798617135673
1747351989369498,25529724,1,278,12,25614778,25420144,194634,61.65418169487346
1747351989463435,25622284,1,279,12,25708715,25512704,196011,61.22105392044325
1747351989557059,25714844,1,280,12,25802339,25605264,197075,60.89052391221616
1747351989651559,25810524,1,281,12,25896839,25700944,195895,61.25730620995941
1747351989745949,25903084,1,282,12,25991229,25793504,197725,60.69035276267543
1747351989839810,25995644,1,283,12,26085090,25886064,199026,60.29362997799282
1747351989930415,26088204,1,284,12,26175695,25978624,197071,60.891759822602005
1747351990024780,26180764,1,285,12,26270060,26071184,198876,60.33910577445242
1747351990118372,26273324,1,286,12,26363652,26163744,199908,60.02761270184285
1747351990212583,26365884,1,287,12,26457863,26256304,201559,59.53591752290893
1747351990401272,26554124,1,289,12,26646552,26444544,202008,59.403587976713794
1747351990495098,26646684,1,290,12,26740378,26537104,203274,59.033619646388615
1747351990588953,26739244,1,291,12,26834233,26629664,204569,58.65991425875866
1747351990679644,26831804,1,292,12,26924924,26722224,202700,59.20078934385792
1747351990773802,26924364,1,293,12,27019082,26814784,204298,58.73772626261637
1747351990868031,27016924,1,294,12,27113311,26907344,205967,58.26176037908985
1747351990962003,27109484,1,295,12,27207283,26999904,207379,57.86506830489104
1747351991052140,27202044,1,296,12,27297420,27092464,204956,58.54915201311501
1747351991146697,27294604,1,297,12,27391977,27185024,206953,57.984179982894666
1747351991240533,27387164,1,298,12,27485813,27277584,208229,57.6288605333551
1747351991334992,27479724,1,299,12,27580272,27370144,210128,57.10804842762506
1747351991425411,27572284,1,300,12,27670691,27462704,207987,57.69591368691312
1747351991519474,27664844,1,301,12,27764754,27555264,209490,57.28197049978519
1747351991612942,27757404,1,302,12,27858222,27647824,210398,57.03476268785825
1747351991707505,27849964,1,303,12,27952785,27740384,212401,56.49690914826201
1747351991801432,27942524,1,304,12,28046712,27832944,213768,56.13562366677893
1747351991891809,28035092,1,305,12,28137089,27925512,211577,56.7169399320342
1747351991985756,28127644,1,306,12,28231036,28018064,212972,56.34543508066788
1747351992080413,28220204,1,307,12,28325693,28110624,215069,55.79604685008067
1747351992174751,28312764,1,308,12,28420031,28203184,216847,55.3385566782109
1747351992264398,28405324,1,309,12,28509678,28295744,213934,56.0920657772958
1747351992358987,28497884,1,310,12,28604267,28388304,215963,55.5650736468747
1747351992453657,28590444,1,311,12,28698937,28480864,218073,55.02744493816291
1747351992546659,28683004,1,312,12,28791939,28573424,218515,54.91613848019587
1747351992932265,29065724,1,316,12,29177545,28956144,221401,54.20029719829631
1747351993026625,29158284,1,317,12,29271905,29048704,223201,53.76319998566314
1747351993117008,29250844,1,318,12,29362288,29141264,221024,54.29274648906906
1747351993210815,29343404,1,319,12,29456095,29233824,222271,53.98814960116255
1747351993301148,29435964,1,320,12,29546428,29326384,220044,54.53454763592736
1747351993399416,29528524,1,321,12,29644696,29418944,225752,53.15567525426131
1747351993489112,29621084,1,322,12,29734392,29511504,222888,53.83869925702595
1747351993583629,29713644,1,323,12,29828909,29604064,224845,53.37009940181014
1747351993677333,29806204,1,324,12,29922613,29696624,225989,53.09992964259322
1747351993772238,29898772,1,325,12,30017518,29789192,228326,52.556432469363976
1747351993861586,29991324,1,326,12,30106866,29881744,225122,53.30443048658061
1747351993955750,30083884,1,327,12,30201030,29974304,226726,52.927321965720736
1747351994050478,30176444,1,328,12,30295758,30066864,228894,52.42601378804163
1747351994145025,30269004,1,329,12,30390305,30159424,230881,51.97482685885802
1747351994238613,30361564,1,330,12,30483893,30251984,231909,51.74443423929213
1747351994329157,30454124,1,331,12,30574437,30344544,229893,52.19819655230912
1747351994423609,30546684,1,332,12,30668889,30437104,231785,51.77211640097504
1747351994516901,30639244,1,333,12,30762181,30529664,232517,51.60912965503598
1747351994611894,30731804,1,334,12,30857174,30622224,234950,51.074696743988085
1747351994705903,30827484,1,335,12,30951183,30717904,233279,51.440549728008094
1747351994800287,30920044,1,336,12,31045567,30810464,235103,51.04145842460539
1747351994894005,31012604,1,337,12,31139285,30903024,236261,50.791285908380985
1747351994984607,31105164,1,338,12,31229887,30995584,234303,51.215733473323006
1747351995078753,31197724,1,339,12,31324033,31088144,235889,50.87138442233424
1747351995172501,31290284,1,340,12,31417781,31180704,237077,50.61646638012122
1747351995267305,31382844,1,341,12,31512585,31273264,239321,50.14185967800569
1747351995357433,31475404,1,342,12,31602713,31365824,236889,50.65663665260945
1747351995450790,31567964,1,343,12,31696070,31458384,237686,50.48677667174339
1747351995545716,31660524,1,344,12,31790996,31550944,240052,49.98916901338044
1747351995639291,31753084,1,345,12,31884571,31643504,241067,49.77869223079061
1747351995733865,31845644,1,346,12,31979145,31736064,243081,49.36626062917299
1747351995824185,31938204,1,347,12,32069465,31828624,240841,49.82540348196528
1747351995918334,32030764,1,348,12,32163614,31921184,242430,49.49882440292043
1747351996012740,32123324,1,349,12,32258020,32013744,244276,49.124760516792485
1747351996106882,32215884,1,350,12,32352162,32106304,245858,48.80866191053372
1747351996196489,32308444,1,351,12,32441769,32198864,242905,49.4020296000494
1747351996290751,32401004,1,352,12,32536031,32291424,244607,49.058285331163866
1747351996384956,32493564,1,353,12,32630236,32383984,246252,48.73056868573656
1747351996479505,32586124,1,354,12,32724785,32476544,248241,48.340121092003336
1747351996569025,32678684,1,355,12,32814305,32569104,245201,48.93944151940653
1747351996663146,32771244,1,356,12,32908426,32661664,246762,48.62985386728913
1747351996753833,32863804,1,357,12,32999113,32754224,244889,49.00179264891441
1747351996848074,32956364,1,358,12,33093354,32846784,246570,48.6677211339579
1747351996942452,33048924,1,359,12,33187732,32939344,248388,48.31151263346055
1747351997036448,33141484,1,360,12,33281728,33031904,249824,48.03381580632766
1747351997155112,33234044,1,361,12,33400392,33124464,275928,43.489605984169785
1747351997224908,33326604,1,362,12,33470188,33217024,253164,47.40010428022941
1747351997318323,33419164,1,363,12,33563603,33309584,254019,47.24056074545605
1747351997408782,33511724,1,364,12,33654062,33402144,251918,47.63454774966458
1747351997502989,33604284,1,365,12,33748269,33494704,253565,47.3251434543411
1747351997597118,33696844,1,366,12,33842398,33587264,255134,47.034107567004
1747351997691031,33789404,1,367,12,33936311,33679824,256487,46.78599695111253
1747351997781441,33881964,1,368,12,34026721,33772384,254337,47.18149541749726
1747351998162151,34261564,1,372,12,34407431,34151984,255447,46.97647652937792
1747351998453475,34548604,1,375,12,34698755,34439024,259731,46.20164708871872
1747351998551888,34641164,1,376,12,34797168,34531584,265584,45.18344478583048
1747351998642195,34733724,1,377,12,34887475,34624144,263331,45.57002403818768
1747351998735624,34826284,1,378,12,34980904,34716704,264200,45.42013626040878
1747351998821991,34918844,1,379,12,35067271,34809264,258007,46.510365997821765
1747351998920465,35011404,1,380,12,35165745,34901824,263921,45.46815145441249
1747351999010299,35103964,1,381,12,35255579,34994384,261195,45.942686498593005
1747351999104944,35196524,1,382,12,35350224,35086944,263280,45.57885141294439
1747351999198276,35289084,1,383,12,35443556,35179504,264052,45.44559404965688
1747351999288981,35381644,1,384,12,35534261,35272064,262197,45.76711404020641
1747351999387711,35474204,1,385,12,35632991,35364624,268367,44.71488670365581
1747351999476886,35566764,1,386,12,35722166,35457184,264982,45.28609490455956
1747351999571353,35659324,1,387,12,35816633,35549744,266889,44.9625125051988
1747351999665563,35751884,1,388,12,35910843,35642304,268539,44.68624669042485
1747351999755400,35844444,1,389,12,36000680,35734864,265816,45.14400938995395
1747351999850072,35937004,1,390,12,36095352,35827424,267928,44.7881520408468
1747351999943731,36029564,1,391,12,36189011,35919984,269027,44.605188326822216
1747352000038365,36122124,1,392,12,36283645,36012544,271101,44.2639459094581
1747352000132051,36214684,1,393,12,36377331,36105104,272227,44.0808589890055
1747352000226276,36307244,1,394,12,36471556,36197664,273892,43.81288975216509
1747352000317279,36399804,1,395,12,36562559,36290224,272335,44.06337782510512
1747352000411292,36492364,1,396,12,36656572,36382784,273788,43.82953233888995
1747352000501213,36584924,1,397,12,36746493,36475344,271149,44.25611010920196
1747352000599879,36677484,1,398,12,36845159,36567904,277255,43.281455699626704
1747352000690113,36770044,1,399,12,36935393,36660464,274929,43.64763266152352
1747352000780056,36862604,1,400,12,37025336,36753024,272312,44.06709950351068
1747352000877724,36955172,1,401,12,37123004,36845592,277412,43.25696076593659
1747352000972564,37047724,1,402,12,37217844,36938144,279700,42.90311047550947
1747352001066210,37140284,1,403,12,37311490,37030704,280786,42.73717350580157
1747352001152166,37232844,1,404,12,37397446,37123264,274182,43.76654922642624
1747352001250400,37325404,1,405,12,37495680,37215824,279856,42.879195014578926
1747352001344622,37417964,1,406,12,37589902,37308384,281518,42.62604877840849
1747352001439333,37510524,1,407,12,37684613,37400944,283669,42.302824771124094
1747352001533494,37603084,1,408,12,37778774,37493504,285270,42.06541171521716
1747352001623158,37695644,1,409,12,37868438,37586064,282374,42.496830444729326
1747352001713328,37788204,1,410,12,37958608,37678624,279984,42.85959197668438
1747352001807338,37880764,1,411,12,38052618,37771184,281434,42.63877143486573
1747352001902189,37973324,1,412,12,38147469,37863744,283725,42.294475284166005
1747352001996436,38065884,1,413,12,38241716,37956304,285412,42.04448306308074
1747352002089702,38158444,1,414,12,38334982,38048864,286118,41.9407377375768
1747352002180015,38251004,1,415,12,38425295,38141424,283871,42.27272246900881
1747352002275008,38343564,1,416,12,38520288,38233984,286304,41.91349055549346
1747352002369217,38436124,1,417,12,38614497,38326544,287953,41.67346754505076
1747352002459178,38528684,1,418,12,38704458,38419104,285354,42.05302886940432
1747352002552996,38621244,1,419,12,38798276,38511664,286612,41.86844933219824
1747352002647008,38713804,1,420,12,38892288,38604224,288064,41.65740946456343
1747352002741679,38806364,1,421,12,38986959,38696784,290175,41.35435513052468
1747352002836350,38898924,1,422,12,39081630,38789344,292286,41.05567834244541
1747352002930328,38991484,1,423,12,39175608,38881904,293704,40.85746193446463
1747352003020083,39084052,1,424,12,39265363,38974472,290891,41.25256539391043
1747352003118163,39176604,1,425,12,39363443,39067024,296419,40.48323488035518
1747352003208398,39269164,1,426,12,39453678,39159584,294094,40.80328058375893
1747352003302761,39361724,1,427,12,39548041,39252144,295897,40.55465246352615
1747352003396947,39454284,1,428,12,39642227,39344704,297523,40.33301627101098
1747352003486875,39546844,1,429,12,39732155,39437264,294891,40.69300182101183
1747352003581203,39639404,1,430,12,39826483,39529824,296659,40.45048355182213
1747352003675191,39731964,1,431,12,39920471,39622384,298087,40.25670357982737
1747352003769198,39824524,1,432,12,40014478,39714944,299534,40.06222999726241
1747352003859418,39917084,1,433,12,40104698,39807504,297194,40.377665767142
1747352003954041,40009644,1,434,12,40199321,39900064,299257,40.09931263094932
1747352004047696,40102204,1,435,12,40292976,39992624,300352,39.9531216705732
1747352004141861,40194764,1,436,12,40387141,40085184,301957,39.74075779001646
1747352004231968,40287324,1,437,12,40477248,40177744,299504,40.06624285485336
1747352004326494,40379884,1,438,12,40571774,40270304,301470,39.80495571698676
1747352004420973,40472444,1,439,12,40666253,40362864,303389,39.55318089976894
1747352004515347,40565004,1,440,12,40760627,40455424,305203,39.31809320353994
1747352004609078,40657564,1,441,12,40854358,40547984,306374,39.16781450123053
1747352004695335,40750124,1,442,12,40940615,40640544,300071,39.99053557324767
1747352004789013,40842684,1,443,12,41034293,40733104,301189,39.84209250669846
1747352004883364,40935244,1,444,12,41128644,40825664,302980,39.60657469139877
1747352004973997,41027804,1,445,12,41219277,40918224,301053,39.86009108030812
1747352005067453,41120364,1,446,12,41312733,41010784,301949,39.74181070313198
1747352005162416,41212924,1,447,12,41407696,41103344,304352,39.42803070129324
1747352005256602,41305484,1,448,12,41501882,41195904,305978,39.21850590565335
1747352005346962,41398044,1,449,12,41592242,41288464,303778,39.50253145389067
1747352005440319,41490604,1,450,12,41685599,41381024,304575,39.39916276779119
1747352005534380,41583164,1,451,12,41779660,41473584,306076,39.2059488493054
1747352005628735,41675724,1,452,12,41874015,41566144,307871,38.97736389591744
1747352005722807,41768284,1,453,12,41968087,41658704,309383,38.78687581412036
1747352005813194,41860844,1,454,12,42058474,41751264,307210,39.06122847563556
1747352005907596,41953404,1,455,12,42152876,41843824,309052,38.82841722428588
1747352006002108,42045964,1,456,12,42247388,41936384,311004,38.58471273681367
1747352006095697,42138524,1,457,12,42340977,42028944,312033,38.45747084442991
1747352006186198,42231084,1,458,12,42431478,42121504,309974,38.71292430978082
1747352006284189,42323644,1,459,12,42529469,42214064,315405,38.0463213963
1747352006374184,42416204,1,460,12,42619464,42306624,312840,38.35826620636748
1747352006468669,42508764,1,461,12,42713949,42399184,314765,38.12367957047321
1747352006562917,42601324,1,462,12,42808197,42491744,316453,37.92032308115265
1747352006653004,42693884,1,463,12,42898284,42584304,313980,38.2189948404357
1747352006751132,42786444,1,464,12,42996412,42676864,319548,37.553043674189794
1747352006841187,42879012,1,465,12,43086467,42769432,317035,37.85071048937815
1747352006935318,42971564,1,466,12,43180598,42861984,318614,37.66312842499074
1747352007025381,43064124,1,467,12,43270661,42954544,316117,37.96062850147256
1747352007119656,43156684,1,468,12,43364936,43047104,317832,37.75579551461149
1747352007214098,43249244,1,469,12,43459378,43139664,319714,37.53354560638571
1747352007308180,43341804,1,470,12,43553460,43232224,321236,37.35571355638845
1747352007398660,43434364,1,471,12,43643940,43324784,319156,37.59916780508591
1747352007496487,43526924,1,472,12,43741767,43417344,324423,36.988746173976566
1747352007587077,43619484,1,473,12,43832357,43509904,322453,37.21472586702559
1747352007685206,43712044,1,474,12,43930486,43602464,328022,36.58291212174793
1747352007779337,43804604,1,475,12,44024617,43695024,329593,36.40854022991993
1747352007873472,43897164,1,476,12,44118752,43787584,331168,36.235385061358585
1747352007963769,43989724,1,477,12,44209049,43880144,328905,36.48469922926073
1747352008057284,44082284,1,478,12,44302564,43972704,329860,36.379069908446006
1747352008151467,44174844,1,479,12,44396747,44065264,331483,36.20095148167477
1747352008246301,44267404,1,480,12,44491581,44157824,333757,35.95430208205371
1747352008336215,44359964,1,481,12,44581495,44250384,331111,36.241622899873455
1747352008430536,44452524,1,482,12,44675816,44342944,332872,36.04989305198394
1747352008524247,44545084,1,483,12,44769527,44435504,334023,35.92566978920613
1747352008618436,44637644,1,484,12,44863716,44528064,335652,35.751313860784386
1747352008708862,44730204,1,485,12,44954142,44620624,333518,35.98006704285826
1747352008803122,44822764,1,486,12,45048402,44713184,335218,35.79760036752203
1747352008897436,44915324,1,487,12,45142716,44805744,336972,35.61126740500694
1747352008991205,45007892,1,488,12,45236485,44898312,338173,35.484796243342906
1747352009085874,45100444,1,489,12,45331154,44990864,340290,35.26403949572424
1747352009175951,45193004,1,490,12,45421231,45083424,337807,35.52324256158102
1747352009270461,45285564,1,491,12,45515741,45175984,339757,35.31936060184191
1747352009359789,45378124,1,492,12,45605069,45268544,336525,35.65856919991085
1747352009454193,45470684,1,493,12,45699473,45361104,338369,35.464241700628605
1747352009544261,45563244,1,494,12,45789541,45453664,335877,35.7273644816406
1747352009638392,45655804,1,495,12,45883672,45546224,337448,35.56103458903297
1747352009732444,45748364,1,496,12,45977724,45638784,338940,35.40449637103912
1747352009826676,45840924,1,497,12,46071956,45731344,340612,35.230702382769834
1747352009916681,45933484,1,498,12,46161961,45823904,338057,35.496972404062035
1747352010011972,46026044,1,499,12,46257252,45916464,340788,35.21250748265784
1747352010105400,46118604,1,500,12,46350680,46009024,341656,35.12304774392957
1747352010195663,46211164,1,501,12,46440943,46101584,339359,35.36078312347691
1747352010294064,46303724,1,502,12,46539344,46194144,345200,34.762456546929315
1747352010384218,46396284,1,503,12,46629498,46286704,342794,35.00644702065964
1747352010478427,46488844,1,504,12,46723707,46379264,344443,34.8388557758468
1747352010572251,46581404,1,505,12,46817531,46471824,345707,34.71147532447998
1747352010666729,46673964,1,506,12,46912009,46564384,347625,34.51995685005394
1747352010757318,46766524,1,507,12,47002598,46656944,345654,34.716797722578065
1747352010850545,46859084,1,508,12,47095825,46749504,346321,34.64993459824845
1747352010940850,46951644,1,509,12,47186130,46842064,344066,34.87702940714863
1747352011035518,47044204,1,510,12,47280798,46934624,346174,34.66464841380346
1747352011129812,47136764,1,511,12,47375092,47027184,347908,34.491877162928134
1747352011223802,47229324,1,512,12,47469082,47119744,349338,34.350686154955945
1747352011317791,47321884,1,513,12,47563071,47212304,350767,34.21074388411681
1747352011407891,47414444,1,514,12,47653171,47304864,348307,34.452365298429264
1747352011502339,47507004,1,515,12,47747619,47397424,350195,34.26662288153743
1747352011596078,47599564,1,516,12,47841358,47489984,351374,34.151644686288684
1747352011690242,47692124,1,517,12,47935522,47582544,352978,33.996453036733165
1747352011784411,47784684,1,518,12,48029691,47675104,354587,33.842188235891335
1747352011874519,47877244,1,519,12,48119799,47767664,352135,34.07783946497792
1747352011969567,47969804,1,520,12,48214847,47860224,354623,33.838752703575345
1747352012063741,48062364,1,521,12,48309021,47952784,356237,33.68543974938033
1747352012157626,48154924,1,522,12,48402906,48045344,357562,33.56061326427305
1747352012251359,48247484,1,523,12,48496639,48137904,358735,33.450875994815114
1747352012342190,48340044,1,524,12,48587470,48230464,357006,33.61288045579066
1747352012436613,48432604,1,525,12,48681893,48323024,358869,33.43838559474349
1747352012530313,48525164,1,526,12,48775593,48415584,360009,33.33250002083281
1747352012624788,48617724,1,527,12,48870068,48508144,361924,33.15613222665532
1747352012715328,48710284,1,528,12,48960608,48600704,359904,33.34222459322486
1747352012809856,48802852,1,529,12,49055136,48693272,361864,33.1616297835651
1747352012899623,48895404,1,530,12,49144903,48785824,359079,33.418829839673165
1747352012993319,48987964,1,531,12,49238599,48878384,360215,33.31343780797579
1747352013087097,49080524,1,532,12,49332377,48970944,361433,33.2011742148614
1747352013181741,49173084,1,533,12,49427021,49063504,363517,33.0108358068536
1747352013275568,49265644,1,534,12,49520848,49156064,364784,32.8961796570025
1747352013366149,49358204,1,535,12,49611429,49248624,362805,33.07561913424567
1747352013460551,49450764,1,536,12,49705831,49341184,364647,32.908538943142275
1747352013554557,49543324,1,537,12,49799837,49433744,366093,32.778556268489154
1747352013648286,49635884,1,538,12,49893566,49526304,367262,32.674221672811235
1747352013738951,49728444,1,539,12,49984231,49618864,365367,32.84368867467505
1747352013833196,49821004,1,540,12,50078476,49711424,367052,32.69291544522302
1747352013926286,49913564,1,541,12,50171566,49803984,367582,32.645776996697336
1747352014021498,50006124,1,542,12,50266778,49896544,370234,32.411934074126094
1747352014111044,50098684,1,543,12,50356324,49989104,367220,32.67795871684549
1747352014205422,50191244,1,544,12,50450702,50081664,369038,32.516976571518384
1747352014300118,50283804,1,545,12,50545398,50174224,371174,32.32985068997289
1747352014394087,50376364,1,546,12,50639367,50266784,372583,32.20758864467783
1747352014484094,50468924,1,547,12,50729374,50359344,370030,32.42980298894684
1747352014582279,50561484,1,548,12,50827559,50451904,375655,31.94420412346435
1747352014671769,50654044,1,549,12,50917049,50544464,372585,32.20741575747816
1747352014766898,50746604,1,550,12,51012178,50637024,375154,31.986864061158887
1747352014861086,50839164,1,551,12,51106366,50729584,376782,31.84865519053458
1747352014950475,50931732,1,552,12,51195755,50822152,373603,32.11965642674176
1747352015045223,51024284,1,553,12,51290503,50914704,375799,31.931963629493428
1747352015138545,51116844,1,554,12,51383825,51007264,376561,31.86734685748126
1747352015233654,51209404,1,555,12,51478934,51099824,379110,31.653082218881064
1747352015327827,51301964,1,556,12,51573107,51192384,380723,31.518978364847936
1747352015421981,51394524,1,557,12,51667261,51284944,382317,31.38756581580207
1747352015512361,51487084,1,558,12,51757641,51377504,380137,31.567566429997605
1747352015606450,51579644,1,559,12,51851730,51470064,381666,31.441102953891622
1747352015699927,51672204,1,560,12,51945207,51562624,382583,31.36574285841242
1747352015794290,51764764,1,561,12,52039570,51655184,384386,31.21861878424292
1747352015884305,51857324,1,562,12,52129585,51747744,381841,31.426693309518885
1747352015978458,51949884,1,563,12,52223738,51840304,383434,31.296129190421297
1747352016076970,52042444,1,564,12,52322250,51932864,389386,30.81774896888948
1747352016167365,52135004,1,565,12,52412645,52025424,387221,30.990054774921816
1747352016257220,52227564,1,566,12,52502500,52117984,384516,31.20806416377992
1747352016351786,52320124,1,567,12,52597066,52210544,386522,31.04609828159846
1747352016445480,52412684,1,568,12,52690760,52303104,387656,30.95527993891492
1747352016539491,52505244,1,569,12,52784771,52395664,389107,30.839846109167915
1747352016629759,52597804,1,570,12,52875039,52488224,386815,31.022581854374828
1747352016728256,52690364,1,571,12,52973536,52580784,392752,30.553631808367623
1747352016818729,52782924,1,572,12,53064009,52673344,390665,30.716854594089565
1747352016908688,52875484,1,573,12,53153968,52765904,388064,30.922734394326707
1747352017011078,52968044,1,574,12,53256358,52858464,397894,30.15878600833388
1747352017097266,53060604,1,575,12,53342546,52951024,391522,30.64961866766108
1747352017191645,53153164,1,576,12,53436925,53043584,393341,30.507879931153884
1747352017284789,53245724,1,577,12,53530069,53136144,393925,30.46265151995938
1747352017379475,53338284,1,578,12,53624755,53228704,396051,30.299128142587698
1747352017473940,53430844,1,579,12,53719220,53321264,397956,30.15408738654525
1747352017563979,53523404,1,580,12,53809259,53413824,395435,30.346327462161923
1747352017657712,53615964,1,581,12,53902992,53506384,396608,30.256575762465708
1747352017751898,53708524,1,582,12,53997178,53598944,398234,30.133037359944154
1747352017846505,53801084,1,583,12,54091785,53691504,400281,29.97893979479416
1747352017940500,53893644,1,584,12,54185780,53784064,401716,29.871849764510248
1747352018034826,53986204,1,585,12,54280106,53876624,403482,29.741103692358024
1747352018124998,54078764,1,586,12,54370278,53969184,401094,29.91817379467157
1747352018218711,54171324,1,587,12,54463991,54061744,402247,29.832416400868123
1747352018309347,54263884,1,588,12,54554627,54154304,400323,29.975794545904183
1747352018402971,54356444,1,589,12,54648251,54246864,401387,29.89633446025905
1747352018497607,54449004,1,590,12,54742887,54339424,403463,29.74250426928863
1747352018591835,54541564,1,591,12,54837115,54431984,405131,29.62004882371381
1747352018681639,54634124,1,592,12,54926919,54524544,402375,29.82292637465052
1747352018780072,54726692,1,593,12,55025352,54617112,408240,29.394473838918284
1747352018874205,54819244,1,594,12,55119485,54709664,409821,29.281076372367448
1747352018964605,54911804,1,595,12,55209885,54802224,407661,29.436222743897503
1747352019058786,55004364,1,596,12,55304066,54894784,409282,29.31963780474099
1747352019148853,55096924,1,597,12,55394133,54987344,406789,29.49932274471532
1747352019243468,55189484,1,598,12,55488748,55079904,408844,29.35104832160922
1747352019337418,55282044,1,599,12,55582698,55172464,410234,29.25159786853357
1747352019431553,55374604,1,600,12,55676833,55265024,411809,29.139722541275205
1747352019521655,55467164,1,601,12,55766935,55357584,409351,29.31469570124416
1747352019615884,55559724,1,602,12,55861164,55450144,411020,29.195659578609312
1747352019709896,55652284,1,603,12,55955176,55542704,412472,29.092883880602805
1747352019804263,55744844,1,604,12,56049543,55635264,414279,28.96598669012912
1747352019894788,55837404,1,605,12,56140068,55727824,412244,29.10897429677569
1747352019988528,55929964,1,606,12,56233808,55820384,413424,29.02589109485661
1747352020082726,56022524,1,607,12,56328006,55912944,415062,28.911343365569483
1747352020172604,56115084,1,608,12,56417884,56005504,412380,29.099374363451183
1747352020267445,56207644,1,609,12,56512725,56098064,414661,28.93930222519118
1747352020361384,56300204,1,610,12,56606664,56190624,416040,28.843380444188057
1747352020451479,56392764,1,611,12,56696759,56283184,413575,29.01529347760382
1747352020549799,56485324,1,612,12,56795079,56375744,419335,28.616738407240035
1747352020639771,56577884,1,613,12,56885051,56468304,416747,28.79444843034263
1747352020734417,56670444,1,614,12,56979697,56560864,418833,28.6510375256964
1747352020828619,56763004,1,615,12,57073899,56653424,420475,28.53915214935489
1747352020922011,56855572,1,616,12,57167291,56745992,421299,28.483333689375005
1747352021016372,56948124,1,617,12,57261652,56838544,423108,28.361553078646587
1747352021106265,57040684,1,618,12,57351545,56931104,420441,28.541460038388266
1747352021200942,57133244,1,619,12,57446222,57023664,422558,28.39846837593893
1747352021294674,57225804,1,620,12,57539954,57116224,423730,28.319920704222028
1747352021389309,57318364,1,621,12,57634589,57208784,425805,28.181914256525875
1747352021479725,57410924,1,622,12,57725005,57301344,423661,28.32453305827065
1747352021573722,57503484,1,623,12,57819002,57393904,425098,28.228784891954326
1747352021668214,57596044,1,624,12,57913494,57486464,427030,28.10107018242278
1747352021762229,57688604,1,625,12,58007509,57579024,428485,28.005647805640805
1747352021852178,57781164,1,626,12,58097458,57671584,425874,28.1773482297581
1747352021946125,57873724,1,627,12,58191405,57764144,427261,28.08587725067348
1747352022040122,57966284,1,628,12,58285402,57856704,428698,27.99173310815539
1747352022134561,58058844,1,629,12,58379841,57949264,430577,27.869579657064826
1747352022224513,58151404,1,630,12,58469793,58041824,427969,28.039414069710656
1747352022319330,58243964,1,631,12,58564610,58134384,430226,27.89231706126548
1747352022417044,58336524,1,632,12,58662324,58226944,435380,27.56212963388305
1747352022511525,58429084,1,633,12,58756805,58319504,437301,27.441053187621343
1747352022601605,58521644,1,634,12,58846885,58412064,434821,27.597563135175164
1747352022696252,58614204,1,635,12,58941532,58504624,436908,27.46573649372408
1747352022789770,58706764,1,636,12,59035050,58597184,437866,27.405644649276265
1747352022880310,58799324,1,637,12,59125590,58689744,435846,27.532660618658884
1747352022974273,58891884,1,638,12,59219553,58782304,437249,27.444316625080905
1747352023068261,58984444,1,639,12,59313541,58874864,438677,27.35497872010614
1747352023161845,59077004,1,640,12,59407125,58967424,439701,27.291272933197785
1747352023253276,59169564,1,641,12,59498556,59059984,438572,27.36152786771613
1747352023347080,59262124,1,642,12,59592360,59152544,439816,27.284137002746604
1747352023441315,59354684,1,643,12,59686595,59245104,441491,27.18062202853512
1747352023535267,59447244,1,644,12,59780547,59337664,442883,27.095192183940227
1747352023629798,59539804,1,645,12,59875078,59430224,444854,26.975142406272617
1747352023723785,59632364,1,646,12,59969065,59522784,446281,26.888888390946512
1747352023810015,59724924,1,647,12,60055295,59615344,439951,27.27576480108012
1747352023908156,59817484,1,648,12,60153436,59707904,445532,26.93409227620014
1747352024002400,59910044,1,649,12,60247680,59800464,447216,26.83267146077064
1747352024096330,60002604,1,650,12,60341610,59893024,448586,26.750723384144848
1747352024186097,60095164,1,651,12,60431377,59985584,445793,26.91832307819997
1747352024280460,60187724,1,652,12,60525740,60078144,447596,26.809891062475984
1747352024375250,60280284,1,653,12,60620530,60170704,449826,26.676981766282964
1747352024468844,60372844,1,654,12,60714124,60263264,450860,26.615800913809167
1747352024559142,60465404,1,655,12,60804422,60355824,448598,26.75000780208561
1747352024653735,60557964,1,656,12,60899015,60448384,450631,26.62932643337897
1747352024747586,60650532,1,657,12,60992866,60540952,451914,26.55372482374965
1747352024842079,60743084,1,658,12,61087359,60633504,453855,26.44016260700004
1747352024935822,60835644,1,659,12,61181102,60726064,455038,26.37142392503484
1747352025026289,60928204,1,660,12,61271569,60818624,452945,26.49328284891101
1747352025120745,61020764,1,661,12,61366025,60911184,454841,26.38284587361297
1747352025210435,61113324,1,662,12,61455715,61003744,451971,26.55037601970038
1747352025304635,61205884,1,663,12,61549915,61096304,453611,26.454384924527844
1747352025398712,61298444,1,664,12,61643992,61188864,455128,26.366209066460424
1747352025492861,61391004,1,665,12,61738141,61281424,456717,26.27447631684391
1747352025586988,61483564,1,666,12,61832268,61373984,458284,26.18463660088504
1747352025680989,61576124,1,667,12,61926269,61466544,459725,26.10256131382892
1747352025771470,61668684,1,668,12,62016750,61559104,457646,26.221140357394145
1747352025866235,61761244,1,669,12,62111515,61651664,459851,26.095409165142623
1747352025959598,61853804,1,670,12,62204878,61744224,460654,26.04992033066032
1747352026050397,61946364,1,671,12,62295677,61836784,458893,26.14988679278176
1747352026148891,62038924,1,672,12,62394171,61929344,464827,25.816056296213432
1747352026234797,62131484,1,673,12,62480077,62021904,458173,26.19098026291379
1747352026328815,62224044,1,674,12,62574095,62114464,459631,26.10789959772078
1747352026423233,62316604,1,675,12,62668513,62207024,461489,26.0027866319674
1747352026517450,62409164,1,676,12,62762730,62299584,463146,25.909756318741824
1747352026607034,62501724,1,677,12,62852314,62392144,460170,26.07731925158093
1747352026701012,62594284,1,678,12,62946292,62484704,461588,25.997209632832742
1747352026799639,62686844,1,679,12,63044919,62577264,467655,25.659941623632808
1747352026889031,62779412,1,680,12,63134311,62669832,464479,25.83539837107813
1747352026979822,62871964,1,681,12,63225102,62762384,462718,25.93372205101163
1747352027078302,62964524,1,682,12,63323582,62854944,468638,25.60611815516454
1747352027171987,63057084,1,683,12,63417267,62947504,469763,25.544795992873
1747352027261962,63149644,1,684,12,63507242,63040064,467178,25.686141042600465
1747352027356500,63242204,1,685,12,63601780,63132624,469156,25.577846174833105
1747352027450988,63334764,1,686,12,63696268,63225184,471084,25.47316402170313
1747352027545460,63427324,1,687,12,63790740,63317744,472996,25.37019340544106
1747352027635176,63519884,1,688,12,63880456,63410304,470152,25.5236604332216
1747352027733177,63612444,1,689,12,63978457,63502864,475593,25.23165816149523
1747352027823428,63705004,1,690,12,64068708,63595424,473284,25.35475528435358
1747352027913872,63797564,1,691,12,64159152,63687984,471168,25.46862265688672
1747352028008247,63890124,1,692,12,64253527,63780544,472983,25.370890708545552
1747352028102499,63982684,1,693,12,64347779,63873104,474675,25.280455048190863
1747352028196098,64075244,1,694,12,64441378,63965664,475714,25.225240375519743
1747352028289948,64167804,1,695,12,64535228,64058224,477004,25.15702174405246
1747352028384853,64260364,1,696,12,64630133,64150784,479349,25.033952297803896
1747352028479199,64352924,1,697,12,64724479,64243344,481135,24.941024868280213
1747352028568729,64445484,1,698,12,64814009,64335904,478105,25.099089112224306
1747352028662999,64538044,1,699,12,64908279,64428464,479815,25.00963913174869
1747352028757012,64630604,1,700,12,65002292,64521024,481268,24.93413233375168
1747352028851156,64723164,1,701,12,65096436,64613584,482852,24.852335705350708
1747352028945692,64815724,1,702,12,65190972,64706144,484828,24.751045731682165
1747352029035721,64908284,1,703,12,65281001,64798704,482297,24.880934362021744
1747352029130456,65000844,1,704,12,65375736,64891264,484472,24.769233309664955
1747352029224433,65093404,1,705,12,65469713,64983824,485889,24.69699869723332
1747352029318938,65185964,1,706,12,65564218,65076384,487834,24.598531467671386
1747352029409002,65278524,1,707,12,65654282,65168944,485338,24.72503698453449
1747352029503078,65371084,1,708,12,65748358,65261504,486854,24.648046436919486
1747352029596576,65463644,1,709,12,65841856,65354064,487792,24.600649457145668
1747352029690821,65556204,1,710,12,65936101,65446624,489477,24.515962956379973
1747352029781628,65648764,1,711,12,66026908,65539184,487724,24.604079356357285
1747352029875036,65741324,1,712,12,66120316,65631744,488572,24.5613747820178
1747352029969636,65833884,1,713,12,66214916,65724304,490612,24.459246818259643
1747352030063369,65926444,1,714,12,66308649,65816864,491785,24.40090690037313
1747352030153960,66019004,1,715,12,66399240,65909424,489816,24.49899554118281
1747352030248186,66111564,1,716,12,66493466,66001984,491482,24.415950126352545
1747352030342519,66204124,1,717,12,66587799,66094544,493255,24.32818724594784
1747352030436421,66296684,1,718,12,66681701,66187104,494597,24.262177085586853
1747352030530613,66389244,1,719,12,66775893,66279664,496229,24.18238353663329
1747352030621266,66481804,1,720,12,66866546,66372224,494322,24.275674560306847
1747352030714789,66574372,1,721,12,66960069,66464792,495277,24.228865866979486
1747352030809004,66666924,1,722,12,67054284,66557344,496940,24.14778444077756
1747352030903098,66759484,1,723,12,67148378,66649904,498474,24.073472237268145
1747352030994053,66852044,1,724,12,67239333,66742464,496869,24.15123503378154
1747352031087928,66944604,1,725,12,67333208,66835024,498184,24.0874857482376
1747352031181675,67037164,1,726,12,67426955,66927584,499371,24.03023002937696
1747352031276625,67129724,1,727,12,67521905,67020144,501761,23.915768662769725
1747352031366477,67222284,1,728,12,67611757,67112704,499053,24.04554225703482
1747352031460211,67314844,1,729,12,67705491,67205264,500227,23.98910894453918
1747352031554343,67407404,1,730,12,67799623,67297824,501799,23.91395758062492
1747352031648434,67499964,1,731,12,67893714,67390384,503330,23.84121749150656
1747352031739287,67592524,1,732,12,67984567,67482944,501623,23.92234805820307
1747352031833708,67685084,1,733,12,68078988,67575504,503484,23.83392520914269
1747352031927033,67777644,1,734,12,68172313,67668064,504249,23.797766579606503
1747352032021514,67870204,1,735,12,68266794,67760624,506170,23.7074500661833
1747352032115487,67962764,1,736,12,68360767,67853184,507583,23.641453712988813
1747352032205770,68055324,1,737,12,68451050,67945744,505306,23.747986368655823
1747352032299788,68147884,1,738,12,68545068,68038304,506764,23.67966153870441
1747352032394194,68240444,1,739,12,68639474,68130864,508610,23.59371620691689
1747352032488355,68333004,1,740,12,68733635,68223424,510211,23.51968107312465
1747352032578394,68425564,1,741,12,68823674,68315984,507690,23.636471074868524
1747352032673367,68518124,1,742,12,68918647,68408544,510103,23.52466070577903
1747352032767422,68610684,1,743,12,69012702,68501104,511598,23.45591655948616
1747352032860980,68703252,1,744,12,69106260,68593672,512588,23.41061437255652
1747352032951851,68795804,1,745,12,69197131,68686224,510907,23.487640607781845
1747352033046007,68888364,1,746,12,69291287,68778784,512503,23.41449708587072
1747352033140162,68980924,1,747,12,69385442,68871344,514098,23.34185310971838
1747352033233878,69073484,1,748,12,69479158,68963904,515254,23.28948440963098
1747352033324289,69166044,1,749,12,69569569,69056464,513105,23.38702604730026
1747352033418009,69258604,1,750,12,69663289,69149024,514265,23.33427318600333
1747352033512147,69351164,1,751,12,69757427,69241584,515843,23.262892003962445
1747352033606638,69443724,1,752,12,69851918,69334144,517774,23.17613476149826
1747352033701266,69536284,1,753,12,69946546,69426704,519842,23.08393704240904
1747352033791321,69628844,1,754,12,70036601,69519264,517337,23.19571188606266
1747352033884919,69721404,1,755,12,70130199,69611824,518375,23.14926452857487
1747352033979816,69813964,1,756,12,70225096,69704384,520712,23.04536864908049
1747352034073910,69906524,1,757,12,70319190,69796944,522246,22.977677186613207
1747352034163597,69999084,1,758,12,70408877,69889504,519373,23.10478211227769
1747352034258312,70091644,1,759,12,70503592,69982064,521528,23.00931110122563
1747352034352110,70184204,1,760,12,70597390,70074624,522766,22.95482108629865
1747352034445941,70276764,1,761,12,70691221,70167184,524037,22.899146434316663
1747352034536229,70369324,1,762,12,70781509,70259744,521765,22.998859639876187
1747352034631045,70461884,1,763,12,70876325,70352304,524021,22.89984561687413
1747352034724562,70554444,1,764,12,70969842,70444864,524978,22.858100720411144
1747352034814933,70647004,1,765,12,71060213,70537424,522789,22.95381119342603
1747352034913734,70742684,1,766,12,71159014,70633104,525910,22.81759236371242
1747352035007272,70835244,1,767,12,71252552,70725664,526888,22.775238760419672
1747352035102005,70927804,1,768,12,71347285,70818224,529061,22.681694549399783
1747352035196031,71020364,1,769,12,71441311,70910784,530527,22.619018447694465
1747352035286184,71112924,1,770,12,71531464,71003344,528120,22.72210861167916
1747352035384449,71208604,1,771,12,71629729,71099024,530705,22.611431963143367
1747352035478673,71301164,1,772,12,71723953,71191584,532369,22.54075650535625
1747352035568709,71393724,1,773,12,71813989,71284144,529845,22.648132944540382
1747352035662393,71486284,1,774,12,71907673,71376704,530969,22.60018946492168
1747352035753112,71578844,1,775,12,71998392,71469264,529128,22.678822515535
1747352035851545,71674524,1,776,12,72096825,71564944,531881,22.561437614804813
1747352035945020,71767084,1,777,12,72190300,71657504,532796,22.522691611798887
1747352036039613,71859644,1,778,12,72284893,71750064,534829,22.437078019329544
1747352036134011,71952204,1,779,12,72379291,71842624,536667,22.36023455886052
1747352036223895,72044764,1,780,12,72469175,71935184,533991,22.47228885880099
1747352036317894,72137324,1,781,12,72563174,72027744,535430,22.41189324468185
1747352036412525,72229884,1,782,12,72657805,72120304,537501,22.32553985946073
1747352036506612,72322444,1,783,12,72751892,72212864,539028,22.262294352055925
1747352036600761,72415004,1,784,12,72846041,72305424,540617,22.19686025411705
1747352036690765,72507564,1,785,12,72936045,72397984,538061,22.302304013857164
1747352036784399,72600124,1,786,12,73029679,72490544,539135,22.25787604217868
1747352036879674,72692684,1,787,12,73124954,72583104,541850,22.14635046599612
1747352036973425,72785244,1,788,12,73218705,72675664,543041,22.097778989063443
1747352037063955,72877804,1,789,12,73309235,72768224,541011,22.18069503207883
1747352037157734,72970364,1,790,12,73403014,72860784,542230,22.13083009055198
1747352037251709,73062924,1,791,12,73496989,72953344,543645,22.073227933669948
1747352037345555,73155484,1,792,12,73590835,73045904,544931,22.02113662096669
1747352037436399,73248044,1,793,12,73681679,73138464,543215,22.090700735436243
1747352037530548,73340604,1,794,12,73775828,73231024,544804,22.02626999801764
1747352037624275,73433164,1,795,12,73869555,73323584,545971,21.97918937086402
1747352037718959,73525724,1,796,12,73964239,73416144,548095,21.8940147237249
1747352037813198,73618284,1,797,12,74058478,73508704,549774,21.82715079287125
1747352037902615,73710844,1,798,12,74147895,73601264,546631,21.95265178886672
1747352037997423,73803404,1,799,12,74242703,73693824,548879,21.862742061547262
1747352038091126,73895972,1,800,12,74336406,73786392,550014,21.81762646041737
1747352038186051,73988524,1,801,12,74431331,73878944,552387,21.72390009178348
1747352038275620,74081084,1,802,12,74520900,73971504,549396,21.842168490487737
1747352038370265,74173644,1,803,12,74615545,74064064,551481,21.7595891789563
1747352038468425,74269324,1,804,12,74713705,74159744,553961,21.66217477403644
1747352038557922,74361892,1,805,12,74803202,74252312,550890,21.78293307193813
1747352038652112,74454444,1,806,12,74897392,74344864,552528,21.71835635479107
1747352038746343,74547004,1,807,12,74991623,74437424,554199,21.65287198280762
1747352038841223,74639564,1,808,12,75086503,74529984,556519,21.56260612845204
1747352038930920,74732124,1,809,12,75176200,74622544,553656,21.67410811045125
1747352039025329,74824684,1,810,12,75270609,74715104,555505,21.60196577888588
1747352039119200,74917244,1,811,12,75364480,74807664,556816,21.55110485330881
1747352039214026,75009804,1,812,12,75459306,74900224,559082,21.463756658236186
1747352039304060,75102364,1,813,12,75549340,74992784,556556,21.56117264030933
1747352039398232,75194924,1,814,12,75643512,75085344,558168,21.49890355591865
1747352039492646,75287484,1,815,12,75737926,75177904,560022,21.42772962490759
1747352039585972,75380044,1,816,12,75831252,75270464,560788,21.39846073739096
1747352039680224,75472604,1,817,12,75925504,75363024,562480,21.33409187882236
1747352039770734,75565164,1,818,12,76016014,75455584,560430,21.41212997162893
1747352039865042,75657724,1,819,12,76110322,75548144,562178,21.345552476261968
1747352039958880,75750284,1,820,12,76204160,75640704,563456,21.297137664697868
1747352040053101,75842844,1,821,12,76298381,75733264,565117,21.23454081190267
1747352040143245,75935404,1,822,12,76388525,75825824,562701,21.3257129452409
1747352040233572,76027964,1,823,12,76478852,75918384,560468,21.41067821891705
1747352040331437,76120524,1,824,12,76576717,76010944,565773,21.209919879527657
1747352040426003,76213084,1,825,12,76671283,76103504,567779,21.13498385815608
1747352040516169,76305644,1,826,12,76761449,76196064,565385,21.22447535749976
1747352040610007,76398204,1,827,12,76855287,76288624,566663,21.17660761334338
1747352040704587,76490772,1,828,12,76949867,76381192,568675,21.101683738514968
1747352040799025,76583324,1,829,12,77044305,76473744,570561,21.031931730349605
1747352040892611,76675884,1,830,12,77137891,76566304,571587,20.994179363771394
1747352040982337,76768444,1,831,12,77227617,76658864,568753,21.09878980858123
1747352041077589,76861004,1,832,12,77322869,76751424,571445,20.99939626735732
1747352041171150,76953564,1,833,12,77416430,76843984,572446,20.9626759554613
1747352041265144,77046124,1,834,12,77510424,76936544,573880,20.910294835157178
1747352041356371,77138684,1,835,12,77601651,77029104,572547,20.95897804023076
1747352041449968,77231244,1,836,12,77695248,77121664,573584,20.921085664872106
1747352041544304,77323804,1,837,12,77789584,77214224,575360,20.85650723025584
1747352041638820,77416364,1,838,12,77884100,77306784,577316,20.78584345488433
1747352041753409,77508924,1,839,12,77998689,77399344,599345,20.021857194103564
1747352041847012,77601484,1,840,12,78092292,77491904,600388,19.987075024817283
1747352041913146,77694044,1,841,12,78158426,77584464,573962,20.907307452409743
1747352042011033,77786604,1,842,12,78256313,77677024,579289,20.71504896519699
1747352042101450,77879164,1,843,12,78346730,77769584,577146,20.791965984343648
1747352042195017,77971724,1,844,12,78440297,77862144,578153,20.7557515052244
1747352042289932,78064284,1,845,12,78535212,77954704,580508,20.671549746084462
1747352042384250,78156844,1,846,12,78629530,78047264,582266,20.60913740455393
1747352042478222,78249404,1,847,12,78723502,78139824,583678,20.559280973413426
1747352042568653,78341964,1,848,12,78813933,78232384,581549,20.6345467019976
1747352042662850,78434524,1,849,12,78908130,78324944,583186,20.576625639161435
1747352042756960,78527084,1,850,12,79002240,78417504,584736,20.52208175997373
1747352042847292,78619644,1,851,12,79092572,78510064,582508,20.6005754427407
1747352042941161,78712204,1,852,12,79186441,78602624,583817,20.55438604905304
1747352043035669,78804764,1,853,12,79280949,78695184,585765,20.486031087552178
1747352043130364,78897324,1,854,12,79375644,78787744,587900,20.411634631740093
1747352043223406,78989884,1,855,12,79468686,78880304,588382,20.39491350857096
1747352043313725,79082444,1,856,12,79559005,78972864,586141,20.472889628945936
1747352043408143,79175004,1,857,12,79653423,79065424,587999,20.4081979731258
1747352043502674,79267564,1,858,12,79747954,79157984,589970,20.340017289014696
1747352043596055,79360124,1,859,12,79841335,79250544,590791,20.31175153311408
1747352043687089,79452684,1,860,12,79932369,79343104,589265,20.364352201471323
1747352043777106,79545244,1,861,12,80022386,79435664,586722,20.452616400953094
1747352043870080,79637804,1,862,12,80115360,79528224,587136,20.438194898626552
1747352043964884,79730364,1,863,12,80210164,79620784,589380,20.360378703043875
1747352044058870,79822924,1,864,12,80304150,79713344,590806,20.31123583714451
1747352044148881,79915484,1,865,12,80394161,79805904,588257,20.399247267775817
1747352044247630,80008044,1,866,12,80492910,79898464,594446,20.18686306241441
1747352044337044,80100604,1,867,12,80582324,79991024,591300,20.29426686960933
1747352044435787,80193164,1,868,12,80681067,80083584,597483,20.0842534431942
1747352044526068,80285732,1,869,12,80771348,80176152,595196,20.16142581603372
1747352044616407,80378284,1,870,12,80861687,80268704,592983,20.236667830275067
1747352044710220,80470844,1,871,12,80955500,80361264,594236,20.19399699782578
1747352044804819,80563404,1,872,12,81050099,80453824,596275,20.12494235042556
1747352044894831,80655964,1,873,12,81140111,80546384,593727,20.21130923808417
1747352044992338,80748524,1,874,12,81237618,80638944,598674,20.044297898355364
1747352045086576,80841084,1,875,12,81331856,80731504,600352,19.98827354618624
1747352045177015,80933644,1,876,12,81422295,80824064,598231,20.05914103414901
1747352045271635,81026204,1,877,12,81516915,80916624,600291,19.990304702219422
1747352045361450,81118764,1,878,12,81606730,81009184,597546,20.08213593597815
1747352045459443,81211324,1,879,12,81704723,81101744,602979,19.90119058872697
1747352045549636,81303884,1,880,12,81794916,81194304,600612,19.979620786797465
1747352045643928,81396444,1,881,12,81889208,81286864,602344,19.92217071972162
1747352045734140,81489004,1,882,12,81979420,81379424,599996,20.00013333422223
1747352045832764,81581564,1,883,12,82078044,81471984,606060,19.8000198000198
1747352045922442,81674124,1,884,12,82167722,81564544,603178,19.89462480395505
1747352046021127,81766684,1,885,12,82266407,81657104,609303,19.69463468914481
1747352046110863,81859244,1,886,12,82356143,81749664,606479,19.786340499835937
1747352046201344,81951804,1,887,12,82446624,81842224,604400,19.854401058901388
1747352046298898,82044364,1,888,12,82544178,81934784,609394,19.69169371539595
1747352046393524,82136924,1,889,12,82638804,82027344,611460,19.62515945442057
1747352046479310,82229484,1,890,12,82724590,82119904,604686,19.845010468243025
1747352046577621,82322044,1,891,12,82822901,82212464,610437,19.658048250679432
1747352046672020,82414612,1,892,12,82917300,82305032,612268,19.59926045457218
1747352046765868,82507164,1,893,12,83011148,82397584,613564,19.55786193453332
1747352046859910,82599724,1,894,12,83105190,82490144,615046,19.510735782364247
1747352046950199,82692284,1,895,12,83195479,82582704,612775,19.583044347435848
1747352047044170,82784844,1,896,12,83289450,82675264,614186,19.53805524710756
1747352047134379,82877404,1,897,12,83379659,82767824,611835,19.61313099119861
1747352047233310,82969964,1,898,12,83478590,82860384,618206,19.41100539302433
1747352047323543,83062524,1,899,12,83568823,82952944,615879,19.48434676291934
1747352047417007,83155084,1,900,12,83662287,83045504,616783,19.455789151127707
1747352047511823,83247644,1,901,12,83757103,83138064,619039,19.38488528186431
1747352047605675,83340204,1,902,12,83850955,83230624,620331,19.344511236742967
1747352047695614,83432764,1,903,12,83940894,83323184,617710,19.42659176636285
1747352047790179,83525324,1,904,12,84035459,83415744,619715,19.363739783610207
1747352047879879,83617884,1,905,12,84125159,83508304,616855,19.45351824983181
1747352047974530,83710444,1,906,12,84219810,83600864,618946,19.387797966219992
1747352048068514,83803004,1,907,12,84313794,83693424,620370,19.34329513032545
1747352048162720,83895564,1,908,12,84408000,83785984,622016,19.29210824158864
1747352048257012,83988124,1,909,12,84502292,83878544,623748,19.23853864060486
1747352048343207,84080684,1,910,12,84588487,83971104,617383,19.436881158049378
1747352048445327,84173244,1,911,12,84690607,84063664,626943,19.140496025954512
1747352048535348,84265804,1,912,12,84780628,84156224,624404,19.21832659624218
1747352048625964,84358364,1,913,12,84871244,84248784,622460,19.278347203033125
1747352048723827,84450924,1,914,12,84969107,84341344,627763,19.115494223138352
1747352048818352,84543484,1,915,12,85063632,84433904,629728,19.055846333655168
1747352048908465,84636044,1,916,12,85153745,84526464,627281,19.1301824859991
1747352049002694,84728604,1,917,12,85247974,84619024,628950,19.079418077748628
1747352049096660,84821164,1,918,12,85341940,84711584,630356,19.03686170989092
1747352049190304,84913724,1,919,12,85435584,84804144,631440,19.004180919802355
1747352049280545,85006284,1,920,12,85525825,84896704,629121,19.074232142942293
1747352049370579,85098844,1,921,12,85615859,84989264,626595,19.151126325617025
1747352049465728,85191404,1,922,12,85711008,85081824,629184,19.07232224595667
1747352049555758,85283964,1,923,12,85801038,85174384,626654,19.149323231001475
1747352049653290,85376524,1,924,12,85898570,85266944,631626,18.998584605446894
1747352049747491,85469084,1,925,12,85992771,85359504,633267,18.949353116457985
1747352049841760,85561644,1,926,12,86087040,85452064,634976,18.898352063700045
1747352049935925,85654204,1,927,12,86181205,85544624,636581,18.850703995249624
1747352050026641,85746764,1,928,12,86271921,85637184,634737,18.9054679339632
1747352050120977,85839324,1,929,12,86366257,85729744,636513,18.85271785493776
1747352050215143,85931884,1,930,12,86460423,85822304,638119,18.80526986345807
1747352050309235,86024444,1,931,12,86554515,85914864,639651,18.76023018802441
1747352050399359,86117004,1,932,12,86644639,86007424,637215,18.831948400461386
1747352050493063,86209572,1,933,12,86738343,86099992,638351,18.798435343564904
1747352050583043,86302124,1,934,12,86828323,86192544,635779,18.874483114415543
1747352050678085,86394684,1,935,12,86923365,86285104,638261,18.80108607607233
1747352050772213,86487244,1,936,12,87017493,86377664,639829,18.75501110452949
1747352050865643,86579804,1,937,12,87110923,86470224,640699,18.72954382635216
1747352050960921,86672364,1,938,12,87206201,86562784,643417,18.65042421944089
1747352051054020,86764924,1,939,12,87299300,86655344,643956,18.634813558690347
1747352051144523,86857484,1,940,12,87389803,86747904,641899,18.69452982478552
1747352051238296,86950044,1,941,12,87483576,86840464,643112,18.65926930301409
1747352051332364,87042604,1,942,12,87577644,86933024,644620,18.6156185039248
1747352051422732,87135164,1,943,12,87668012,87025584,642428,18.67913602769493
1747352051520735,87227724,1,944,12,87766015,87118144,647871,18.52220580948985
1747352051615222,87320284,1,945,12,87860502,87210704,649798,18.46727752316874
1747352051702061,87412844,1,946,12,87947341,87303264,644077,18.631312715715666
1747352051800342,87505404,1,947,12,88045622,87395824,649798,18.46727752316874
1747352051890073,87597964,1,948,12,88135353,87488384,646969,18.548029349165105
1747352051987746,87690524,1,949,12,88233026,87580944,652082,18.40259353884941
1747352052074027,87783084,1,950,12,88319307,87673504,645803,18.581517893227502
1747352052168395,87875644,1,951,12,88413675,87766064,647611,18.52964202275749
1747352052263102,87968204,1,952,12,88508382,87858624,649758,18.46841439428218
1747352052356715,88060764,1,953,12,88601995,87951184,650811,18.43853284594145
1747352052446858,88153324,1,954,12,88692138,88043744,648394,18.50726564403742
1747352052545585,88245884,1,955,12,88790865,88136304,654561,18.33289792700757
1747352052639620,88338452,1,956,12,88884900,88228872,656028,18.29190217490717
1747352052729131,88431004,1,957,12,88974411,88321424,652987,18.37708867098426
1747352052823382,88523564,1,958,12,89068662,88413984,654678,18.32962158496238
1747352052913436,88616124,1,959,12,89158716,88506544,652172,18.40005397349165
1747352053011986,88708684,1,960,12,89257266,88599104,658162,18.232593191341948
1747352053106229,88801244,1,961,12,89351509,88691664,659845,18.18608915730209
1747352053200704,88893804,1,962,12,89445984,88784224,661760,18.13346228239845
1747352053290797,88986364,1,963,12,89536077,88876784,659293,18.20131565176636
1747352053380321,89078924,1,964,12,89625601,88969344,656257,18.285519240175724
1747352053478650,89171484,1,965,12,89723930,89061904,662026,18.126176313317
1747352053569353,89264044,1,966,12,89814633,89154464,660169,18.177163726257973
1747352053659342,89356604,1,967,12,89904622,89247024,657598,18.248230681966795
1747352053757351,89449164,1,968,12,90002631,89339584,663047,18.098264527250706
1747352053847082,89541724,1,969,12,90092362,89432144,660218,18.17581465515936
1747352053946360,89634284,1,970,12,90191640,89524704,666936,17.992730936701573
1747352054036549,89726844,1,971,12,90281829,89617264,664565,18.056924454342315
1747352054130591,89819404,1,972,12,90375871,89709824,666047,18.01674656593304
1747352054220610,89911964,1,973,12,90465890,89802384,663506,18.0857445147444
1747352054314988,90004524,1,974,12,90560268,89894944,665324,18.036325158869964
1747352054408608,90097084,1,975,12,90653888,89987504,666384,18.007635237340633
1747352054502395,90189644,1,976,12,90747675,90080064,667611,17.974539065413843
1747352054593512,90282204,1,977,12,90838792,90172624,666168,18.013474078610802
1747352054691744,90374764,1,978,12,90937024,90265184,671840,17.861395570373897
1747352054785872,90467324,1,979,12,91031152,90357744,673408,17.81980612050941
1747352054871276,90559884,1,980,12,91116556,90450304,666252,18.011202968246252
1747352054970421,90652444,1,981,12,91215701,90542864,672837,17.834928816340362
1747352055059696,90745004,1,982,12,91304976,90635424,669552,17.92243171553516
1747352055154056,90837564,1,983,12,91399336,90727984,671352,17.87437886533443
1747352055243889,90930124,1,984,12,91489169,90820544,668625,17.9472798653954
1747352055342355,91022684,1,985,12,91587635,90913104,674531,17.79013862965527
1747352055436826,91115244,1,986,12,91682106,91005664,676442,17.739880137543203
1747352055531247,91207804,1,987,12,91776527,91098224,678303,17.691208796069013
1747352055621403,91300364,1,988,12,91866683,91190784,675899,17.754131904322982
1747352055715751,91392924,1,989,12,91961031,91283344,677687,17.70728964846603
1747352055809020,91485484,1,990,12,92054300,91375904,678396,17.688783542355793
1747352055902619,91578044,1,991,12,92147899,91468464,679435,17.6617336463385
1747352055993841,91670604,1,992,12,92239121,91561024,678097,17.696583232192445
1747352056088150,91763164,1,993,12,92333430,91653584,679846,17.651056268625542
1747352056180601,91855724,1,994,12,92425881,91746144,679737,17.653886723835836
1747352056272134,91948284,1,995,12,92517414,91838704,678710,17.68059996169203
1747352056371011,92040844,1,996,12,92616291,91931264,685027,17.517557702105172
1747352056460584,92133412,1,997,12,92705864,92023832,682032,17.594482370328667
1747352056554593,92225964,1,998,12,92799873,92116384,683489,17.556976044969268
1747352056649256,92318524,1,999,12,92894536,92208944,685592,17.503121389981214
1747352056739299,92411084,1,1000,12,92984579,92301504,683075,17.567617025948834
1747352056841527,92504684,1,1001,12,93086807,92395104,691703,17.348486272287385
1747352056935527,92598292,1,1002,12,93180807,92488712,692095,17.338660155036518
1747352057030553,92691884,1,1003,12,93275833,92582304,693529,17.30280925527267
1747352057123946,92785484,1,1004,12,93369226,92675904,693322,17.307975226518128
1747352057210121,92879084,1,1005,12,93455401,92769504,685897,17.49533822133644
1747352057311985,92972684,1,1006,12,93557265,92863104,694161,17.28705588472991
1747352057410713,93066284,1,1007,12,93655993,92956704,699289,17.160287091603042
1747352057500936,93159884,1,1008,12,93746216,93050304,695912,17.243559530515352
1747352057599408,93253484,1,1009,12,93844688,93143904,700784,17.12367862279961
1747352057689607,93347084,1,1010,12,93934887,93237504,697383,17.207187442194606
1747352057775485,93440684,1,1011,12,94020765,93331104,689661,17.399852971242392
1747352057873777,93534284,1,1012,12,94119057,93424704,694353,17.282275730068136
1747352057976160,93627884,1,1013,12,94221440,93518304,703136,17.066399672325126
1747352058070293,93721484,1,1014,12,94315573,93611904,703669,17.053472584411136
1747352058164357,93815084,1,1015,12,94409637,93705504,704133,17.042234918687235
1747352058258628,93908684,1,1016,12,94503908,93799104,704804,17.026010068047288
1747352058353480,94002284,1,1017,12,94598760,93892704,706056,16.995819028518984
1747352058446629,94095884,1,1018,12,94691909,93986304,705605,17.006682208884573
1747352058536713,94189484,1,1019,12,94781993,94079904,702089,17.091850178538618
1747352058635938,94283084,1,1020,12,94881218,94173504,707714,16.956002000808237
1747352058729835,94376684,1,1021,12,94975115,94267104,708011,16.94888921217326
1747352058815945,94470284,1,1022,12,95061225,94360704,700521,17.130107448598974
1747352058918037,94563884,1,1023,12,95163317,94454304,709013,16.924936496227854
1747352059012410,94657484,1,1024,12,95257690,94547904,709786,16.906504213946175
1747352059106496,94751084,1,1025,12,95351776,94641504,710272,16.89493602450892
1747352059200496,94844684,1,1026,12,95445776,94735104,710672,16.885426751018755
1747352059294991,94938284,1,1027,12,95540271,94828704,711567,16.864188474170387
1747352059388884,95031884,1,1028,12,95634164,94922304,711860,16.857247211530357
1747352059483013,95125484,1,1029,12,95728293,95015904,712389,16.844729494700225
1747352059573169,95219084,1,1030,12,95818449,95109504,708945,16.926559888284704
1747352059672083,95312684,1,1031,12,95917363,95203104,714259,16.800628343500048
1747352059766158,95406284,1,1032,12,96011438,95296704,714734,16.78946293306321
1747352059860433,95499884,1,1033,12,96105713,95390304,715409,16.77362180235362
1747352059954022,95593492,1,1034,12,96199302,95483912,715390,16.77406729196662
1747352060052722,95687084,1,1035,12,96298002,95577504,720498,16.65514685675741
1747352060142912,95780684,1,1036,12,96388192,95671104,717088,16.734347806684816
1747352060241010,95874284,1,1037,12,96486290,95764704,721586,16.630034396454477
1747352060347994,95967884,1,1038,12,96593274,95858304,734970,16.32719702845014
1747352060441831,96061484,1,1039,12,96687111,95951904,735207,16.321933822719316
1747352060519371,96155084,1,1040,12,96764651,96045504,719147,16.68643545756292
1747352060613748,96248684,1,1041,12,96859028,96139104,719924,16.66842611164512
1747352060707550,96342284,1,1042,12,96952830,96232704,720126,16.663750510327358
1747352060806670,96435884,1,1043,12,97051950,96326304,725646,16.53698911039267
1747352060904958,96529484,1,1044,12,97150238,96419904,730334,16.430838493073033
1747352061002621,96623084,1,1045,12,97247901,96513504,734397,16.339936029150447
1747352061084636,96716684,1,1046,12,97329916,96607104,722812,16.601827307792345
1747352061179051,96810284,1,1047,12,97424331,96700704,723627,16.583129153555628
1747352061273244,96903884,1,1048,12,97518524,96794304,724220,16.56955068901715
1747352061371164,96997484,1,1049,12,97616444,96887904,728540,16.471298761907377
1747352061462059,97091084,1,1050,12,97707339,96981504,725835,16.53268304780012
1747352061555233,97184684,1,1051,12,97800513,97075104,725409,16.5423919471636
1747352061662130,97278284,1,1052,12,97907410,97168704,738706,16.244622353141846
1747352061744149,97371884,1,1053,12,97989429,97262304,727125,16.503352243424445
1747352061842638,97465484,1,1054,12,98087918,97355904,732014,16.39312909315942
1747352061932165,97559084,1,1055,12,98177445,97449504,727941,16.48485248117636
1747352062026697,97652684,1,1056,12,98271977,97543104,728873,16.4637735243314
1747352062124778,97746284,1,1057,12,98370058,97636704,733354,16.36317521960745
1747352062227491,97839884,1,1058,12,98472771,97730304,742467,16.162334487593387
1747352062308901,97936604,1,1059,12,98554181,97827024,727157,16.502625980359124
1747352062407629,98030204,1,1060,12,98652909,97920624,732285,16.387062414223973
1747352062502364,98123812,1,1061,12,98747644,98014232,733412,16.361881180018873
1747352062608034,98217404,1,1062,12,98853314,98107824,745490,16.096795396316516
1747352062690545,98311004,1,1063,12,98935825,98201424,734401,16.339847031798705
1747352062784551,98404604,1,1064,12,99029831,98295024,734807,16.330818840865696
1747352062879145,98498204,1,1065,12,99124425,98388624,735801,16.308757395002182
1747352062989786,98591804,1,1066,12,99235066,98482224,752842,15.939599544127454
1747352063067374,98685404,1,1067,12,99312654,98575824,736830,16.285981841130248
1747352063165524,98779004,1,1068,12,99410804,98669424,741380,16.18603145485446
1747352063259764,98872604,1,1069,12,99505044,98763024,742020,16.17207083367025
1747352063353895,98966204,1,1070,12,99599175,98856624,742551,16.160506147052526
1747352063447458,99059804,1,1071,12,99692738,98950224,742514,16.161311436552037
1747352063550812,99153404,1,1072,12,99796092,99043824,752268,15.951761872098771
1747352063636213,99247004,1,1073,12,99881493,99137424,744069,16.127536559109437
1747352063730416,99340604,1,1074,12,99975696,99231024,744672,16.114477246358128
1747352063824604,99434204,1,1075,12,100069884,99324624,745260,16.101763143064165
1747352063927534,99527804,1,1076,12,100172814,99418224,754590,15.902675625173936
1747352064012804,99621404,1,1077,12,100258084,99511824,746260,16.08018653016375
1747352064107333,99715004,1,1078,12,100352613,99605424,747189,16.060193605633916
1747352064197512,99808604,1,1079,12,100442792,99699024,743768,16.13406331006443
1747352064295779,99902204,1,1080,12,100541059,99792624,748435,16.03345647918657
1747352064390507,99995804,1,1081,12,100635787,99886224,749563,16.009328101840673
1747352064492521,100089404,1,1082,12,100737801,99979824,757977,15.831614943461345
1747352064573833,100184044,1,1083,12,100819113,100074464,744649,16.11497497478678
1747352064664144,100278684,1,1084,12,100909424,100169104,740320,16.209206829479143
1747352064771075,100373324,1,1085,12,101016355,100263744,752611,15.94449190883471
1747352064860602,100467964,1,1086,12,101105882,100358384,747498,16.05355465834022
1747352064955596,100562604,1,1087,12,101200876,100453024,747852,16.045955616886765
1747352065049200,100657244,1,1088,12,101294480,100547664,746816,16.06821492844288
1747352065147213,100751884,1,1089,12,101392493,100642304,750189,15.995969015808017
1747352065241843,100846524,1,1090,12,101487123,100736944,750179,15.996182244504311
1747352065336212,100941164,1,1091,12,101581492,100831584,749908,16.00196290744998
1747352065430715,101035804,1,1092,12,101675995,100926224,749771,16.004886825444036
1747352065528394,101130444,1,1093,12,101773674,101020864,752810,15.94027709515017
1747352065622863,101225084,1,1094,12,101868143,101115504,752639,15.943898734984502
1747352065717278,101319724,1,1095,12,101962558,101210144,752414,15.948666558570148
1747352065814846,101414364,1,1096,12,102060126,101304784,755342,15.886843310712235
1747352065909875,101509004,1,1097,12,102155155,101399424,755731,15.878665821568784
1747352066004152,101603644,1,1098,12,102249432,101494064,755368,15.886296480655783
1747352066094166,101698284,1,1099,12,102339446,101588704,750742,15.984186311675648
1747352066188223,101792924,1,1100,12,102433503,101683344,750159,15.99660871895158
1747352066285953,101887564,1,1101,12,102531233,101777984,753249,15.930986964469918
1747352066384730,101982204,1,1102,12,102630010,101872624,757386,15.84396859725424
1747352066474811,102076844,1,1103,12,102720091,101967264,752827,15.939917138997403
1747352066572466,102171484,1,1104,12,102817746,102061904,755842,15.876333942808152
1747352066667460,102266124,1,1105,12,102912740,102156544,756196,15.868901713312422
1747352066761283,102360764,1,1106,12,103006563,102251184,755379,15.886065140810109
1747352066855216,102455404,1,1107,12,103100496,102345824,754672,15.90094769648271
1747352066949831,102550044,1,1108,12,103195111,102440464,754647,15.901474464219696
1747352067047649,102644684,1,1109,12,103292929,102535104,757825,15.834790353973544
1747352067142547,102739324,1,1110,12,103387827,102629744,758083,15.82940126608828
1747352067236678,102833964,1,1111,12,103481958,102724384,757574,15.840036748885256
1747352067334972,102928604,1,1112,12,103580252,102819024,761228,15.76400237510969
1747352067428464,103023244,1,1113,12,103673744,102913664,760080,15.787811809283234
1747352067527578,103117884,1,1114,12,103772858,103008304,764554,15.695425045189744
1747352067617734,103212524,1,1115,12,103863014,103102944,760070,15.78801952451748
1747352067715729,103307164,1,1116,12,103961009,103197584,763425,15.71863640829158
1747352067810243,103401804,1,1117,12,104055523,103292224,763299,15.72123112960976
1747352067903808,103496444,1,1118,12,104149088,103386864,762224,15.743403513927664
1747352068001997,103591084,1,1119,12,104247277,103481504,765773,15.670440195723796
1747352068096367,103685724,1,1120,12,104341647,103576144,765503,15.675967305157522
1747352068191162,103780372,1,1121,12,104436442,103670792,765650,15.67295761771044
1747352068284801,103875004,1,1122,12,104530081,103765424,764657,15.693310857024784
1747352068383099,103969644,1,1123,12,104628379,103860064,768315,15.618593936080904
1747352068489894,104064284,1,1124,12,104735174,103954704,780470,15.37535075018899
1747352068571466,104158924,1,1125,12,104816746,104049344,767402,15.637175821798744
1747352068674364,104253564,1,1126,12,104919644,104143984,775660,15.470695923471624
1747352068764371,104348204,1,1127,12,105009651,104238624,771027,15.563657303829826
1747352068862851,104442844,1,1128,12,105108131,104333264,774867,15.48652865588546
1747352068952894,104537484,1,1129,12,105198174,104427904,770270,15.578952834720292
1747352069055152,104632124,1,1130,12,105300432,104522544,777888,15.426385289398988
1747352069148268,104726764,1,1131,12,105393548,104617184,776364,15.456667233411132
1747352069243510,104821404,1,1132,12,105488790,104711824,776966,15.444691273492015
1747352069341756,104916044,1,1133,12,105587036,104806464,780572,15.373341600774816
1747352069431348,105010684,1,1134,12,105676628,104901104,775524,15.473408946725051
1747352069538023,105105324,1,1135,12,105783303,104995744,787559,15.236953675851586
1747352069632521,105199964,1,1136,12,105877801,105090384,787417,15.239701454248513
1747352069722511,105294604,1,1137,12,105967791,105185024,782767,15.330232367997118
1747352069816465,105389244,1,1138,12,106061745,105279664,782081,15.343679235271026
1747352069915196,105483884,1,1139,12,106160476,105374304,786172,15.263835394799102
1747352070000822,105578532,1,1140,12,106246102,105468952,777150,15.441034549314804
1747352070103932,105673164,1,1141,12,106349212,105563584,785628,15.274404680077597
1747352070201996,105767804,1,1142,12,106447276,105658224,789052,15.208123165520144
1747352070300495,105862444,1,1143,12,106545775,105752864,792911,15.134107106598345
1747352070381883,105957084,1,1144,12,106627163,105847504,779659,15.391344164564252
1747352070484694,106051724,1,1145,12,106729974,105942144,787830,15.23171242526941
1747352070574396,106146364,1,1146,12,106819676,106036784,782892,15.32778467528088
1747352070668403,106241004,1,1147,12,106913683,106131424,782259,15.340187840600109
1747352070762318,106335644,1,1148,12,107007598,106226064,781534,15.354418361837103
1747352070868242,106430284,1,1149,12,107113522,106320704,792818,15.135882384103288
1747352070955519,106524924,1,1150,12,107200799,106415344,785455,15.27776893647631
1747352071050032,106619564,1,1151,12,107295312,106509984,785328,15.280239594156836
1747352071156013,106714204,1,1152,12,107401293,106604624,796669,15.06271738953066
1747352071245957,106808844,1,1153,12,107491237,106699264,791973,15.152031698050312
1747352071340399,106903484,1,1154,12,107585679,106793904,791775,15.155820782419248
1747352071438691,106998124,1,1155,12,107683971,106888544,795427,15.08623670053946
1747352071533212,107092764,1,1156,12,107778492,106983184,795308,15.088494017412122
1747352071627602,107187404,1,1157,12,107872882,107077824,795058,15.093238480714614
1747352071725417,107282044,1,1158,12,107970697,107172464,798233,15.033204590639576
1747352071819229,107376684,1,1159,12,108064509,107267104,797405,15.048814592333882
1747352071914065,107471324,1,1160,12,108159345,107361744,797601,15.045116543234023
1747352072004238,107565964,1,1161,12,108249518,107456384,793134,15.129851954398626
1747352072098049,107660604,1,1162,12,108343329,107551024,792305,15.145682533872687
1747352072195824,107755244,1,1163,12,108441104,107645664,795440,15.085990143819773
1747352072294824,107849884,1,1164,12,108540104,107740304,799800,15.003750937734434
1747352072385208,107944524,1,1165,12,108630488,107834944,795544,15.084017980149431
1747352072479122,108039164,1,1166,12,108724402,107929584,794818,15.097795973417814
1747352072576992,108133804,1,1167,12,108822272,108024224,798048,15.036689522434742
1747352072671005,108228444,1,1168,12,108916285,108118864,797421,15.048512642631684
1747352072778079,108323084,1,1169,12,109023359,108213504,809855,14.817467324397578
1747352072863628,108417724,1,1170,12,109108908,108308144,800764,14.985688667322709
1747352072962421,108512364,1,1171,12,109207701,108402784,804917,14.90836943436404
1747352073056599,108607004,1,1172,12,109301879,108497424,804455,14.916931338608125
1747352073154795,108701644,1,1173,12,109400075,108592064,808011,14.851282965207156
1747352073249569,108796284,1,1174,12,109494849,108686704,808145,14.848820446825757
1747352073343502,108890924,1,1175,12,109588782,108781344,807438,14.861822208020923
1747352073441393,108985564,1,1176,12,109686673,108875984,810689,14.80222378742033
1747352073539665,109080204,1,1177,12,109784945,108970624,814321,14.736203536443249
1747352073630105,109174844,1,1178,12,109875385,109065264,810121,14.812602068086123
1747352073724169,109269484,1,1179,12,109969449,109159904,809545,14.823141394239975
1747352073822315,109364124,1,1180,12,110067595,109254544,813051,14.75922174623732
1747352073912099,109458764,1,1181,12,110157379,109349184,808195,14.847901805876058
1747352074010329,109553404,1,1182,12,110255609,109443824,811785,14.782239139673685
1747352074109239,109648044,1,1183,12,110354519,109538464,816055,14.704891214440204
1747352074203253,109742684,1,1184,12,110448533,109633104,815429,14.716180072084756
1747352074293503,109837332,1,1185,12,110538783,109727752,811031,14.795981904514132
1747352074392045,109931964,1,1186,12,110637325,109822384,814941,14.724992361410212
1747352074489775,110026604,1,1187,12,110735055,109917024,818031,14.66937072066951
1747352074588644,110121244,1,1188,12,110833924,110011664,822260,14.59392406294846
1747352074673813,110215884,1,1189,12,110919093,110106304,812789,14.763979335350257
1747352074776579,110310524,1,1190,12,111021859,110200944,820915,14.61783497682464
1747352074870802,110405164,1,1191,12,111116082,110295584,820498,14.62526416883405
1747352074965455,110499804,1,1192,12,111210735,110390224,820511,14.625032449290748
1747352075062825,110594444,1,1193,12,111308105,110484864,823241,14.576533481690053
1747352075149823,110689084,1,1194,12,111395103,110579504,815599,14.713112693860587
1747352075251978,110783724,1,1195,12,111497258,110674144,823114,14.578782525871263
1747352075345574,110878364,1,1196,12,111590854,110768784,822070,14.597297067159731
1747352075440428,110973004,1,1197,12,111685708,110863424,822284,14.593498110141994
1747352075538762,111067644,1,1198,12,111784042,110958064,825978,14.528231986808365
1747352075632624,111162284,1,1199,12,111877904,111052704,825200,14.54192922927775
1747352075726335,111256924,1,1200,12,111971615,111147344,824271,14.55831880534436
1747352075825272,111351564,1,1201,12,112070552,111241984,828568,14.482818549594
1747352075919143,111446204,1,1202,12,112164423,111336624,827799,14.496272645895925
1747352076013917,111540844,1,1203,12,112259197,111431264,827933,14.493926440907655
1747352076104039,111635492,1,1204,12,112349319,111525912,823407,14.573594832203272
1747352076205952,111730124,1,1205,12,112451232,111620544,830688,14.445856928232985
1747352076296287,111824764,1,1206,12,112541567,111715184,826383,14.52111188153677
1747352076394224,111919404,1,1207,12,112639504,111809824,829680,14.463407578825572
1747352076485054,112014044,1,1208,12,112730334,111904464,825870,14.530131860946636
1747352076587217,112108684,1,1209,12,112832497,111999104,833393,14.398969033817178
1747352076681521,112203324,1,1210,12,112926801,112093744,833057,14.404776623928496
1747352076775133,112297964,1,1211,12,113020413,112188384,832029,14.422574213158436
1747352076865604,112392604,1,1212,12,113110884,112283024,827860,14.495204503176865
1747352076959300,112487244,1,1213,12,113204580,112377664,826916,14.511752100576118
1747352077058339,112581884,1,1214,12,113303619,112472304,831315,14.43496147669656
1747352077152016,112676524,1,1215,12,113397296,112566944,830352,14.451702410543962
1747352077254862,112771164,1,1216,12,113500142,112661584,838558,14.310280266839026
1747352077344363,112865804,1,1217,12,113589643,112756224,833419,14.398519832161254
1747352077438987,112960444,1,1218,12,113684267,112850864,833403,14.398796260632611
1747352077532843,113055084,1,1219,12,113778123,112945504,832619,14.412354270080312
1747352077635672,113149724,1,1220,12,113880952,113040144,840808,14.27198599442441
1747352077729657,113244364,1,1221,12,113974937,113134784,840153,14.283112718754795
1747352077823650,113339004,1,1222,12,114068930,113229424,839506,14.294120589966004
1747352077922511,113433644,1,1223,12,114167791,113324064,843727,14.222609920033376
1747352078016739,113528284,1,1224,12,114262019,113418704,843315,14.229558350082709
1747352078109973,113622924,1,1225,12,114355253,113513344,841909,14.253321914838777
1747352078208929,113717564,1,1226,12,114454209,113607984,846225,14.1806257201099
1747352078302793,113812204,1,1227,12,114548073,113702624,845449,14.193641485175332
1747352078396977,113906844,1,1228,12,114642257,113797264,844993,14.2013010758669
1747352078491982,114001484,1,1229,12,114737262,113891904,845358,14.195169383858673
1747352078589622,114096124,1,1230,12,114834902,113986544,848358,14.144971816143658
1747352078683786,114190764,1,1231,12,114929066,114081184,847882,14.152912787392586
1747352078778205,114285404,1,1232,12,115023485,114175824,847661,14.156602698484418
1747352078872671,114380044,1,1233,12,115117951,114270464,847487,14.15950923141004
1747352078970206,114474684,1,1234,12,115215486,114365104,850382,14.11130527221884
1747352079065238,114569324,1,1235,12,115310518,114459744,850774,14.104803390794734
1747352079159253,114663964,1,1236,12,115404533,114554384,850149,14.11517275207052
1747352079248745,114758604,1,1237,12,115494025,114649024,845001,14.201166625838312
1747352079343842,114853244,1,1238,12,115589122,114743664,845458,14.193490392189794
1747352079445649,114947884,1,1239,12,115690929,114838304,852625,14.074182671162587
1747352079540092,115042524,1,1240,12,115785372,114932944,852428,14.077435278991306
1747352079634308,115137164,1,1241,12,115879588,115027584,852004,14.084440918117757
1747352079732850,115231804,1,1242,12,115978130,115122224,855906,14.020231193612384
1747352079822172,115326444,1,1243,12,116067452,115216864,850588,14.107887720024266
1747352079921144,115421084,1,1244,12,116166424,115311504,854920,14.03640106676648
1747352080018706,115515724,1,1245,12,116263986,115406144,857842,13.988589973444991
1747352080117071,115610364,1,1246,12,116362351,115500784,861567,13.928110059925697
1747352080208062,115705004,1,1247,12,116453342,115595424,857918,13.987350772451448
1747352080305579,115799644,1,1248,12,116550859,115690064,860795,13.940601420779627
1747352080400345,115894292,1,1249,12,116645625,115784712,860913,13.938690669092
1747352080494118,115988924,1,1250,12,116739398,115879344,860054,13.952612277833715
1747352080588415,116083564,1,1251,12,116833695,115973984,859711,13.958178969444385
1747352080691005,116178204,1,1252,12,116936285,116068624,867661,13.830286252349708
1747352080776467,116272844,1,1253,12,117021747,116163264,858483,13.978145170026664
1747352080875599,116367484,1,1254,12,117120879,116257904,862975,13.90538543990266
1747352080973354,116462124,1,1255,12,117218634,116352544,866090,13.855372998187256
1747352081067879,116556764,1,1256,12,117313159,116447184,865975,13.857212968041802
1747352081162222,116651404,1,1257,12,117407502,116541824,865678,13.861967151758506
1747352081256379,116746044,1,1258,12,117501659,116636464,865195,13.869705673287523
1747352081345898,116840684,1,1259,12,117591178,116731104,860074,13.952287826396333
1747352081448128,116935324,1,1260,12,117693408,116825744,867664,13.83023843331059
1747352081543263,117029964,1,1261,12,117788543,116920384,868159,13.822352817859402
1747352081636807,117124604,1,1262,12,117882087,117015024,867063,13.839824787818186
1747352081726849,117219244,1,1263,12,117972129,117109664,862465,13.913608088444168
1747352081829300,117313884,1,1264,12,118074580,117204304,870276,13.788729092839512
1747352081923691,117408524,1,1265,12,118168971,117298944,870027,13.792675399728974
1747352082022053,117503164,1,1266,12,118267333,117393584,873749,13.733921297764002
1747352082111654,117597804,1,1267,12,118356934,117488224,868710,13.813585661498085
1747352082210170,117692452,1,1268,12,118455450,117582872,872578,13.752352225245192
1747352082300793,117787084,1,1269,12,118546073,117677504,868569,13.815828103466735
1747352082402888,117881724,1,1270,12,118648168,117772144,876024,13.698254842333087
1747352082497196,117976364,1,1271,12,118742476,117866784,875692,13.703448244359889
1747352082591409,118071004,1,1272,12,118836689,117961424,875265,13.71013350242498
1747352082689748,118165644,1,1273,12,118935028,118056064,878964,13.652436277253676
1747352082783702,118260284,1,1274,12,119028982,118150704,878278,13.663099838547703
1747352082877637,118354924,1,1275,12,119122917,118245344,877573,13.674076116744702
1747352082972022,118449564,1,1276,12,119217302,118339984,877318,13.678050604227884
1747352083070380,118544204,1,1277,12,119315660,118434624,881036,13.620328794737103
1747352083156607,118638844,1,1278,12,119401887,118529264,872623,13.7516430348501
1747352083254802,118733484,1,1279,12,119500082,118623904,876178,13.695847190867608
1747352083353403,118828124,1,1280,12,119598683,118718544,880139,13.634210050912412
1747352083443554,118922764,1,1281,12,119688834,118813184,875650,13.704105521612515
1747352083541703,119017404,1,1282,12,119786983,118907824,879159,13.649408127540068
1747352083635231,119112044,1,1283,12,119880511,119002464,878047,13.666694379685826
1747352083730048,119206684,1,1284,12,119975328,119097104,878224,13.66393995153856
1747352083831870,119301324,1,1285,12,120077150,119191744,885406,13.553104451517155
1747352083926834,119395964,1,1286,12,120172114,119286384,885730,13.548146726429048
1747352084020395,119490604,1,1287,12,120265675,119381024,884651,13.56467126584382
1747352084119071,119585244,1,1288,12,120364351,119475664,888687,13.503066884066044
1747352084212971,119679884,1,1289,12,120458251,119570304,887947,13.514320111448091
1747352084303306,119774524,1,1290,12,120548586,119664944,883642,13.580160291158636
1747352084397320,119869164,1,1291,12,120642600,119759584,883016,13.589787727515697
1747352084495316,119963804,1,1292,12,120740596,119854224,886372,13.538333792132422
1747352084589861,120058444,1,1293,12,120835141,119948864,886277,13.539784965648437
1747352084688518,120153084,1,1294,12,120933798,120043504,890294,13.478693555162677
1747352084778598,120247724,1,1295,12,121023878,120138144,885734,13.548085542612116
1747352084873066,120342364,1,1296,12,121118346,120232784,885562,13.550716945849077
1747352084975384,120437004,1,1297,12,121220664,120327424,893240,13.434239398146074
1747352085065324,120531644,1,1298,12,121310604,120422064,888540,13.505300830576
1747352085167318,120626284,1,1299,12,121412598,120516704,895894,13.394441753153831
1747352085257418,120720924,1,1300,12,121502698,120611344,891354,13.462664665217186
1747352085351421,120815564,1,1301,12,121596701,120705984,890717,13.47229254634188
1747352085446454,120910204,1,1302,12,121691734,120800624,891110,13.46635095554982
1747352085539940,121004844,1,1303,12,121785220,120895264,889956,13.48381268287421
1747352085646490,121099484,1,1304,12,121891770,120989904,901866,13.305746086447432
1747352085736709,121194124,1,1305,12,121981989,121084544,897445,13.37129294831438
1747352085834875,121288764,1,1306,12,122080155,121179184,900971,13.31896365143828
1747352085920976,121383404,1,1307,12,122166256,121273824,892432,13.446402639080624
1747352086019347,121478044,1,1308,12,122264627,121368464,896163,13.390421162221603
1747352086118107,121572684,1,1309,12,122363387,121463104,900283,13.329142058663775
1747352086207613,121667324,1,1310,12,122452893,121557744,895149,13.405589460525569
1747352086313972,121761964,1,1311,12,122559252,121652384,906868,13.232355756295291
1747352086400489,121856604,1,1312,12,122645769,121747024,898745,13.351951888466695
1747352086502709,121951252,1,1313,12,122747989,121841672,906317,13.240400433843789
1747352086597194,122045884,1,1314,12,122842474,121936304,906170,13.24254830771268
1747352086690860,122140524,1,1315,12,122936140,122030944,905196,13.25679742287858
1747352086785258,122235164,1,1316,12,123030538,122125584,904954,13.260342514647151
1747352086874950,122329804,1,1317,12,123120230,122220224,900006,13.333244445037034
1747352086977477,122424444,1,1318,12,123222757,122314864,907893,13.217416589840434
1747352087071817,122519084,1,1319,12,123317097,122409504,907593,13.221785536027712
1747352087165931,122613724,1,1320,12,123411211,122504144,907067,13.229452730614168
1747352087264386,122708364,1,1321,12,123509666,122598784,910882,13.174044497530964
1747352087354766,122803004,1,1322,12,123600046,122693424,906622,13.23594618264282
1747352087452644,122897644,1,1323,12,123697924,122788064,909860,13.188842239465412
1747352087543009,122992284,1,1324,12,123788289,122882704,905585,13.251102878249972
1747352087645173,123086924,1,1325,12,123890453,122977344,913109,13.141914054072409
1747352087739858,123181564,1,1326,12,123985138,123071984,913154,13.141266423845266
1747352087829614,123276204,1,1327,12,124074894,123166624,908270,13.211930373126933
1747352087924103,123370844,1,1328,12,124169383,123261264,908119,13.214127223414552
1747352088022282,123465484,1,1329,12,124267562,123355904,911658,13.162830798391502
1747352088123972,123560124,1,1330,12,124369252,123450544,918708,13.061821601640563
1747352088210527,123654764,1,1331,12,124455807,123545184,910623,13.177791468038915
1747352088304991,123749412,1,1332,12,124550271,123639832,910439,13.180454703719851
1747352088402580,123844044,1,1333,12,124647860,123734464,913396,13.13778470674275
1747352088501136,123938684,1,1334,12,124746416,123829104,917312,13.081699574408708
1747352088603415,124033324,1,1335,12,124848695,123923744,924951,12.973660226325505
1747352088693943,124127964,1,1336,12,124939223,124018384,920839,13.031594013720095
1747352088792024,124222604,1,1337,12,125037304,124113024,924280,12.983078720733976
1747352088886315,124317244,1,1338,12,125131595,124207664,923931,12.987982868850596
1747352088981047,124411884,1,1339,12,125226327,124302304,924023,12.986689725255756
1747352089070410,124506524,1,1340,12,125315690,124396944,918746,13.061281355238554
1747352089165011,124601164,1,1341,12,125410291,124491584,918707,13.06183581925467
1747352089271764,124695804,1,1342,12,125517044,124586224,930820,12.891858791173377
1747352089361543,124790444,1,1343,12,125606823,124680864,925959,12.959537085335311
1747352089459760,124885084,1,1344,12,125705040,124775504,929536,12.909666758468742
1747352089549768,124979724,1,1345,12,125795048,124870144,924904,12.974319496942384
1747352089647747,125074364,1,1346,12,125893027,124964784,928243,12.92764933320262
1747352089742408,125169004,1,1347,12,125987688,125059424,928264,12.927356872613826
1747352089832636,125263644,1,1348,12,126077916,125154064,923852,12.989093491165251
1747352089938800,125358284,1,1349,12,126184080,125248704,935376,12.829065530866732
1747352090028866,125452924,1,1350,12,126274146,125343344,930802,12.892108096029016
1747352090127690,125547564,1,1351,12,126372970,125437984,934986,12.834416772015835
1747352090217114,125642204,1,1352,12,126462394,125532624,929770,12.906417716209384
1747352090315486,125736844,1,1353,12,126560766,125627264,933502,12.854819807563349
1747352090409677,125831484,1,1354,12,126654957,125721904,933053,12.861005752084822
1747352090500480,125926124,1,1355,12,126745760,125816544,929216,12.9141125421861
1747352090602015,126020764,1,1356,12,126847295,125911184,936111,12.818992619464998
1747352090696482,126115404,1,1357,12,126941762,126005824,935938,12.8213620987715
1747352090791184,126210044,1,1358,12,127036464,126100464,936000,12.82051282051282
1747352090884709,126304684,1,1359,12,127129989,126195104,934885,12.835803334099916
1747352090983208,126399324,1,1360,12,127228488,126289744,938744,12.783037761093546
1747352091081867,126493964,1,1361,12,127327147,126384384,942763,12.728543653070814
1747352091171640,126588604,1,1362,12,127416920,126479024,937896,12.79459556283426
1747352091269705,126683244,1,1363,12,127514985,126573664,941321,12.748042378742214
1747352091356069,126777884,1,1364,12,127601349,126668304,933045,12.861116023342923
1747352091458878,126872524,1,1365,12,127704158,126762944,941214,12.74949161402189
1747352091552946,126967164,1,1366,12,127798226,126857584,940642,12.757244520231929
1747352091650947,127061804,1,1367,12,127896227,126952224,944003,12.711824009033869
1747352091737387,127156444,1,1368,12,127982667,127046864,935803,12.823211722980156
1747352091835137,127251084,1,1369,12,128080417,127141504,938913,12.780736873384434
1747352091929757,127345724,1,1370,12,128175037,127236144,938893,12.781009124575432
1747352092023883,127440364,1,1371,12,128269163,127330784,938379,12.78800996185976
1747352092117452,127535004,1,1372,12,128362732,127425424,937308,12.802621976980886
1747352092216521,127629644,1,1373,12,128461801,127520064,941737,12.742411097790573
1747352092310312,127724284,1,1374,12,128555592,127614704,940888,12.753909073130917
1747352092404506,127818924,1,1375,12,128649786,127709344,940442,12.759957551874544
1747352092502945,127913564,1,1376,12,128748225,127803984,944241,12.708619939189251
1747352092596765,128008212,1,1377,12,128842045,127898632,943413,12.719773842421082
1747352092691210,128102844,1,1378,12,128936490,127993264,943226,12.722295611020051
1747352092785272,128197484,1,1379,12,129030552,128087904,942648,12.730096494131423
1747352092883954,128292124,1,1380,12,129129234,128182544,946690,12.675743907720584
1747352092978013,128386764,1,1381,12,129223293,128277184,946109,12.683528007872244
1747352093079969,128481404,1,1382,12,129325249,128371824,953425,12.5862023756457
1747352093170482,128576044,1,1383,12,129415762,128466464,949298,12.640919921879116
1747352093264783,128670684,1,1384,12,129510063,128561104,948959,12.645435682679652
1747352093366476,128765324,1,1385,12,129611756,128655744,956012,12.552143696941044
1747352093452810,128859964,1,1386,12,129698090,128750384,947706,12.662154718868509
1747352093551775,128954604,1,1387,12,129797055,128845024,952031,12.604631571871083
1747352093645853,129049244,1,1388,12,129891133,128939664,951469,12.612076694038375
1747352093747830,129143884,1,1389,12,129993110,129034304,958806,12.515566235505409
1747352093841844,129238524,1,1390,12,130087124,129128944,958180,12.52374292930347
1747352093932031,129333164,1,1391,12,130177311,129223584,953727,12.582216923710874
1747352094030460,129427804,1,1392,12,130275740,129318224,957516,12.532427656561351
1747352094121357,129522444,1,1393,12,130366637,129412864,953773,12.581610089612518
1747352094223044,129617084,1,1394,12,130468324,129507504,960820,12.489332028891988
1747352094317343,129711724,1,1395,12,130562623,129602144,960479,12.493766131274084
1747352094415351,129806372,1,1396,12,130660631,129696792,963839,12.450212120489002
1747352094501437,129901004,1,1397,12,130746717,129791424,955293,12.561591051122535
1747352094603834,129995644,1,1398,12,130849114,129886064,963050,12.460412231971342
1747352094698268,130090284,1,1399,12,130943548,129980704,962844,12.463078131036802
1747352094788605,130184924,1,1400,12,131033885,130075344,958541,12.519026311863552
1747352094890618,130279564,1,1401,12,131135898,130169984,965914,12.423466271324362
1747352094984738,130374204,1,1402,12,131230018,130264624,965394,12.4301580494596
1747352095074937,130468844,1,1403,12,131320217,130359264,960953,12.487603451989848
1747352095169653,130563484,1,1404,12,131414933,130453904,961029,12.486615908573
1747352095267901,130658124,1,1405,12,131513181,130548544,964637,12.43991263034696
1747352095361973,130752764,1,1406,12,131607253,130643184,964069,12.447241846797274
1747352095455386,130847404,1,1407,12,131700666,130737824,962842,12.463104019143328
1747352095550253,130942044,1,1408,12,131795533,130832464,963069,12.460166405522346
1747352095647966,131036684,1,1409,12,131893246,130927104,966142,12.420534455597624
1747352095742613,131131324,1,1410,12,131987893,131021744,966149,12.4204444656052
1747352095836885,131225964,1,1411,12,132082165,131116384,965781,12.425177136431552
1747352095935039,131320604,1,1412,12,132180319,131211024,969295,12.38013195157305
1747352096029524,131415244,1,1413,12,132274804,131305664,969140,12.382111975565966
1747352096123495,131509884,1,1414,12,132368775,131400304,968471,12.390665285795858
1747352096217219,131604524,1,1415,12,132462499,131494944,967555,12.402395729441736
1747352096315572,131699164,1,1416,12,132560852,131589584,971268,12.354983382547353
1747352096409975,131793804,1,1417,12,132655255,131684224,971031,12.357998869243104
1747352096504723,131888444,1,1418,12,132750003,131778864,971139,12.35662454087417
1747352096602253,131983084,1,1419,12,132847533,131873504,974029,12.319961725985571
1747352096697269,132077724,1,1420,12,132942549,131968144,974405,12.3152077421606
1747352096791408,132172364,1,1421,12,133036688,132062784,973904,12.321542985756295
1747352096885403,132267004,1,1422,12,133130683,132157424,973259,12.329708741455256
1747352096983759,132361644,1,1423,12,133229039,132252064,976975,12.282811740320888
1747352097077614,132456284,1,1424,12,133322894,132346704,976190,12.29268892326289
1747352097172330,132550924,1,1425,12,133417610,132441344,976266,12.29173196649274
1747352097265759,132645564,1,1426,12,133511039,132535984,975055,12.30699806677572
1747352097364241,132740204,1,1427,12,133609521,132630624,978897,12.258695245771516
1747352097458928,132834844,1,1428,12,133704208,132725264,978944,12.258106694560668
1747352097552420,132929484,1,1429,12,133797700,132819904,977796,12.27249855798142
1747352097650887,133024124,1,1430,12,133896167,132914544,981623,12.224652437850375
1747352097745406,133118764,1,1431,12,133990686,133009184,981502,12.22615949840143
1747352097839309,133213404,1,1432,12,134084589,133103824,980765,12.235346897574852
1747352097933826,133308044,1,1433,12,134179106,133198464,980642,12.236881553105006
1747352098032065,133402684,1,1434,12,134277345,133293104,984241,12.192135869162126
1747352098125710,133497324,1,1435,12,134370990,133387744,983246,12.204473753262157
1747352098220305,133591964,1,1436,12,134465585,133482384,983201,12.205032338250266
1747352098314858,133686604,1,1437,12,134560138,133577024,983114,12.20611241422663
1747352098412671,133781244,1,1438,12,134657951,133671664,986287,12.16684393082338
1747352098507417,133875884,1,1439,12,134752697,133766304,986393,12.165536454536884
1747352098600926,133970524,1,1440,12,134846206,133860944,985262,12.179501493003892
1747352098699575,134065172,1,1441,12,134944855,133955592,989263,12.130242412786084
1747352098793538,134159804,1,1442,12,135038818,134050224,988594,12.13845117409169
1747352098887982,134254444,1,1443,12,135133262,134144864,988398,12.140858237268793
1747352098982014,134349084,1,1444,12,135227294,134239504,987790,12.148331123011976
1747352099080116,134443724,1,1445,12,135325396,134334144,991252,12.10590243449698
1747352099174790,134538364,1,1446,12,135420070,134428784,991286,12.10548721559671
1747352099268560,134633004,1,1447,12,135513840,134523424,990416,12.11612090273178
1747352099367395,134727644,1,1448,12,135612675,134618064,994611,12.065018384071765
1747352099461401,134822284,1,1449,12,135706681,134712704,993977,12.07271395615794
1747352099555456,134916924,1,1450,12,135800736,134807344,993392,12.079823473512974
1747352099649863,135011564,1,1451,12,135895143,134901984,993159,12.082657459681682
1747352099748185,135106204,1,1452,12,135993465,134996624,996841,12.038028130865404
1747352099841946,135200844,1,1453,12,136087226,135091264,995962,12.04865245862794
1747352099936290,135295484,1,1454,12,136181570,135185904,995666,12.052234383819473
1747352100030967,135390124,1,1455,12,136276247,135280544,995703,12.051786526705252
1747352100129176,135484764,1,1456,12,136374456,135375184,999272,12.008742364441312
1747352100223604,135579404,1,1457,12,136468884,135469824,999060,12.011290613176389
1747352100317069,135674044,1,1458,12,136562349,135564464,997885,12.025433792471077
1747352100416057,135768684,1,1459,12,136661337,135659104,1002233,11.973263702153092
1747352100510086,135863332,1,1460,12,136755366,135753752,1001614,11.980663209579738
1747352100604304,135957964,1,1461,12,136849584,135848384,1001200,11.985617259288851
1747352100697815,136052604,1,1462,12,136943095,135943024,1000071,11.999148060487704
1747352100796799,136147244,1,1463,12,137042079,136037664,1004415,11.94725287854124
1747352100890599,136241884,1,1464,12,137135879,136132304,1003575,11.957252821164335
1747352100985197,136336524,1,1465,12,137230477,136226944,1003533,11.957753257740404
1747352101083722,136431164,1,1466,12,137329002,136321584,1007418,11.911639458496872
1747352101177934,136525804,1,1467,12,137423214,136416224,1006990,11.916702251263668
1747352101271930,136620444,1,1468,12,137517210,136510864,1006346,11.924328213159292
1747352101365598,136715084,1,1469,12,137610878,136605504,1005374,11.935856706061625
1747352101464141,136809724,1,1470,12,137709421,136700144,1009277,11.889699259965305
1747352101558653,136904364,1,1471,12,137803933,136794784,1009149,11.891207344009654
1747352101652950,136999004,1,1472,12,137898230,136889424,1008806,11.895250424759569
1747352101747304,137093644,1,1473,12,137992584,136984064,1008520,11.898623725855709
1747352101845527,137188284,1,1474,12,138090807,137078704,1012103,11.856500771166573
1747352101939791,137282924,1,1475,12,138185071,137173344,1011727,11.860907141946392
1747352102033359,137377564,1,1476,12,138278639,137267984,1010655,11.873487985514345
1747352102131608,137472204,1,1477,12,138376888,137362624,1014264,11.831239203994226
1747352102226282,137566844,1,1478,12,138471562,137457264,1014298,11.830842612328922
1747352102320135,137661484,1,1479,12,138565415,137551904,1013511,11.84002936327282
1747352102418608,137756124,1,1480,12,138663888,137646544,1017344,11.795420231504782
1747352102512390,137850764,1,1481,12,138757670,137741184,1016486,11.805376561998886
1747352102607529,137945404,1,1482,12,138852809,137835824,1016985,11.79958406466172
1747352102701507,138040044,1,1483,12,138946787,137930464,1016323,11.807269932885507
1747352102799757,138134684,1,1484,12,139045037,138025104,1019933,11.76547871281741
1747352102894238,138229324,1,1485,12,139139518,138119744,1019774,11.767313149776324
1747352102988287,138323964,1,1486,12,139233567,138214384,1019183,11.77413673501226
1747352103082762,138418604,1,1487,12,139328042,138309024,1019018,11.776043210227886
1747352103181269,138513244,1,1488,12,139426549,138403664,1022885,11.731524071620957
1747352103274793,138607884,1,1489,12,139520073,138498304,1021769,11.744337516601112
1747352103368966,138702524,1,1490,12,139614246,138592944,1021302,11.749707726020317
1747352103463530,138797164,1,1491,12,139708810,138687584,1021226,11.750582143423689
1747352103561259,138891804,1,1492,12,139806539,138782224,1024315,11.715146219668751
1747352103655236,138986444,1,1493,12,139900516,138876864,1023652,11.722733897848096
1747352103749809,139081084,1,1494,12,139995089,138971504,1023585,11.72350122364044
1747352103847739,139175724,1,1495,12,140093019,139066144,1026875,11.685940353012782
1747352103942170,139270364,1,1496,12,140187450,139160784,1026666,11.6883192781294
1747352104036465,139365004,1,1497,12,140281745,139255424,1026321,11.692248331662316
1747352104130770,139459644,1,1498,12,140376050,139350064,1025986,11.696066028191415
1747352104228538,139554284,1,1499,12,140473818,139444704,1029114,11.660515744611384
1747352104322932,139648924,1,1500,12,140568212,139539344,1028868,11.663303747419496
1747351654505185,109580,1,1,1,0,0,0,0.0
1747351654594431,197404,1,2,1,89246,87824,1422,703.2348804500702
1747351680708829,109580,1,1,1,26203644,0,26203644,0.0381626311210761
1747351680799226,200524,1,2,1,26294041,90944,26203097,0.0381634277810748
1747351680888812,292044,1,3,1,26383627,182464,26201163,0.0381662447579139
1747351680983215,383564,1,4,1,26478030,273984,26204046,0.0381620456627194
1747351681073754,475084,1,5,1,26568569,365504,26203065,0.0381634743874428
1747351681167930,566604,1,6,1,26662745,457024,26205721,0.0381596064462412
1747351681257372,658124,1,7,1,26752187,548544,26203643,0.0381626325774626
1747351681351721,749644,1,8,1,26846536,640064,26206472,0.0381585129047511
1747351681441819,841164,1,9,1,26936634,731584,26205050,0.0381605835516436
1747351681536383,932684,1,10,1,27031198,823104,26208094,0.0381561513019603
1747351681629969,1022124,1,11,1,27124784,912544,26212240,0.0381501161289534
1747351681724812,1115724,1,12,1,27219627,1006144,26213483,0.0381483071135567
1747351681818880,1209324,1,13,1,27313695,1099744,26213951,0.038147626048435
1747351681912730,1302924,1,14,1,27407545,1193344,26214201,0.0381472622415613
1747351682007079,1396524,1,15,1,27501894,1286944,26214950,0.0381461723177042
1747351682101336,1490124,1,16,1,27596151,1380544,26215607,0.0381452163209495
1747351682191746,1580604,1,17,1,27686561,1471024,26215537,0.0381453181752485
1747351682285587,1674204,1,18,1,27780402,1564624,26215778,0.0381449675077352
1747351682380559,1767804,1,19,1,27875374,1658224,26217150,0.0381429712993212
1747351682474444,1861404,1,20,1,27969259,1751824,26217435,0.0381425566612447
1747351682568972,1955004,1,21,1,28063787,1845424,26218363,0.0381412066039363
1747351682658522,2045484,1,22,1,28153337,1935904,26217433,0.0381425595709541
1747351682752760,2139084,1,23,1,28247575,2029504,26218071,0.0381416313961465
1747351682847012,2232684,1,24,1,28341827,2123104,26218723,0.0381406829005363
1747351682941123,2326284,1,25,1,28435938,2216704,26219234,0.0381399395573493
1747351683034927,2416764,1,26,1,28529742,2307184,26222558,0.0381351048970889
1747351683129997,2510364,1,27,1,28624812,2400784,26224028,0.0381329672161728
1747351683224426,2603964,1,28,1,28719241,2494384,26224857,0.0381317617861557
1747351683318309,2697564,1,29,1,28813124,2587984,26225140,0.0381313502997505
1747351683413621,2791164,1,30,1,28908436,2681584,26226852,0.038128861214453
1747351683506058,2884764,1,31,1,29000873,2775184,26225689,0.038130552070529
1747351683600356,2978364,1,32,1,29095171,2868784,26226387,0.0381295372481158
1747351683695121,3071964,1,33,1,29189936,2962384,26227552,0.0381278435745737
1747351683784701,3162444,1,34,1,29279516,3052864,26226652,0.0381291519786818
1747351683875028,3252924,1,35,1,29369843,3143344,26226499,0.0381293744163107
1747351683964912,3343404,1,36,1,29459727,3233824,26225903,0.0381302409301216
1747351684059616,3433884,1,37,1,29554431,3324304,26230127,0.0381241005809846
1747351684149751,3524364,1,38,1,29644566,3414784,26229782,0.0381246020268105
1747351684243773,3617964,1,39,1,29738588,3508384,26230204,0.0381239886658906
1747351684337751,3711564,1,40,1,29832566,3601984,26230582,0.0381234392740504
1747351684431985,3805164,1,41,1,29926800,3695584,26231216,0.0381225178428632
1747351684526170,3898764,1,42,1,30020985,3789184,26231801,0.0381216676658991
1747351684620525,3992364,1,43,1,30115340,3882784,26232556,0.038120570485011
1747351684714860,4085964,1,44,1,30209675,3976384,26233291,0.0381195024291843
1747351684808491,4179564,1,45,1,30303306,4069984,26233322,0.0381194573832471
1747351684902623,4273172,1,46,1,30397438,4163592,26233846,0.0381186959777075
1747351684997203,4366764,1,47,1,30492018,4257184,26234834,0.0381172604332087
1747351685091295,4460364,1,48,1,30586110,4350784,26235326,0.0381165456072472
1747351685185096,4553964,1,49,1,30679911,4444384,26235527,0.0381162535824037
1747351685279335,4647564,1,50,1,30774150,4537984,26236166,0.0381153252346398
1747351685373412,4741164,1,51,1,30868227,4631584,26236643,0.0381146322721241
1747351685467667,4834764,1,52,1,30962482,4725184,26237298,0.0381136807608771
1747351685562848,4928364,1,53,1,31057663,4818784,26238879,0.038111384255402
1747351685656547,5021964,1,54,1,31151362,4912384,26238978,0.0381112404606612
1747351685750657,5115564,1,55,1,31245472,5005984,26239488,0.0381104997170676
1747351685845275,5209164,1,56,1,31340090,5099584,26240506,0.038109021220856
1747351685939164,5302764,1,57,1,31433979,5193184,26240795,0.0381086015115014
1747351686033530,5396364,1,58,1,31528345,5286784,26241561,0.0381074891085938
1747351686127375,5489964,1,59,1,31622190,5380384,26241806,0.0381071333276375
1747351686222061,5583564,1,60,1,31716876,5473984,26242892,0.0381055563540786
1747351686315652,5677164,1,61,1,31810467,5567584,26242883,0.0381055694223839
1747351686409656,5770764,1,62,1,31904471,5661184,26243287,0.0381049828095085
1747351686504559,5864364,1,63,1,31999374,5754784,26244590,0.0381030909608418
1747351686597914,5957964,1,64,1,32092729,5848384,26244345,0.0381034466663199
1747351686697224,6051564,1,65,1,32192039,5941984,26250055,0.0380951582768112
1747351686791057,6145164,1,66,1,32285872,6035584,26250288,0.0380948201406399
1747351686885103,6238764,1,67,1,32379918,6129184,26250734,0.0380941729096032
1747351686979216,6332364,1,68,1,32474031,6222784,26251247,0.0380934284759882
1747351687072959,6425964,1,69,1,32567774,6316384,26251390,0.0380932209684896
1747351687167903,6519564,1,70,1,32662718,6409984,26252734,0.0380912707986909
1747351687261905,6613164,1,71,1,32756720,6503584,26253136,0.0380906875277681
1747351687356306,6706764,1,72,1,32851121,6597184,26253937,0.038089525391944
1747351687450407,6800364,1,73,1,32945222,6690784,26254438,0.03808879854903
1747351687544384,6893964,1,74,1,33039199,6784384,26254815,0.0380882516216549
1747351687638106,6987564,1,75,1,33132921,6877984,26254937,0.0380880746352581
1747351687733260,7081164,1,76,1,33228075,6971584,26256491,0.0380858203786637
1747351687827488,7174764,1,77,1,33322303,7065184,26257119,0.0380849094677904
1747351687921853,7268372,1,78,1,33416668,7158792,26257876,0.0380838115009759
1747351688012069,7358844,1,79,1,33506884,7249264,26257620,0.0380841828010307
1747351688105976,7452444,1,80,1,33600791,7342864,26257927,0.0380837375319079
1747351688200468,7546044,1,81,1,33695283,7436464,26258819,0.0380824438448659
1747351688293647,7639644,1,82,1,33788462,7530064,26258398,0.0380830544193899
1747351688388438,7733244,1,83,1,33883253,7623664,26259589,0.0380813271677633
1747351688482187,7826844,1,84,1,33977002,7717264,26259738,0.038081111091055
1747351688576367,7920444,1,85,1,34071182,7810864,26260318,0.0380802700104393
1747351688670493,8014044,1,86,1,34165308,7904464,26260844,0.038079507269454
1747351688765602,8107644,1,87,1,34260417,7998064,26262353,0.03807731927143
1747351688858889,8201252,1,88,1,34353704,8091672,26262032,0.0380777846893187
1747351688954035,8294844,1,89,1,34448850,8185264,26263586,0.0380755316505522
1747351689048118,8388444,1,90,1,34542933,8278864,26264069,0.0380748314360581
1747351689141664,8482044,1,91,1,34636479,8372464,26264015,0.0380749097196296
1747351689236240,8575644,1,92,1,34731055,8466064,26264991,0.038073494866227
1747351689330554,8669244,1,93,1,34825369,8559664,26265705,0.0380724598863803
1747351689425023,8762844,1,94,1,34919838,8653264,26266574,0.0380712003019503
1747351689518996,8853324,1,95,1,35013811,8743744,26270067,0.0380661381640176
1747351689612551,8946924,1,96,1,35107366,8837344,26270022,0.0380662033705186
1747351689706638,9040524,1,97,1,35201453,8930944,26270509,0.0380654977031469
1747351689800907,9134124,1,98,1,35295722,9024544,26271178,0.0380645283587968
1747351689895164,9227724,1,99,1,35389979,9118144,26271835,0.0380635764498368
1747351689989518,9321324,1,100,1,35484333,9211744,26272589,0.0380624840589558
1747351690083683,9415964,1,101,1,35578498,9306384,26272114,0.0380631722289268
1747351690182123,9510604,1,102,1,35676938,9401024,26275914,0.0380576675658171
1747351690276537,9605244,1,103,1,35771352,9495664,26275688,0.0380579949038822
1747351690371008,9699884,1,104,1,35865823,9590304,26275519,0.0380582396869116
1747351690464873,9794524,1,105,1,35959688,9684944,26274744,0.0380593622529681
1747351690562883,9889164,1,106,1,36057698,9779584,26278114,0.038054481383253
1747351690656877,9983804,1,107,1,36151692,9874224,26277468,0.0380554169069866
1747351690752006,10078444,1,108,1,36246821,9968864,26277957,0.0380547087431492
1747351690846124,10171004,1,109,1,36340939,10061424,26279515,0.0380524526422957
1747351690943906,10266684,1,110,1,36438721,10157104,26281617,0.0380494092125305
1747351691038289,10362364,1,111,1,36533104,10252784,26280320,0.038051287046733
1747351691136293,10458044,1,112,1,36631108,10348464,26282644,0.0380479224236343
1747351691230370,10550604,1,113,1,36725185,10441024,26284161,0.0380457264738258
1747351691325155,10646284,1,114,1,36819970,10536704,26283266,0.0380470220101261
1747351691418737,10738844,1,115,1,36913552,10629264,26284288,0.0380455426450965
1747351691513198,10834524,1,116,1,37008013,10724944,26283069,0.0380473071847127
1747351691611405,10930212,1,117,1,37106220,10820632,26285588,0.0380436610358497
1747351691706313,11025884,1,118,1,37201128,10916304,26284824,0.0380447668205805
1747351691804580,11121564,1,119,1,37299395,11011984,26287411,0.0380410227541997
1747351691902644,11217244,1,120,1,37397459,11107664,26289795,0.0380375731343663
1747351691997038,11312924,1,121,1,37491853,11203344,26288509,0.0380394338834507
1747351692093937,11408604,1,122,1,37588752,11299024,26289728,0.0380376700740304
1747351692188899,11504284,1,123,1,37683714,11394704,26289010,0.0380387089510027
1747351692287269,11599964,1,124,1,37782084,11490384,26291700,0.0380348170715472
1747351692381806,11695644,1,125,1,37876621,11586064,26290557,0.03803647066131
1747351692480110,11791324,1,126,1,37974925,11681744,26293181,0.0380326747075601
1747351692574493,11887004,1,127,1,38069308,11777424,26291884,0.0380345508903051
1747351692671951,11982684,1,128,1,38166766,11873104,26293662,0.0380319789613177
1747351692766489,12078364,1,129,1,38261304,11968784,26292520,0.0380336308577496
1747351692864710,12174044,1,130,1,38359525,12064464,26295061,0.0380299555114171
1747351692958760,12269724,1,131,1,38453575,12160144,26293431,0.038032313089912
1747351693057160,12365404,1,132,1,38551975,12255824,26296151,0.0380283791342695
1747351693151241,12461092,1,133,1,38646056,12351512,26294544,0.0380307032515947
1747351693249997,12556764,1,134,1,38744812,12447184,26297628,0.0380262432794318
1747351693348616,12652444,1,135,1,38843431,12542864,26300567,0.0380219939745025
1747351693442420,12748124,1,136,1,38937235,12638544,26298691,0.0380247062486874
1747351693541087,12843804,1,137,1,39035902,12734224,26301678,0.0380203879007263
1747351693635180,12939484,1,138,1,39129995,12829904,26300091,0.0380226821268413
1747351693733133,13035164,1,139,1,39227948,12925584,26302364,0.038019396279361
1747351693827753,13130844,1,140,1,39322568,13021264,26301304,0.0380209285440752
1747351693925886,13226524,1,141,1,39420701,13116944,26303757,0.0380173828400254
1747351694020215,13322204,1,142,1,39515030,13212624,26302406,0.0380193355695292
1747351694117904,13417884,1,143,1,39612719,13308304,26304415,0.0380164318423352
1747351694212877,13513564,1,144,1,39707692,13403984,26303708,0.0380174536609059
1747351694311115,13609244,1,145,1,39805930,13499664,26306266,0.0380137568745028
1747351694405350,13704924,1,146,1,39900165,13595344,26304821,0.0380158450802611
1747351694503406,13800604,1,147,1,39998221,13691024,26307197,0.0380124115845561
1747351694597798,13896284,1,148,1,40092613,13786704,26305909,0.0380142727628229
1747351694695898,13991972,1,149,1,40190713,13882392,26308321,0.0380107875375247
1747351694790160,14087644,1,150,1,40284975,13978064,26306911,0.0380128248428711
1747351694888610,14183324,1,151,1,40383425,14073744,26309681,0.038008822683939
1747351694986804,14279004,1,152,1,40481619,14169424,26312195,0.0380051911290563
1747351695080827,14374684,1,153,1,40575642,14265104,26310538,0.0380075846415607
1747351695174817,14467244,1,154,1,40669632,14357664,26311968,0.0380055190094484
1747351695268822,14559804,1,155,1,40763637,14450224,26313413,0.0380034319379245
1747351695358813,14652364,1,156,1,40853628,14542784,26310844,0.0380071426062957
1747351695453252,14744924,1,157,1,40948067,14635344,26312723,0.0380044285040358
1747351695547766,14837484,1,158,1,41042581,14727904,26314677,0.0380016064799123
1747351695641967,14930044,1,159,1,41136782,14820464,26316318,0.0379992368233276
1747351695736387,15025724,1,160,1,41231202,14916144,26315058,0.0380010562773602
1747351695834387,15121404,1,161,1,41329202,15011824,26317378,0.0379977063064565
1747351695928313,15217084,1,162,1,41423128,15107504,26315624,0.0380002389455024
1747351696027093,15312764,1,163,1,41521908,15203184,26318724,0.0379957630164745
1747351696121433,15408444,1,164,1,41616248,15298864,26317384,0.0379976976435043
1747351696219567,15504124,1,165,1,41714382,15394544,26319838,0.0379941548272447
1747351696313524,15599804,1,166,1,41808339,15490224,26318115,0.0379966422367255
1747351696412103,15695484,1,167,1,41906918,15585904,26321014,0.0379924572814709
1747351696506102,15791164,1,168,1,42000917,15681584,26319333,0.0379948838369118
1747351696604180,15886844,1,169,1,42098995,15777264,26321731,0.0379914223726395
1747351696702176,15982524,1,170,1,42196991,15872944,26324047,0.0379880798723691
1747351696796670,16078204,1,171,1,42291485,15968624,26322861,0.0379897914592186
1747351696894839,16173884,1,172,1,42389654,16064304,26325350,0.0379861996136803
1747351696989346,16269564,1,173,1,42484161,16159984,26324177,0.037987892271048
1747351697083268,16362124,1,174,1,42578083,16252544,26325539,0.037985926897831
1747351697177672,16457804,1,175,1,42672487,16348224,26324263,0.0379877681665769
1747351697271558,16550364,1,176,1,42766373,16440784,26325589,0.0379858547514359
1747351697365836,16642924,1,177,1,42860651,16533344,26327307,0.0379833759677736
1747351697459730,16735484,1,178,1,42954545,16625904,26328641,0.0379814514543306
1747351697550730,16828044,1,179,1,43045545,16718464,26327081,0.0379837020291007
1747351697644879,16920612,1,180,1,43139694,16811032,26328662,0.037981421159951
1747351697738947,17013164,1,181,1,43233762,16903584,26330178,0.0379792343219252
1747351697832924,17105724,1,182,1,43327739,16996144,26331595,0.037977190519602
1747351697927267,17198284,1,183,1,43422082,17088704,26333378,0.0379746191316586
1747351698017166,17290844,1,184,1,43511981,17181264,26330717,0.037978456872253
1747351698111421,17383404,1,185,1,43606236,17273824,26332412,0.0379760122240226
1747351698205484,17475964,1,186,1,43700299,17366384,26333915,0.0379738447549481
1747351698300285,17568524,1,187,1,43795100,17458944,26336156,0.0379706134790513
1747351698389799,17661084,1,188,1,43884614,17551504,26333110,0.037975005610807
1747351698483602,17753644,1,189,1,43978417,17644064,26334353,0.0379732131638092
1747351698578007,17846204,1,190,1,44072822,17736624,26336198,0.0379705529249134
1747351698672152,17938764,1,191,1,44166967,17829184,26337783,0.037968267868256
1747351698762987,18031324,1,192,1,44257802,17921744,26336058,0.0379707547727909
1747351698857408,18123884,1,193,1,44352223,18014304,26337919,0.0379680718131147
1747351698951253,18216444,1,194,1,44446068,18106864,26339204,0.0379662194802849
1747351699045678,18309004,1,195,1,44540493,18199424,26341069,0.0379635313965427
1747351699139149,18401564,1,196,1,44633964,18291984,26341980,0.0379622184816782
1747351699229388,18494124,1,197,1,44724203,18384544,26339659,0.0379655636392255
1747351699323462,18586684,1,198,1,44818277,18477104,26341173,0.0379633815092441
1747351699417873,18679244,1,199,1,44912688,18569664,26343024,0.0379607140015512
1747351699512484,18771804,1,200,1,45007299,18662224,26345075,0.0379577587082215
1747351699602310,18864364,1,201,1,45097125,18754784,26342341,0.0379616982408662
1747351699696740,18956924,1,202,1,45191555,18847344,26344211,0.0379590035928576
1747351699791004,19049492,1,203,1,45285819,18939912,26345907,0.0379565600075943
1747351699885002,19142044,1,204,1,45379817,19032464,26347353,0.0379544768690805
1747351699975096,19234604,1,205,1,45469911,19125024,26344887,0.0379580295789463
1747351700068906,19327164,1,206,1,45563721,19217584,26346137,0.0379562286493841
1747351700163884,19419724,1,207,1,45658699,19310144,26348555,0.0379527454162097
1747351700257793,19512284,1,208,1,45752608,19402704,26349904,0.0379508024014053
1747351700347830,19604844,1,209,1,45842645,19495264,26347381,0.0379544365339386
1747351700442090,19697404,1,210,1,45936905,19587824,26349081,0.0379519877752093
1747351700536611,19789964,1,211,1,46031426,19680384,26351042,0.0379491634524357
1747351700630533,19882524,1,212,1,46125348,19772944,26352404,0.0379472020844853
1747351700720923,19975084,1,213,1,46215738,19865504,26350234,0.0379503271204346
1747351700814833,20067644,1,214,1,46309648,19958064,26351584,0.0379483829131486
1747351700908579,20160204,1,215,1,46403394,20050624,26352770,0.0379466750554116
1747351701002854,20252764,1,216,1,46497669,20143184,26354485,0.0379442057016101
1747351701097264,20345324,1,217,1,46592079,20235744,26356335,0.0379415423274897
1747351701187817,20437884,1,218,1,46682632,20328304,26354328,0.0379444317457079
1747351701283920,20530444,1,219,1,46778735,20420864,26357871,0.0379393312912108
1747351701375433,20623004,1,220,1,46870248,20513424,26356824,0.0379408383953999
1747351701470344,20715564,1,221,1,46965159,20605984,26359175,0.0379374544157774
1747351701560473,20808124,1,222,1,47055288,20698544,26356744,0.0379409535563269
1747351701654581,20900684,1,223,1,47149396,20791104,26358292,0.0379387253164962
1747351701748363,20993244,1,224,1,47243178,20883664,26359514,0.0379369665161504
1747351701842325,21085804,1,225,1,47337140,20976224,26360916,0.0379349488462388
1747351701933320,21178364,1,226,1,47428135,21068784,26359351,0.0379372011093899
1747351702027473,21270924,1,227,1,47522288,21161344,26360944,0.037934908552592
1747351702121564,21363484,1,228,1,47616379,21253904,26362475,0.0379327054838364
1747351702214888,21456044,1,229,1,47709703,21346464,26363239,0.0379316062036231
1747351702309607,21548604,1,230,1,47804422,21439024,26365398,0.037928500074226
1747351702399426,21641164,1,231,1,47894241,21531584,26362657,0.0379324436076378
1747351702493402,21733724,1,232,1,47988217,21624144,26364073,0.0379304062767539
1747351702587564,21826284,1,233,1,48082379,21716704,26365675,0.0379281015942129
1747351702682596,21918844,1,234,1,48177411,21809264,26368147,0.0379245458545115
1747351702772314,22011404,1,235,1,48267129,21901824,26365305,0.0379286338618119
1747351702866395,22103964,1,236,1,48361210,21994384,26366826,0.0379264459059274
1747351702960499,22196524,1,237,1,48455314,22086944,26368370,0.0379242251227512
1747351703055164,22289084,1,238,1,48549979,22179504,26370475,0.0379211978547978
1747351703145135,22381644,1,239,1,48639950,22272064,26367886,0.0379249212470047
1747351703239384,22474204,1,240,1,48734199,22364624,26369575,0.0379224921144917
1747351703333492,22566764,1,241,1,48828307,22457184,26371123,0.0379202660425193
1747351703428062,22659324,1,242,1,48922877,22549744,26373133,0.037917375990179
1747351703517733,22751884,1,243,1,49012548,22642304,26370244,0.0379215300396917
1747351703612114,22844452,1,244,1,49106929,22734872,26372057,0.0379189230479821
1747351703706522,22937004,1,245,1,49201337,22827424,26373913,0.0379162545959714
1747351703800356,23029564,1,246,1,49295171,22919984,26375187,0.037914423128071
1747351703894244,23122124,1,247,1,49389059,23012544,26376515,0.0379125142195623
1747351703984834,23214684,1,248,1,49479649,23105104,26374545,0.0379153460277703
1747351704078532,23307244,1,249,1,49573347,23197664,26375683,0.0379137101397525
1747351704173087,23399804,1,250,1,49667902,23290224,26377678,0.0379108426450576
1747351704267321,23492364,1,251,1,49762136,23382784,26379352,0.0379084368713833
1747351704357018,23584924,1,252,1,49851833,23475344,26376489,0.0379125515909263
1747351704451299,23677484,1,253,1,49946114,23567904,26378210,0.0379100780530597
1747351704546073,23770044,1,254,1,50040888,23660464,26380424,0.0379068964168278
1747351704639989,23862604,1,255,1,50134804,23753024,26381780,0.0379049480361067
1747351704730586,23955164,1,256,1,50225401,23845584,26379817,0.0379077686551047
1747351704827867,24047724,1,257,1,50322682,23938144,26384538,0.0379009857970603
1747351704918191,24140284,1,258,1,50413006,24030704,26382302,0.0379041980491315
1747351705012896,24232844,1,259,1,50507711,24123264,26384447,0.0379011165176211
1747351705102535,24325404,1,260,1,50597350,24215824,26381526,0.0379053129830321
1747351705197216,24417964,1,261,1,50692031,24308384,26383647,0.0379022657481734
1747351705291552,24510524,1,262,1,50786367,24400944,26385423,0.0378997145507199
1747351705385172,24603084,1,263,1,50879987,24493504,26386483,0.0378981920402199
1747351705479285,24695644,1,264,1,50974100,24586064,26388036,0.0378959616395854
1747351705570264,24788204,1,265,1,51065079,24678624,26386455,0.0378982322559055
1747351705664048,24880764,1,266,1,51158863,24771184,26387679,0.037896474335617
1747351705758166,24973332,1,267,1,51252981,24863752,26389229,0.0378942484450758
1747351705851938,25065884,1,268,1,51346753,24956304,26390449,0.037892496637704
1747351705942418,25158444,1,269,1,51437233,25048864,26388369,0.0378954834230186
1747351706036865,25251004,1,270,1,51531680,25141424,26390256,0.0378927737571018
1747351706131349,25343564,1,271,1,51626164,25233984,26392180,0.0378900113594254
1747351706225113,25436124,1,272,1,51719928,25326544,26393384,0.0378882829121116
1747351706315276,25528684,1,273,1,51810091,25419104,26390987,0.0378917241708315
1747351706409043,25621244,1,274,1,51903858,25511664,26392194,0.0378899912602946
1747351706503393,25713804,1,275,1,51998208,25604224,26393984,0.0378874216185021
1747351706598161,25806364,1,276,1,52092976,25696784,26396192,0.0378842523951939
1747351706688358,25898924,1,277,1,52183173,25789344,26393829,0.0378876441155999
1747351706782161,25991484,1,278,1,52276976,25881904,26395072,0.0378858599059703
1747351706876178,26084044,1,279,1,52370993,25974464,26396529,0.0378837687333815
1747351706970757,26176604,1,280,1,52465572,26067024,26398548,0.0378808713267108
1747351707063729,26269164,1,281,1,52558544,26159584,26398960,0.0378802801322476
1747351707155054,26361724,1,282,1,52649869,26252144,26397725,0.0378820523359494
1747351707249008,26454284,1,283,1,52743823,26344704,26399119,0.0378800519820377
1747351707343323,26546844,1,284,1,52838138,26437264,26400874,0.0378775339028548
1747351707437381,26639404,1,285,1,52932196,26529824,26402372,0.0378753848328475
1747351707528066,26731964,1,286,1,53022881,26622384,26400497,0.0378780747953343
1747351707621168,26824524,1,287,1,53115983,26714944,26401039,0.0378772971775845
1747351707716175,26917084,1,288,1,53210990,26807504,26403486,0.0378737868173922
1747351707810424,27009644,1,289,1,53305239,26900064,26405175,0.0378713642306858
1747351707900497,27102204,1,290,1,53395312,26992624,26402688,0.0378749315221238
1747351707993872,27194764,1,291,1,53488687,27085184,26403503,0.0378737624322045
1747351708088973,27287324,1,292,1,53583788,27177744,26406044,0.0378701179169435
1747351708182255,27379884,1,293,1,53677070,27270304,26406766,0.0378690824919643
1747351708273268,27472444,1,294,1,53768083,27362864,26405219,0.0378713011242209
1747351708367287,27565004,1,295,1,53862102,27455424,26406678,0.0378692086903168
1747351708460905,27657564,1,296,1,53955720,27547984,26407736,0.0378676914976732
1747351708555903,27750124,1,297,1,54050718,27640544,26410174,0.0378641958208984
1747351708649740,27842684,1,298,1,54144555,27733104,26411451,0.0378623650779353
1747351708739824,27935244,1,299,1,54234639,27825664,26408975,0.0378659149020361
1747351708833830,28027804,1,300,1,54328645,27918224,26410421,0.0378638417009709
1747351708927801,28120364,1,301,1,54422616,28010784,26411832,0.0378618188999536
1747351709021968,28212924,1,302,1,54516783,28103344,26413439,0.037859515377759
1747351709113019,28305484,1,303,1,54607834,28195904,26411930,0.0378616784157765
1747351709206825,28398044,1,304,1,54701640,28288464,26413176,0.0378598923506964
1747351709300360,28490604,1,305,1,54795175,28381024,26414151,0.0378584948651198
1747351709395445,28583164,1,306,1,54890260,28473584,26416676,0.0378548762153118
1747351709484971,28675724,1,307,1,54979786,28566144,26413642,0.0378592244113856
1747351709579077,28768292,1,308,1,55073892,28658712,26415180,0.0378570200922348
1747351709673862,28860844,1,309,1,55168677,28751264,26417413,0.0378538201299271
1747351709767983,28953404,1,310,1,55262798,28843824,26418974,0.0378515834869287
1747351709858277,29045964,1,311,1,55353092,28936384,26416708,0.0378548303596345
1747351709952660,29138524,1,312,1,55447475,29028944,26418531,0.0378522182024428
1747351710046810,29231084,1,313,1,55541625,29121504,26420121,0.0378499402027719
1747351710139874,29323644,1,314,1,55634689,29214064,26420625,0.037849218177087
1747351710235118,29416204,1,315,1,55729933,29306624,26423309,0.0378453735677087
1747351710325051,29508764,1,316,1,55819866,29399184,26420682,0.0378491365211541
1747351710418547,29601324,1,317,1,55913362,29491744,26421618,0.0378477956951765
1747351710513175,29693884,1,318,1,56007990,29584304,26423686,0.0378448336087554
1747351710607496,29786444,1,319,1,56102311,29676864,26425447,0.0378423116172831
1747351710698022,29879004,1,320,1,56192837,29769424,26423413,0.0378452246119757
1747351710791393,29971564,1,321,1,56286208,29861984,26424224,0.0378440630839338
1747351710886220,30064124,1,322,1,56381035,29954544,26426491,0.0378408166260136
1747351710980694,30156684,1,323,1,56475509,30047104,26428405,0.0378380761154522
1747351711070948,30249244,1,324,1,56565763,30139664,26426099,0.037841377949882
1747351711164156,30341804,1,325,1,56658971,30232224,26426747,0.0378404500561495
1747351711258205,30434364,1,326,1,56753020,30324784,26428236,0.0378383180776802
1747351711352649,30526924,1,327,1,56847464,30417344,26430120,0.0378356208749714
1747351711443228,30619484,1,328,1,56938043,30509904,26428139,0.0378384569568065
1747351711537361,30712044,1,329,1,57032176,30602464,26429712,0.0378362049499442
1747351711631812,30804604,1,330,1,57126627,30695024,26431603,0.0378334980288558
1747351711725401,30897172,1,331,1,57220216,30787592,26432624,0.0378320366528877
1747351711819854,30989724,1,332,1,57314669,30880144,26434525,0.0378293160175944
1747351711910410,31082284,1,333,1,57405225,30972704,26432521,0.0378321840735509
1747351712004288,31174844,1,334,1,57499103,31065264,26433839,0.0378302977482763
1747351712098774,31267404,1,335,1,57593589,31157824,26435765,0.0378275415899634
1747351712192104,31359964,1,336,1,57686919,31250384,26436535,0.03782643981142
1747351712283145,31452524,1,337,1,57777960,31342944,26435016,0.0378286133815844
1747351712377017,31545084,1,338,1,57871832,31435504,26436328,0.0378267359975258
1747351712470879,31637644,1,339,1,57965694,31528064,26437630,0.0378248731070069
1747351712565033,31730204,1,340,1,58059848,31620624,26439224,0.0378225926751859
1747351712655537,31822764,1,341,1,58150352,31713184,26437168,0.0378255341116718
1747351712750025,31915324,1,342,1,58244840,31805744,26439096,0.0378227757862825
1747351712843949,32007884,1,343,1,58338764,31898304,26440460,0.0378208245998745
1747351712938140,32100444,1,344,1,58432955,31990864,26442091,0.0378184917372835
1747351713028273,32193004,1,345,1,58523088,32083424,26439664,0.0378219632443135
1747351713122494,32285564,1,346,1,58617309,32175984,26441325,0.0378195873315728
1747351713216950,32378124,1,347,1,58711765,32268544,26443221,0.0378168756370489
1747351713310884,32470684,1,348,1,58805699,32361104,26444595,0.0378149107596467
1747351713404845,32563244,1,349,1,58899660,32453664,26445996,0.0378129074813442
1747351713494963,32655804,1,350,1,58989778,32546224,26443554,0.0378163994143903
1747351713589948,32748364,1,351,1,59084763,32638784,26445979,0.0378129317882314
1747351713683122,32840924,1,352,1,59177937,32731344,26446593,0.0378120539004778
1747351713777421,32933484,1,353,1,59272236,32823904,26448332,0.0378095677262369
1747351713868035,33026044,1,354,1,59362850,32916464,26446386,0.0378123498613383
1747351713961565,33118604,1,355,1,59456380,33009024,26447356,0.0378109630316164
1747351714056298,33211164,1,356,1,59551113,33101584,26449529,0.0378078566162747
1747351714150121,33303724,1,357,1,59644936,33194144,26450792,0.0378060513273099
1747351714240774,33396284,1,358,1,59735589,33286704,26448885,0.0378087771941993
1747351714334204,33488844,1,359,1,59829019,33379264,26449755,0.037807533566946
1747351714428340,33581404,1,360,1,59923155,33471824,26451331,0.0378052809516466
1747351714522179,33673964,1,361,1,60016994,33564384,26452610,0.0378034530430078
1747351714617601,33766524,1,362,1,60112416,33656944,26455472,0.0377993633982413
1747351714707504,33859084,1,363,1,60202319,33749504,26452815,0.0378031600795605
1747351714801274,33951644,1,364,1,60296089,33842064,26454025,0.0378014309731694
1747351714895377,34044204,1,365,1,60390192,33934624,26455568,0.0377992262347192
1747351714989938,34136764,1,366,1,60484753,34027184,26457569,0.0377963674591569
1747351715079962,34229324,1,367,1,60574777,34119744,26455033,0.0377999906482823
1747351715174063,34321884,1,368,1,60668878,34212304,26456574,0.0377977889351811
1747351715268325,34414444,1,369,1,60763140,34304864,26458276,0.0377953574904124
1747351715362664,34507004,1,370,1,60857479,34397424,26460055,0.0377928163792554
1747351715453139,34599564,1,371,1,60947954,34489984,26457970,0.0377957946131165
1747351715547072,34692132,1,372,1,61041887,34582552,26459335,0.0377938447810574
1747351715641467,34784684,1,373,1,61136282,34675104,26461178,0.0377912124698303
1747351715735238,34877244,1,374,1,61230053,34767664,26462389,0.0377894830281574
1747351715825306,34969804,1,375,1,61320121,34860224,26459897,0.0377930420515242
1747351715919907,35062364,1,376,1,61414722,34952784,26461938,0.0377901270874415
1747351716013409,35154924,1,377,1,61508224,35045344,26462880,0.0377887818710586
1747351716107993,35247484,1,378,1,61602808,35137904,26464904,0.037785891836222
1747351716201901,35340044,1,379,1,61696716,35230464,26466252,0.0377839672954069
1747351716292704,35432604,1,380,1,61787519,35323024,26464495,0.0377864758046582
1747351716386504,35525164,1,381,1,61881319,35415584,26465735,0.0377847053935966
1747351716480209,35617724,1,382,1,61975024,35508144,26466880,0.0377830707661802
1747351716575209,35710284,1,383,1,62070024,35600704,26469320,0.0377795878398085
1747351716664863,35802844,1,384,1,62159678,35693264,26466414,0.0377837360210567
1747351716759152,35895404,1,385,1,62253967,35785824,26468143,0.0377812678433844
1747351716857659,35991084,1,386,1,62352474,35881504,26470970,0.0377772329461292
1747351716951795,36086764,1,387,1,62446610,35977184,26469426,0.0377794365469051
1747351717050458,36182444,1,388,1,62545273,36072864,26472409,0.0377751794330466
1747351717144257,36278124,1,389,1,62639072,36168544,26470528,0.0377778637434054
1747351717238333,36370684,1,390,1,62733148,36261104,26472044,0.0377757002821542
1747351717332363,36463244,1,391,1,62827178,36353664,26473514,0.0377736027034416
1747351717426650,36555812,1,392,1,62921465,36446232,26475233,0.0377711501160348
1747351717516996,36648364,1,393,1,63011811,36538784,26473027,0.0377742975897693
1747351717611441,36740924,1,394,1,63106256,36631344,26474912,0.0377716080793771
1747351717705542,36833484,1,395,1,63200357,36723904,26476453,0.037769409671303
1747351717799611,36926044,1,396,1,63294426,36816464,26477962,0.037767257162768
1747351717890071,37018604,1,397,1,63384886,36909024,26475862,0.0377702527683517
1747351717983672,37111164,1,398,1,63478487,37001584,26476903,0.0377687677444752
1747351718078545,37203724,1,399,1,63573360,37094144,26479216,0.0377654685848704
1747351718172252,37296284,1,400,1,63667067,37186704,26480363,0.0377638327692109
1747351718262667,37388844,1,401,1,63757482,37279264,26478218,0.0377668920166757
1747351718356577,37481404,1,402,1,63851392,37371824,26479568,0.0377649665583668
1747351718450723,37573964,1,403,1,63945538,37464384,26481154,0.0377627047522173
1747351718545299,37666524,1,404,1,64040114,37556944,26483170,0.0377598301109723
1747351718634691,37759084,1,405,1,64129506,37649504,26480002,0.03776434760088
1747351718728984,37851644,1,406,1,64223799,37742064,26481735,0.0377618762516881
1747351718823687,37944204,1,407,1,64318502,37834624,26483878,0.0377588206681816
1747351718917857,38036764,1,408,1,64412672,37927184,26485488,0.0377565253847692
1747351719011425,38129324,1,409,1,64506240,38019744,26486496,0.0377550884798049
1747351719101947,38221884,1,410,1,64596762,38112304,26484458,0.0377579937637387
1747351719196509,38314444,1,411,1,64691324,38204864,26486460,0.0377551397959561
1747351719290585,38407004,1,412,1,64785400,38297424,26487976,0.0377529789365559
1747351719384520,38499564,1,413,1,64879335,38389984,26489351,0.0377510192680824
1747351719474609,38592124,1,414,1,64969424,38482544,26486880,0.0377545411162054
1747351719569028,38684692,1,415,1,65063843,38575112,26488731,0.0377519028752264
1747351719663435,38777244,1,416,1,65158250,38667664,26490586,0.0377492593029085
1747351719757521,38869804,1,417,1,65252336,38760224,26492112,0.0377470848681298
1747351719847522,38962364,1,418,1,65342337,38852784,26489553,0.0377507313921076
1747351719941831,39054924,1,419,1,65436646,38945344,26491302,0.0377482390257753
1747351720035360,39147484,1,420,1,65530175,39037904,26492271,0.0377468583195453
1747351720129553,39240044,1,421,1,65624368,39130464,26493904,0.037744531723222
1747351720220522,39332604,1,422,1,65715337,39223024,26492313,0.037746798476977
1747351720314537,39425164,1,423,1,65809352,39315584,26493768,0.0377447254765724
1747351720408655,39517724,1,424,1,65903470,39408144,26495326,0.0377425059801113
1747351720502843,39610284,1,425,1,65997658,39500704,26496954,0.0377401870418765
1747351720596908,39702844,1,426,1,66091723,39593264,26498459,0.0377380435594386
1747351720686960,39795404,1,427,1,66181775,39685824,26495951,0.0377416156906389
1747351720781348,39887964,1,428,1,66276163,39778384,26497779,0.0377390120130445
1747351720875229,39980524,1,429,1,66370044,39870944,26499100,0.0377371306950047
1747351720969458,40073084,1,430,1,66464273,39963504,26500769,0.0377347540367602
1747351721059427,40165644,1,431,1,66554242,40056064,26498178,0.0377384437526232
1747351721153570,40258204,1,432,1,66648385,40148624,26499761,0.0377361893943119
1747351721248427,40350764,1,433,1,66743242,40241184,26502058,0.0377329187038983
1747351721342263,40443324,1,434,1,66837078,40333744,26503334,0.0377311020568204
1747351721432842,40535884,1,435,1,66927657,40426304,26501353,0.0377339224906743
1747351721527102,40628444,1,436,1,67021917,40518864,26503053,0.0377315021027954
1747351721621102,40721004,1,437,1,67115917,40611424,26504493,0.0377294521347757
1747351721714773,40813564,1,438,1,67209588,40703984,26505604,0.0377278706797249
1747351721805375,40906124,1,439,1,67300190,40796544,26503646,0.0377306578875978
1747351721899581,40998684,1,440,1,67394396,40889104,26505292,0.037728314783327
1747351721993812,41091244,1,441,1,67488627,40981664,26506963,0.037725936388865
1747351722087314,41183804,1,442,1,67582129,41074224,26507905,0.0377245957385164
1747351722181822,41276364,1,443,1,67676637,41166784,26509853,0.0377218236555291
1747351722272428,41368924,1,444,1,67767243,41259344,26507899,0.0377246042773891
1747351722365790,41461484,1,445,1,67860605,41351904,26508701,0.0377234629490143
1747351722460935,41554044,1,446,1,67955750,41444464,26511286,0.0377197846984865
1747351722554329,41646604,1,447,1,68049144,41537024,26512120,0.0377185981354942
1747351722645258,41739164,1,448,1,68140073,41629584,26510489,0.037720918689957
1747351722738786,41831724,1,449,1,68233601,41722144,26511457,0.0377195414043068
1747351722833299,41924284,1,450,1,68328114,41814704,26513410,0.0377167629512763
1747351722926976,42016844,1,451,1,68421791,41907264,26514527,0.0377151740251674
1747351723017393,42109404,1,452,1,68512208,41999824,26512384,0.0377182225483758
1747351723111915,42201964,1,453,1,68606730,42092384,26514346,0.0377154314875426
1747351723206275,42294524,1,454,1,68701090,42184944,26516146,0.0377128712445617
1747351723300511,42387084,1,455,1,68795326,42277504,26517822,0.0377104876863567
1747351723390647,42479652,1,456,1,68885462,42370072,26515390,0.0377139465042754
1747351723484265,42572204,1,457,1,68979080,42462624,26516456,0.0377124303489123
1747351723579054,42664764,1,458,1,69073869,42555184,26518685,0.0377092604704946
1747351723673222,42757324,1,459,1,69168037,42647744,26520293,0.0377069740519081
1747351723766749,42849884,1,460,1,69261564,42740304,26521260,0.0377055992060709
1747351723856435,42942444,1,461,1,69351250,42832864,26518386,0.0377096856497978
1747351723951491,43035004,1,462,1,69446306,42925424,26520882,0.0377061366209464
1747351724045804,43127564,1,463,1,69540619,43017984,26522635,0.0377036444531246
1747351724139389,43220124,1,464,1,69634204,43110544,26523660,0.0377021874055088
1747351724229610,43312684,1,465,1,69724425,43203104,26521321,0.0377055124818254
1747351724324216,43405244,1,466,1,69819031,43295664,26523367,0.0377026038964057
1747351724418569,43497804,1,467,1,69913384,43388224,26525160,0.0377000553436812
1747351724512512,43590364,1,468,1,70007327,43480784,26526543,0.0376980897963221
1747351724602709,43682924,1,469,1,70097524,43573344,26524180,0.0377014482634335
1747351724697047,43775484,1,470,1,70191862,43665904,26525958,0.037698921185052
1747351724790683,43868044,1,471,1,70285498,43758464,26527034,0.0376973920265642
1747351724884833,43960604,1,472,1,70379648,43851024,26528624,0.037695132623539
1747351724974990,44053164,1,473,1,70469805,43943584,26526221,0.0376985474108807
1747351725069917,44145724,1,474,1,70564732,44036144,26528588,0.0376951837768372
1747351725164014,44238284,1,475,1,70658829,44128704,26530125,0.0376929999387488
1747351725257930,44330844,1,476,1,70752745,44221264,26531481,0.0376910734836099
1747351725352223,44423404,1,477,1,70847038,44313824,26533214,0.0376886117151129
1747351725442698,44515964,1,478,1,70937513,44406384,26531129,0.0376915735474355
1747351725536329,44608532,1,479,1,71031144,44498952,26532192,0.0376900634519756
1747351725630254,44701084,1,480,1,71125069,44591504,26533565,0.0376881131502683
1747351725724708,44793644,1,481,1,71219523,44684064,26535459,0.0376854231162913
1747351725814636,44886204,1,482,1,71309451,44776624,26532827,0.0376891614301031
1747351725908964,44978764,1,483,1,71403779,44869184,26534595,0.0376866502013691
1747351726003592,45071324,1,484,1,71498407,44961744,26536663,0.0376837132837689
1747351726097618,45163884,1,485,1,71592433,45054304,26538129,0.0376816315875169
1747351726187314,45256444,1,486,1,71682129,45146864,26535265,0.037685698635382
1747351726282409,45349004,1,487,1,71777224,45239424,26537800,0.0376820987421715
1747351726375886,45441564,1,488,1,71870701,45331984,26538717,0.0376807967016642
1747351726470080,45534124,1,489,1,71964895,45424544,26540351,0.0376784768219531
1747351726560335,45626684,1,490,1,72055150,45517104,26538046,0.0376817494400303
1747351727039753,46101964,1,495,1,72534568,45992384,26542184,0.0376758747509247
1747351727133712,46194524,1,496,1,72628527,46084944,26543583,0.037673889014908
1747351727227445,46287084,1,497,1,72722260,46177504,26544756,0.037672224223873
1747351727322276,46379644,1,498,1,72817091,46270064,26547027,0.0376690015043869
1747351727411955,46472212,1,499,1,72906770,46362632,26544138,0.0376731013077162
1747351727506603,46564764,1,500,1,73001418,46455184,26546234,0.037670126768264
1747351727600967,46657324,1,501,1,73095782,46547744,26548038,0.037667566996853
1747351727694676,46749884,1,502,1,73189491,46640304,26549187,0.037665936813809
1747351727789346,46842444,1,503,1,73284161,46732864,26551297,0.0376629435465996
1747351727879227,46935004,1,504,1,73374042,46825424,26548618,0.0376667440843813
1747351727972853,47027564,1,505,1,73467668,46917984,26549684,0.0376652317217786
1747351728066958,47120124,1,506,1,73561773,47010544,26551229,0.0376630400046641
1747351728162084,47212684,1,507,1,73656899,47103104,26553795,0.0376594004736422
1747351728251768,47305244,1,508,1,73746583,47195664,26550919,0.0376634797462189
1747351728346244,47397804,1,509,1,73841059,47288224,26552835,0.0376607620240927
1747351728439841,47490364,1,510,1,73934656,47380784,26553872,0.0376592912702147
1747351728534087,47582924,1,511,1,74028902,47473344,26555558,0.0376569002993648
1747351728624222,47675484,1,512,1,74119037,47565904,26553133,0.0376603393656033
1747351728718552,47768044,1,513,1,74213367,47658464,26554903,0.0376578291398767
1747351728813244,47860604,1,514,1,74308059,47751024,26557035,0.0376548059676089
1747351728907115,47953164,1,515,1,74401930,47843584,26558346,0.0376529472129024
1747351728997603,48045724,1,516,1,74492418,47936144,26556274,0.037655885008567
1747351729091450,48138284,1,517,1,74586265,48028704,26557561,0.0376540601751794
1747351729185910,48230844,1,518,1,74680725,48121264,26559461,0.0376513664942221
1747351729279451,48323404,1,519,1,74774266,48213824,26560442,0.0376499758550704
1747351729373669,48415964,1,520,1,74868484,48306384,26562100,0.0376476257524819
1747351729463847,48508524,1,521,1,74958662,48398944,26559718,0.03765100216802
1747351729558253,48601084,1,522,1,75053068,48491504,26561564,0.0376483854640487
1747351729652737,48693644,1,523,1,75147552,48584064,26563488,0.0376456585821861
1747351729746940,48786204,1,524,1,75241755,48676624,26565131,0.0376433302738089
1747351729836666,48878764,1,525,1,75331481,48769184,26562297,0.0376473465378389
1747351729931090,48971324,1,526,1,75425905,48861744,26564161,0.0376447048337043
1747351730025331,49063884,1,527,1,75520146,48954304,26565842,0.03764232279933
1747351730118770,49156444,1,528,1,75613585,49046864,26566721,0.0376410773463537
1747351730209365,49249004,1,529,1,75704180,49139424,26564756,0.0376438616639279
1747351730304142,49341564,1,530,1,75798957,49231984,26566973,0.0376407203033631
1747351730397384,49434124,1,531,1,75892199,49324544,26567655,0.037639754054319
1747351730492321,49526684,1,532,1,75987136,49417104,26570032,0.0376363867382621
1747351730582570,49619244,1,533,1,76077385,49509664,26567721,0.0376396605489797
1747351730675816,49711804,1,534,1,76170631,49602224,26568407,0.0376386886876582
1747351730771088,49804364,1,535,1,76265903,49694784,26571119,0.0376348470683526
1747351730864401,49896924,1,536,1,76359216,49787344,26571872,0.0376337805631458
1747351730958400,49989484,1,537,1,76453215,49879904,26573311,0.0376317426157395
1747351731049466,50082044,1,538,1,76544281,49972464,26571817,0.0376338584598862
1747351731143109,50174604,1,539,1,76637924,50065024,26572900,0.0376323246615913
1747351731236920,50267172,1,540,1,76731735,50157592,26574143,0.0376305644174489
1747351731331506,50359724,1,541,1,76826321,50250144,26576177,0.0376276843731135
1747351731421564,50452284,1,542,1,76916379,50342704,26573675,0.0376312271449093
1747351731516478,50544844,1,543,1,77011293,50435264,26576029,0.0376278939189899
1747351731610296,50637404,1,544,1,77105111,50527824,26577287,0.03762611285343
1747351731704100,50729964,1,545,1,77198915,50620384,26578531,0.0376243517747463
1747351731794778,50822524,1,546,1,77289593,50712944,26576649,0.0376270161072601
1747351731888890,50915084,1,547,1,77383705,50805504,26578201,0.0376248189258558
1747351731983434,51007644,1,548,1,77478249,50898064,26580185,0.0376220105315294
1747351732077227,51100204,1,549,1,77572042,50990624,26581418,0.0376202654049531
1747351732167086,51192764,1,550,1,77661901,51083184,26578717,0.0376240884765054
1747351732261663,51285324,1,551,1,77756478,51175744,26580734,0.0376212334843725
1747351732356065,51377884,1,552,1,77850880,51268304,26582576,0.037618626577048
1747351732450209,51470444,1,553,1,77945024,51360864,26584160,0.0376163850954854
1747351732544362,51563004,1,554,1,78039177,51453424,26585753,0.0376141311476112
1747351732633829,51655564,1,555,1,78128644,51545984,26582660,0.0376185077038941
1747351732728806,51748124,1,556,1,78223621,51638544,26585077,0.0376150875921856
1747351732822019,51840684,1,557,1,78316834,51731104,26585730,0.0376141636885652
1747351732916355,51933244,1,558,1,78411170,51823664,26587506,0.0376116511266607
1747351733006432,52025804,1,559,1,78501247,51916224,26585023,0.0376151639966608
1747351733101515,52118364,1,560,1,78596330,52008784,26587546,0.0376115945412938
1747351733194903,52210924,1,561,1,78689718,52101344,26588374,0.0376104232624379
1747351733289388,52303484,1,562,1,78784203,52193904,26590299,0.0376077004624882
1747351733379477,52396052,1,563,1,78874292,52286472,26587820,0.0376112069361083
1747351733473477,52488604,1,564,1,78968292,52379024,26589268,0.0376091587026765
1747351733568467,52581164,1,565,1,79063282,52471584,26591698,0.0376057219061377
1747351733662378,52673724,1,566,1,79157193,52564144,26593049,0.0376038114320776
1747351733752015,52766284,1,567,1,79246830,52656704,26590126,0.0376079451447503
1747351733846407,52858844,1,568,1,79341222,52749264,26591958,0.0376053542202495
1747351733941127,52951404,1,569,1,79435942,52841824,26594118,0.0376022998769878
1747351734035287,53043964,1,570,1,79530102,52934384,26595718,0.0376000377203578
1747351734128627,53136524,1,571,1,79623442,53026944,26596498,0.0375989350176854
1747351734218890,53229084,1,572,1,79713705,53119504,26594201,0.0376021825209187
1747351734313621,53321644,1,573,1,79808436,53212064,26596372,0.0375991131421984
1747351734408058,53414204,1,574,1,79902873,53304624,26598249,0.0375964598271111
1747351734501363,53506764,1,575,1,79996178,53397184,26598994,0.0375954068037309
1747351734592364,53599324,1,576,1,80087179,53489744,26597435,0.0375976104462704
1747351734685737,53691884,1,577,1,80180552,53582304,26598248,0.037596461240605
1747351734796476,53784444,1,578,1,80291291,53674864,26616427,0.0375707828853211
1747351734874269,53877004,1,579,1,80369084,53767424,26601660,0.0375916390180161
1747351734965150,53969564,1,580,1,80459965,53859984,26599981,0.0375940118152716
1747351735059151,54062124,1,581,1,80553966,53952544,26601422,0.0375919753462803
1747351735153160,54154684,1,582,1,80647975,54045104,26602871,0.0375899277938836
1747351735246708,54247244,1,583,1,80741523,54137664,26603859,0.0375885317990897
1747351735337837,54339804,1,584,1,80832652,54230224,26602428,0.0375905537644909
1747351735431957,54432364,1,585,1,80926772,54322784,26603988,0.0375883495361672
1747351735526142,54524924,1,586,1,81020957,54415344,26605613,0.037586053739863
1747351735619837,54617484,1,587,1,81114652,54507904,26606748,0.0375844503807831
1747351735714341,54710044,1,588,1,81209156,54600464,26608692,0.0375817045046784
1747351735804301,54802604,1,589,1,81299116,54693024,26606092,0.037585377063268
1747351735898303,54895164,1,590,1,81393118,54785584,26607534,0.0375833401171262
1747351735992028,54987724,1,591,1,81486843,54878144,26608699,0.0375816946179894
1747351736087036,55080284,1,592,1,81581851,54970704,26611147,0.0375782374205816
1747351736176698,55172844,1,593,1,81671513,55063264,26608249,0.0375823302014349
1747351736270962,55265404,1,594,1,81765777,55155824,26609953,0.0375799235722062
1747351736364995,55357964,1,595,1,81859810,55248384,26611426,0.0375778434421364
1747351736459559,55450524,1,596,1,81954374,55340944,26613430,0.0375750138182113
1747351736549568,55543084,1,597,1,82044383,55433504,26610879,0.0375786158736056
1747351736643925,55635644,1,598,1,82138740,55526064,26612676,0.037576078407147
1747351736737565,55728204,1,599,1,82232380,55618624,26613756,0.037574553550427
1747351736832432,55820764,1,600,1,82327247,55711184,26616063,0.0375712967015444
1747351736922043,55913324,1,601,1,82416858,55803744,26613114,0.0375754599781145
1747351737016619,56005884,1,602,1,82511434,55896304,26615130,0.0375726137726924
1747351737110613,56098444,1,603,1,82605428,55988864,26616564,0.0375705895020859
1747351737205192,56191012,1,604,1,82700007,56081432,26618575,0.0375677510911083
1747351737299564,56283564,1,605,1,82794379,56173984,26620395,0.037565182635344
1747351737389201,56376124,1,606,1,82884016,56266544,26617472,0.0375693078591385
1747351737483776,56468684,1,607,1,82978591,56359104,26619487,0.0375664639968456
1747351737578121,56561244,1,608,1,83072936,56451664,26621272,0.0375639451037501
1747351737671722,56653804,1,609,1,83166537,56544224,26622313,0.0375624762581673
1747351737761891,56746364,1,610,1,83256706,56636784,26619922,0.0375658501178177
1747351737856270,56838924,1,611,1,83351085,56729344,26621741,0.0375632833329721
1747351737950535,56931484,1,612,1,83445350,56821904,26623446,0.0375608777316054
1747351738044575,57024044,1,613,1,83539390,56914464,26624926,0.0375587898347586
1747351738134733,57116604,1,614,1,83629548,57007024,26622524,0.0375621785522665
1747351738228989,57209164,1,615,1,83723804,57099584,26624220,0.0375597857890296
1747351738322559,57301724,1,616,1,83817374,57192144,26625230,0.037558360998196
1747351738417289,57394284,1,617,1,83912104,57284704,26627400,0.0375553001795143
1747351738511861,57486844,1,618,1,84006676,57377264,26629412,0.0375524626679702
1747351738601999,57579404,1,619,1,84096814,57469824,26626990,0.0375558784526527
1747351738695689,57671964,1,620,1,84190504,57562384,26628120,0.0375542847185606
1747351738789872,57764524,1,621,1,84284687,57654944,26629743,0.0375519959017253
1747351738884639,57857084,1,622,1,84379454,57747504,26631950,0.0375488839532967
1747351738974323,57949644,1,623,1,84469138,57840064,26629074,0.0375529393173791
1747351739068515,58042204,1,624,1,84563330,57932624,26630706,0.0375506379740739
1747351739162670,58134764,1,625,1,84657485,58025184,26632301,0.0375483890783601
1747351739257038,58227324,1,626,1,84751853,58117744,26634109,0.0375458401856056
1747351739347390,58319892,1,627,1,84842205,58210312,26631893,0.0375489643188338
1747351739441070,58412444,1,628,1,84935885,58302864,26633021,0.0375473739911067
1747351739535649,58505004,1,629,1,85030464,58395424,26635040,0.0375445278099826
1747351739629891,58597564,1,630,1,85124706,58487984,26636722,0.0375421570266791
1747351739719732,58690124,1,631,1,85214547,58580544,26634003,0.0375459896133525
1747351739813968,58782684,1,632,1,85308783,58673104,26635679,0.0375436271025792
1747351739908190,58875244,1,633,1,85403005,58765664,26637341,0.0375412846199626
1747351740002236,58967804,1,634,1,85497051,58858224,26638827,0.0375391904455853
1747351740096342,59060364,1,635,1,85591157,58950784,26640373,0.0375370119630081
1747351740186140,59152924,1,636,1,85680955,59043344,26637611,0.0375409040998458
1747351740281167,59245484,1,637,1,85775982,59135904,26640078,0.0375374276306548
1747351740375422,59338044,1,638,1,85870237,59228464,26641773,0.0375350394284944
1747351740469506,59430604,1,639,1,85964321,59321024,26643297,0.0375328924194329
1747351740559843,59523164,1,640,1,86054658,59413584,26641074,0.0375360242608837
1747351740653710,59615724,1,641,1,86148525,59506144,26642381,0.0375341828494983
1747351740747406,59708284,1,642,1,86242221,59598704,26643517,0.037532582504029
1747351740841539,59800844,1,643,1,86336354,59691264,26645090,0.037530366758003
1747351740932471,59893404,1,644,1,86427286,59783824,26643462,0.0375326599824001
1747351741026581,59985964,1,645,1,86521396,59876384,26645012,0.0375304766235421
1747351741119936,60078524,1,646,1,86614751,59968944,26645807,0.0375293568702948
1747351741214520,60171084,1,647,1,86709335,60061504,26647831,0.0375265063786992
1747351741304562,60263644,1,648,1,86799377,60154064,26645313,0.0375300526587921
1747351741399540,60356204,1,649,1,86894355,60246624,26647731,0.0375266472030958
1747351741492979,60448764,1,650,1,86987794,60339184,26648610,0.0375254093928351
1747351741587063,60541324,1,651,1,87081878,60431744,26650134,0.0375232634852792
1747351741681501,60633884,1,652,1,87176316,60524304,26652012,0.0375206194564222
1747351741771549,60726444,1,653,1,87266364,60616864,26649500,0.037524156175538
1747351741865635,60819004,1,654,1,87360450,60709424,26651026,0.0375220075955049
1747351741960299,60911564,1,655,1,87455114,60801984,26653130,0.0375190456055255
1747351742053988,61004124,1,656,1,87548803,60894544,26654259,0.0375174564034963
1747351742144606,61096684,1,657,1,87639421,60987104,26652317,0.0375201900832861
1747351742238411,61189244,1,658,1,87733226,61079664,26653562,0.0375184374981475
1747351742333254,61281804,1,659,1,87828069,61172224,26655845,0.0375152241468991
1747351742427064,61374364,1,660,1,87921879,61264784,26657095,0.0375134649893396
1747351742517477,61466924,1,661,1,88012292,61357344,26654948,0.0375164866200451
1747351742610751,61559484,1,662,1,88105566,61449904,26655662,0.0375154817014111
1747351742705736,61652044,1,663,1,88200551,61542464,26658087,0.0375120690393125
1747351742800604,61744604,1,664,1,88295419,61635024,26660395,0.0375088216059814
1747351742890670,61837164,1,665,1,88385485,61727584,26657901,0.0375123307720289
1747351742984661,61929724,1,666,1,88479476,61820144,26659332,0.0375103172127493
1747351743078056,62022284,1,667,1,88572871,61912704,26660167,0.0375091423845919
1747351743172498,62114852,1,668,1,88667313,62005272,26662041,0.0375065059722922
1747351743267170,62207404,1,669,1,88761985,62097824,26664161,0.0375035239248667
1747351743357002,62299964,1,670,1,88851817,62190384,26661433,0.0375073612884948
1747351743450949,62392524,1,671,1,88945764,62282944,26662820,0.0375054101554149
1747351743545353,62485084,1,672,1,89040168,62375504,26664664,0.0375028164615162
1747351743639318,62577644,1,673,1,89134133,62468064,26666069,0.0375008404875874
1747351743729062,62670204,1,674,1,89223877,62560624,26663253,0.0375048010833486
1747351743823678,62762764,1,675,1,89318493,62653184,26665309,0.037501909315958
1747351743917525,62855324,1,676,1,89412340,62745744,26666596,0.0375000993752633
1747351744012060,62947884,1,677,1,89506875,62838304,26668571,0.0374973222224767
1747351744102669,63040444,1,678,1,89597484,62930864,26666620,0.0375000656251148
1747351744195838,63133004,1,679,1,89690653,63023424,26667229,0.0374992092354252
1747351744290213,63225564,1,680,1,89785028,63115984,26669044,0.037496657173013
1747351744384312,63318124,1,681,1,89879127,63208544,26670583,0.0374944934649535
1747351744475236,63410684,1,682,1,89970051,63301104,26668947,0.037496793555441
1747351744569119,63503244,1,683,1,90063934,63393664,26670270,0.0374949334971112
1747351744663113,63595804,1,684,1,90157928,63486224,26671704,0.0374929175878676
1747351744757716,63688364,1,685,1,90252531,63578784,26673747,0.0374900459241815
1747351744851745,63780924,1,686,1,90346560,63671344,26675216,0.0374879813531781
1747351744942202,63873484,1,687,1,90437017,63763904,26673113,0.0374909370346085
1747351745036021,63966044,1,688,1,90530836,63856464,26674372,0.0374891675050494
1747351745130016,64058604,1,689,1,90624831,63949024,26675807,0.0374871508104703
1747351745224255,64151164,1,690,1,90719070,64041584,26677486,0.0374847914829755
1747351745314541,64243732,1,691,1,90809356,64134152,26675204,0.0374879982173707
1747351745408871,64336284,1,692,1,90903686,64226704,26676982,0.0374854996715895
1747351745502653,64428844,1,693,1,90997468,64319264,26678204,0.0374837826414401
1747351745596655,64521404,1,694,1,91091470,64411824,26679646,0.037481756691974
1747351745687773,64613964,1,695,1,91182588,64504384,26678204,0.0374837826414401
1747351745780842,64706524,1,696,1,91275657,64596944,26678713,0.0374830674927984
1747351745875857,64799084,1,697,1,91370672,64689504,26681168,0.0374796185834143
1747351745970151,64891644,1,698,1,91464966,64782064,26682902,0.0374771829540879
1747351746060273,64984204,1,699,1,91555088,64874624,26680464,0.037480607533662
1747351746154349,65076764,1,700,1,91649164,64967184,26681980,0.0374784779840176
1747351746248708,65169324,1,701,1,91743523,65059744,26683779,0.0374759512136568
1747351746342277,65261884,1,702,1,91837092,65152304,26684788,0.0374745341802977
1747351746436444,65354444,1,703,1,91931259,65244864,26686395,0.0374722775406719
1747351746526867,65447004,1,704,1,92021682,65337424,26684258,0.0374752784956583
1747351746621194,65539564,1,705,1,92116009,65429984,26686025,0.0374727970913614
1747351746715324,65632124,1,706,1,92210139,65522544,26687595,0.0374705926105368
1747351746809764,65724684,1,707,1,92304579,65615104,26689475,0.037467953191286
1747351746899359,65817244,1,708,1,92394174,65707664,26686510,0.0374721160616356
1747351746993459,65909804,1,709,1,92488274,65800224,26688050,0.037469953780812
1747351747087962,66002364,1,710,1,92582777,65892784,26689993,0.0374672260123859
1747351747181882,66094924,1,711,1,92676697,65985344,26691353,0.0374653169511489
1747351747272647,66187484,1,712,1,92767462,66077904,26689558,0.0374678366723045
1747351747366584,66280044,1,713,1,92861399,66170464,26690935,0.0374659036860267
1747351747460507,66372604,1,714,1,92955322,66263024,26692298,0.0374639905488841
1747351747554677,66465164,1,715,1,93049492,66355584,26693908,0.0374617309687288
1747351747644629,66557724,1,716,1,93139444,66448144,26691300,0.0374653913447452
1747351747739154,66650284,1,717,1,93233969,66540704,26693265,0.0374626333646333
1747351747833004,66742844,1,718,1,93327819,66633264,26694555,0.0374608230030431
1747351747927467,66835404,1,719,1,93422282,66725824,26696458,0.0374581526882704
1747351748021593,66927964,1,720,1,93516408,66818384,26698024,0.0374559555418783
1747351748111834,67020524,1,721,1,93606649,66910944,26695705,0.0374592092623139
1747351748206539,67113084,1,722,1,93701354,67003504,26697850,0.0374561996565266
1747351748300561,67205644,1,723,1,93795376,67096064,26699312,0.0374541486312456
1747351748394390,67298204,1,724,1,93889205,67188624,26700581,0.037452368545838
1747351748484642,67390764,1,725,1,93979457,67281184,26698273,0.0374556062109335
1747351748578633,67483324,1,726,1,94073448,67373744,26699704,0.0374535987365253
1747351748672732,67575884,1,727,1,94167547,67466304,26701243,0.0374514399947597
1747351748766896,67668444,1,728,1,94261711,67558864,26702847,0.0374491903428874
1747351748857583,67761004,1,729,1,94352398,67651424,26700974,0.0374518173007471
1747351748951447,67853564,1,730,1,94446262,67743984,26702278,0.0374499883493086
1747351749045648,67946124,1,731,1,94540463,67836544,26703919,0.0374476869855694
1747351749139808,68038692,1,732,1,94634623,67929112,26705511,0.0374454546104734
1747351749229947,68131244,1,733,1,94724762,68021664,26703098,0.03744883833329
1747351749324300,68223804,1,734,1,94819115,68114224,26704891,0.0374463239711407
1747351749418450,68316364,1,735,1,94913265,68206784,26706481,0.0374440945626644
1747351749512053,68408924,1,736,1,95006868,68299344,26707524,0.037442632270966
1747351749606123,68501484,1,737,1,95100938,68391904,26709034,0.0374405154450737
1747351749697385,68594044,1,738,1,95192200,68484464,26707736,0.0374423350597744
1747351749790878,68686604,1,739,1,95285693,68577024,26708669,0.0374410271062178
1747351749885615,68779164,1,740,1,95380430,68669584,26710846,0.0374379755699239
1747351749979768,68871724,1,741,1,95474583,68762144,26712439,0.0374357429510648
1747351750069316,68964284,1,742,1,95564131,68854704,26709427,0.0374399645488463
1747351750163590,69056844,1,743,1,95658405,68947264,26711141,0.0374375621018959
1747351750258111,69149404,1,744,1,95752926,69039824,26713102,0.0374348138228199
1747351750352495,69241964,1,745,1,95847310,69132384,26714926,0.0374322579070591
1747351750442468,69334524,1,746,1,95937283,69224944,26712339,0.0374358830950745
1747351750536822,69427084,1,747,1,96031637,69317504,26714133,0.0374333690709707
1747351750630734,69519644,1,748,1,96125549,69410064,26715485,0.0374314746672201
1747351750724982,69612204,1,749,1,96219797,69502624,26717173,0.0374291097340276
1747351750814864,69704764,1,750,1,96309679,69595184,26714495,0.037432861822767
1747351750909033,69797324,1,751,1,96403848,69687744,26716104,0.0374306073969468
1747351751003926,69889884,1,752,1,96498741,69780304,26718437,0.0374273390318453
1747351751097432,69982444,1,753,1,96592247,69872864,26719383,0.0374260139165638
1747351751191908,70075004,1,754,1,96686723,69965424,26721299,0.0374233303553094
1747351751281651,70167572,1,755,1,96776466,70057992,26718474,0.0374272872021059
1747351751376475,70260124,1,756,1,96871290,70150544,26720746,0.0374241048509648
1747351751490286,70352684,1,757,1,96985101,70243104,26741997,0.0373943651253868
1747351751564704,70445244,1,758,1,97059519,70335664,26723855,0.0374197510052348
1747351751655013,70537804,1,759,1,97149828,70428224,26721604,0.0374229032059602
1747351751748303,70630364,1,760,1,97243118,70520784,26722334,0.037421880888099
1747351751842558,70722924,1,761,1,97337373,70613344,26724029,0.03741950736545
1747351751937446,70815484,1,762,1,97432261,70705904,26726357,0.0374162479383179
1747351752027797,70908044,1,763,1,97522612,70798464,26724148,0.0374193407400677
1747351752121096,71000604,1,764,1,97615911,70891024,26724887,0.0374183060156624
1747351752215859,71093164,1,765,1,97710674,70983584,26727090,0.0374152217843394
1747351752309579,71185724,1,766,1,97804394,71076144,26728250,0.0374135979721829
1747351752404606,71278284,1,767,1,97899421,71168704,26730717,0.0374101450402546
1747351752493923,71370844,1,768,1,97988738,71261264,26727474,0.0374146842309153
1747351752588684,71463404,1,769,1,98083499,71353824,26729675,0.0374116033958512
1747351752682285,71555964,1,770,1,98177100,71446384,26730716,0.0374101464397736
1747351752776971,71648524,1,771,1,98271786,71538944,26732842,0.0374071712988839
1747351752867231,71741084,1,772,1,98362046,71631504,26730542,0.0374103899576746
1747351752961168,71833644,1,773,1,98455983,71724064,26731919,0.0374084628941154
1747351753054685,71926204,1,774,1,98549500,71816624,26732876,0.0374071237228646
1747351753149453,72018764,1,775,1,98644268,71909184,26735084,0.0374040343392973
1747351753239446,72111324,1,776,1,98734261,72001744,26732517,0.0374076260757638
1747351753333701,72203884,1,777,1,98828516,72094304,26734212,0.0374052543609663
1747351753428352,72296444,1,778,1,98923167,72186864,26736303,0.0374023289607392
1747351753522436,72389004,1,779,1,99017251,72279424,26737827,0.0374001971065187
1747351753611986,72481564,1,780,1,99106801,72371984,26734817,0.0374044078925245
1747351753706679,72574124,1,781,1,99201494,72464544,26736950,0.0374014238722068
1747351753800653,72666684,1,782,1,99295468,72557104,26738364,0.037399445979567
1747351753894963,72759244,1,783,1,99389778,72649664,26740114,0.0373969983822806
1747351753989301,72851804,1,784,1,99484116,72742224,26741892,0.0373945119515103
1747351754079493,72944364,1,785,1,99574308,72834784,26739524,0.0373978235364249
1747351754173560,73036924,1,786,1,99668375,72927344,26741031,0.0373957159692159
1747351754267360,73129484,1,787,1,99762175,73019904,26742271,0.0373939819845517
1747351754361789,73222044,1,788,1,99856604,73112464,26744140,0.0373913687260087
1747351754451989,73314604,1,789,1,99946804,73205024,26741780,0.037394668567313
1747351754546568,73407164,1,790,1,100041383,73297584,26743799,0.0373918454891169
1747351754640170,73499724,1,791,1,100134985,73390144,26744841,0.0373903886734641
1747351754734143,73592284,1,792,1,100228958,73482704,26746254,0.0373884133456595
1747351754824327,73684844,1,793,1,100319142,73575264,26743878,0.0373917350355845
1747351754918525,73777404,1,794,1,100413340,73667824,26745516,0.0373894450194941
1747351755012958,73869964,1,795,1,100507773,73760384,26747389,0.0373868268039172
1747351755106980,73962532,1,796,1,100601795,73852952,26748843,0.0373847945498053
1747351755197341,74055084,1,797,1,100692156,73945504,26746652,0.0373878569923443
1747351755291435,74147644,1,798,1,100786250,74038064,26748186,0.0373857128105808
1747351755385527,74240204,1,799,1,100880342,74130624,26749718,0.0373835716698022
1747351755480085,74332764,1,800,1,100974900,74223184,26751716,0.0373807796105491
1747351755574190,74425324,1,801,1,101069005,74315744,26753261,0.0373786208716761
1747351755664165,74517884,1,802,1,101158980,74408304,26750676,0.0373822328826381
1747351755758699,74610444,1,803,1,101253514,74500864,26752650,0.0373794745567261
1747351755852552,74703004,1,804,1,101347367,74593424,26753943,0.0373776680319607
1747351755947079,74795564,1,805,1,101441894,74685984,26755910,0.0373749201578268
1747351756037017,74888124,1,806,1,101531832,74778544,26753288,0.0373785831483591
1747351756130929,74980684,1,807,1,101625744,74871104,26754640,0.0373766942855519
1747351756225675,75073244,1,808,1,101720490,74963664,26756826,0.0373736406552855
1747351756319693,75165804,1,809,1,101814508,75056224,26758284,0.0373716042478658
1747351756410224,75258364,1,810,1,101905039,75148784,26756255,0.0373744382388342
1747351756503910,75350924,1,811,1,101998725,75241344,26757381,0.0373728654534612
1747351756597656,75443484,1,812,1,102092471,75333904,26758567,0.0373712090038304
1747351756692268,75536044,1,813,1,102187083,75426464,26760619,0.0373683433854799
1747351756782735,75628604,1,814,1,102277550,75519024,26758526,0.0373712662648159
1747351756876158,75721164,1,815,1,102370973,75611584,26759389,0.0373700610279255
1747351756970462,75813724,1,816,1,102465277,75704144,26761133,0.0373676256532187
1747351757065102,75906284,1,817,1,102559917,75796704,26763213,0.0373647214928939
1747351757159484,75998844,1,818,1,102654299,75889264,26765035,0.0373621779310208
1747351757249386,76091412,1,819,1,102744201,75981832,26762369,0.0373658998573706
1747351757343881,76183964,1,820,1,102838696,76074384,26764312,0.0373631872173661
1747351757438106,76276524,1,821,1,102932921,76166944,26765977,0.0373608630090356
1747351757532104,76369084,1,822,1,103026919,76259504,26767415,0.0373588559074531
1747351757622271,76461644,1,823,1,103117086,76352064,26765022,0.03736219607815
1747351757716349,76554204,1,824,1,103211164,76444624,26766540,0.0373600771709754
1747351757810509,76646764,1,825,1,103305324,76537184,26768140,0.0373578440638759
1747351757904392,76739324,1,826,1,103399207,76629744,26769463,0.0373559977650653
1747351757994510,76831884,1,827,1,103489325,76722304,26767021,0.0373594058150886
1747351758088600,76924444,1,828,1,103583415,76814864,26768551,0.0373572704775839
1747351758183409,77017004,1,829,1,103678224,76907424,26770800,0.0373541321140944
1747351758276852,77109564,1,830,1,103771667,76999984,26771683,0.0373529000772943
1747351758368032,77202124,1,831,1,103862847,77092544,26770303,0.0373548256065685
1747351758461799,77294684,1,832,1,103956614,77185104,26771510,0.0373531414552261
1747351758555759,77387244,1,833,1,104050574,77277664,26772910,0.0373511881973233
1747351758649606,77479804,1,834,1,104144421,77370224,26774197,0.0373493927754397
1747351758743881,77572364,1,835,1,104238696,77462784,26775912,0.037347000542876
1747351758834408,77664924,1,836,1,104329223,77555344,26773879,0.0373498363834392
1747351758928768,77757484,1,837,1,104423583,77647904,26775679,0.0373473255337427
1747351759022633,77850044,1,838,1,104517448,77740464,26776984,0.0373455053787984
1747351759117169,77942604,1,839,1,104611984,77833024,26778960,0.0373427496810929
1747351759206812,78035164,1,840,1,104701627,77925584,26776043,0.037346817825173
1747351759301435,78127724,1,841,1,104796250,78018144,26778106,0.0373439406058068
1747351759395452,78220284,1,842,1,104890267,78110704,26779563,0.0373419088280118
1747351759489474,78312844,1,843,1,104984289,78203264,26781025,0.0373398702999605
1747351759580078,78405404,1,844,1,105074893,78295824,26779069,0.0373425976832876
1747351759673859,78497964,1,845,1,105168674,78388384,26780290,0.0373408951135331
1747351759767879,78590524,1,846,1,105262694,78480944,26781750,0.037338859484537
1747351759861957,78683084,1,847,1,105356772,78573504,26783268,0.0373367432234184
1747351759952777,78775644,1,848,1,105447592,78666064,26781528,0.0373391689973775
1747351760046657,78868204,1,849,1,105541472,78758624,26782848,0.0373373287262056
1747351760140154,78960764,1,850,1,105634969,78851184,26783785,0.0373360225225822
1747351760235059,79053324,1,851,1,105729874,78943744,26786130,0.0373327539289923
1747351760329517,79145884,1,852,1,105824332,79036304,26788028,0.0373301088083079
1747351760419262,79238444,1,853,1,105914077,79128864,26785213,0.037334032027298
1747351760513726,79331004,1,854,1,106008541,79221424,26787117,0.0373313783637111
1747351760607489,79423564,1,855,1,106102304,79313984,26788320,0.0373297018999325
1747351760701505,79516124,1,856,1,106196320,79406544,26789776,0.0373276730645302
1747351760792544,79608684,1,857,1,106287359,79499104,26788255,0.0373297924780841
1747351760886402,79701244,1,858,1,106381217,79591664,26789553,0.037327983785321
1747351760980652,79793804,1,859,1,106475467,79684224,26791243,0.037325629124412
1747351761074468,79886372,1,860,1,106569283,79776792,26792491,0.0373238904885701
1747351761164903,79978924,1,861,1,106659718,79869344,26790374,0.0373268398567336
1747351761259277,80071484,1,862,1,106754092,79961904,26792188,0.0373243125944025
1747351761353059,80164044,1,863,1,106847874,80054464,26793410,0.0373226102985771
1747351761447220,80256604,1,864,1,106942035,80147024,26795011,0.0373203802752684
1747351761537279,80349164,1,865,1,107032094,80239584,26792510,0.0373238640202056
1747351761631378,80441724,1,866,1,107126193,80332144,26794049,0.037321720207349
1747351761726359,80534284,1,867,1,107221174,80424704,26796470,0.037318348274978
1747351761819965,80626844,1,868,1,107314780,80517264,26797516,0.0373168916104015
1747351761914211,80719404,1,869,1,107409026,80609824,26799202,0.037314543918136
1747351762004209,80811964,1,870,1,107499024,80702384,26796640,0.0373181115244299
1747351762098226,80904524,1,871,1,107593041,80794944,26798097,0.0373160825561606
1747351762192944,80997084,1,872,1,107687759,80887504,26800255,0.0373130778046701
1747351762286490,81089644,1,873,1,107781305,80980064,26801241,0.0373117050811191
1747351762376889,81182204,1,874,1,107871704,81072624,26799080,0.0373147137886823
1747351762472494,81274764,1,875,1,107967309,81165184,26802125,0.0373104744493207
1747351762565219,81367324,1,876,1,108060034,81257744,26802290,0.0373102447589366
1747351762659253,81459884,1,877,1,108154068,81350304,26803764,0.0373081929836421
1747351762749896,81552444,1,878,1,108244711,81442864,26801847,0.0373108614492128
1747351762843531,81645004,1,879,1,108338346,81535424,26802922,0.0373093650013233
1747351762938134,81737564,1,880,1,108432949,81627984,26804965,0.0373065213851239
1747351763032454,81830124,1,881,1,108527269,81720544,26806725,0.0373040720192414
1747351763122376,81922684,1,882,1,108617191,81813104,26804087,0.0373077434049516
1747351763217147,82015252,1,883,1,108711962,81905672,26806290,0.0373046773723629
1747351763310344,82107804,1,884,1,108805159,81998224,26806935,0.037303779786835
1747351763404845,82200364,1,885,1,108899660,82090784,26808876,0.0373010789411685
1747351763499098,82292924,1,886,1,108993913,82183344,26810569,0.0372987234996765
1747351763589240,82385484,1,887,1,109084055,82275904,26808151,0.0373020877120544
1747351763684138,82478044,1,888,1,109178953,82368464,26810489,0.0372988347955906
1747351763777323,82570604,1,889,1,109272138,82461024,26811114,0.0372979653139366
1747351763872084,82663164,1,890,1,109366899,82553584,26813315,0.0372949036700609
1747351763962326,82755724,1,891,1,109457141,82646144,26810997,0.0372981280778182
1747351764056338,82848284,1,892,1,109551153,82738704,26812449,0.0372961082368865
1747351764150611,82940844,1,893,1,109645426,82831264,26814162,0.0372937256066402
1747351764244616,83033404,1,894,1,109739431,82923824,26815607,0.0372917159771919
1747351764335271,83125964,1,895,1,109830086,83016384,26813702,0.0372943653957219
1747351764429010,83218524,1,896,1,109923825,83108944,26814881,0.0372927256324575
1747351764522931,83311084,1,897,1,110017746,83201504,26816242,0.0372908329213317
1747351764617591,83403644,1,898,1,110112406,83294064,26818342,0.0372879128769407
1747351764712068,83496204,1,899,1,110206883,83386624,26820259,0.0372852476927981
1747351764802057,83588764,1,900,1,110296872,83479184,26817688,0.0372888222131602
1747351764896468,83681324,1,901,1,110391283,83571744,26819539,0.0372862486562502
1747351764989856,83773884,1,902,1,110484671,83664304,26820367,0.0372850975529156
1747351765084065,83866444,1,903,1,110578880,83756864,26822016,0.0372828052895054
1747351765174960,83959004,1,904,1,110669775,83849424,26820351,0.0372851197957849
1747351765268957,84051564,1,905,1,110763772,83941984,26821788,0.0372831222139254
1747351765363049,84144124,1,906,1,110857864,84034544,26823320,0.0372809928077508
1747351765456814,84236684,1,907,1,110951629,84127104,26824525,0.0372793180867135
1747351765547293,84329244,1,908,1,111042108,84219664,26822444,0.0372822103757584
1747351765641639,84421804,1,909,1,111136454,84312224,26824230,0.0372797280667515
1747351765735395,84514364,1,910,1,111230210,84404784,26825426,0.0372780659662217
1747351765829882,84606924,1,911,1,111324697,84497344,26827353,0.0372753882949242
1747351765919670,84699484,1,912,1,111414485,84589904,26824581,0.0372792402610128
1747351766014685,84792044,1,913,1,111509500,84682464,26827036,0.0372758287572283
1747351766108785,84884604,1,914,1,111603600,84775024,26828576,0.0372736890694459
1747351766202181,84977164,1,915,1,111696996,84867584,26829412,0.0372725276275156
1747351766296223,85069724,1,916,1,111791038,84960144,26830894,0.0372704688856062
1747351766387318,85162284,1,917,1,111882133,85052704,26829429,0.0372725040104282
1747351766480752,85254844,1,918,1,111975567,85145264,26830303,0.0372712898546095
1747351766575369,85347404,1,919,1,112070184,85237824,26832360,0.0372684325940767
1747351766669428,85439964,1,920,1,112164243,85330384,26833859,0.0372663506952168
1747351766759513,85532524,1,921,1,112254328,85422944,26831384,0.0372697882449895
1747351766853659,85625084,1,922,1,112348474,85515504,26832970,0.0372675853623359
1747351766948283,85717644,1,923,1,112443098,85608064,26835034,0.037264718949117
1747351767042191,85810212,1,924,1,112537006,85700632,26836374,0.0372628582385981
1747351767132630,85902764,1,925,1,112627445,85793184,26834261,0.037265792413661
1747351767226191,85995324,1,926,1,112721006,85885744,26835262,0.0372644023374916
1747351767321005,86087884,1,927,1,112815820,85978304,26837516,0.0372612726155431
1747351767414796,86180444,1,928,1,112909611,86070864,26838747,0.0372595635705347
1747351767505322,86273004,1,929,1,113000137,86163424,26836713,0.0372623875360592
1747351767599103,86365564,1,930,1,113093918,86255984,26837934,0.0372606922723634
1747351767693100,86458124,1,931,1,113187915,86348544,26839371,0.037258697307027
1747351767787588,86550684,1,932,1,113282403,86441104,26841299,0.0372560210293846
1747351767882019,86643244,1,933,1,113376834,86533664,26843170,0.0372534242416227
1747351767972279,86735804,1,934,1,113467094,86626224,26840870,0.037256616495665
1747351768066440,86828364,1,935,1,113561255,86718784,26842471,0.0372543943513993
1747351768160549,86920924,1,936,1,113655364,86811344,26844020,0.0372522446340004
1747351768254335,87013484,1,937,1,113749150,86903904,26845246,0.0372505433550506
1747351768344663,87106044,1,938,1,113839478,86996464,26843014,0.0372536407424292
1747351768438636,87198604,1,939,1,113933451,87089024,26844427,0.0372516798365634
1747351768533466,87291164,1,940,1,114028281,87181584,26846697,0.0372485300519464
1747351768627385,87383724,1,941,1,114122200,87274144,26848056,0.0372466445987746
1747351768717168,87476284,1,942,1,114211983,87366704,26845279,0.0372504975642085
1747351768812067,87568844,1,943,1,114306882,87459264,26847618,0.0372472522515777
1747351768905451,87661404,1,944,1,114400266,87551824,26848442,0.0372461091038355
1747351769000182,87753964,1,945,1,114494997,87644384,26850613,0.0372430975784426
1747351769090475,87846524,1,946,1,114585290,87736944,26848346,0.0372462422824854
1747351769184760,87939092,1,947,1,114679575,87829512,26850063,0.0372438604706439
1747351769278278,88031644,1,948,1,114773093,87922064,26851029,0.0372425205752822
1747351769372575,88124204,1,949,1,114867390,88014624,26852766,0.0372401115028522
1747351769466787,88216764,1,950,1,114961602,88107184,26854418,0.037237820607395
1747351769556790,88309324,1,951,1,115051605,88199744,26851861,0.0372413666225964
1747351769650694,88401884,1,952,1,115145509,88292304,26853205,0.037239502696233
1747351769745051,88494444,1,953,1,115239866,88384864,26855002,0.0372370108183198
1747351769839779,88587004,1,954,1,115334594,88477424,26857170,0.0372340049230801
1747351769929493,88679564,1,955,1,115424308,88569984,26854324,0.0372379509534479
1747351770023697,88772124,1,956,1,115518512,88662544,26855968,0.0372356714157538
1747351770117822,88864684,1,957,1,115612637,88755104,26857533,0.0372335016771644
1747351770212547,88957244,1,958,1,115707362,88847664,26859698,0.0372305005067443
1747351770302260,89049804,1,959,1,115797075,88940224,26856851,0.0372344471807212
1747351770396717,89142364,1,960,1,115891532,89032784,26858748,0.0372318173579796
1747351770490311,89234924,1,961,1,115985126,89125344,26859782,0.0372303840738543
1747351770584962,89327484,1,962,1,116079777,89217904,26861873,0.0372274859612358
1747351770674824,89420044,1,963,1,116169639,89310464,26859175,0.037231225456478
1747351770769099,89512604,1,964,1,116263914,89403024,26860890,0.0372288483367453
1747351770863892,89605164,1,965,1,116358707,89495584,26863123,0.0372257536847074
1747351770957249,89697724,1,966,1,116452064,89588144,26863920,0.0372246492693545
1747351771051735,89790284,1,967,1,116546550,89680704,26865846,0.0372219806515677
1747351771141579,89882844,1,968,1,116636394,89773264,26863130,0.0372257439844128
1747351771235825,89975404,1,969,1,116730640,89865824,26864816,0.0372234077463996
1747351771330220,90067964,1,970,1,116825035,89958384,26866651,0.0372208653769314
1747351771424142,90160524,1,971,1,116918957,90050944,26868013,0.0372189785675628
1747351771514781,90253084,1,972,1,117009596,90143504,26866092,0.037221639827631
1747351771608860,90345644,1,973,1,117103675,90236064,26867611,0.0372195354473458
1747351771702893,90438204,1,974,1,117197708,90328624,26869084,0.0372174950214156
1747351771797006,90530764,1,975,1,117291821,90421184,26870637,0.0372153440203148
1747351771885615,90623324,1,976,1,117380430,90513744,26866686,0.0372208168882459
1747351771981756,90715884,1,977,1,117476571,90606304,26870267,0.0372158564706483
1747351772075659,90808444,1,978,1,117570474,90698864,26871610,0.0372139964817887
1747351772169731,90901004,1,979,1,117664546,90791424,26873122,0.0372119026587234
1747351772259796,90993564,1,980,1,117754611,90883984,26870627,0.0372153578701382
1747351772354941,91086124,1,981,1,117849756,90976544,26873212,0.0372117780338278
1747351772448777,91178684,1,982,1,117943592,91069104,26874488,0.0372100112195625
1747351772543011,91271244,1,983,1,118037826,91161664,26876162,0.0372076935687469
1747351772637196,91363804,1,984,1,118132011,91254224,26877787,0.0372054440345107
1747351772727424,91456364,1,985,1,118222239,91346784,26875455,0.0372086723741049
1747351772821544,91548924,1,986,1,118316359,91439344,26877015,0.0372065127023964
1747351772915737,91641484,1,987,1,118410552,91531904,26878648,0.0372042522376869
1747351773010311,91734052,1,988,1,118505126,91624472,26880654,0.0372014758271878
1747351773099727,91826604,1,989,1,118594542,91717024,26877518,0.0372058164001601
1747351773194524,91919164,1,990,1,118689339,91809584,26879755,0.0372027200396729
1747351773288636,92011724,1,991,1,118783451,91902144,26881307,0.0372005721299191
1747351773382102,92104284,1,992,1,118876917,91994704,26882213,0.0371993183745698
1747351773473255,92196844,1,993,1,118968070,92087264,26880806,0.0372012654680071
1747351773567560,92289404,1,994,1,119062375,92179824,26882551,0.0371988506596714
1747351773661267,92381964,1,995,1,119156082,92272384,26883698,0.0371972635609877
1747351773754861,92474524,1,996,1,119249676,92364944,26884732,0.0371958329359578
1747351773845621,92567084,1,997,1,119340436,92457504,26882932,0.0371983234566824
1747351773939297,92659644,1,998,1,119434112,92550064,26884048,0.0371967792945467
1747351774033533,92752204,1,999,1,119528348,92642624,26885724,0.0371944605248495
1747351774127563,92844764,1,1000,1,119622378,92735184,26887194,0.0371924269970306
1747351774221772,92938364,1,1001,1,119716587,92828784,26887803,0.0371915846006458
1747351774316461,93031964,1,1002,1,119811276,92922384,26888892,0.0371900783416438
1747351774410370,93125564,1,1003,1,119905185,93015984,26889201,0.0371896509680596
1747351774505010,93219164,1,1004,1,119999825,93109584,26890241,0.0371882126307458
1747351774598831,93312764,1,1005,1,120093646,93203184,26890462,0.0371879069983996
1747351774693463,93406364,1,1006,1,120188278,93296784,26891494,0.0371864798586497
1747351774787199,93499964,1,1007,1,120282014,93390384,26891630,0.0371862917941381
1747351774881114,93593564,1,1008,1,120375929,93483984,26891945,0.0371858562108467
1747351774975746,93687164,1,1009,1,120470561,93577584,26892977,0.0371844292284933
1747351775069649,93780764,1,1010,1,120564464,93671184,26893280,0.0371840102806351
1747351775164048,93874364,1,1011,1,120658863,93764784,26894079,0.0371829055756101
1747351775258257,93967964,1,1012,1,120753072,93858384,26894688,0.0371820636104795
1747351775351947,94061564,1,1013,1,120846762,93951984,26894778,0.0371819391853689
1747351775446630,94155164,1,1014,1,120941445,94045584,26895861,0.0371804420018381
1747351775540536,94248764,1,1015,1,121035351,94139184,26896167,0.0371800189967589
1747351775634737,94342364,1,1016,1,121129552,94232784,26896768,0.0371791882206813
1747351775728751,94435964,1,1017,1,121223566,94326384,26897182,0.0371786159605865
1747351775823405,94529572,1,1018,1,121318220,94419992,26898228,0.03717717018385
1747351775917329,94623164,1,1019,1,121412144,94513584,26898560,0.0371767113183754
1747351776011525,94716764,1,1020,1,121506340,94607184,26899156,0.0371758876003395
1747351776105889,94810364,1,1021,1,121600704,94700784,26899920,0.0371748317467115
1747351776204194,94903964,1,1022,1,121699009,94794384,26904625,0.0371683307238067
1747351776298210,94997564,1,1023,1,121793025,94887984,26905041,0.0371677560350121
1747351776392641,95091164,1,1024,1,121887456,94981584,26905872,0.0371666080920923
1747351776487087,95184764,1,1025,1,121981902,95075184,26906718,0.0371654395010197
1747351776581438,95278364,1,1026,1,122076253,95168784,26907469,0.0371644021962823
1747351776674839,95371964,1,1027,1,122169654,95262384,26907270,0.0371646770556804
1747351776769380,95465564,1,1028,1,122264195,95355984,26908211,0.037163377379492
1747351776863455,95559164,1,1029,1,122358270,95449584,26908686,0.0371627213606788
1747351776958032,95652764,1,1030,1,122452847,95543184,26909663,0.0371613721063693
1747351777051694,95746364,1,1031,1,122546509,95636784,26909725,0.0371612864865768
1747351777145793,95839964,1,1032,1,122640608,95730384,26910224,0.0371605973997094
1747351777240449,95933564,1,1033,1,122735264,95823984,26911280,0.0371591392159718
1747351777334978,96027164,1,1034,1,122829793,95917584,26912209,0.0371578564955407
1747351777428590,96120764,1,1035,1,122923405,96011184,26912221,0.0371578399270725
1747351777523386,96214364,1,1036,1,123018201,96104784,26913417,0.0371561886771939
1747351777617752,96307964,1,1037,1,123112567,96198384,26914183,0.0371551311812065
1747351777711100,96401564,1,1038,1,123205915,96291984,26913931,0.0371554790714147
1747351777805402,96495164,1,1039,1,123300217,96385584,26914633,0.0371545099648953
1747351777899665,96588764,1,1040,1,123394480,96479184,26915296,0.0371535947440444
1747351777994094,96682364,1,1041,1,123488909,96572784,26916125,0.037152450436309
1747351778112355,96775964,1,1042,1,123607170,96666384,26940786,0.0371184419044047
1747351778182307,96869564,1,1043,1,123677122,96759984,26917138,0.0371510522403979
1747351778276638,96963164,1,1044,1,123771453,96853584,26917869,0.037150043341098
1747351778371268,97056764,1,1045,1,123866083,96947184,26918899,0.0371486218659983
1747351778464866,97150364,1,1046,1,123959681,97040784,26918897,0.0371486246260387
1747351778559014,97243964,1,1047,1,124053829,97134384,26919445,0.0371478683903029
1747351778653666,97337564,1,1048,1,124148481,97227984,26920497,0.0371464167247729
1747351778747723,97431164,1,1049,1,124242538,97321584,26920954,0.0371457861411597
1747351778841845,97524772,1,1050,1,124336660,97415192,26921468,0.0371450769326546
1747351778936121,97618364,1,1051,1,124430936,97508784,26922152,0.0371441332030218
1747351779030669,97711964,1,1052,1,124525484,97602384,26923100,0.0371428253061497
1747351779124862,97805564,1,1053,1,124619677,97695984,26923693,0.0371420072276117
1747351779218631,97899164,1,1054,1,124713446,97789584,26923862,0.0371417740887247
1747351779312967,97992764,1,1055,1,124807782,97883184,26924598,0.0371407587961016
1747351779407262,98086364,1,1056,1,124902077,97976784,26925293,0.037139800112853
1747351779501552,98179964,1,1057,1,124996367,98070384,26925983,0.0371388483755634
1747351779595291,98273564,1,1058,1,125090106,98163984,26926122,0.037138656654679
1747351779690117,98367164,1,1059,1,125184932,98257584,26927348,0.037136965734613
1747351779784291,98460764,1,1060,1,125279106,98351184,26927922,0.037136174116963
1747351779878541,98554364,1,1061,1,125373356,98444784,26928572,0.0371352777265723
1747351779972536,98647964,1,1062,1,125467351,98538384,26928967,0.0371347330181659
1747351780066348,98741564,1,1063,1,125561163,98631984,26929179,0.0371344406749273
1747351780160858,98835164,1,1064,1,125655673,98725584,26930089,0.0371331858576479
1747351780254917,98928764,1,1065,1,125749732,98819184,26930548,0.0371325529655022
1747351780348743,99022364,1,1066,1,125843558,98912784,26930774,0.0371322413533305
1747351780443359,99115964,1,1067,1,125938174,99006384,26931790,0.0371308405419766
1747351780537068,99209564,1,1068,1,126031883,99099984,26931899,0.037130690264359
1747351780631229,99303164,1,1069,1,126126044,99193584,26932460,0.0371299168364122
1747351780729594,99396764,1,1070,1,126224409,99287184,26937225,0.0371233488230506
1747351780823813,99490364,1,1071,1,126318628,99380784,26937844,0.0371224957721189
1747351780917816,99583964,1,1072,1,126412631,99474384,26938247,0.0371219404143112
1747351781012569,99677564,1,1073,1,126507384,99567984,26939400,0.0371203516039704
1747351781106894,99771164,1,1074,1,126601709,99661584,26940125,0.0371193526384899
1747351781200395,99864764,1,1075,1,126695210,99755184,26940026,0.0371194890457789
1747351781295369,99958364,1,1076,1,126790184,99848784,26941400,0.0371175959675443
1747351781389115,100051964,1,1077,1,126883930,99942384,26941546,0.0371173948221085
1747351781483919,100146604,1,1078,1,126978734,100037024,26941710,0.0371171688805202
1747351781577503,100241244,1,1079,1,127072318,100131664,26940654,0.037118623772088
1747351781676123,100335884,1,1080,1,127170938,100226304,26944634,0.0371131409689959
1747351781770218,100430524,1,1081,1,127265033,100320944,26944089,0.0371138916591316
1747351781864596,100525164,1,1082,1,127359411,100415584,26943827,0.0371142525521708
1747351781963082,100619804,1,1083,1,127457897,100510224,26947673,0.0371089555673322
1747351782057412,100714444,1,1084,1,127552227,100604864,26947363,0.037109382465364
1747351782151667,100809084,1,1085,1,127646482,100699504,26946978,0.0371099126588517
1747351782245384,100903724,1,1086,1,127740199,100794144,26946055,0.0371111838077967
1747351782343556,100998364,1,1087,1,127838371,100888784,26949587,0.0371063200337726
1747351782437969,101093004,1,1088,1,127932784,100983424,26949360,0.0371066325879353
1747351782529054,101187644,1,1089,1,128023869,101078064,26945805,0.0371115281209821
1747351782630048,101282284,1,1090,1,128124863,101172704,26952159,0.037102779038963
1747351782724332,101376924,1,1091,1,128219147,101267344,26951803,0.0371032691208079
1747351782818822,101471564,1,1092,1,128313637,101361984,26951653,0.0371034756198441
1747351782913097,101566204,1,1093,1,128407912,101456624,26951288,0.0371039781104339
1747351783011218,101660844,1,1094,1,128506033,101551264,26954769,0.0370991864185517
1747351783105693,101755484,1,1095,1,128600508,101645904,26954604,0.0370994135176313
1747351783199336,101850132,1,1096,1,128694151,101740552,26953599,0.0371007968175233
1747351783293432,101944764,1,1097,1,128788247,101835184,26953063,0.037101534619646
1747351783391864,102039404,1,1098,1,128886679,101929824,26956855,0.0370963155753888
1747351783486510,102134044,1,1099,1,128981325,102024464,26956861,0.0370963073185709
1747351783580696,102228684,1,1100,1,129075511,102119104,26956407,0.0370969320948448
1747351783679126,102323324,1,1101,1,129173941,102213744,26960197,0.0370917170968743
1747351783773128,102417964,1,1102,1,129267943,102308384,26959559,0.0370925948751609
1747351783867568,102512604,1,1103,1,129362383,102403024,26959359,0.0370928700493212
1747351783961557,102607244,1,1104,1,129456372,102497664,26958708,0.0370937657694871
1747351784059742,102701884,1,1105,1,129554557,102592304,26962253,0.0370888886770701
1747351784153600,102796524,1,1106,1,129648415,102686944,26961471,0.037089964416259
1747351784248516,102891164,1,1107,1,129743331,102781584,26961747,0.0370895847364786
1747351784342410,102985804,1,1108,1,129837225,102876224,26961001,0.0370906109902966
1747351784440763,103080444,1,1109,1,129935578,102970864,26964714,0.0370855036697218
1747351784535515,103175084,1,1110,1,130030330,103065504,26964826,0.0370853496328884
1747351784629000,103269724,1,1111,1,130123815,103160144,26963671,0.0370869381991791
1747351784727139,103364364,1,1112,1,130221954,103254784,26967170,0.0370821261556181
1747351784821391,103459004,1,1113,1,130316206,103349424,26966782,0.0370826596959177
1747351784915678,103553644,1,1114,1,130410493,103444064,26966429,0.0370831451209205
1747351785010835,103648292,1,1115,1,130505650,103538712,26966938,0.0370824451778692
1747351785108556,103742924,1,1116,1,130603371,103633344,26970027,0.0370781979565685
1747351785202434,103837564,1,1117,1,130697249,103727984,26969265,0.0370792455782536
1747351785297161,103932204,1,1118,1,130791976,103822624,26969352,0.03707912596491
1747351785395272,104026844,1,1119,1,130890087,103917264,26972823,0.0370743544344616
1747351785489236,104121484,1,1120,1,130984051,104011904,26972147,0.0370752836249928
1747351785583352,104216124,1,1121,1,131078167,104106544,26971623,0.0370760039171539
1747351785677439,104310764,1,1122,1,131172254,104201184,26971070,0.0370767641031668
1747351785776042,104405404,1,1123,1,131270857,104295824,26975033,0.0370713170211877
1747351785870563,104500044,1,1124,1,131365378,104390464,26974914,0.037071480561532
1747351785963598,104594684,1,1125,1,131458413,104485104,26973309,0.037073686435728
1747351786058775,104689324,1,1126,1,131553590,104579744,26973846,0.0370729483663545
1747351786156859,104783964,1,1127,1,131651674,104674384,26977290,0.0370682155249841
1747351786251130,104878604,1,1128,1,131745945,104769024,26976921,0.0370687225573296
1747351786344708,104973244,1,1129,1,131839523,104863664,26975859,0.0370701818985634
1747351786443121,105067884,1,1130,1,131937936,104958304,26979632,0.0370649977731349
1747351786537818,105162524,1,1131,1,132032633,105052944,26979689,0.0370649194658989
1747351786631966,105257164,1,1132,1,132126781,105147584,26979197,0.0370655953918865
1747351786725866,105351804,1,1133,1,132220681,105242224,26978457,0.0370666120749604
1747351786824156,105446444,1,1134,1,132318971,105336864,26982107,0.0370615978952273
1747351786918159,105541084,1,1135,1,132412974,105431504,26981470,0.0370624728749026
1747351787013153,105635724,1,1136,1,132507968,105526144,26981824,0.0370619866173613
1747351787111207,105730364,1,1137,1,132606022,105620784,26985238,0.0370572977714704
1747351787205034,105825004,1,1138,1,132699849,105715424,26984425,0.0370584142519249
1747351787299667,105919644,1,1139,1,132794482,105810064,26984418,0.0370584238652099
1747351787393525,106014284,1,1140,1,132888340,105904704,26983636,0.0370594978378747
1747351787491855,106108924,1,1141,1,132986670,105999344,26987326,0.0370544306612667
1747351787586249,106203564,1,1142,1,133081064,106093984,26987080,0.0370547684299301
1747351787680503,106298204,1,1143,1,133175318,106188624,26986694,0.0370552984370742
1747351787774277,106392844,1,1144,1,133269092,106283264,26985828,0.0370564875756267
1747351787873239,106487484,1,1145,1,133368054,106377904,26990150,0.0370505536278975
1747351787966790,106582124,1,1146,1,133461605,106472544,26989061,0.0370520486059148
1747351788061142,106676764,1,1147,1,133555957,106567184,26988773,0.037052443992174
1747351788159623,106771404,1,1148,1,133654438,106661824,26992614,0.0370471714966175
1747351788253946,106866044,1,1149,1,133748761,106756464,26992297,0.0370476065819815
1747351788347564,106960684,1,1150,1,133842379,106851104,26991275,0.037049009355801
1747351788442700,107055324,1,1151,1,133937515,106945744,26991771,0.0370483285442811
1747351788540557,107149964,1,1152,1,134035372,107040384,26994988,0.0370439134849772
1747351788634831,107244604,1,1153,1,134129646,107135024,26994622,0.0370444157358454
1747351788728821,107339244,1,1154,1,134223636,107229664,26993972,0.0370453077450032
1747351788823223,107433884,1,1155,1,134318038,107324304,26993734,0.0370456343683315
1747351788921393,107528524,1,1156,1,134416208,107418944,26997264,0.037040790503808
1747351789015865,107623164,1,1157,1,134510680,107513584,26997096,0.0370410210046295
1747351789109515,107717804,1,1158,1,134604330,107608224,26996106,0.0370423793713063
1747351789207845,107812444,1,1159,1,134702660,107702864,26999796,0.0370373168745423
1747351789302305,107907092,1,1160,1,134797120,107797512,26999608,0.0370375747677521
1747351789396015,108001724,1,1161,1,134890830,107892144,26998686,0.0370388395938972
1747351789490465,108096364,1,1162,1,134985280,107986784,26998496,0.0370391002521029
1747351789589324,108191004,1,1163,1,135084139,108081424,27002715,0.037033313131661
1747351789683001,108285644,1,1164,1,135177816,108176064,27001752,0.0370346339007928
1747351789777262,108380284,1,1165,1,135272077,108270704,27001373,0.0370351537308862
1747351789875756,108474924,1,1166,1,135370571,108365344,27005227,0.0370298683288239
1747351789970074,108569564,1,1167,1,135464889,108459984,27004905,0.0370303098640783
1747351790064515,108664204,1,1168,1,135559330,108554624,27004706,0.0370305827436151
1747351790158182,108758844,1,1169,1,135652997,108649264,27003733,0.0370319170316192
1747351790256930,108853484,1,1170,1,135751745,108743904,27007841,0.0370262843297988
1747351790350282,108948124,1,1171,1,135845097,108838544,27006553,0.0370280501921144
1747351790445204,109042764,1,1172,1,135940019,108933184,27006835,0.0370276635525784
1747351790538749,109137404,1,1173,1,136033564,109027824,27005740,0.0370291649108671
1747351790637761,109232044,1,1174,1,136132576,109122464,27010112,0.0370231711738181
1747351790732201,109326684,1,1175,1,136227016,109217104,27009912,0.0370234453188888
1747351790825894,109421324,1,1176,1,136320709,109311744,27008965,0.0370247434509245
1747351790923687,109515964,1,1177,1,136418502,109406384,27012118,0.0370204217233169
1747351791018407,109610604,1,1178,1,136513222,109501024,27012198,0.0370203120827116
1747351791112993,109705252,1,1179,1,136607808,109595672,27012136,0.0370203970541241
1747351791207195,109799884,1,1180,1,136702010,109690304,27011706,0.0370209863827186
1747351791305064,109894524,1,1181,1,136799879,109784944,27014935,0.0370165613946507
1747351791399543,109989164,1,1182,1,136894358,109879584,27014774,0.0370167820023221
1747351791493729,110083804,1,1183,1,136988544,109974224,27014320,0.0370174041027129
1747351791591199,110178444,1,1184,1,137086014,110068864,27017150,0.0370135265932935
1747351791685522,110273084,1,1185,1,137180337,110163504,27016833,0.037013960888754
1747351791780058,110367724,1,1186,1,137274873,110258144,27016729,0.0370141033727658
1747351791873863,110462364,1,1187,1,137368678,110352784,27015894,0.0370152473947373
1747351791972105,110557004,1,1188,1,137466920,110447424,27019496,0.0370103128496549
1747351792066728,110651644,1,1189,1,137561543,110542064,27019479,0.0370103361356449
1747351792160818,110746284,1,1190,1,137655633,110636704,27018929,0.0370110895217201
1747351792255095,110840924,1,1191,1,137749910,110731344,27018566,0.037011586773332
1747351792352924,110935564,1,1192,1,137847739,110825984,27021755,0.0370072188131377
1747351792447831,111030204,1,1193,1,137942646,110920624,27022022,0.0370068531511076
1747351792541636,111124844,1,1194,1,138036451,111015264,27021187,0.0370079967249403
1747351792639030,111219484,1,1195,1,138133845,111109904,27023941,0.0370042252534521
1747351792734224,111314124,1,1196,1,138229039,111204544,27024495,0.0370034666697749
1747351792829076,111408764,1,1197,1,138323891,111299184,27024707,0.0370031763896644
1747351792923327,111503404,1,1198,1,138418142,111393824,27024318,0.0370037090297708
1747351793021608,111598044,1,1199,1,138516423,111488464,27027959,0.0369987241729943
1747351793115578,111692684,1,1200,1,138610393,111583104,27027289,0.0369996413624762
1747351793209706,111787324,1,1201,1,138704521,111677744,27026777,0.0370003422901665
1747351793307696,111881964,1,1202,1,138802511,111772384,27030127,0.036995756623711
1747351793401610,111976604,1,1203,1,138896425,111867024,27029401,0.0369967503164424
1747351793495500,112071244,1,1204,1,138990315,111961664,27028651,0.0369977769145785
1747351793590481,112165884,1,1205,1,139085296,112056304,27028992,0.036997310147563
1747351793688683,112260524,1,1206,1,139183498,112150944,27032554,0.0369924351210026
1747351793782663,112355164,1,1207,1,139277478,112245584,27031894,0.0369933383136231
1747351793877414,112449804,1,1208,1,139372229,112340224,27032005,0.036993186409961
1747351793971588,112544444,1,1209,1,139466403,112434864,27031539,0.0369938241400166
1747351794070052,112639084,1,1210,1,139564867,112529504,27035363,0.0369885915717129
1747351794163545,112733724,1,1211,1,139658360,112624144,27034216,0.0369901609131183
1747351794258122,112828364,1,1212,1,139752937,112718784,27034153,0.0369902471144555
1747351794356375,112923004,1,1213,1,139851190,112813424,27037766,0.0369853041852644
1747351794450790,113017644,1,1214,1,139945605,112908064,27037541,0.0369856119681889
1747351794545394,113112284,1,1215,1,140040209,113002704,27037505,0.0369856612139322
1747351794638643,113206924,1,1216,1,140133458,113097344,27036114,0.0369875641151683
1747351794736730,113301564,1,1217,1,140231545,113191984,27039561,0.0369828489449218
1747351794831746,113396204,1,1218,1,140326561,113286624,27039937,0.0369823346851732
1747351794925173,113490844,1,1219,1,140419988,113381264,27038724,0.0369839937713037
1747351795020277,113585484,1,1220,1,140515092,113475904,27039188,0.0369833591156657
1747351795118478,113680124,1,1221,1,140613293,113570544,27042749,0.0369784891321514
1747351795211987,113774764,1,1222,1,140706802,113665184,27041618,0.0369800357360273
1747351795306088,113869404,1,1223,1,140800903,113759824,27041079,0.0369807728456397
1747351795404655,113964052,1,1224,1,140899470,113854472,27044998,0.0369754140858135
1747351795499294,114058684,1,1225,1,140994109,113949104,27045005,0.0369754045155473
1747351795593413,114153324,1,1226,1,141088228,114043744,27044484,0.0369761168303303
1747351795687615,114247964,1,1227,1,141182430,114138384,27044046,0.0369767156881777
1747351795785747,114342604,1,1228,1,141280562,114233024,27047538,0.0369719417715579
1747351795880116,114437244,1,1229,1,141374931,114327664,27047267,0.0369723122118031
1747351795974355,114531884,1,1230,1,141469170,114422304,27046866,0.03697286036763
1747351796072664,114626524,1,1231,1,141567479,114516944,27050535,0.0369678455527774
1747351796166199,114721164,1,1232,1,141661014,114611584,27049430,0.0369693557313407
1747351796260823,114815804,1,1233,1,141755638,114706224,27049414,0.0369693775990858
1747351796355529,114910444,1,1234,1,141850344,114800864,27049480,0.0369692873948038
1747351796453656,115005084,1,1235,1,141948471,114895504,27052967,0.0369645222278207
1747351796547428,115099724,1,1236,1,142042243,114990144,27052099,0.0369657082801597
1747351796641459,115194364,1,1237,1,142136274,115084784,27051490,0.0369665404752196
1747351796736354,115289004,1,1238,1,142231169,115179424,27051745,0.0369661920146001
1747351796834223,115383644,1,1239,1,142329038,115274064,27054974,0.0369617801148136
1747351796928126,115478284,1,1240,1,142422941,115368704,27054237,0.0369627870118828
1747351797022744,115572924,1,1241,1,142517559,115463344,27054215,0.0369628170693549
1747351797120342,115667564,1,1242,1,142615157,115557984,27057173,0.03695877614413
1747351797214992,115762212,1,1243,1,142709807,115652632,27057175,0.0369587734122279
1747351797308993,115856844,1,1244,1,142803808,115747264,27056544,0.0369596353473673
1747351797403430,115951484,1,1245,1,142898245,115841904,27056341,0.0369599126504208
1747351797502144,116046124,1,1246,1,142996959,115936544,27060415,0.0369543482611039
1747351797595844,116140764,1,1247,1,143090659,116031184,27059475,0.036955631992121
1747351797689928,116235404,1,1248,1,143184743,116125824,27058919,0.0369563913473409
1747351797788865,116330044,1,1249,1,143283680,116220464,27063216,0.036950523544578
1747351797883044,116424684,1,1250,1,143377859,116315104,27062755,0.0369511529775885
1747351797976958,116519324,1,1251,1,143471773,116409744,27062029,0.0369521442756565
1747351798071747,116613964,1,1252,1,143566562,116504384,27062178,0.0369519408230926
1747351798169530,116708604,1,1253,1,143664345,116599024,27065321,0.0369476497249007
1747351798263573,116803244,1,1254,1,143758388,116693664,27064724,0.0369484647247834
1747351798357719,116897884,1,1255,1,143852534,116788304,27064230,0.0369491391404817
1747351798451725,116992524,1,1256,1,143946540,116882944,27063596,0.0369500047222106
1747351798550151,117087164,1,1257,1,144044966,116977584,27067382,0.0369448364086338
1747351798644867,117181804,1,1258,1,144139682,117072224,27067458,0.0369447326749338
1747351798738967,117276444,1,1259,1,144233782,117166864,27066918,0.0369454697428055
1747351798836969,117371084,1,1260,1,144331784,117261504,27070280,0.0369408812912167
1747351798931230,117465724,1,1261,1,144426045,117356144,27069901,0.0369413984927392
1747351799025918,117560364,1,1262,1,144520733,117450784,27069949,0.036941332988843
1747351799119516,117655004,1,1263,1,144614331,117545424,27068907,0.0369427550214716
1747351799217695,117749644,1,1264,1,144712510,117640064,27072446,0.0369379257419148
1747351799312030,117844284,1,1265,1,144806845,117734704,27072141,0.0369383418917624
1747351799406656,117938924,1,1266,1,144901471,117829344,27072127,0.0369383609939477
1747351799500157,118033564,1,1267,1,144994972,117923984,27070988,0.036939915159358
1747351799598515,118128204,1,1268,1,145093330,118018624,27074706,0.0369348424318993
1747351799693313,118222844,1,1269,1,145188128,118113264,27074864,0.0369346268923086
1747351799787387,118317484,1,1270,1,145282202,118207904,27074298,0.0369353990267817
1747351799886082,118412124,1,1271,1,145380897,118302544,27078353,0.0369298679280826
1747351799980091,118506764,1,1272,1,145474906,118397184,27077722,0.0369307285154932
1747351800074250,118601404,1,1273,1,145569065,118491824,27077241,0.0369313845528058
1747351800168023,118696044,1,1274,1,145662838,118586464,27076374,0.0369325671155229
1747351800266770,118790684,1,1275,1,145761585,118681104,27080481,0.0369269659575101
1747351800360479,118885324,1,1276,1,145855294,118775744,27079550,0.0369282355135148
1747351800454539,118979964,1,1277,1,145949354,118870384,27078970,0.0369290264733112
1747351800553313,119074604,1,1278,1,146048128,118965024,27083104,0.0369233895789788
1747351800647021,119169244,1,1279,1,146141836,119059664,27082172,0.0369246602525085
1747351800741772,119263884,1,1280,1,146236587,119154304,27082283,0.0369245089123394
1747351800836044,119358524,1,1281,1,146330859,119248944,27081915,0.0369250106574812
1747351800934088,119453164,1,1282,1,146428903,119343584,27085319,0.036920370035147
1747351801028366,119547804,1,1283,1,146523181,119438224,27084957,0.0369208634889101
1747351801122025,119642444,1,1284,1,146616840,119532864,27083976,0.0369222007876539
1747351801216115,119737084,1,1285,1,146710930,119627504,27083426,0.0369229505897813
1747351801315049,119831724,1,1286,1,146809864,119722144,27087720,0.0369170974891943
1747351801409150,119926364,1,1287,1,146903965,119816784,27087181,0.0369178320918666
1747351801503757,120021012,1,1288,1,146998572,119911432,27087140,0.0369178879719305
1747351801601222,120115644,1,1289,1,147096037,120006064,27089973,0.0369140271937517
1747351801695138,120210284,1,1290,1,147189953,120100704,27089249,0.0369150137753911
1747351801789745,120304924,1,1291,1,147284560,120195344,27089216,0.0369150587451478
1747351801884374,120399564,1,1292,1,147379189,120289984,27089205,0.0369150737350911
1747351801982773,120494204,1,1293,1,147477588,120384624,27092964,0.0369099519712941
1747351802080414,120591964,1,1294,1,147575229,120482384,27092845,0.0369101140910081
1747351802175086,120686612,1,1295,1,147669901,120577032,27092869,0.0369100813944805
1747351802272805,120784364,1,1296,1,147767620,120674784,27092836,0.0369101263522209
1747351802371596,120882124,1,1297,1,147866411,120772544,27093867,0.036908721815162
1747351802470503,120979884,1,1298,1,147965318,120870304,27095014,0.0369071593762601
1747351802564654,121074524,1,1299,1,148059469,120964944,27094525,0.0369078254739656
1747351802662845,121169164,1,1300,1,148157660,121059584,27098076,0.0369029889797342
1747351802756697,121263804,1,1301,1,148251512,121154224,27097288,0.0369040621334504
1747351802851316,121358444,1,1302,1,148346131,121248864,27097267,0.0369040907335784
1747351802949066,121453084,1,1303,1,148443881,121343504,27100377,0.0368998556735945
1747351803043790,121547724,1,1304,1,148538605,121438144,27100461,0.0368997412996037
1747351803138387,121642364,1,1305,1,148633202,121532784,27100418,0.0368997998481056
1747351803231523,121737004,1,1306,1,148726338,121627424,27098914,0.0369018478009856
1747351803330181,121831644,1,1307,1,148824996,121722064,27102932,0.0368963771152139
1747351803424582,121926284,1,1308,1,148919397,121816704,27102693,0.036896702478975
1747351803518547,122020924,1,1309,1,149013362,121911344,27102018,0.0368976214243529
1747351803613163,122115564,1,1310,1,149107978,122005984,27101994,0.0368976540988091
1747351803710525,122210204,1,1311,1,149205340,122100624,27104716,0.0368939486397865
1747351803804783,122304844,1,1312,1,149299598,122195264,27104334,0.0368944686115512
1747351803898969,122399484,1,1313,1,149393784,122289904,27103880,0.0368950866075263
1747351803997774,122494124,1,1314,1,149492589,122384544,27108045,0.0368894178831413
1747351804091712,122588764,1,1315,1,149586527,122479184,27107343,0.0368903732099453
1747351804186371,122683412,1,1316,1,149681186,122573832,27107354,0.0368903582400554
1747351804280527,122778044,1,1317,1,149775342,122668464,27106878,0.0368910060391314
1747351804378554,122872684,1,1318,1,149873369,122763104,27110265,0.0368863970898108
1747351804472570,122967324,1,1319,1,149967385,122857744,27109641,0.0368872461276783
1747351804566940,123061964,1,1320,1,150061755,122952384,27109371,0.0368876135119475
1747351804664893,123156604,1,1321,1,150159708,123047024,27112684,0.0368831060768458
1747351804760145,123251244,1,1322,1,150254960,123141664,27113296,0.0368822735531674
1747351804853651,123345884,1,1323,1,150348466,123236304,27112162,0.036883816200272
1747351804947445,123440524,1,1324,1,150442260,123330944,27111316,0.0368849671480351
1747351805046020,123535164,1,1325,1,150540835,123425584,27115251,0.0368796143542982
1747351805140172,123629804,1,1326,1,150634987,123520224,27114763,0.0368802780979498
1747351805234923,123724444,1,1327,1,150729738,123614864,27114874,0.0368801271213725
1747351805328488,123819084,1,1328,1,150823303,123709504,27113799,0.0368815893339033
1747351805427144,123913724,1,1329,1,150921959,123804144,27117815,0.0368761273723565
1747351805521746,124008364,1,1330,1,151016561,123898784,27117777,0.0368761790466821
1747351805615704,124103004,1,1331,1,151110519,123993424,27117095,0.0368771064894672
1747351805713912,124197644,1,1332,1,151208727,124088064,27120663,0.0368722549297559
1747351805807637,124292284,1,1333,1,151302452,124182704,27119748,0.0368734989720405
1747351805902545,124386924,1,1334,1,151397360,124277344,27120016,0.0368731345881211
1747351805996604,124481572,1,1335,1,151491419,124371992,27119427,0.036873935426438
1747351806095047,124576204,1,1336,1,151589862,124466624,27123238,0.0368687543869209
1747351806188506,124670844,1,1337,1,151683321,124561264,27122057,0.0368703597960877
1747351806282864,124765484,1,1338,1,151777679,124655904,27121775,0.0368707431574814
1747351806377113,124860124,1,1339,1,151871928,124750544,27121384,0.0368712747107596
1747351806475719,124954764,1,1340,1,151970534,124845184,27125350,0.0368658837581819
1747351806569897,125049404,1,1341,1,152064712,124939824,27124888,0.0368665116700205
1747351806664094,125144044,1,1342,1,152158909,125034464,27124445,0.0368671137787335
1747351806762061,125238684,1,1343,1,152256876,125129104,27127772,0.0368625923278918
1747351806855971,125333324,1,1344,1,152350786,125223744,27127042,0.0368635843156065
1747351806950665,125427964,1,1345,1,152445480,125318384,27127096,0.0368635109338647
1747351807045269,125522604,1,1346,1,152540084,125413024,27127060,0.0368635598549935
1747351807143098,125617244,1,1347,1,152637913,125507664,27130249,0.0368592267619806
1747351807237037,125711884,1,1348,1,152731852,125602304,27129548,0.03686017916701
1747351807331193,125806524,1,1349,1,152826008,125696944,27129064,0.0368608367763812
1747351807429763,125901164,1,1350,1,152924578,125791584,27132994,0.0368554977751441
1747351807523700,125995804,1,1351,1,153018515,125886224,27132291,0.0368564527042703
1747351807617925,126090444,1,1352,1,153112740,125980864,27131876,0.036857016448107
1747351807712123,126185084,1,1353,1,153206938,126075504,27131434,0.036857616888219
1747351807810667,126279724,1,1354,1,153305482,126170144,27135338,0.0368523141300101
1747351807904670,126374364,1,1355,1,153399485,126264784,27134701,0.0368531792555959
1747351807998870,126469004,1,1356,1,153493685,126359424,27134261,0.0368537768542876
1747351808093691,126563644,1,1357,1,153588506,126454064,27134442,0.0368535310215702
1747351808191896,126658284,1,1358,1,153686711,126548704,27138007,0.0368486897361328
1747351808285634,126752924,1,1359,1,153780449,126643344,27137105,0.0368499145358357
1747351808380053,126847564,1,1360,1,153874868,126737984,27136884,0.0368502146377601
1747351808477786,126942204,1,1361,1,153972601,126832624,27139977,0.0368460150132035
1747351808572976,127036844,1,1362,1,154067791,126927264,27140527,0.036845268332483
1747351808666836,127131484,1,1363,1,154161651,127021904,27139747,0.0368463272704789
1747351808760799,127226124,1,1364,1,154255614,127116544,27139070,0.0368472464236983
1747351808859460,127320764,1,1365,1,154354275,127211184,27143091,0.03684178784207
1747351808953020,127415404,1,1366,1,154447835,127305824,27142011,0.0368432538031172
1747351809048033,127510044,1,1367,1,154542848,127400464,27142384,0.0368427474904194
1747351809145750,127604684,1,1368,1,154640565,127495104,27145461,0.0368385712808487
1747351809240001,127699324,1,1369,1,154734816,127589744,27145072,0.0368390991926637
1747351809334099,127793964,1,1370,1,154828914,127684384,27144530,0.0368398347659731
1747351809428268,127888604,1,1371,1,154923083,127779024,27144059,0.0368404740057483
1747351809526277,127983244,1,1372,1,155021092,127873664,27147428,0.0368359020972447
1747351809620930,128077884,1,1373,1,155115745,127968304,27147441,0.0368358844577652
1747351809715216,128172524,1,1374,1,155210031,128062944,27147087,0.0368363648003927
1747351809809692,128267164,1,1375,1,155304507,128157584,27146923,0.0368365873362517
1747351809907695,128361804,1,1376,1,155402510,128252224,27150286,0.0368320245318962
1747351810001760,128456444,1,1377,1,155496575,128346864,27149711,0.0368328045922846
1747351810095983,128551084,1,1378,1,155590798,128441504,27149294,0.0368333703263149
1747351810194637,128645724,1,1379,1,155689452,128536144,27153308,0.0368279253489114
1747351810289040,128740372,1,1380,1,155783855,128630792,27153063,0.0368282576444506
1747351810382595,128835004,1,1381,1,155877410,128725424,27151986,0.0368297184596368
1747351810477509,128929644,1,1382,1,155972324,128820064,27152260,0.0368293468020709
1747351810575701,129024284,1,1383,1,156070516,128914704,27155812,0.036824529496669
1747351810669206,129118924,1,1384,1,156164021,129009344,27154677,0.0368260686731792
1747351810764168,129213564,1,1385,1,156258983,129103984,27154999,0.0368256319950518
1747351810857834,129308204,1,1386,1,156352649,129198624,27154025,0.0368269529102959
1747351810955971,129402844,1,1387,1,156450786,129293264,27157522,0.0368222108040637
1747351811050347,129497484,1,1388,1,156545162,129387904,27157258,0.0368225687585985
1747351811144538,129592124,1,1389,1,156639353,129482544,27156809,0.0368231775684691
1747351811242591,129686764,1,1390,1,156737406,129577184,27160222,0.0368185503049275
1747351811337618,129781404,1,1391,1,156832433,129671824,27160609,0.0368180256930174
1747351811430907,129876044,1,1392,1,156925722,129766464,27159258,0.0368198571551549
1747351811525555,129970684,1,1393,1,157020370,129861104,27159266,0.0368198463095431
1747351811624005,130065324,1,1394,1,157118820,129955744,27163076,0.0368146818129139
1747351811717829,130159964,1,1395,1,157212644,130050384,27162260,0.0368157877879086
1747351811812359,130254604,1,1396,1,157307174,130145024,27162150,0.0368159368827578
1747351811910279,130349244,1,1397,1,157405094,130239664,27165430,0.0368114916642217
1747351812004513,130443884,1,1398,1,157499328,130334304,27165024,0.0368120418373272
1747351812099338,130538532,1,1399,1,157594153,130428952,27165201,0.036811801981513
1747351812193287,130633164,1,1400,1,157688102,130523584,27164518,0.0368127275440705
1747351812290989,130727804,1,1401,1,157785804,130618224,27167580,0.0368085784600615
1747351812385257,130822444,1,1402,1,157880072,130712864,27167208,0.0368090824791417
1747351812479726,130917084,1,1403,1,157974541,130807504,27167037,0.0368093141699626
1747351812573804,131011724,1,1404,1,158068619,130902144,27166475,0.0368100756539079
1747351812671820,131106364,1,1405,1,158166635,130996784,27169851,0.0368055018041872
1747351812766453,131201004,1,1406,1,158261268,131091424,27169844,0.0368055112867044
1747351812861240,131295644,1,1407,1,158356055,131186064,27169991,0.0368053121548696
1747351812958662,131390284,1,1408,1,158453477,131280704,27172773,0.0368015439572545
1747351813053137,131484924,1,1409,1,158547952,131375344,27172608,0.0368017674269617
1747351813147155,131579564,1,1410,1,158641970,131469984,27171986,0.036802609864439
1747351813241782,131674204,1,1411,1,158736597,131564624,27171973,0.0368026274720646
1747351813339983,131768844,1,1412,1,158834798,131659264,27175534,0.0367978049667763
1747351813434597,131863484,1,1413,1,158929412,131753904,27175508,0.0367978401728497
1747351813528294,131958124,1,1414,1,159023109,131848544,27174565,0.0367991171155821
1747351813626310,132052764,1,1415,1,159121125,131943184,27177941,0.0367945459886015
1747351813720806,132147404,1,1416,1,159215621,132037824,27177797,0.0367947409423949
1747351813814720,132242044,1,1417,1,159309535,132132464,27177071,0.0367957238659015
1747351813909259,132336684,1,1418,1,159404074,132227104,27176970,0.0367958606128644
1747351814007430,132431324,1,1419,1,159502245,132321744,27180501,0.0367910804881779
1747351814101508,132525964,1,1420,1,159596323,132416384,27179939,0.0367918412178923
1747351814195380,132620604,1,1421,1,159690195,132511024,27179171,0.0367928808424657
1747351814290284,132715244,1,1422,1,159785099,132605664,27179435,0.0367925234648917
1747351814388704,132809884,1,1423,1,159883519,132700304,27183215,0.0367874072290566
1747351814483142,132904524,1,1424,1,159977957,132794944,27183013,0.0367876806003808
1747351814576566,132999164,1,1425,1,160071381,132889584,27181797,0.0367893263274683
1747351814675306,133093804,1,1426,1,160170121,132984224,27185897,0.0367837780007773
1747351814769379,133188444,1,1427,1,160264194,133078864,27185330,0.0367845451940439
1747351814863913,133283084,1,1428,1,160358728,133173504,27185224,0.0367846886234963
1747351814954028,133377724,1,1429,1,160448843,133268144,27180699,0.0367908124805767
1747351815056112,133472364,1,1430,1,160550927,133362784,27188143,0.0367807393097792
1747351815149956,133567004,1,1431,1,160644771,133457424,27187347,0.0367818161882437
1747351815243910,133661644,1,1432,1,160738725,133552064,27186661,0.0367827443024356
1747351815343277,133756284,1,1433,1,160838092,133646704,27191388,0.0367763499237332
1747351815437040,133850924,1,1434,1,160931855,133741344,27190511,0.0367775361044152
1747351815531385,133945564,1,1435,1,161026200,133835984,27190216,0.0367779351219571
1747351815625567,134040204,1,1436,1,161120382,133930624,27189758,0.0367785546307547
1747351815723151,134134844,1,1437,1,161217966,134025264,27192702,0.0367745728247233
1747351815817429,134229484,1,1438,1,161312244,134119904,27192340,0.0367750623888933
1747351815911949,134324124,1,1439,1,161406764,134214544,27192220,0.0367752246782351
1747351816006446,134418764,1,1440,1,161501261,134309184,27192077,0.0367754180749046
1747351816104555,134513404,1,1441,1,161599370,134403824,27195546,0.0367707270889137
1747351816198468,134608044,1,1442,1,161693283,134498464,27194819,0.0367717100819829
1747351816292914,134702684,1,1443,1,161787729,134593104,27194625,0.0367719724026347
1747351816390967,134797332,1,1444,1,161885782,134687752,27198030,0.0367673688131088
1747351816485659,134891964,1,1445,1,161980474,134782384,27198090,0.0367672877029232
1747351816579175,134986604,1,1446,1,162073990,134877024,27196966,0.0367688072265119
1747351816673894,135081244,1,1447,1,162168709,134971664,27197045,0.0367687004231525
1747351816771974,135175884,1,1448,1,162266789,135066304,27200485,0.0367640503468963
1747351816866763,135270524,1,1449,1,162361578,135160944,27200634,0.0367638489602852
1747351816960200,135365164,1,1450,1,162455015,135255584,27199431,0.0367654749836494
1747351817055256,135459804,1,1451,1,162550071,135350224,27199847,0.0367649126849867
1747351817153035,135554444,1,1452,1,162647850,135444864,27202986,0.0367606703175894
1747351817247320,135649084,1,1453,1,162742135,135539504,27202631,0.0367611500519931
1747351817341933,135743724,1,1454,1,162836748,135634144,27202604,0.0367611865393474
1747351817439706,135838364,1,1455,1,162934521,135728784,27205737,0.0367569531382296
1747351817533878,135933004,1,1456,1,163028693,135823424,27205269,0.0367575854515535
1747351817628389,136027644,1,1457,1,163123204,135918064,27205140,0.0367577597468713
1747351817722548,136122284,1,1458,1,163217363,136012704,27204659,0.0367584096532876
1747351817820935,136216924,1,1459,1,163315750,136107344,27208406,0.0367533474765114
1747351817914632,136311564,1,1460,1,163409447,136201984,27207463,0.0367546213331246
1747351818009397,136406204,1,1461,1,163504212,136296624,27207588,0.0367544524711268
1747351818107403,136500844,1,1462,1,163602218,136391264,27210954,0.0367499059386157
1747351818201476,136595492,1,1463,1,163696291,136485912,27210379,0.0367506825244881
1747351818295879,136690124,1,1464,1,163790694,136580544,27210150,0.0367509918173916
1747351818389774,136784764,1,1465,1,163884589,136675184,27209405,0.0367519980683149
1747351818488523,136879404,1,1466,1,163983338,136769824,27213514,0.0367464488415571
1747351818582598,136974044,1,1467,1,164077413,136864464,27212949,0.0367472117777459
1747351818676432,137068684,1,1468,1,164171247,136959104,27212143,0.0367483001981872
1747351818770343,137163324,1,1469,1,164265158,137053744,27211414,0.036749284693548
1747351818869321,137257964,1,1470,1,164364136,137148384,27215752,0.036743427115297
1747351818962877,137352604,1,1471,1,164457692,137243024,27214668,0.0367448906596986
1747351819057200,137447244,1,1472,1,164552015,137337664,27214351,0.0367453186739599
1747351819155545,137541884,1,1473,1,164650360,137432304,27218056,0.0367403167955859
1747351819249533,137636524,1,1474,1,164744348,137526944,27217404,0.0367411969194416
1747351819343945,137731164,1,1475,1,164838760,137621584,27217176,0.0367415047027656
1747351819438836,137825804,1,1476,1,164933651,137716224,27217427,0.0367411658714102
1747351819536454,137920444,1,1477,1,165031269,137810864,27220405,0.0367371462694989
1747351819630536,138015084,1,1478,1,165125351,137905504,27219847,0.0367378993717341
1747351819725219,138109724,1,1479,1,165220034,138000144,27219890,0.036737841335876
1747351819823492,138204364,1,1480,1,165318307,138094784,27223523,0.0367329386428053
1747351819917738,138299004,1,1481,1,165412553,138189424,27223129,0.0367334702781594
1747351820011515,138393644,1,1482,1,165506330,138284064,27222266,0.0367346348022607
1747351820106372,138488284,1,1483,1,165601187,138378704,27222483,0.0367343419775484
1747351820204213,138582924,1,1484,1,165699028,138473344,27225684,0.0367300230179708
1747351820298951,138677564,1,1485,1,165793766,138567984,27225782,0.0367298908071768
1747351820392515,138772204,1,1486,1,165887330,138662624,27224706,0.0367313424798783
1747351820486620,138866844,1,1487,1,165981435,138757264,27224171,0.0367320643115266
1747351820585063,138961484,1,1488,1,166079878,138851904,27227974,0.0367269338511929
1747351820681320,139056124,1,1489,1,166176135,138946544,27229591,0.0367247528616937
1747351820773313,139150764,1,1490,1,166268128,139041184,27226944,0.0367283232374518
1747351820871726,139245404,1,1491,1,166366541,139135824,27230717,0.0367232342798759
1747351820966114,139340044,1,1492,1,166460929,139230464,27230465,0.0367235741291968
1747351821060291,139434684,1,1493,1,166555106,139325104,27230002,0.0367241985512891
1747351821154798,139529324,1,1494,1,166649613,139419744,27229869,0.0367243779248442
1747351821253038,139623964,1,1495,1,166747853,139514384,27233469,0.0367195233188985
1747351821346619,139718604,1,1496,1,166841434,139609024,27232410,0.0367209512488979
1747351821441768,139813244,1,1497,1,166936583,139703664,27232919,0.0367202649117415
1747351821535283,139907884,1,1498,1,167030098,139798304,27231794,0.0367217818994958
1747351821634065,140002524,1,1499,1,167128880,139892944,27235936,0.0367161973063822
1747351821728048,140097164,1,1500,1,167222863,139987584,27235279,0.0367170830157458
1747352159869185,109580,1,1,25,0,0,0,0.0
1747352159959450,197404,1,2,25,90265,87824,2441,10241.704219582138
1747352160049394,285804,1,3,25,180209,176224,3985,6273.525721455459
1747352160135529,374204,1,4,25,266344,264624,1720,14534.883720930233
1747352160224771,462604,1,5,25,355586,353024,2562,9758.001561280247
1747352160315031,551004,1,6,25,445846,441424,4422,5653.550429669833
1747352160405537,639404,1,7,25,536352,529824,6528,3829.656862745098
1747352160491708,727804,1,8,25,622523,618224,4299,5815.305885089556
1747352160582034,816204,1,9,25,712849,706624,6225,4016.064257028113
1747352160671262,904604,1,10,25,802077,795024,7053,3544.590954203885
1747352160761497,994044,1,11,25,892312,884464,7848,3185.5249745158
1747352160852230,1083484,1,12,25,983045,973904,9141,2734.930532764468
1747352160946432,1173964,1,13,25,1077247,1064384,12863,1943.559045323797
1747352161036094,1264444,1,14,25,1166909,1154864,12045,2075.5500207555
1747352161125869,1354924,1,15,25,1256684,1245344,11340,2204.5855379188715
1747352161220810,1445404,1,16,25,1351625,1335824,15801,1582.1783431428391
1747352161310573,1535884,1,17,25,1441388,1426304,15084,1657.3853089366216
1747352161400703,1626364,1,18,25,1531518,1516784,14734,1696.755802904846
1747352161494525,1716844,1,19,25,1625340,1607264,18076,1383.0493472007083
1747352161580411,1807324,1,20,25,1711226,1697744,13482,1854.3242842308264
1747352161674747,1897804,1,21,25,1805562,1788224,17338,1441.9194832160572
1747352161765618,1988284,1,22,25,1896433,1878704,17729,1410.1190140447852
1747352161855245,2078764,1,23,25,1986060,1969184,16876,1481.3936951884334
1747352161945253,2169244,1,24,25,2076068,2059664,16404,1524.01853206535
1747352162039564,2259724,1,25,25,2170379,2150144,20235,1235.4830738818878
1747352162129624,2350204,1,26,25,2260439,2240624,19815,1261.6704516780217
1747352162219985,2440684,1,27,25,2350800,2331104,19696,1269.293257514216
1747352162310461,2531164,1,28,25,2441276,2421584,19692,1269.5510867357302
1747352162404117,2621644,1,29,25,2534932,2512064,22868,1093.2307154101802
1747352162494883,2712124,1,30,25,2625698,2602544,23154,1079.7270450030232
1747352162588018,2802604,1,31,25,2718833,2693024,25809,968.6543453833934
1747352162674957,2893084,1,32,25,2805772,2783504,22268,1122.6872642356743
1747352162769006,2983564,1,33,25,2899821,2873984,25837,967.60459805705
1747352162859143,3074044,1,34,25,2989958,2964464,25494,980.622891660783
1747352162949590,3164524,1,35,25,3080405,3054944,25461,981.8938769097836
1747352163039130,3255004,1,36,25,3169945,3145424,24521,1019.534276742384
1747352163133158,3345484,1,37,25,3263973,3235904,28069,890.6622964836653
1747352163223496,3435964,1,38,25,3354311,3326384,27927,895.1910337666058
1747352163313093,3526444,1,39,25,3443908,3416864,27044,924.419464576246
1747352163403929,3616924,1,40,25,3534744,3507344,27400,912.4087591240876
1747352163498283,3707404,1,41,25,3629098,3597824,31274,799.3860714970901
1747352163588157,3797884,1,42,25,3718972,3688304,30668,815.1819486109299
1747352163678469,3888364,1,43,25,3809284,3778784,30500,819.672131147541
1747352163768757,3978844,1,44,25,3899572,3869264,30308,824.8647221855615
1747352163864068,4069324,1,45,25,3994883,3959744,35139,711.4602009163608
1747352163952506,4159804,1,46,25,4083321,4050224,33097,755.3554702843157
1747352164046231,4250284,1,47,25,4177046,4140704,36342,687.909306037092
1747352164132393,4340772,1,48,25,4263208,4231192,32016,780.8595702148925
1747352164227135,4431244,1,49,25,4357950,4321664,36286,688.9709529846222
1747352164317068,4521724,1,50,25,4447883,4412144,35739,699.5159349729987
1747352164407083,4612204,1,51,25,4537898,4502624,35274,708.7373136020865
1747352164497144,4702684,1,52,25,4627959,4593104,34855,717.2572084349448
1747352164591685,4793164,1,53,25,4722500,4683584,38916,642.4092918079967
1747352164681016,4883644,1,54,25,4811831,4774064,37767,661.9535573384171
1747352164771300,4974124,1,55,25,4902115,4864544,37571,665.4068297357004
1747352164866026,5064604,1,56,25,4996841,4955024,41817,597.8429825190711
1747352164956001,5155084,1,57,25,5086816,5045504,41312,605.151045701007
1747352165045919,5245564,1,58,25,5176734,5135984,40750,613.4969325153374
1747352165136084,5336044,1,59,25,5266899,5226464,40435,618.2762458266353
1747352165226271,5426524,1,60,25,5357086,5316944,40142,622.7890986996164
1747352165320737,5517004,1,61,25,5451552,5407424,44128,566.5337200870196
1747352165410137,5607484,1,62,25,5540952,5497904,43048,580.7470730347519
1747352165500174,5697964,1,63,25,5630989,5588384,42605,586.7855885459453
1747352165590521,5788444,1,64,25,5721336,5678864,42472,588.6230928611791
1747352165684638,5878924,1,65,25,5815453,5769344,46109,542.1934980155718
1747352165774785,5969404,1,66,25,5905600,5859824,45776,546.1377140859839
1747352165865196,6059884,1,67,25,5996011,5950304,45707,546.9621720961778
1747352165955448,6150364,1,68,25,6086263,6040784,45479,549.7042591085996
1747352166049522,6240844,1,69,25,6180337,6131264,49073,509.44511238359183
1747352166139237,6331324,1,70,25,6270052,6221744,48308,517.5126273081064
1747352166229326,6421804,1,71,25,6360141,6312224,47917,521.735500970428
1747352166319307,6512284,1,72,25,6450122,6402704,47418,527.2259479522544
1747352166414211,6602772,1,73,25,6545026,6493192,51834,482.30890921017095
1747352166503840,6693244,1,74,25,6634655,6583664,50991,490.2825988900002
1747352166594329,6783724,1,75,25,6725144,6674144,51000,490.1960784313726
1747352166687746,6874204,1,76,25,6818561,6764624,53937,463.5037172998128
1747352166778110,6964684,1,77,25,6908925,6855104,53821,464.5027034057338
1747352166868732,7055164,1,78,25,6999547,6945584,53963,463.2803958267703
1747352166962581,7145644,1,79,25,7093396,7036064,57332,436.0566524802902
1747352167052784,7236124,1,80,25,7183599,7126544,57055,438.1736920515292
1747352167142670,7326604,1,81,25,7273485,7217024,56461,442.7835142841962
1747352167232547,7417084,1,82,25,7363362,7307504,55858,447.563464499266
1747352167327048,7507564,1,83,25,7457863,7397984,59879,417.5086424288983
1747352167417548,7598044,1,84,25,7548363,7488464,59899,417.3692382176664
1747352167507311,7688524,1,85,25,7638126,7578944,59182,422.4257375553378
1747352167601007,7779004,1,86,25,7731822,7669424,62398,400.65386711112535
1747352167687725,7869484,1,87,25,7818540,7759904,58636,426.3592332355549
1747352167782218,7959964,1,88,25,7913033,7850384,62649,399.0486679755463
1747352167876122,8050444,1,89,25,8006937,7940864,66073,378.36937932287015
1747352167966403,8140924,1,90,25,8097218,8031344,65874,379.51240246531256
1747352168055805,8231404,1,91,25,8186620,8121824,64796,385.8262855731835
1747352168146035,8321884,1,92,25,8276850,8212304,64546,387.3206705295448
1747352168236035,8412364,1,93,25,8366850,8302784,64066,390.2225829613212
1747352168326224,8502844,1,94,25,8457039,8393264,63775,392.0031360250882
1747352168416638,8593324,1,95,25,8547453,8483744,63709,392.40923574377246
1747352168511084,8683804,1,96,25,8641899,8574224,67675,369.4126339120798
1747352168600999,8774284,1,97,25,8731814,8664704,67110,372.52272388615705
1747352168695138,8864764,1,98,25,8825953,8755184,70769,353.26202150659185
1747352168784813,8955244,1,99,25,8915628,8845664,69964,357.3266251214911
1747352168875339,9045724,1,100,25,9006154,8936144,70010,357.09184402228254
1747352168969632,9137244,1,101,25,9100447,9027664,72783,343.4868032370196
1747352169059668,9228764,1,102,25,9190483,9119184,71299,350.63605380159606
1747352169150124,9320284,1,103,25,9280939,9210704,70235,355.9478892290168
1747352169244021,9411804,1,104,25,9374836,9302224,72612,344.29570869828683
1747352169333979,9503324,1,105,25,9464794,9393744,71050,351.8648838845883
1747352169428187,9594844,1,106,25,9559002,9485264,73738,339.0382163877512
1747352169518600,9686364,1,107,25,9649415,9576784,72631,344.20564221888725
1747352169612645,9777884,1,108,25,9743460,9668304,75156,332.6414391399223
1747352169703085,9869404,1,109,25,9833900,9759824,74076,337.49122522814406
1747352169797061,9960924,1,110,25,9927876,9851344,76532,326.6607432185229
1747352169891190,10052444,1,111,25,10022005,9942864,79141,315.8918891598539
1747352169981037,10145004,1,112,25,10111852,10035424,76428,327.10524938504216
1747352170075531,10237564,1,113,25,10206346,10127984,78362,319.0321839667185
1747352170169654,10330132,1,114,25,10300469,10220552,79917,312.82455547630667
1747352170263315,10422684,1,115,25,10394130,10313104,81026,308.54293683509
1747352170358148,10515244,1,116,25,10488963,10405664,83299,300.123650944189
1747352170447992,10607804,1,117,25,10578807,10498224,80583,310.2391323231947
1747352170542305,10700364,1,118,25,10673120,10590784,82336,303.6338904003109
1747352170636314,10792924,1,119,25,10767129,10683344,83785,298.38276541146985
1747352170730397,10885484,1,120,25,10861212,10775904,85308,293.0557509260562
1747352170820505,10978044,1,121,25,10951320,10868464,82856,301.7282997006855
1747352170915547,11070604,1,122,25,11046362,10961024,85338,292.9527291476247
1747352171009263,11163164,1,123,25,11140078,11053584,86494,289.03738987675445
1747352171103755,11255724,1,124,25,11234570,11146144,88426,282.72227625359056
1747352171197652,11348284,1,125,25,11328467,11238704,89763,278.5111905796375
1747352171287716,11440844,1,126,25,11418531,11331264,87267,286.4771333952124
1747352171386434,11533404,1,127,25,11517249,11423824,93425,267.5943270002676
1747352171480358,11625964,1,128,25,11611173,11516384,94789,263.743683338784
1747352171566576,11718524,1,129,25,11697391,11608944,88447,282.655149411512
1747352171663923,11811084,1,130,25,11794738,11701504,93234,268.1425231138855
1747352171754243,11903644,1,131,25,11885058,11794064,90994,274.7433896740444
1747352171848945,11996204,1,132,25,11979760,11886624,93136,268.4246693008074
1747352171942721,12088764,1,133,25,12073536,11979184,94352,264.9652365609632
1747352172033114,12181324,1,134,25,12163929,12071744,92185,271.1937950859684
1747352172127712,12273884,1,135,25,12258527,12164304,94223,265.3279984717107
1747352172221931,12366444,1,136,25,12352746,12256864,95882,260.7371560876911
1747352172315984,12459004,1,137,25,12446799,12349424,97375,256.73940949935815
1747352172405990,12551564,1,138,25,12536805,12441984,94821,263.654675652018
1747352172500707,12644124,1,139,25,12631522,12534544,96978,257.79042669471426
1747352172594065,12736684,1,140,25,12724880,12627104,97776,255.6864670266732
1747352172688518,12829244,1,141,25,12819333,12719664,99669,250.83024812128147
1747352172778681,12921804,1,142,25,12909496,12812224,97272,257.0112673739617
1747352172873207,13014364,1,143,25,13004022,12904784,99238,251.91962756202253
1747352172967299,13106924,1,144,25,13098114,12997344,100770,248.0897092388608
1747352173060942,13199484,1,145,25,13191757,13089904,101853,245.45177854358727
1747352173155401,13292044,1,146,25,13286216,13182464,103752,240.9592104248593
1747352173245306,13384604,1,147,25,13376121,13275024,101097,247.28725877127903
1747352173339320,13477164,1,148,25,13470135,13367584,102551,243.78114304102348
1747352173434309,13569724,1,149,25,13565124,13460144,104980,238.14059820918268
1747352173527765,13662284,1,150,25,13658580,13552704,105876,236.1252786278288
1747352173618266,13754844,1,151,25,13749081,13645264,103817,240.80834545402004
1747352173712270,13847404,1,152,25,13843085,13737824,105261,237.50486884981143
1747352173806429,13939964,1,153,25,13937244,13830384,106860,233.9509638779712
1747352173901205,14032524,1,154,25,14032020,13922944,109076,229.19799039202024
1747352173991348,14125092,1,155,25,14122163,14015512,106651,234.40942888486748
1747352174085618,14217644,1,156,25,14216433,14108064,108369,230.6932794433833
1747352174179118,14310204,1,157,25,14309933,14200624,109309,228.7094383811031
1747352174273587,14402764,1,158,25,14404402,14293184,111218,224.78375802478016
1747352174363630,14495324,1,159,25,14494445,14385744,108701,229.9886845567198
1747352174457420,14587884,1,160,25,14588235,14478304,109931,227.41537873757176
1747352174552075,14680444,1,161,25,14682890,14570864,112026,223.16248013853928
1747352174645967,14773004,1,162,25,14776782,14663424,113358,220.5402353605392
1747352174740561,14865564,1,163,25,14871376,14755984,115392,216.65280088740988
1747352174830645,14958124,1,164,25,14961460,14848544,112916,221.4035212016012
1747352174924559,15050684,1,165,25,15055374,14941104,114270,218.78008226131087
1747352175018564,15143244,1,166,25,15149379,15033664,115715,216.04804908611675
1747352175113070,15235804,1,167,25,15243885,15126224,117661,212.47482173362457
1747352175203240,15328364,1,168,25,15334055,15218784,115271,216.88022139133
1747352175297623,15420924,1,169,25,15428438,15311344,117094,213.50368080345703
1747352175391624,15513484,1,170,25,15522439,15403904,118535,210.9081705825284
1747352175485636,15606044,1,171,25,15616451,15496464,119987,208.35590522306583
1747352175580101,15698604,1,172,25,15710916,15589024,121892,205.09959636399435
1747352175670269,15791164,1,173,25,15801084,15681584,119500,209.2050209205021
1747352175764679,15883724,1,174,25,15895494,15774144,121350,206.01565718994644
1747352175858140,15976284,1,175,25,15988955,15866704,122251,204.4973047255237
1747352175948149,16068844,1,176,25,16078964,15959264,119700,208.85547201336675
1747352176042485,16161404,1,177,25,16173300,16051824,121476,205.8019691132405
1747352176137384,16253972,1,178,25,16268199,16144392,123807,201.9271931312446
1747352176231492,16346524,1,179,25,16362307,16236944,125363,199.4208817593708
1747352176324927,16439084,1,180,25,16455742,16329504,126238,198.03862545350847
1747352176419508,16531644,1,181,25,16550323,16422064,128259,194.91809541630604
1747352176509666,16624204,1,182,25,16640481,16514624,125857,198.63813693318608
1747352176603752,16716764,1,183,25,16734567,16607184,127383,196.25852743301692
1747352176698156,16809324,1,184,25,16828971,16699744,129227,193.4580234780657
1747352176792715,16901884,1,185,25,16923530,16792304,131226,190.5110267782299
1747352176882114,16994444,1,186,25,17012929,16884864,128065,195.2133682114551
1747352176976683,17087004,1,187,25,17107498,16977424,130074,192.1982871288651
1747352177070482,17179564,1,188,25,17201297,17069984,131313,190.38480576942115
1747352177160759,17272124,1,189,25,17291574,17162544,129030,193.75339068433692
1747352177255529,17364684,1,190,25,17386344,17255104,131240,190.4907040536422
1747352177349077,17457244,1,191,25,17479892,17347664,132228,189.06736848473847
1747352177443686,17549804,1,192,25,17574501,17440224,134277,186.18229480849288
1747352177533552,17642364,1,193,25,17664367,17532784,131583,189.99414818023604
1747352177627339,17734924,1,194,25,17758154,17625344,132810,188.23883743694
1747352177722457,17827484,1,195,25,17853272,17717904,135368,184.6817563973761
1747352177816020,17920044,1,196,25,17946835,17810464,136371,183.32343386790447
1747352177910190,18012604,1,197,25,18041005,17903024,137981,181.18436596342977
1747352178000754,18105164,1,198,25,18131569,17995584,135985,183.8438063021657
1747352178094075,18197724,1,199,25,18224890,18088144,136746,182.82070407909555
1747352178189100,18290284,1,200,25,18319915,18180704,139211,179.58350992378476
1747352178282750,18382844,1,201,25,18413565,18273264,140301,178.1883236755262
1747352178372870,18475404,1,202,25,18503685,18365824,137861,181.34207643931205
1747352178467446,18567964,1,203,25,18598261,18458384,139877,178.72845428483595
1747352178561822,18660524,1,204,25,18692637,18550944,141693,176.43779156345053
1747352178655838,18753084,1,205,25,18786653,18643504,143149,174.6432039343621
1747352178745840,18845644,1,206,25,18876655,18736064,140591,177.82077088860598
1747352178840012,18938204,1,207,25,18970827,18828624,142203,175.8050111460377
1747352178934781,19030764,1,208,25,19065596,18921184,144412,173.11580755061905
1747352179029021,19123324,1,209,25,19159836,19013744,146092,171.12504449251156
1747352179119158,19215884,1,210,25,19249973,19106304,143669,174.01109494741385
1747352179216621,19308444,1,211,25,19347436,19198864,148572,168.26858358237084
1747352179307241,19401004,1,212,25,19438056,19291424,146632,170.49484423591028
1747352179401363,19493564,1,213,25,19532178,19383984,148194,168.6977880346033
1747352179495808,19586124,1,214,25,19626623,19476544,150079,166.57893509418375
1747352179585709,19678684,1,215,25,19716524,19569104,147420,169.58350291683627
1747352179679816,19771244,1,216,25,19810631,19661664,148967,167.82240361959362
1747352179773636,19863804,1,217,25,19904451,19754224,150227,166.41482556397983
1747352179868077,19956364,1,218,25,19998892,19846784,152108,164.35690430483604
1747352179958876,20048932,1,219,25,20089691,19939352,150339,166.2908493471421
1747352180052694,20141484,1,220,25,20183509,20031904,151605,164.9022129876983
1747352180146740,20234044,1,221,25,20277555,20124464,153091,163.30156573541225
1747352180240352,20326604,1,222,25,20371167,20217024,154143,162.18706006759956
1747352180331659,20419164,1,223,25,20462474,20309584,152890,163.51625351559946
1747352180425508,20511724,1,224,25,20556323,20402144,154179,162.149190226944
1747352180519627,20604284,1,225,25,20650442,20494704,155738,160.52601163492534
1747352180613502,20696844,1,226,25,20744317,20587264,157053,159.18193221396598
1747352180703598,20789404,1,227,25,20834413,20679824,154589,161.71913913667854
1747352180797623,20881964,1,228,25,20928438,20772384,156054,160.20095607930588
1747352180892332,20974524,1,229,25,21023147,20864944,158203,158.02481621713872
1747352180986683,21067084,1,230,25,21117498,20957504,159994,156.2558595947348
1747352181080341,21159644,1,231,25,21211156,21050064,161092,155.1908226355126
1747352181171161,21252204,1,232,25,21301976,21142624,159352,156.8853858125408
1747352181265234,21344764,1,233,25,21396049,21235184,160865,155.40981568395858
1747352181358638,21437324,1,234,25,21489453,21327744,161709,154.59869271345443
1747352181453643,21529884,1,235,25,21584458,21420304,164154,152.29601471788686
1747352181543836,21622444,1,236,25,21674651,21512864,161787,154.52415830690973
1747352181637555,21715004,1,237,25,21768370,21605424,162946,153.4250610631743
1747352181732176,21807564,1,238,25,21862991,21697984,165007,151.5087238723206
1747352181825532,21900124,1,239,25,21956347,21790544,165803,150.78134895026025
1747352181916464,21992684,1,240,25,22047279,21883104,164175,152.27653418608193
1747352182013928,22085244,1,241,25,22144743,21975664,169079,147.85987615256772
1747352182104479,22177812,1,242,25,22235294,22068232,167062,149.64504196046977
1747352182198921,22270364,1,243,25,22329736,22160784,168952,147.9710213551778
1747352182292360,22362924,1,244,25,22423175,22253344,169831,147.205162779469
1747352182382672,22455484,1,245,25,22513487,22345904,167583,149.1798094078755
1747352182477537,22548044,1,246,25,22608352,22438464,169888,147.15577321529477
1747352182571846,22640604,1,247,25,22702661,22531024,171637,145.6562396219929
1747352182665367,22733164,1,248,25,22796182,22623584,172598,144.84524733774435
1747352182756162,22825724,1,249,25,22886977,22716144,170833,146.34174895951014
1747352182849388,22918284,1,250,25,22980203,22808704,171499,145.77344474311803
1747352182943914,23010844,1,251,25,23074729,22901264,173465,144.12129247975096
1747352183037895,23103404,1,252,25,23168710,22993824,174886,142.9502647438903
1747352183128585,23195964,1,253,25,23259400,23086384,173016,144.49530679243537
1747352183222600,23288524,1,254,25,23353415,23178944,174471,143.29028893053862
1747352183316439,23381084,1,255,25,23447254,23271504,175750,142.2475106685633
1747352183410639,23473644,1,256,25,23541454,23364064,177390,140.9324088167315
1747352183501059,23566204,1,257,25,23631874,23456624,175250,142.65335235378032
1747352183595726,23658764,1,258,25,23726541,23549184,177357,140.9586314608389
1747352183689873,23751324,1,259,25,23820688,23641744,178944,139.7085121602289
1747352183783604,23843884,1,260,25,23914419,23734304,180115,138.8002109763207
1747352183877604,23936444,1,261,25,24008419,23826864,181555,137.69931976536037
1747352183967924,24029004,1,262,25,24098739,23919424,179315,139.41945737947188
1747352184061919,24121564,1,263,25,24192734,24011984,180750,138.31258644536652
1747352184156455,24214124,1,264,25,24287270,24104544,182726,136.8168733513567
1747352184250541,24306684,1,265,25,24381356,24197104,184252,135.6837374899594
1747352184340735,24399244,1,266,25,24471550,24289664,181886,137.44873162310458
1747352184435116,24491804,1,267,25,24565931,24382224,183707,136.08626780688817
1747352184529188,24584364,1,268,25,24660003,24474784,185219,134.9753535004508
1747352184622838,24676924,1,269,25,24753653,24567344,186309,134.18568077763285
1747352184713424,24769484,1,270,25,24844239,24659904,184335,135.6226435565682
1747352184807578,24862044,1,271,25,24938393,24752464,185929,134.45992825218227
1747352184902017,24954604,1,272,25,25032832,24845024,187808,133.1146703015846
1747352184996336,25047164,1,273,25,25127151,24937584,189567,131.879493793751
1747352185085393,25139724,1,274,25,25216208,25030144,186064,134.3623699372259
1747352185180146,25232284,1,275,25,25310961,25122704,188257,132.79718682439432
1747352185274402,25324844,1,276,25,25405217,25215264,189953,131.61150389833273
1747352185368983,25417404,1,277,25,25499798,25307824,191974,130.22596809984685
1747352185462882,25509964,1,278,25,25593697,25400384,193313,129.3239461391629
1747352185553053,25602524,1,279,25,25683868,25492944,190924,130.94215499361002
1747352185646844,25695084,1,280,25,25777659,25585504,192155,130.10330202180532
1747352185741267,25787644,1,281,25,25872082,25678064,194018,128.8540238534569
1747352185835916,25880204,1,282,25,25966731,25770624,196107,127.48142595623816
1747352185925428,25972772,1,283,25,26056243,25863192,193051,129.49945869226266
1747352186019991,26065324,1,284,25,26150806,25955744,195062,128.16437850529573
1747352186114303,26157884,1,285,25,26245118,26048304,196814,127.02348410174072
1747352186208253,26250444,1,286,25,26339068,26140864,198204,126.13267138907388
1747352186298174,26343004,1,287,25,26428989,26233424,195565,127.8347352542633
1747352186393071,26435564,1,288,25,26523886,26325984,197902,126.3251508322301
1747352186486457,26528124,1,289,25,26617272,26418544,198728,125.80008856326236
1747352186581508,26620684,1,290,25,26712323,26511104,201219,124.24274049667278
1747352186670721,26713244,1,291,25,26801536,26603664,197872,126.34430338804884
1747352186765760,26805804,1,292,25,26896575,26696224,200351,124.78100932862826
1747352186859738,26898364,1,293,25,26990553,26788784,201769,123.90406851399372
1747352186953801,26990924,1,294,25,27084616,26881344,203272,122.9879176669684
1747352187048186,27083484,1,295,25,27179001,26973904,205097,121.89354305523727
1747352187137754,27176044,1,296,25,27268569,27066464,202105,123.69807773187205
1747352187232374,27268604,1,297,25,27363189,27159024,204165,122.44997918350352
1747352187325776,27361164,1,298,25,27456591,27251584,205007,121.94705546639872
1747352187420040,27453724,1,299,25,27550855,27344144,206711,120.94179796914533
1747352187510899,27546284,1,300,25,27641714,27436704,205010,121.94527096239209
1747352187604758,27638844,1,301,25,27735573,27529264,206309,121.17745711529793
1747352187699549,27731404,1,302,25,27830364,27621824,208540,119.88107797065312
1747352187793107,27823964,1,303,25,27923922,27714384,209538,119.31010127041397
1747352187883094,27916524,1,304,25,28013909,27806944,206965,120.7933708598072
1747352187977209,28009084,1,305,25,28108024,27899504,208520,119.89257625167848
1747352188072059,28101652,1,306,25,28202874,27992072,210802,118.59470024003568
1747352188165590,28194204,1,307,25,28296405,28084624,211781,118.0464725353077
1747352188255792,28286764,1,308,25,28386607,28177184,209423,119.37561776882195
1747352188350791,28379324,1,309,25,28481606,28269744,211862,118.00134049522804
1747352188444802,28471884,1,310,25,28575617,28362304,213313,117.19867049828188
1747352188539109,28564444,1,311,25,28669924,28454864,215060,116.24662884776342
1747352188633160,28657004,1,312,25,28763975,28547424,216551,115.4462459189752
1747352188723191,28749564,1,313,25,28854006,28639984,214022,116.81042135855192
1747352188817636,28842124,1,314,25,28948451,28732544,215907,115.79059502470972
1747352188911862,28934684,1,315,25,29042677,28825104,217573,114.90396326750104
1747352189005910,29027244,1,316,25,29136725,28917664,219061,114.12346332756628
1747352189096173,29119804,1,317,25,29226988,29010224,216764,115.33280434020408
1747352189189684,29212364,1,318,25,29320499,29102784,217715,114.82901958983076
1747352189284012,29304924,1,319,25,29414827,29195344,219483,113.90403812595964
1747352189378633,29397484,1,320,25,29509448,29287904,221544,112.84440111219442
1747352189468047,29490044,1,321,25,29598862,29380464,218398,114.46991272813852
1747352189566783,29582604,1,322,25,29697598,29473024,224574,111.32188053826356
1747352189657169,29675164,1,323,25,29787984,29565584,222400,112.41007194244604
1747352189751068,29767724,1,324,25,29881883,29658144,223739,111.7373368076196
1747352189841456,29860284,1,325,25,29972271,29750704,221567,112.83268717814477
1747352189935702,29952844,1,326,25,30066517,29843264,223253,111.98057808853632
1747352190029785,30045404,1,327,25,30160600,29935824,224776,111.22183863045876
1747352190123466,30137964,1,328,25,30254281,30028384,225897,110.669907081546
1747352190217838,30230524,1,329,25,30348653,30120944,227709,109.78924855846716
1747352190307984,30323084,1,330,25,30438799,30213504,225295,110.96562285004106
1747352190401952,30415644,1,331,25,30532767,30306064,226703,110.27644098225431
1747352190496160,30508204,1,332,25,30626975,30398624,228351,109.48058033466025
1747352190590383,30600764,1,333,25,30721198,30491184,230014,108.68903631952838
1747352190681372,30693324,1,334,25,30812187,30583744,228443,109.4364896276095
1747352190774469,30785884,1,335,25,30905284,30676304,228980,109.17984103415148
1747352190869161,30878444,1,336,25,30999976,30768864,231112,108.17266087438124
1747352190963059,30971004,1,337,25,31093874,30861424,232450,107.55001075500108
1747352191053226,31063564,1,338,25,31184041,30953984,230057,108.66872122995603
1747352191147469,31156124,1,339,25,31278284,31046544,231740,107.87952015189435
1747352191241986,31248684,1,340,25,31372801,31139104,233697,106.9761272074524
1747352191335972,31341244,1,341,25,31466787,31231664,235123,106.3273265482322
1747352191429795,31433804,1,342,25,31560610,31324224,236386,105.75922431954514
1747352191520640,31526364,1,343,25,31651455,31416784,234671,106.53212369657948
1747352191614292,31618924,1,344,25,31745107,31509344,235763,106.0386913977172
1747352191708565,31711484,1,345,25,31839380,31601904,237476,105.27379608886793
1747352191803456,31804044,1,346,25,31934271,31694464,239807,104.25050144491196
1747352191893626,31896612,1,347,25,32024441,31787032,237409,105.3035057643139
1747352191987138,31989164,1,348,25,32117953,31879584,238369,104.87940965477894
1747352192081454,32081724,1,349,25,32212269,31972144,240125,104.1124414367517
1747352192175465,32174284,1,350,25,32306280,32064704,241576,103.48710136768553
1747352192266013,32266844,1,351,25,32396828,32157264,239564,104.35624718238132
1747352192360477,32359404,1,352,25,32491292,32249824,241468,103.53338744678383
1747352192454660,32451964,1,353,25,32585475,32342384,243091,102.842145533977
1747352192549109,32544524,1,354,25,32679924,32434944,244980,102.04914686913216
1747352192638558,32637084,1,355,25,32769373,32527504,241869,103.36173713869904
1747352192733410,32729644,1,356,25,32864225,32620064,244161,102.39145481874664
1747352192827700,32822204,1,357,25,32958515,32712624,245891,101.67106563477311
1747352192921892,32914764,1,358,25,33052707,32805184,247523,101.0007150850628
1747352193015778,33007324,1,359,25,33146593,32897744,248849,100.4625294857524
1747352193106017,33099884,1,360,25,33236832,32990304,246528,101.40835929387332
1747352193199886,33192444,1,361,25,33330701,33082864,247837,100.87275104201552
1747352193294381,33285004,1,362,25,33425196,33175424,249772,100.0912832503243
1747352193388554,33377564,1,363,25,33519369,33267984,251385,99.44905225053203
1747352193478737,33470124,1,364,25,33609552,33360544,249008,100.39838077491486
1747352193572780,33562684,1,365,25,33703595,33453104,250491,99.80398497351202
1747352193667374,33655244,1,366,25,33798189,33545664,252525,99.000099000099
1747352193760889,33747804,1,367,25,33891704,33638224,253480,98.62711062016729
1747352193850673,33840364,1,368,25,33981488,33730784,250704,99.71919075882316
1747352193945456,33932924,1,369,25,34076271,33823344,252927,98.842749093612
1747352194038923,34025492,1,370,25,34169738,33915912,253826,98.49266820577876
1747352194133711,34118044,1,371,25,34264526,34008464,256062,97.63260460357256
1747352194224112,34210604,1,372,25,34354927,34101024,253903,98.46279878536292
1747352194318080,34303164,1,373,25,34448895,34193584,255311,97.91979194002607
1747352194412282,34395724,1,374,25,34543097,34286144,256953,97.29405766813386
1747352194506496,34488284,1,375,25,34637311,34378704,258607,96.67178382642388
1747352194600446,34580844,1,376,25,34731261,34471264,259997,96.15495563410347
1747352194690862,34673404,1,377,25,34821677,34563824,257853,96.95446630444478
1747352194784253,34765964,1,378,25,34915068,34656384,258684,96.64300845819608
1747352194878826,34858524,1,379,25,35009641,34748944,260697,95.8967690460573
1747352194973577,34951084,1,380,25,35104392,34841504,262888,95.0975320288488
1747352195063773,35043644,1,381,25,35194588,34934064,260524,95.96044894136432
1747352195157321,35136204,1,382,25,35288136,35026624,261512,95.59790755299947
1747352195251417,35228764,1,383,25,35382232,35119184,263048,95.03968857394848
1747352195345841,35321324,1,384,25,35476656,35211744,264912,94.37096092287253
1747352195436365,35413884,1,385,25,35567180,35304304,262876,95.1018731264931
1747352195530373,35506444,1,386,25,35661188,35396864,264324,94.58089314629017
1747352195624085,35599004,1,387,25,35754900,35489424,265476,94.17047115370129
1747352195718244,35691564,1,388,25,35849059,35581984,267075,93.60666479453336
1747352195808234,35784124,1,389,25,35939049,35674544,264505,94.51617171698078
1747352195902696,35876684,1,390,25,36033511,35767104,266407,93.84137804186828
1747352195997505,35969244,1,391,25,36128320,35859664,268656,93.05580370436545
1747352196091574,36061804,1,392,25,36222389,35952224,270165,92.5360427886662
1747352196185817,36154364,1,393,25,36316632,36044784,271848,91.96315588122776
1747352196275503,36246924,1,394,25,36406318,36137344,268974,92.94578658160268
1747352196369700,36339484,1,395,25,36500515,36229904,270611,92.38353208110536
1747352196464298,36432044,1,396,25,36595113,36322464,272649,91.69298255265927
1747352196557538,36524604,1,397,25,36688353,36415024,273329,91.46486468687918
1747352196647922,36617164,1,398,25,36778737,36507584,271153,92.19886927306725
1747352196742690,36709724,1,399,25,36873505,36600144,273361,91.45415768891684
1747352196836725,36802284,1,400,25,36967540,36692704,274836,90.96333813619758
1747352196930439,36894844,1,401,25,37061254,36785264,275990,90.58299213739627
1747352197021347,36987404,1,402,25,37152162,36877824,274338,91.12846197027024
1747352197115630,37079964,1,403,25,37246445,36970384,276061,90.55969513984228
1747352197209842,37172524,1,404,25,37340657,37062944,277713,90.02099289554324
1747352197303988,37265084,1,405,25,37434803,37155504,279299,89.50980848481376
1747352197393617,37357644,1,406,25,37524432,37248064,276368,90.45909801424187
1747352197488424,37450204,1,407,25,37619239,37340624,278615,89.72955512086571
1747352197582548,37542764,1,408,25,37713363,37433184,280179,89.22867167061057
1747352197676347,37635324,1,409,25,37807162,37525744,281418,88.83582428984641
1747352197770154,37727884,1,410,25,37900969,37618304,282665,88.44391771177897
1747352197860259,37820452,1,411,25,37991074,37710872,280202,89.22134745647783
1747352197954863,37913004,1,412,25,38085678,37803424,282254,88.57270401836644
1747352198049194,38005564,1,413,25,38180009,37895984,284025,88.02042073761112
1747352198142925,38098124,1,414,25,38273740,37988544,285196,87.65901345039902
1747352198232988,38190684,1,415,25,38363803,38081104,282699,88.43328062709809
1747352198327463,38283244,1,416,25,38458278,38173664,284614,87.83826515912781
1747352198421647,38375804,1,417,25,38552462,38266224,286238,87.33990595238927
1747352198516256,38468364,1,418,25,38647071,38358784,288287,86.71913752614581
1747352198605736,38560924,1,419,25,38736551,38451344,285207,87.65563257563805
1747352198700107,38653484,1,420,25,38830922,38543904,287018,87.10255105951543
1747352198794010,38746044,1,421,25,38924825,38636464,288361,86.69688342043482
1747352198888660,38838604,1,422,25,39019475,38729024,290451,86.07303813724174
1747352198982073,38931164,1,423,25,39112888,38821584,291304,85.82099799522149
1747352199072518,39023724,1,424,25,39203333,38914144,289189,86.44865468603578
1747352199167209,39116284,1,425,25,39298024,39006704,291320,85.81628449814636
1747352199261817,39208844,1,426,25,39392632,39099264,293368,85.21720160344687
1747352199355250,39301404,1,427,25,39486065,39191824,294241,84.9643659449227
1747352199445811,39393964,1,428,25,39576626,39284384,292242,85.54554102421966
1747352199539752,39486524,1,429,25,39670567,39376944,293623,85.14319382337214
1747352199633843,39579084,1,430,25,39764658,39469504,295154,84.70154563380471
1747352199727841,39671644,1,431,25,39858656,39562064,296592,84.29087770405135
1747352199818314,39764204,1,432,25,39949129,39654624,294505,84.888202237653
1747352199912397,39856764,1,433,25,40043212,39747184,296028,84.45147080681556
1747352200006885,39949332,1,434,25,40137700,39839752,297948,83.9072589847893
1747352200100556,40041884,1,435,25,40231371,39932304,299067,83.59330852283935
1747352200191010,40134444,1,436,25,40321825,40024864,296961,84.186138920599
1747352200285225,40227004,1,437,25,40416040,40117424,298616,83.71955956814102
1747352200379634,40319564,1,438,25,40510449,40209984,300465,83.20436656515734
1747352200473831,40412124,1,439,25,40604646,40302544,302102,82.75350709363063
1747352200567747,40504684,1,440,25,40698562,40395104,303458,82.38372361249333
1747352200658096,40597244,1,441,25,40788911,40487664,301247,82.98837830750182
1747352200752651,40689804,1,442,25,40883466,40580224,303242,82.44240573535328
1747352200846027,40782364,1,443,25,40976842,40672784,304058,82.22115517434173
1747352200940306,40874924,1,444,25,41071121,40765344,305777,81.75892889262435
1747352201031096,40967484,1,445,25,41161911,40857904,304007,82.23494853736919
1747352201124760,41060044,1,446,25,41255575,40950464,305111,81.93739327654525
1747352201219169,41152604,1,447,25,41349984,41043024,306960,81.44383633046651
1747352201313367,41245164,1,448,25,41444182,41135584,308598,81.0115425245789
1747352201403861,41337724,1,449,25,41534676,41228144,306532,81.55755353437813
1747352201498021,41430284,1,450,25,41628836,41320704,308132,81.13405942907585
1747352201592000,41522844,1,451,25,41722815,41413264,309551,80.76213612619568
1747352201685573,41615404,1,452,25,41816388,41505824,310564,80.49870558081426
1747352201776047,41707964,1,453,25,41906862,41598384,308478,81.0430565550866
1747352201870262,41800524,1,454,25,42001077,41690944,310133,80.61057675255455
1747352201964920,41893084,1,455,25,42095735,41783504,312231,80.06892332920178
1747352202058870,41985644,1,456,25,42189685,41876064,313621,79.71404976069843
1747352202153358,42078204,1,457,25,42284173,41968624,315549,79.2269980256632
1747352202242843,42170764,1,458,25,42373658,42061184,312474,80.00665655382528
1747352202337589,42263324,1,459,25,42468404,42153744,314660,79.45083582279285
1747352202431285,42355884,1,460,25,42562100,42246304,315796,79.16503058936782
1747352202525117,42448444,1,461,25,42655932,42338864,317068,78.84743966593916
1747352202615962,42541004,1,462,25,42746777,42431424,315353,79.27623964255929
1747352202710049,42633564,1,463,25,42840864,42523984,316880,78.89421863165867
1747352202804271,42726124,1,464,25,42935086,42616544,318542,78.48258628375537
1747352202898350,42818684,1,465,25,43029165,42709104,320061,78.11011026023165
1747352202988949,42911244,1,466,25,43119764,42801664,318100,78.59163784973279
1747352203079918,43003804,1,467,25,43210733,42894224,316509,78.98669548101319
1747352203177166,43096364,1,468,25,43307981,42986784,321197,77.83385274457731
1747352203271134,43188924,1,469,25,43401949,43079344,322605,77.49414919173603
1747352203360788,43281484,1,470,25,43491603,43171904,319699,78.1985555162825
1747352203459792,43374044,1,471,25,43590607,43264464,326143,76.65349248642467
1747352203549739,43466604,1,472,25,43680554,43357024,323530,77.27258677711495
1747352203643262,43559164,1,473,25,43774077,43449584,324493,77.0432644155652
1747352203738303,43651724,1,474,25,43869118,43542144,326974,76.45867867169866
1747352203827951,43744292,1,475,25,43958766,43634712,324054,77.14763588784585
1747352203922698,43836844,1,476,25,44053513,43727264,326249,76.62858736731759
1747352204016503,43929404,1,477,25,44147318,43819824,327494,76.3372764081174
1747352204110285,44021964,1,478,25,44241100,43912384,328716,76.05349298482581
1747352204200269,44114524,1,479,25,44331084,44004944,326140,76.6541975838597
1747352204295265,44207084,1,480,25,44426080,44097504,328576,76.08589793533308
1747352204389282,44299644,1,481,25,44520097,44190064,330033,75.7500007575
1747352204483574,44392204,1,482,25,44614389,44282624,331765,75.35454312540503
1747352204573292,44484764,1,483,25,44704107,44375184,328923,76.00563049710722
1747352204668076,44577324,1,484,25,44798891,44467744,331147,75.49517283864868
1747352204761634,44669884,1,485,25,44892449,44560304,332145,75.2683316021617
1747352204856491,44762444,1,486,25,44987306,44652864,334442,74.75137692036287
1747352204946262,44855004,1,487,25,45077077,44745424,331653,75.3799905322732
1747352205040072,44947564,1,488,25,45170887,44837984,332903,75.09695016266
1747352205134593,45040124,1,489,25,45265408,44930544,334864,74.65717425581728
1747352205228218,45132684,1,490,25,45359033,45023104,335929,74.42048766257156
1747352205322716,45225244,1,491,25,45453531,45115664,337867,73.99361287133695
1747352205413114,45317804,1,492,25,45543929,45208224,335705,74.47014491890202
1747352205507663,45410364,1,493,25,45638478,45300784,337694,74.03151965981036
1747352205601144,45502924,1,494,25,45731959,45393344,338615,73.83016109741152
1747352205695812,45595484,1,495,25,45826627,45485904,340723,73.37338541865387
1747352205785668,45688044,1,496,25,45916483,45578464,338019,73.96033950754247
1747352205880256,45780604,1,497,25,46011071,45671024,340047,73.51924880972336
1747352205974393,45873172,1,498,25,46105208,45763592,341616,73.18158400074938
1747352206067886,45965724,1,499,25,46198701,45856144,342557,72.98055506090957
1747352206158666,46058284,1,500,25,46289481,45948704,340777,73.36175856938702
1747352206253024,46150844,1,501,25,46383839,46041264,342575,72.97672042618404
1747352206346723,46243404,1,502,25,46477538,46133824,343714,72.73489005394019
1747352206440920,46335964,1,503,25,46571735,46226384,345351,72.39011903831174
1747352206530729,46428524,1,504,25,46661544,46318944,342600,72.97139521307648
1747352206624960,46521084,1,505,25,46755775,46411504,344271,72.61721144098689
1747352206719660,46613644,1,506,25,46850475,46504064,346411,72.16860896449593
1747352206813994,46706204,1,507,25,46944809,46596624,348185,71.80091043554432
1747352206908000,46798764,1,508,25,47038815,46689184,349631,71.50395702898197
1747352206998469,46891324,1,509,25,47129284,46781744,347540,71.93416585141279
1747352207092117,46983884,1,510,25,47222932,46874304,348628,71.70967334809596
1747352207186012,47076444,1,511,25,47316827,46966864,349963,71.43612324731471
1747352207281085,47169004,1,512,25,47411900,47059424,352476,70.92681487533903
1747352207371105,47261564,1,513,25,47501920,47151984,349936,71.44163504183622
1747352207464943,47354124,1,514,25,47595758,47244544,351214,71.1816727123634
1747352207559610,47446684,1,515,25,47690425,47337104,353321,70.75718680746404
1747352207653448,47539244,1,516,25,47784263,47429664,354599,70.50217287696807
1747352207744139,47631804,1,517,25,47874954,47522224,352730,70.8757406514898
1747352207837916,47724364,1,518,25,47968731,47614784,353947,70.63204378056601
1747352207932222,47816924,1,519,25,48063037,47707344,355693,70.28533032699548
1747352208026458,47909484,1,520,25,48157273,47799904,357369,69.95570404819668
1747352208120279,48002044,1,521,25,48251094,47892464,358630,69.70972868973594
1747352208210429,48094604,1,522,25,48341244,47985024,356220,70.18134860479479
1747352208304324,48187164,1,523,25,48435139,48077584,357555,69.91931311266798
1747352208399209,48279724,1,524,25,48530024,48170144,359880,69.46760031121485
1747352208493189,48372284,1,525,25,48624004,48262704,361300,69.1945751453086
1747352208583590,48464844,1,526,25,48714405,48355264,359141,69.61054293439068
1747352208676885,48557404,1,527,25,48807700,48447824,359876,69.4683724393958
1747352208771560,48649964,1,528,25,48902375,48540384,361991,69.06249050390755
1747352208866056,48742524,1,529,25,48996871,48632944,363927,68.69509544496562
1747352208955789,48835084,1,530,25,49086604,48725504,361100,69.23289947382997
1747352209050490,48927644,1,531,25,49181305,48818064,363241,68.82482979619591
1747352209144344,49020204,1,532,25,49275159,48910624,364535,68.58052038898872
1747352209238438,49112764,1,533,25,49369253,49003184,366069,68.29313599348757
1747352209328802,49205324,1,534,25,49459617,49095744,363873,68.70529003251134
1747352209422474,49297884,1,535,25,49553289,49188304,364985,68.49596558762688
1747352209516757,49390444,1,536,25,49647572,49280864,366708,68.17413309772353
1747352209611432,49483004,1,537,25,49742247,49373424,368823,67.78319139533055
1747352209704798,49575564,1,538,25,49835613,49465984,369629,67.6353857516591
1747352209795783,49668132,1,539,25,49926598,49558552,368046,67.92629182221788
1747352209889436,49760684,1,540,25,50020251,49651104,369147,67.72369814735052
1747352209983929,49853244,1,541,25,50114744,49743664,371080,67.37091732241026
1747352210077622,49945804,1,542,25,50208437,49836224,372213,67.16584321342887
1747352210168611,50038364,1,543,25,50299426,49928784,370642,67.45053177999255
1747352210262347,50130924,1,544,25,50393162,50021344,371818,67.23719669300571
1747352210356567,50223484,1,545,25,50487382,50113904,373478,66.93834710478262
1747352210451060,50316044,1,546,25,50581875,50206464,375411,66.5936799933939
1747352210541203,50408604,1,547,25,50672018,50299024,372994,67.02520683978831
1747352210635433,50501164,1,548,25,50766248,50391584,374664,66.72645356906455
1747352210728888,50593724,1,549,25,50859703,50484144,375559,66.56743680753225
1747352210823198,50686284,1,550,25,50954013,50576704,377309,66.25868982717083
1747352210913347,50778844,1,551,25,51044162,50669264,374898,66.6848049336086
1747352211007854,50871404,1,552,25,51138669,50761824,376845,66.34027252583954
1747352211102179,50963964,1,553,25,51232994,50854384,378610,66.03100816143261
1747352211196455,51056524,1,554,25,51327270,50946944,380326,65.73308161945279
1747352211290168,51149084,1,555,25,51420983,51039504,381479,65.53440687429715
1747352211380747,51241644,1,556,25,51511562,51132064,379498,65.87650000790518
1747352211474858,51334204,1,557,25,51605673,51224624,381049,65.60836007967478
1747352211569214,51426764,1,558,25,51700029,51317184,382845,65.30057856312607
1747352211662907,51519324,1,559,25,51793722,51409744,383978,65.10789680658787
1747352211752974,51611884,1,560,25,51883789,51502304,381485,65.53337614847241
1747352211847695,51704444,1,561,25,51978510,51594864,383646,65.16423995037091
1747352211942046,51797012,1,562,25,52072861,51687432,385429,64.86278925560867
1747352212035052,51889564,1,563,25,52165867,51779984,385883,64.7864767299933
1747352212126126,51982124,1,564,25,52256941,51872544,384397,65.03692796770007
1747352212220081,52074684,1,565,25,52350896,51965104,385792,64.80175846051758
1747352212313827,52167244,1,566,25,52444642,52057664,386978,64.60315573495134
1747352212408178,52259804,1,567,25,52538993,52150224,388769,64.30553876466489
1747352212499094,52352364,1,568,25,52629909,52242784,387125,64.57862447529868
1747352212593319,52444924,1,569,25,52724134,52335344,388790,64.30206538234007
1747352212687400,52537484,1,570,25,52818215,52427904,390311,64.05148714742859
1747352212781230,52630044,1,571,25,52912045,52520464,391581,63.84375135667971
1747352212875475,52722604,1,572,25,53006290,52613024,393266,63.57020439092116
1747352212965485,52815164,1,573,25,53096300,52705584,390716,63.98509403249419
1747352213059401,52907724,1,574,25,53190216,52798144,392072,63.763798485992375
1747352213154392,53000284,1,575,25,53285207,52890704,394503,63.370874239232656
1747352213248398,53092844,1,576,25,53379213,52983264,395949,63.139444726467296
1747352213338118,53185404,1,577,25,53468933,53075824,393109,63.59559307978195
1747352213432130,53277964,1,578,25,53562945,53168384,394561,63.36155879572487
1747352213526668,53370524,1,579,25,53657483,53260944,396539,63.04550119912544
1747352213620628,53463084,1,580,25,53751443,53353504,397939,62.82369910966254
1747352213711160,53555644,1,581,25,53841975,53446064,395911,63.14550492408648
1747352213805151,53648204,1,582,25,53935966,53538624,397342,62.91809071278647
1747352213899501,53740764,1,583,25,54030316,53631184,399132,62.63591994628344
1747352213993776,53833324,1,584,25,54124591,53723744,400847,62.36793589574077
1747352214084166,53925884,1,585,25,54214981,53816304,398677,62.707404741181456
1747352214178321,54018444,1,586,25,54309136,53908864,400272,62.45752888036135
1747352214272173,54111004,1,587,25,54402988,54001424,401564,62.256576784771546
1747352214366438,54203564,1,588,25,54497253,54093984,403269,61.993359271354855
1747352214460488,54296124,1,589,25,54591303,54186544,404759,61.76514913812911
1747352214550731,54388684,1,590,25,54681546,54279104,402442,62.12075280413078
1747352214644729,54481244,1,591,25,54775544,54371664,403880,61.89957413092998
1747352214738955,54573804,1,592,25,54869770,54464224,405546,61.64528808076026
1747352214833108,54666364,1,593,25,54963923,54556784,407139,61.404090494892415
1747352214923863,54758924,1,594,25,55054678,54649344,405334,61.67753013564122
1747352215017697,54851484,1,595,25,55148512,54741904,406608,61.48427969936646
1747352215111648,54944044,1,596,25,55242463,54834464,407999,61.27465998691173
1747352215205808,55036604,1,597,25,55336623,54927024,409599,61.035305261975736
1747352215296191,55129164,1,598,25,55427006,55019584,407422,61.36143850847524
1747352215390617,55221724,1,599,25,55521432,55112144,409288,61.08168331346143
1747352215484172,55314284,1,600,25,55614987,55204704,410283,60.93355074424239
1747352215578301,55406844,1,601,25,55709116,55297264,411852,60.701417013878775
1747352215668244,55499404,1,602,25,55799059,55389824,409235,61.089593998558286
1747352215762795,55591972,1,603,25,55893610,55482392,411218,60.79500410974228
1747352215857463,55684524,1,604,25,55988278,55574944,413334,60.48377341326869
1747352215951249,55777084,1,605,25,56082064,55667504,414560,60.30490158240062
1747352216045919,55869644,1,606,25,56176734,55760064,416670,59.99952000383997
1747352216136089,55962204,1,607,25,56266904,55852624,414280,60.34565994013711
1747352216230256,56054764,1,608,25,56361071,55945184,415887,60.11248247721136
1747352216324138,56147324,1,609,25,56454953,56037744,417209,59.92200551761827
1747352216418639,56239884,1,610,25,56549454,56130304,419150,59.64451866873434
1747352216508762,56332444,1,611,25,56639577,56222864,416713,59.993328741843904
1747352216602574,56425004,1,612,25,56733389,56315424,417965,59.81362075771895
1747352216696589,56517564,1,613,25,56827404,56407984,419420,59.60612274092794
1747352216790590,56610124,1,614,25,56921405,56500544,420861,59.40203535133928
1747352216881587,56702684,1,615,25,57012402,56593104,419298,59.6234658882227
1747352216974954,56795244,1,616,25,57105769,56685664,420105,59.50893229073684
1747352217069317,56887804,1,617,25,57200132,56778224,421908,59.254624230874974
1747352217162952,56980364,1,618,25,57293767,56870784,422983,59.1040301856103
1747352217253656,57072924,1,619,25,57384471,56963344,421127,59.3645147425836
1747352217347669,57165484,1,620,25,57478484,57055904,422580,59.1603956647262
1747352217441605,57258044,1,621,25,57572420,57148464,423956,58.96838351149648
1747352217536167,57350604,1,622,25,57666982,57241024,425958,58.69123246892886
1747352217630344,57443164,1,623,25,57761159,57333584,427575,58.46927439630475
1747352217720662,57535724,1,624,25,57851477,57426144,425333,58.77747553093693
1747352217814556,57628284,1,625,25,57945371,57518704,426667,58.593704223668574
1747352217909378,57720852,1,626,25,58040193,57611272,428921,58.2857915560208
1747352218002946,57813404,1,627,25,58133761,57703824,429937,58.14805424980869
1747352218093479,57905964,1,628,25,58224294,57796384,427910,58.4235002687481
1747352218187439,57998524,1,629,25,58318254,57888944,429310,58.232978500384334
1747352218281633,58091084,1,630,25,58412448,57981504,430944,58.01217791638821
1747352218375695,58183644,1,631,25,58506510,58074064,432446,57.8106861897208
1747352218466323,58276204,1,632,25,58597138,58166624,430514,58.070120832307424
1747352218560349,58368764,1,633,25,58691164,58259184,431980,57.87304967822585
1747352218654440,58461324,1,634,25,58785255,58351744,433511,57.66866354025619
1747352218748968,58553884,1,635,25,58879783,58444304,435479,57.408049527072485
1747352218842587,58646444,1,636,25,58973402,58536864,436538,57.26878301545341
1747352218932742,58739004,1,637,25,59063557,58629424,434133,57.586039301320106
1747352219026756,58831564,1,638,25,59157571,58721984,435587,57.39381570157053
1747352219121343,58924124,1,639,25,59252158,58814544,437614,57.127971225783455
1747352219214964,59016684,1,640,25,59345779,58907104,438675,56.989798826010144
1747352219305899,59109244,1,641,25,59436714,58999664,437050,57.20169317011784
1747352219399423,59201804,1,642,25,59530238,59092224,438014,57.07580123009767
1747352219494211,59294364,1,643,25,59625026,59184784,440242,56.78694899623389
1747352219588112,59386924,1,644,25,59718927,59277344,441583,56.61449829363902
1747352219678588,59479484,1,645,25,59809403,59369904,439499,56.88295081445009
1747352219772794,59572044,1,646,25,59903609,59462464,441145,56.67070917725464
1747352219866884,59664604,1,647,25,59997699,59555024,442675,56.474840458575706
1747352219961263,59757164,1,648,25,60092078,59647584,444494,56.2437288242361
1747352220051374,59849724,1,649,25,60182189,59740144,442045,56.55532807745818
1747352220145343,59942284,1,650,25,60276158,59832704,443454,56.37563309835969
1747352220239763,60034844,1,651,25,60370578,59925264,445314,56.14016177349017
1747352220333218,60127404,1,652,25,60464033,60017824,446209,56.02755659343491
1747352220427741,60219964,1,653,25,60558556,60110384,448172,55.782155065465936
1747352220518084,60312524,1,654,25,60648899,60202944,445955,56.05946788353085
1747352220612770,60405084,1,655,25,60743585,60295504,448081,55.79348376744383
1747352220706580,60497644,1,656,25,60837395,60388064,449331,55.63827111861857
1747352220800657,60590204,1,657,25,60931472,60480624,450848,55.45106111150543
1747352220891195,60682764,1,658,25,61022010,60573184,448826,55.70087294408078
1747352220985431,60775324,1,659,25,61116246,60665744,450502,55.49364930677333
1747352221078848,60867884,1,660,25,61209663,60758304,451359,55.38828294107351
1747352221172835,60960444,1,661,25,61303650,60850864,452786,55.213721272300816
1747352221262970,61053004,1,662,25,61393785,60943424,450361,55.5110233790226
1747352221357863,61145564,1,663,25,61488678,61035984,452694,55.224942234710426
1747352221451664,61238124,1,664,25,61582479,61128544,453935,55.0739643341007
1747352221546456,61330684,1,665,25,61677271,61221104,456167,54.80449046073039
1747352221635730,61423244,1,666,25,61766545,61313664,452881,55.20213919329802
1747352221730407,61515812,1,667,25,61861222,61406232,454990,54.94626255522099
1747352221824906,61608364,1,668,25,61955721,61498784,456937,54.71213755944474
1747352221918995,61700924,1,669,25,62049810,61591344,458466,54.52967068441281
1747352222012917,61793484,1,670,25,62143732,61683904,459828,54.368155049279295
1747352222103424,61886044,1,671,25,62234239,61776464,457775,54.61198186882202
1747352222196983,61978604,1,672,25,62327798,61869024,458774,54.49306194335337
1747352222291714,62071164,1,673,25,62422529,61961584,460945,54.2364056449251
1747352222385657,62163724,1,674,25,62516472,62054144,462328,54.07416379713104
1747352222476554,62256284,1,675,25,62607369,62146704,460665,54.26937145213984
1747352222569982,62348844,1,676,25,62700797,62239264,461533,54.167307646473816
1747352222664419,62441404,1,677,25,62795234,62331824,463410,53.94790790013163
1747352222759025,62533964,1,678,25,62889840,62424384,465456,53.71076965384484
1747352222848761,62626524,1,679,25,62979576,62516944,462632,54.03863113662696
1747352222942409,62719084,1,680,25,63073224,62609504,463720,53.91184335374795
1747352223037483,62811644,1,681,25,63168298,62702064,466234,53.62114303118177
1747352223130907,62904204,1,682,25,63261722,62794624,467098,53.52195898933415
1747352223221170,62996764,1,683,25,63351985,62887184,464801,53.78645915133573
1747352223315771,63089324,1,684,25,63446586,62979744,466842,53.55130857977646
1747352223409657,63181884,1,685,25,63540472,63072304,468168,53.39963431930418
1747352223504146,63274444,1,686,25,63634961,63164864,470097,53.18051380885222
1747352223598363,63367004,1,687,25,63729178,63257424,471754,52.99372130389991
1747352223688712,63459564,1,688,25,63819527,63349984,469543,53.24325993572474
1747352223786412,63552124,1,689,25,63917227,63442544,474683,52.66672705784703
1747352223876408,63644692,1,690,25,64007223,63535112,472111,52.95364861229668
1747352223970306,63737244,1,691,25,64101121,63627664,473457,52.80310566746294
1747352224060935,63829804,1,692,25,64191750,63720224,471526,53.0193456988586
1747352224155186,63922364,1,693,25,64286001,63812784,473217,52.829885654995486
1747352224249224,64014924,1,694,25,64380039,63905344,474695,52.66539567511771
1747352224343195,64107484,1,695,25,64474010,63997904,476106,52.50931515250806
1747352224433388,64200044,1,696,25,64564203,64090464,473739,52.77167385416865
1747352224527761,64292604,1,697,25,64658576,64183024,475552,52.570486508310346
1747352224621461,64385164,1,698,25,64752276,64275584,476692,52.44476517331946
1747352224716464,64477724,1,699,25,64847279,64368144,479135,52.177361286485024
1747352224806572,64570284,1,700,25,64937387,64460704,476683,52.44575535523608
1747352224899962,64662844,1,701,25,65030777,64553264,477513,52.354595581690965
1747352224994958,64755404,1,702,25,65125773,64645824,479949,52.08886777553448
1747352225088299,64847964,1,703,25,65219114,64738384,480730,52.00424354627338
1747352225183485,64940524,1,704,25,65314300,64830944,483356,51.72171236107548
1747352225273528,65033084,1,705,25,65404343,64923504,480839,51.99245485495145
1747352225367283,65125644,1,706,25,65498098,65016064,482034,51.863561491513046
1747352225461287,65218204,1,707,25,65592102,65108624,483478,51.70866099388183
1747352225555287,65310764,1,708,25,65686102,65201184,484918,51.55510828634944
1747352225645857,65403324,1,709,25,65776672,65293744,482928,51.76755127058278
1747352225739755,65495884,1,710,25,65870570,65386304,484266,51.62452040820541
1747352225834740,65588444,1,711,25,65965555,65478864,486691,51.36729464896619
1747352225928167,65681004,1,712,25,66058982,65571424,487558,51.27595075867897
1747352226018423,65773564,1,713,25,66149238,65663984,485254,51.5194104530823
1747352226112781,65866124,1,714,25,66243596,65756544,487052,51.329221520494734
1747352226206824,65958684,1,715,25,66337639,65849104,488535,51.17340620426377
1747352226301569,66051244,1,716,25,66432384,65941664,490720,50.94554939680469
1747352226395632,66143804,1,717,25,66526447,66034224,492223,50.78998746503109
1747352226485101,66236364,1,718,25,66615916,66126784,489132,51.11094755607893
1747352226579875,66328924,1,719,25,66710690,66219344,491346,50.8806421544085
1747352226674244,66421484,1,720,25,66805059,66311904,493155,50.694000871936815
1747352226768557,66514044,1,721,25,66899372,66404464,494908,50.51443904725727
1747352226858086,66606604,1,722,25,66988901,66497024,491877,50.82571455872098
1747352226952203,66699164,1,723,25,67083018,66589584,493434,50.665337208218325
1747352227046486,66791724,1,724,25,67177301,66682144,495157,50.48903681054696
1747352227140953,66884284,1,725,25,67271768,66774704,497064,50.29533420243671
1747352227230648,66976844,1,726,25,67361463,66867264,494199,50.5869093219533
1747352227325594,67069404,1,727,25,67456409,66959824,496585,50.3438484851536
1747352227418919,67161964,1,728,25,67549734,67052384,497350,50.26641198351262
1747352227513282,67254524,1,729,25,67644097,67144944,499153,50.08484372527061
1747352227603957,67347084,1,730,25,67734772,67237504,497268,50.274700966078655
1747352227698066,67439652,1,731,25,67828881,67330072,498809,50.119384373577866
1747352227791962,67532204,1,732,25,67922777,67422624,500153,49.98470468036781
1747352227886301,67624764,1,733,25,68017116,67515184,501932,49.80754365133125
1747352227980693,67717324,1,734,25,68111508,67607744,503764,49.626412367695984
1747352228070766,67809884,1,735,25,68201581,67700304,501277,49.87262531494563
1747352228164888,67902444,1,736,25,68295703,67792864,502839,49.71770288303015
1747352228259028,67995004,1,737,25,68389843,67885424,504419,49.56197129767119
1747352228353329,68087564,1,738,25,68484144,67977984,506160,49.39149675991781
1747352228443778,68180124,1,739,25,68574593,68070544,504049,49.598352541122
1747352228537816,68272684,1,740,25,68668631,68163104,505527,49.4533427492498
1747352228631905,68365244,1,741,25,68762720,68255664,507056,49.30421886339971
1747352228725440,68457804,1,742,25,68856255,68348224,508031,49.20959547744133
1747352228815916,68550364,1,743,25,68946731,68440784,505947,49.41229022012187
1747352228910531,68642924,1,744,25,69041346,68533344,508002,49.21240467557215
1747352229004140,68735484,1,745,25,69134955,68625904,509051,49.11099280818621
1747352229098227,68828044,1,746,25,69229042,68718464,510578,48.964115179267424
1747352229188376,68920604,1,747,25,69319191,68811024,508167,49.19642558450273
1747352229282692,69013164,1,748,25,69413507,68903584,509923,49.02700996032734
1747352229376682,69105724,1,749,25,69507497,68996144,511353,48.88990579892951
1747352229471310,69198284,1,750,25,69602125,69088704,513421,48.692982951612805
1747352229565791,69290844,1,751,25,69696606,69181264,515342,48.51147393381483
1747352229655199,69383404,1,752,25,69786014,69273824,512190,48.8100119096429
1747352229749395,69475964,1,753,25,69880210,69366384,513826,48.65460292005465
1747352229843456,69568532,1,754,25,69974271,69458952,515319,48.51363912450346
1747352229937676,69661084,1,755,25,70068491,69551504,516987,48.35711536266869
1747352230028662,69753644,1,756,25,70159477,69644064,515413,48.50479130328494
1747352230122749,69846204,1,757,25,70253564,69736624,516940,48.36151197431037
1747352230216085,69938764,1,758,25,70346900,69829184,517716,48.28902332552983
1747352230310967,70031324,1,759,25,70441782,69921744,520038,48.073410020037
1747352230400656,70123884,1,760,25,70531471,70014304,517167,48.34028466626834
1747352230494654,70216444,1,761,25,70625469,70106864,518605,48.20624560118009
1747352230589014,70309004,1,762,25,70719829,70199424,520405,48.03950769112518
1747352230683159,70401564,1,763,25,70813974,70291984,521990,47.89363780915344
1747352230774251,70494124,1,764,25,70905066,70384544,520522,48.02870964147529
1747352230867530,70586684,1,765,25,70998345,70477104,521241,47.9624588242291
1747352230961917,70679244,1,766,25,71092732,70569664,523068,47.794932972386
1747352231056289,70771804,1,767,25,71187104,70662224,524880,47.62993446121018
1747352231150523,70864364,1,768,25,71281338,70754784,526554,47.4785112258192
1747352231240219,70956924,1,769,25,71371034,70847344,523690,47.73816570872081
1747352231334692,71049484,1,770,25,71465507,70939904,525603,47.56441648925139
1747352231428525,71142044,1,771,25,71559340,71032464,526876,47.44949475777982
1747352231523089,71234604,1,772,25,71653904,71125024,528880,47.26970201179852
1747352231613182,71327164,1,773,25,71743997,71217584,526413,47.491228370120034
1747352231707354,71419724,1,774,25,71838169,71310144,528025,47.34624307561195
1747352231801958,71512284,1,775,25,71932773,71402704,530069,47.163671144700025
1747352231896050,71604844,1,776,25,72026865,71495264,531601,47.02775201702028
1747352231986186,71697404,1,777,25,72117001,71587824,529177,47.24317194435888
1747352232080206,71789964,1,778,25,72211021,71680384,530637,47.113186604024975
1747352232174324,71882524,1,779,25,72305139,71772944,532195,46.97526282659552
1747352232268254,71975084,1,780,25,72399069,71865504,533565,46.85464751248677
1747352232358961,72067644,1,781,25,72489776,71958064,531712,47.01793452094367
1747352232453349,72160204,1,782,25,72584164,72050624,533540,46.856842973347824
1747352232546757,72252764,1,783,25,72677572,72143184,534388,46.78248763071027
1747352232641682,72345324,1,784,25,72772497,72235744,536753,46.57635821318185
1747352232735491,72437884,1,785,25,72866306,72328304,538002,46.46822874264408
1747352232825999,72530444,1,786,25,72956814,72420864,535950,46.64614236402649
1747352232920167,72623004,1,787,25,73050982,72513424,537558,46.50660951934489
1747352233014151,72715564,1,788,25,73144966,72605984,538982,46.383738232445616
1747352233108327,72808124,1,789,25,73239142,72698544,540598,46.24508414755511
1747352233198609,72900684,1,790,25,73329424,72791104,538320,46.44077871897756
1747352233292824,72993244,1,791,25,73423639,72883664,539975,46.29843974258068
1747352233386597,73085804,1,792,25,73517412,72976224,541188,46.19466802663769
1747352233480619,73178364,1,793,25,73611434,73068784,542650,46.07021100156639
1747352233571303,73270924,1,794,25,73702118,73161344,540774,46.23003324863991
1747352233665527,73363492,1,795,25,73796342,73253912,542430,46.0888962631123
1747352233759253,73456044,1,796,25,73890068,73346464,543604,45.98935990169315
1747352233853180,73548604,1,797,25,73983995,73439024,544971,45.87400063489617
1747352233943958,73641164,1,798,25,74074773,73531584,543189,46.02449607779244
1747352234037478,73733724,1,799,25,74168293,73624144,544149,45.9432986185769
1747352234131634,73826284,1,800,25,74262449,73716704,545745,45.80894007274459
1747352234226300,73918844,1,801,25,74357115,73809264,547851,45.63284542695003
1747352234320906,74011404,1,802,25,74451721,73901824,549897,45.46305944567801
1747352234411098,74103964,1,803,25,74541913,73994384,547529,45.659681952919385
1747352234505315,74196524,1,804,25,74636130,74086944,549186,45.52191789302714
1747352234598897,74289084,1,805,25,74729712,74179504,550208,45.43736187041991
1747352234693091,74381644,1,806,25,74823906,74272064,551842,45.30282218461081
1747352234783466,74474204,1,807,25,74914281,74364624,549657,45.48291025130218
1747352234877398,74566764,1,808,25,75008213,74457184,551029,45.36966293970009
1747352234972057,74659324,1,809,25,75102872,74549744,553128,45.19749497403856
1747352235066143,74751884,1,810,25,75196958,74642304,554654,45.07314469921789
1747352235156320,74844444,1,811,25,75287135,74734864,552271,45.26763128971104
1747352235250596,74937004,1,812,25,75381411,74827424,553987,45.12741273712199
1747352235344841,75029564,1,813,25,75475656,74919984,555672,44.99056997653292
1747352235439035,75122124,1,814,25,75569850,75012544,557306,44.85865933616362
1747352235532558,75214684,1,815,25,75663373,75105104,558269,44.78127927576133
1747352235622698,75307244,1,816,25,75753513,75197664,555849,44.97624354815786
1747352235716754,75399804,1,817,25,75847569,75290224,557345,44.8555203688918
1747352235811020,75492372,1,818,25,75941835,75382792,559043,44.7192791967702
1747352235905409,75584924,1,819,25,76036224,75475344,560880,44.57281414919412
1747352235995740,75677484,1,820,25,76126555,75567904,558651,44.75065828218333
1747352236090086,75770044,1,821,25,76220901,75660464,560437,44.608046934802665
1747352236184383,75862604,1,822,25,76315198,75753024,562174,44.47021740599886
1747352236278425,75955164,1,823,25,76409240,75845584,563656,44.353293498162
1747352236368489,76047724,1,824,25,76499304,75938144,561160,44.55057381139069
1747352236463021,76140284,1,825,25,76593836,76030704,563132,44.39456468465653
1747352236556813,76232844,1,826,25,76687628,76123264,564364,44.29765187006967
1747352236650524,76325404,1,827,25,76781339,76215824,565515,44.2074922857926
1747352236740725,76417964,1,828,25,76871540,76308384,563156,44.39267272301103
1747352236835380,76510524,1,829,25,76966195,76400944,565251,44.22813935755974
1747352236929179,76603084,1,830,25,77059994,76493504,566490,44.13140567353351
1747352237023642,76695644,1,831,25,77154457,76586064,568393,43.98365215616659
1747352237117501,76788204,1,832,25,77248316,76678624,569692,43.88336153570702
1747352237207707,76880764,1,833,25,77338522,76771184,567338,44.06544246992093
1747352237302548,76973324,1,834,25,77433363,76863744,569619,43.88898544465687
1747352237396321,77065884,1,835,25,77527136,76956304,570832,43.795722734534856
1747352237490887,77158444,1,836,25,77621702,77048864,572838,43.64235612860879
1747352237580542,77251004,1,837,25,77711357,77141424,569933,43.86480516130843
1747352237674819,77343564,1,838,25,77805634,77233984,571650,43.733053441791306
1747352237769636,77436124,1,839,25,77900451,77326544,573907,43.56106477181844
1747352237863501,77528684,1,840,25,77994316,77419104,575212,43.462236531922144
1747352237953709,77621244,1,841,25,78084524,77511664,572860,43.64068009635862
1747352238047130,77713804,1,842,25,78177945,77604224,573721,43.57518724257958
1747352238141762,77806364,1,843,25,78272577,77696784,575793,43.41838125854257
1747352238235788,77898924,1,844,25,78366603,77789344,577259,43.30811646072214
1747352238325826,77991484,1,845,25,78456641,77881904,574737,43.498156548125486
1747352238420492,78084044,1,846,25,78551307,77974464,576843,43.33934883495162
1747352238514752,78176604,1,847,25,78645567,78067024,578543,43.21199979949632
1747352238609068,78269164,1,848,25,78739883,78159584,580299,43.08123915429804
1747352238703153,78361724,1,849,25,78833968,78252144,581824,42.968320316796834
1747352238792672,78454284,1,850,25,78923487,78344704,578783,43.19408137419378
1747352238887320,78546844,1,851,25,79018135,78437264,580871,43.0388158472363
1747352238981576,78639404,1,852,25,79112391,78529824,582567,42.91351896005095
1747352239076107,78731964,1,853,25,79206922,78622384,584538,42.768819135796136
1747352239165465,78824524,1,854,25,79296280,78714944,581336,43.00438988811978
1747352239260392,78917084,1,855,25,79391207,78807504,583703,42.83000087373202
1747352239354484,79009644,1,856,25,79485299,78900064,585235,42.71788255999727
1747352239447605,79102204,1,857,25,79578420,78992624,585796,42.67697287110189
1747352239538379,79194764,1,858,25,79669194,79085184,584010,42.80748617318197
1747352239632377,79287332,1,859,25,79763192,79177752,585440,42.70292429625581
1747352239727285,79379884,1,860,25,79858100,79270304,587796,42.5317627203996
1747352239821210,79472444,1,861,25,79952025,79362864,589161,42.43322283722106
1747352239911216,79565004,1,862,25,80042031,79455424,586607,42.61797080498528
1747352240005477,79657564,1,863,25,80136292,79547984,588308,42.49474764919056
1747352240100039,79750124,1,864,25,80230854,79640544,590310,42.35062933035185
1747352240193590,79842684,1,865,25,80324405,79733104,591301,42.2796511421425
1747352240287548,79935244,1,866,25,80418363,79825664,592699,42.17992606702559
1747352240378291,80027804,1,867,25,80509106,79918224,590882,42.30963204159206
1747352240472061,80120364,1,868,25,80602876,80010784,592092,42.2231680211859
1747352240566470,80212924,1,869,25,80697285,80103344,593941,42.09172291523905
1747352240660906,80305484,1,870,25,80791721,80195904,595817,41.95919216806502
1747352240751262,80398044,1,871,25,80882077,80288464,593613,42.11498063553191
1747352240845157,80490604,1,872,25,80975972,80381024,594948,42.02047910069451
1747352240939442,80583164,1,873,25,81070257,80473584,596673,41.89899660282936
1747352241033508,80675724,1,874,25,81164323,80566144,598179,41.793509969423866
1747352241123386,80768284,1,875,25,81254201,80658704,595497,41.98173962253378
1747352241217855,80860844,1,876,25,81348670,80751264,597406,41.84758773765245
1747352241311306,80953404,1,877,25,81442121,80843824,598297,41.78526718335542
1747352241406008,81045964,1,878,25,81536823,80936384,600439,41.63620284491847
1747352241496739,81138524,1,879,25,81627554,81028944,598610,41.76341858639181
1747352241590273,81231084,1,880,25,81721088,81121504,599584,41.69557559908203
1747352241688592,81323644,1,881,25,81819407,81214064,605343,41.2988999625006
1747352241778592,81416212,1,882,25,81909407,81306632,602775,41.474845506200495
1747352241873370,81508764,1,883,25,82004185,81399184,605001,41.322245748354135
1747352241966868,81601324,1,884,25,82097683,81491744,605939,41.25827847357572
1747352242057085,81693884,1,885,25,82187900,81584304,603596,41.41843219636976
1747352242151726,81786444,1,886,25,82282541,81676864,605677,41.27612572377687
1747352242245230,81879004,1,887,25,82376045,81769424,606621,41.21189342274666
1747352242335968,81971564,1,888,25,82466783,81861984,604799,41.3360471826177
1747352242429627,82064124,1,889,25,82560442,81954544,605898,41.26107034517361
1747352242524321,82156684,1,890,25,82655136,82047104,608032,41.1162570391032
1747352242617782,82249244,1,891,25,82748597,82139664,608933,41.055419890201385
1747352242708535,82341804,1,892,25,82839350,82232224,607126,41.1776138725734
1747352242802521,82434364,1,893,25,82933336,82324784,608552,41.0811237166257
1747352242896883,82526924,1,894,25,83027698,82417344,610354,40.95983642279727
1747352242991338,82619484,1,895,25,83122153,82509904,612249,40.83305975183299
1747352243085414,82712044,1,896,25,83216229,82602464,613765,40.732202064308
1747352243174967,82804604,1,897,25,83305782,82695024,610758,40.932742591992245
1747352243269594,82897164,1,898,25,83400409,82787584,612825,40.79468037367928
1747352243363737,82989724,1,899,25,83494552,82880144,614408,40.68957435450059
1747352243457805,83082284,1,900,25,83588620,82972704,615916,40.58995057767618
1747352243548163,83174844,1,901,25,83678978,83065264,613714,40.73558693463079
1747352243642565,83267404,1,902,25,83773380,83157824,615556,40.61368908758911
1747352243736928,83359964,1,903,25,83867743,83250384,617359,40.495076608585926
1747352243830730,83452524,1,904,25,83961545,83342944,618601,40.41377236700232
1747352243920867,83545084,1,905,25,84051682,83435504,616178,40.57269165728085
1747352244014865,83637644,1,906,25,84145680,83528064,617616,40.47822595269552
1747352244109139,83730204,1,907,25,84239954,83620624,619330,40.36620218623351
1747352244203414,83822764,1,908,25,84334229,83713184,621045,40.25473194373999
1747352244293439,83915324,1,909,25,84424254,83805744,618510,40.4197183554025
1747352244387350,84007884,1,910,25,84518165,83898304,619861,40.331622734774406
1747352244481802,84100444,1,911,25,84612617,83990864,621753,40.20889324217173
1747352244576259,84193004,1,912,25,84707074,84083424,623650,40.08658702798044
1747352244670413,84285564,1,913,25,84801228,84175984,625244,39.98439009410726
1747352244760692,84378124,1,914,25,84891507,84268544,622963,40.1307942847328
1747352244854830,84470684,1,915,25,84985645,84361104,624541,40.02939758958979
1747352244949109,84563244,1,916,25,85079924,84453664,626260,39.91952224315779
1747352245043212,84655804,1,917,25,85174027,84546224,627803,39.82140894516274
1747352245133200,84748364,1,918,25,85264015,84638784,625231,39.98522146214759
1747352245227381,84840924,1,919,25,85358196,84731344,626852,39.88182218450288
1747352245321476,84933484,1,920,25,85452291,84823904,628387,39.78440037747439
1747352245416173,85026044,1,921,25,85546988,84916464,630524,39.64956131725359
1747352245506083,85118604,1,922,25,85636898,85009024,627874,39.81690593972676
1747352245600442,85211172,1,923,25,85731257,85101592,629665,39.70365194190561
1747352245694651,85303724,1,924,25,85825466,85194144,631322,39.5994437070148
1747352245788810,85396284,1,925,25,85919625,85286704,632921,39.49940039910194
1747352245878914,85488844,1,926,25,86009729,85379264,630465,39.65327179145551
1747352245973102,85581404,1,927,25,86103917,85471824,632093,39.551141999674094
1747352246066877,85673964,1,928,25,86197692,85564384,633308,39.47526322105516
1747352246160956,85766524,1,929,25,86291771,85656944,634827,39.38080768461329
1747352246255175,85859084,1,930,25,86385990,85749504,636486,39.278161656344366
1747352246345597,85951644,1,931,25,86476412,85842064,634348,39.41054436996727
1747352246439638,86044204,1,932,25,86570453,85934624,635829,39.31874765070483
1747352246533538,86136764,1,933,25,86664353,86027184,637169,39.236058251421525
1747352246628236,86229324,1,934,25,86759051,86119744,639307,39.104843213041626
1747352246718389,86321884,1,935,25,86849204,86212304,636900,39.25262992620505
1747352246812370,86414444,1,936,25,86943185,86304864,638321,39.16524757919605
1747352246906233,86507004,1,937,25,87037048,86397424,639624,39.08546270934174
1747352247000298,86599564,1,938,25,87131113,86489984,641129,38.99371265377171
1747352247090957,86692124,1,939,25,87221772,86582544,639228,39.109676046731366
1747352247185371,86784684,1,940,25,87316186,86675104,641082,38.99657142144063
1747352247279170,86877244,1,941,25,87409985,86767664,642321,38.92134929420025
1747352247373285,86969804,1,942,25,87504100,86860224,643876,38.82735185035628
1747352247463598,87062364,1,943,25,87594413,86952784,641629,38.96332615888621
1747352247557463,87154924,1,944,25,87688278,87045344,642934,38.884240061965926
1747352247651821,87247484,1,945,25,87782636,87137904,644732,38.77580141826371
1747352247745771,87340052,1,946,25,87876586,87230472,646114,38.69286225031496
1747352247840306,87432604,1,947,25,87971121,87323024,648097,38.57447264838442
1747352247930345,87525164,1,948,25,88061160,87415584,645576,38.72510750089842
1747352248024321,87617724,1,949,25,88155136,87508144,646992,38.64035413111754
1747352248118694,87710284,1,950,25,88249509,87600704,648805,38.53237875787024
1747352248213057,87802844,1,951,25,88343872,87693264,650608,38.425595750436514
1747352248303176,87895404,1,952,25,88433991,87785824,648167,38.57030672650721
1747352248397650,87987964,1,953,25,88528465,87878384,650081,38.45674615932476
1747352248491582,88080524,1,954,25,88622397,87970944,651453,38.37575389168521
1747352248585636,88173084,1,955,25,88716451,88063504,652947,38.28794680119519
1747352248676306,88265644,1,956,25,88807121,88156064,651057,38.39909562449985
1747352248770127,88358204,1,957,25,88900942,88248624,652318,38.32486609291787
1747352248864563,88450764,1,958,25,88995378,88341184,654194,38.21496375692837
1747352248958446,88543324,1,959,25,89089261,88433744,655517,38.13783624223323
1747352249048840,88635884,1,960,25,89179655,88526304,653351,38.264271425313495
1747352249146511,88728444,1,961,25,89277326,88618864,658462,37.96726310705857
1747352249236684,88821004,1,962,25,89367499,88711424,656075,38.10539953511413
1747352249331584,88913564,1,963,25,89462399,88803984,658415,37.96997334507872
1747352249425474,89006124,1,964,25,89556289,88896544,659745,37.89342852162578
1747352249515315,89098684,1,965,25,89646130,88989104,657026,38.050244586972205
1747352249609447,89191244,1,966,25,89740262,89081664,658598,37.95942289530184
1747352249703582,89283804,1,967,25,89834397,89174224,660173,37.86886164687135
1747352249798607,89376364,1,968,25,89929422,89266784,662638,37.72799024505085
1747352249888565,89468924,1,969,25,90019380,89359344,660036,37.87672187577648
1747352249982774,89561484,1,970,25,90113589,89451904,661685,37.78232844933768
1747352250077124,89654044,1,971,25,90207939,89544464,663475,37.68039489053845
1747352250170696,89746604,1,972,25,90301511,89637024,664487,37.62300842604896
1747352250265402,89839164,1,973,25,90396217,89729584,666633,37.5018938456392
1747352250355183,89931724,1,974,25,90485998,89822144,663854,37.658882826645616
1747352250449724,90024284,1,975,25,90580539,89914704,665835,37.54683968250393
1747352250543723,90116844,1,976,25,90674538,90007264,667274,37.46586859371113
1747352250634374,90209404,1,977,25,90765189,90099824,665365,37.57336198928408
1747352250728030,90301964,1,978,25,90858845,90192384,666461,37.51157232006074
1747352250822235,90394524,1,979,25,90953050,90284944,668106,37.41921192146157
1747352250916249,90487084,1,980,25,91047064,90377504,669560,37.33795328275285
1747352251010628,90579644,1,981,25,91141443,90470064,671379,37.23679173760276
1747352251100390,90672204,1,982,25,91231205,90562624,668581,37.39262707136458
1747352251194770,90764764,1,983,25,91325585,90655184,670401,37.2911138259042
1747352251289078,90857324,1,984,25,91419893,90747744,672149,37.194134038732486
1747352251382818,90949884,1,985,25,91513633,90840304,673329,37.128951819986966
1747352251473339,91042444,1,986,25,91604154,90932864,671290,37.241728612075256
1747352251567953,91135012,1,987,25,91698768,91025432,673336,37.12856582746207
1747352251661282,91227564,1,988,25,91792097,91117984,674113,37.08577048655048
1747352251755679,91320124,1,989,25,91886494,91210544,675950,36.984984096456834
1747352251845963,91412684,1,990,25,91976778,91303104,673674,37.10993744748944
1747352251940210,91505244,1,991,25,92071025,91395664,675361,37.01723966885858
1747352252034254,91597804,1,992,25,92165069,91488224,676845,36.9360784226817
1747352252128778,91690364,1,993,25,92259593,91580784,678809,36.82921116249195
1747352252223160,91782924,1,994,25,92353975,91673344,680631,36.73062202573788
1747352252312554,91875484,1,995,25,92443369,91765904,677465,36.902275394300815
1747352252406936,91968044,1,996,25,92537751,91858464,679287,36.803295219840805
1747352252501753,92060604,1,997,25,92632568,91951024,681544,36.68141748735224
1747352252595882,92153164,1,998,25,92726697,92043584,683113,36.59716620822616
1747352252685715,92245724,1,999,25,92816530,92136144,680386,36.74384834491009
1747352252780249,92338284,1,1000,25,92911064,92228704,682360,36.63755202532388
1747352252874509,92431884,1,1001,25,93005324,92322304,683020,36.602149278205616
1747352252968565,92525484,1,1002,25,93099380,92415904,683476,36.57772913752641
1747352253063049,92619084,1,1003,25,93193864,92509504,684360,36.53048103337425
1747352253160547,92712684,1,1004,25,93291362,92603104,688258,36.32358795684176
1747352253255026,92806284,1,1005,25,93385841,92696704,689137,36.27725691698458
1747352253345862,92899884,1,1006,25,93476677,92790304,686373,36.42334415835121
1747352253443958,92993484,1,1007,25,93574773,92883904,690869,36.18631028458362
1747352253537651,93087084,1,1008,25,93668466,92977504,690962,36.18143978974242
1747352253632495,93180684,1,1009,25,93763310,93071104,692206,36.116416211359045
1747352253726392,93274284,1,1010,25,93857207,93164704,692503,36.10092663858496
1747352253820575,93367884,1,1011,25,93951390,93258304,693086,36.07055978623144
1747352253914568,93461484,1,1012,25,94045383,93351904,693479,36.05011831648832
1747352254008239,93555084,1,1013,25,94139054,93445504,693550,36.04642779900512
1747352254102763,93648684,1,1014,25,94233578,93539104,694474,35.99846790520595
1747352254201440,93742284,1,1015,25,94332255,93632704,699551,35.737208580932624
1747352254290444,93835884,1,1016,25,94421259,93726304,694955,35.97355224438993
1747352254385443,93929492,1,1017,25,94516258,93819912,696346,35.901692549393545
1747352254479351,94023084,1,1018,25,94610166,93913504,696662,35.88540784483724
1747352254574200,94116684,1,1019,25,94705015,94007104,697911,35.821186369035594
1747352254668439,94210284,1,1020,25,94799254,94100704,698550,35.78841886765443
1747352254762582,94303884,1,1021,25,94893397,94194304,699093,35.76062126212106
1747352254856690,94397484,1,1022,25,94987505,94287904,699601,35.73465446733209
1747352254950910,94491084,1,1023,25,95081725,94381504,700221,35.703013762797745
1747352255045112,94584684,1,1024,25,95175927,94475104,700823,35.67234522839576
1747352255139266,94678284,1,1025,25,95270081,94568704,701377,35.64416854273807
1747352255233443,94771884,1,1026,25,95364258,94662304,701954,35.61486935041328
1747352255327664,94865484,1,1027,25,95458479,94755904,702575,35.58338967370032
1747352255421305,94959084,1,1028,25,95552120,94849504,702616,35.581313263574984
1747352255515477,95052684,1,1029,25,95646292,94943104,703188,35.55237006319789
1747352255610001,95146284,1,1030,25,95740816,95036704,704112,35.505714999886386
1747352255703990,95239884,1,1031,25,95834805,95130304,704501,35.4861100268133
1747352255798074,95333484,1,1032,25,95928889,95223904,704985,35.46174741306553
1747352255892991,95427084,1,1033,25,96023806,95317504,706302,35.39562396821756
1747352255991311,95520684,1,1034,25,96122126,95411104,711022,35.16065606971373
1747352256080988,95614284,1,1035,25,96211803,95504704,707099,35.35572812293611
1747352256174969,95707884,1,1036,25,96305784,95598304,707480,35.33668796291061
1747352256273733,95801484,1,1037,25,96404548,95691904,712644,35.080629318425466
1747352256363825,95895084,1,1038,25,96494640,95785504,709136,35.25416845287787
1747352256457998,95988684,1,1039,25,96588813,95879104,709709,35.225705183392066
1747352256552183,96082284,1,1040,25,96682998,95972704,710294,35.19669320028045
1747352256650374,96175884,1,1041,25,96781189,96066304,714885,34.97065961658169
1747352256740316,96269484,1,1042,25,96871131,96159904,711227,35.15052156343896
1747352256834586,96363084,1,1043,25,96965401,96253504,711897,35.117439741985145
1747352256933275,96456684,1,1044,25,97064090,96347104,716986,34.86818431601175
1747352257022734,96550284,1,1045,25,97153549,96440704,712845,35.07073767789632
1747352257117655,96643884,1,1046,25,97248470,96534304,714166,35.005866983306404
1747352257210863,96737484,1,1047,25,97341678,96627904,713774,35.02509197589153
1747352257309610,96831084,1,1048,25,97440425,96721504,718921,34.77433542767564
1747352257399572,96924692,1,1049,25,97530387,96815112,715275,34.95159204501765
1747352257498053,97018284,1,1050,25,97628868,96908704,720164,34.71431507267789
1747352257588717,97111884,1,1051,25,97719532,97002304,717228,34.85641943705488
1747352257682073,97205484,1,1052,25,97812888,97095904,716984,34.868281579505265
1747352257776957,97299084,1,1053,25,97907772,97189504,718268,34.805949868294284
1747352257874681,97392684,1,1054,25,98005496,97283104,722392,34.60724924971483
1747352257969537,97486284,1,1055,25,98100352,97376704,723648,34.5471831608738
1747352258063222,97579884,1,1056,25,98194037,97470304,723733,34.543125710724816
1747352258157340,97673484,1,1057,25,98288155,97563904,724251,34.51841971913052
1747352258251325,97767084,1,1058,25,98382140,97657504,724636,34.50008004018569
1747352258346366,97860684,1,1059,25,98477181,97751104,726077,34.43160987057847
1747352258439875,97954284,1,1060,25,98570690,97844704,725986,34.435925761653806
1747352258534357,98047884,1,1061,25,98665172,97938304,726868,34.39414033909871
1747352258628614,98141484,1,1062,25,98759429,98031904,727525,34.363080306518675
1747352258722456,98235084,1,1063,25,98853271,98125504,727767,34.351653757315184
1747352258817266,98328684,1,1064,25,98948081,98219104,728977,34.29463481015176
1747352258911273,98422284,1,1065,25,99042088,98312704,729384,34.27549822864225
1747352259005676,98515884,1,1066,25,99136491,98406304,730187,34.23780483629536
1747352259099842,98609484,1,1067,25,99230657,98499904,730753,34.21128616646117
1747352259193968,98703084,1,1068,25,99324783,98593504,731279,34.18667840865114
1747352259288056,98796684,1,1069,25,99418871,98687104,731767,34.16388003285199
1747352259382248,98890284,1,1070,25,99513063,98780704,732359,34.13626377227562
1747352259476175,98983884,1,1071,25,99606990,98874304,732686,34.12102865347502
1747352259570592,99077484,1,1072,25,99701407,98967904,733503,34.08302351864955
1747352259664703,99171084,1,1073,25,99795518,99061504,734014,34.059295871740865
1747352259758451,99264684,1,1074,25,99889266,99155104,734162,34.05242984518404
1747352259852671,99358284,1,1075,25,99983486,99248704,734782,34.02369682436423
1747352259946651,99451884,1,1076,25,100077466,99342304,735162,34.00611021788395
1747352260041797,99545484,1,1077,25,100172612,99435904,736708,33.93474755262601
1747352260135403,99639084,1,1078,25,100266218,99529504,736714,33.93447117877494
1747352260230063,99732684,1,1079,25,100360878,99623104,737774,33.88571567986944
1747352260323779,99826284,1,1080,25,100454594,99716704,737890,33.880388675818885
1747352260417939,99919892,1,1081,25,100548754,99810312,738442,33.85506241519307
1747352260512544,100013484,1,1082,25,100643359,99903904,739455,33.80868342225017
1747352260610291,100108124,1,1083,25,100741106,99998544,742562,33.667222400284416
1747352260704517,100202764,1,1084,25,100835332,100093184,742148,33.686003330872005
1747352260799413,100297404,1,1085,25,100930228,100187824,742404,33.6743875302396
1747352260893543,100392044,1,1086,25,101024358,100282464,741894,33.69753630572561
1747352260991216,100486684,1,1087,25,101122031,100377104,744927,33.560335442264815
1747352261089696,100581324,1,1088,25,101220511,100471744,748767,33.38822357288716
1747352261180111,100675964,1,1089,25,101310926,100566384,744542,33.577689371452514
1747352261277952,100770604,1,1090,25,101408767,100661024,747743,33.43394722518298
1747352261372531,100865244,1,1091,25,101503346,100755664,747682,33.43667495004561
1747352261466892,100959884,1,1092,25,101597707,100850304,747403,33.44915661296516
1747352261561221,101054524,1,1093,25,101692036,100944944,747092,33.46308085215743
1747352261658689,101149164,1,1094,25,101789504,101039584,749920,33.33688926818861
1747352261753910,101243804,1,1095,25,101884725,101134224,750501,33.31108153087072
1747352261847418,101338444,1,1096,25,101978233,101228864,749369,33.36140139237145
1747352261945856,101433084,1,1097,25,102076671,101323504,753167,33.19316964232368
1747352262040109,101527724,1,1098,25,102170924,101418144,752780,33.21023406572969
1747352262134394,101622364,1,1099,25,102265209,101512784,752425,33.22590291391168
1747352262228595,101717012,1,1100,25,102359410,101607432,751978,33.24565346326621
1747352262327288,101811644,1,1101,25,102458103,101702064,756039,33.06707722749752
1747352262420854,101906284,1,1102,25,102551669,101796704,754965,33.11411787301398
1747352262515208,102000924,1,1103,25,102646023,101891344,754679,33.12666709952178
1747352262610092,102095564,1,1104,25,102740907,101985984,754923,33.11596017077238
1747352262707663,102190204,1,1105,25,102838478,102080624,757854,32.98788420988739
1747352262802152,102284844,1,1106,25,102932967,102175264,757703,32.9944582507922
1747352262896426,102379484,1,1107,25,103027241,102269904,757337,33.01040355878558
1747352262994858,102474124,1,1108,25,103125673,102364544,761129,32.84594332892322
1747352263088299,102568764,1,1109,25,103219114,102459184,759930,32.897766899582855
1747352263183466,102663404,1,1110,25,103314281,102553824,760457,32.874968604404984
1747352263277544,102758044,1,1111,25,103408359,102648464,759895,32.899282137663754
1747352263375109,102852684,1,1112,25,103505924,102743104,762820,32.773131276054634
1747352263469910,102947324,1,1113,25,103600725,102837744,762981,32.76621567247415
1747352263564042,103041964,1,1114,25,103694857,102932384,762473,32.7880462652448
1747352263658141,103136604,1,1115,25,103788956,103027024,761932,32.81132699505992
1747352263756419,103231244,1,1116,25,103887234,103121664,765570,32.65540708230469
1747352263850947,103325884,1,1117,25,103981762,103216304,765458,32.66018514405754
1747352263944944,103420524,1,1118,25,104075759,103310944,764815,32.68764341703549
1747352264042724,103515172,1,1119,25,104173539,103405592,767947,32.5543299212055
1747352264136784,103609804,1,1120,25,104267599,103500224,767375,32.57859586251833
1747352264231123,103704444,1,1121,25,104361938,103594864,767074,32.59137971043211
1747352264325366,103799084,1,1122,25,104456181,103689504,766677,32.60825614959103
1747352264424145,103893724,1,1123,25,104554960,103784144,770816,32.43316174028562
1747352264522288,103988364,1,1124,25,104653103,103878784,774319,32.28643491894168
1747352264616474,104083004,1,1125,25,104747289,103973424,773865,32.30537626071731
1747352264710939,104177644,1,1126,25,104841754,104068064,773690,32.31268337447815
1747352264804363,104272284,1,1127,25,104935178,104162704,772474,32.36354880552614
1747352264899576,104366924,1,1128,25,105030391,104257344,773047,32.33956020785282
1747352264993005,104461564,1,1129,25,105123820,104351984,771836,32.39030053016444
1747352265091688,104556204,1,1130,25,105222503,104446624,775879,32.221519077072585
1747352265185675,104650844,1,1131,25,105316490,104541264,775226,32.24866039064737
1747352265284447,104745484,1,1132,25,105415262,104635904,779358,32.07768445310114
1747352265374599,104840124,1,1133,25,105505414,104730544,774870,32.26347645411489
1747352265472824,104934764,1,1134,25,105603639,104825184,778455,32.11489424565325
1747352265570636,105029404,1,1135,25,105701451,104919824,781627,31.98456552805878
1747352265661035,105124044,1,1136,25,105791850,105014464,777386,32.15905611883929
1747352265759068,105218684,1,1137,25,105889883,105109104,780779,32.01930379787366
1747352265853010,105313324,1,1138,25,105983825,105203744,780081,32.04795399452108
1747352265947526,105407964,1,1139,25,106078341,105298384,779957,32.053049078346625
1747352266041441,105502604,1,1140,25,106172256,105393024,779232,32.082871339986035
1747352266140117,105597244,1,1141,25,106270932,105487664,783268,31.91755567698413
1747352266234092,105691884,1,1142,25,106364907,105582304,782603,31.944676930704325
1747352266332909,105786524,1,1143,25,106463724,105676944,786780,31.775083250718115
1747352266427052,105881164,1,1144,25,106557867,105771584,786283,31.7951678975636
1747352266520685,105975804,1,1145,25,106651500,105866224,785276,31.83594048461942
1747352266614875,106070444,1,1146,25,106745690,105960864,784826,31.854194432906148
1747352266709825,106165084,1,1147,25,106840640,106055504,785136,31.84161724847669
1747352266807826,106259724,1,1148,25,106938641,106150144,788497,31.705891081386486
1747352266902068,106354364,1,1149,25,107032883,106244784,788099,31.72190295889222
1747352266996149,106449004,1,1150,25,107126964,106339424,787540,31.744419331081595
1747352267090181,106543644,1,1151,25,107220996,106434064,786932,31.76894572847464
1747352267188057,106638284,1,1152,25,107318872,106528704,790168,31.63884136031832
1747352267282529,106732924,1,1153,25,107413344,106623344,790000,31.645569620253163
1747352267377017,106827564,1,1154,25,107507832,106717984,789848,31.65165955981404
1747352267475111,106922204,1,1155,25,107605926,106812624,793302,31.513849706669088
1747352267569482,107016844,1,1156,25,107700297,106907264,793033,31.524539331906745
1747352267664166,107111484,1,1157,25,107794981,107001904,793077,31.52279034696505
1747352267758180,107206124,1,1158,25,107888995,107096544,792451,31.547691907764644
1747352267856159,107300764,1,1159,25,107986974,107191184,795790,31.4153231380138
1747352267950462,107395404,1,1160,25,108081277,107285824,795453,31.428632489914552
1747352268044055,107490044,1,1161,25,108174870,107380464,794406,31.470054355077885
1747352268142597,107584684,1,1162,25,108273412,107475104,798308,31.31623383456009
1747352268236671,107679324,1,1163,25,108367486,107569744,797742,31.338452782979964
1747352268330960,107773972,1,1164,25,108461775,107664392,797383,31.35256206866713
1747352268425522,107868604,1,1165,25,108556337,107759024,797313,31.35531466312477
1747352268523444,107963244,1,1166,25,108654259,107853664,800595,31.226775086029768
1747352268617964,108057884,1,1167,25,108748779,107948304,800475,31.23145632280833
1747352268712454,108152524,1,1168,25,108843269,108042944,800325,31.23730984287633
1747352268806449,108247164,1,1169,25,108937264,108137584,799680,31.262505002000804
1747352268904709,108341804,1,1170,25,109035524,108232224,803300,31.12162330387153
1747352268998750,108436444,1,1171,25,109129565,108326864,802701,31.14484720960856
1747352269093159,108531084,1,1172,25,109223974,108421504,802470,31.153812603586427
1747352269191558,108625724,1,1173,25,109322373,108516144,806229,31.008559602792754
1747352269285496,108720364,1,1174,25,109416311,108610784,805527,31.035582916525456
1747352269380158,108815004,1,1175,25,109510973,108705424,805549,31.03473531715637
1747352269473680,108909644,1,1176,25,109604495,108800064,804431,31.07786746159708
1747352269571722,109004284,1,1177,25,109702537,108894704,807833,30.94699028140717
1747352269666149,109098924,1,1178,25,109796964,108989344,807620,30.95515217552809
1747352269760803,109193564,1,1179,25,109891618,109083984,807634,30.954615580820025
1747352269859276,109288204,1,1180,25,109990091,109178624,811467,30.80840009513634
1747352269952634,109382844,1,1181,25,110083449,109273264,810185,30.85714991020569
1747352270047308,109477484,1,1182,25,110178123,109367904,810219,30.85585502191383
1747352270141457,109572132,1,1183,25,110272272,109462552,809720,30.874870325544634
1747352270239827,109666764,1,1184,25,110370642,109557184,813458,30.73299420498661
1747352270333807,109761404,1,1185,25,110464622,109651824,812798,30.75794969967938
1747352270428205,109856044,1,1186,25,110559020,109746464,812556,30.767110205327388
1747352270522768,109950684,1,1187,25,110653583,109841104,812479,30.770026056058065
1747352270620418,110045324,1,1188,25,110751233,109935744,815489,30.6564527541144
1747352270714412,110139964,1,1189,25,110845227,110030384,814843,30.680756906545188
1747352270809413,110234604,1,1190,25,110940228,110125024,815204,30.667170426052863
1747352270907704,110329244,1,1191,25,111038519,110219664,818855,30.530435791440485
1747352271001448,110423884,1,1192,25,111132263,110314304,817959,30.56387911863553
1747352271096405,110518524,1,1193,25,111227220,110408944,818276,30.5520386764368
1747352271194489,110613164,1,1194,25,111325304,110503584,821720,30.4239887066154
1747352271287997,110707804,1,1195,25,111418812,110598224,820588,30.465958556547257
1747352271382682,110802444,1,1196,25,111513497,110692864,820633,30.464287933826693
1747352271476361,110897084,1,1197,25,111607176,110787504,819672,30.500004880000784
1747352271574773,110991724,1,1198,25,111705588,110882144,823444,30.360291653105737
1747352271669332,111086364,1,1199,25,111800147,110976784,823363,30.363278408186915
1747352271763945,111181004,1,1200,25,111894760,111071424,823336,30.364274123808507
1747352271857210,111275644,1,1201,25,111988025,111166064,821961,30.41506835482462
1747352271956406,111370284,1,1202,25,112087221,111260704,826517,30.24741172897836
1747352272050503,111464924,1,1203,25,112181318,111355344,825974,30.26729654928605
1747352272143883,111559564,1,1204,25,112274698,111449984,824714,30.31353899654911
1747352272238861,111654204,1,1205,25,112369676,111544624,825052,30.30112041422844
1747352272336955,111748844,1,1206,25,112467770,111639264,828506,30.174796561521585
1747352272430891,111843484,1,1207,25,112561706,111733904,827802,30.20045856376283
1747352272525026,111938124,1,1208,25,112655841,111828544,827297,30.21889357751812
1747352272623108,112032764,1,1209,25,112753923,111923184,830739,30.093687668449416
1747352272717829,112127404,1,1210,25,112848644,112017824,830820,30.090753713199007
1747352272811564,112222044,1,1211,25,112942379,112112464,829915,30.1235668713061
1747352272906486,112316684,1,1212,25,113037301,112207104,830197,30.11333454589694
1747352273004396,112411324,1,1213,25,113135211,112301744,833467,29.99518877172102
1747352273098234,112505964,1,1214,25,113229049,112396384,832665,30.02407931160791
1747352273193036,112600604,1,1215,25,113323851,112491024,832827,30.018239082066263
1747352273287223,112695244,1,1216,25,113418038,112585664,832374,30.03457580366518
1747352273384946,112789884,1,1217,25,113515761,112680304,835457,29.9237423350334
1747352273479539,112884524,1,1218,25,113610354,112774944,835410,29.925425838809687
1747352273573289,112979164,1,1219,25,113704104,112869584,834520,29.957340746776588
1747352273671737,113073804,1,1220,25,113802552,112964224,838328,29.82126327642641
1747352273766073,113168444,1,1221,25,113896888,113058864,838024,29.83208118144588
1747352273860848,113263084,1,1222,25,113991663,113153504,838159,29.827276208929334
1747352273954473,113357724,1,1223,25,114085288,113248144,837144,29.86344045946695
1747352274053368,113452364,1,1224,25,114184183,113342784,841399,29.712419434774706
1747352274147082,113547004,1,1225,25,114277897,113437424,840473,29.74515540653893
1747352274241235,113641644,1,1226,25,114372050,113532064,839986,29.76240080191813
1747352274339642,113736284,1,1227,25,114470457,113626704,843753,29.629524280209967
1747352274433385,113830932,1,1228,25,114564200,113721352,842848,29.661338699267244
1747352274528025,113925564,1,1229,25,114658840,113815984,842856,29.66105716753514
1747352274622262,114020204,1,1230,25,114753077,113910624,842453,29.67524597811392
1747352274720191,114114844,1,1231,25,114851006,114005264,845742,29.559842126795168
1747352274815253,114209484,1,1232,25,114946068,114099904,846164,29.545100004254493
1747352274909066,114304124,1,1233,25,115039881,114194544,845337,29.57400421370412
1747352275003534,114398764,1,1234,25,115134349,114289184,845165,29.580022835777623
1747352275101263,114493404,1,1235,25,115232078,114383824,848254,29.47230428621616
1747352275196061,114588044,1,1236,25,115326876,114478464,848412,29.466815650886595
1747352275290053,114682684,1,1237,25,115420868,114573104,847764,29.4893390141596
1747352275388385,114777324,1,1238,25,115519200,114667744,851456,29.36147023451593
1747352275482065,114871964,1,1239,25,115612880,114762384,850496,29.39461208518324
1747352275576641,114966604,1,1240,25,115707456,114857024,850432,29.39682420228777
1747352275670807,115061244,1,1241,25,115801622,114951664,849958,29.41321806489261
1747352275769221,115155884,1,1242,25,115900036,115046304,853732,29.283194257682737
1747352275863349,115250524,1,1243,25,115994164,115140944,853220,29.30076650805185
1747352275957528,115345164,1,1244,25,116088343,115235584,852759,29.316606450357018
1747352276052134,115439804,1,1245,25,116182949,115330224,852725,29.317775367205137
1747352276149802,115534444,1,1246,25,116280617,115424864,855753,29.21403722803192
1747352276244377,115629092,1,1247,25,116375192,115519512,855680,29.216529543754675
1747352276338826,115723724,1,1248,25,116469641,115614144,855497,29.222779273334684
1747352276436771,115818364,1,1249,25,116567586,115708784,858802,29.110318792923167
1747352276531134,115913004,1,1250,25,116661949,115803424,858525,29.119711132465568
1747352276625548,116007644,1,1251,25,116756363,115898064,858299,29.127378687380503
1747352276719294,116102284,1,1252,25,116850109,115992704,857405,29.157749255019507
1747352276817130,116196924,1,1253,25,116947945,116087344,860601,29.049466593694408
1747352276911608,116291564,1,1254,25,117042423,116181984,860439,29.05493591062237
1747352277006400,116386204,1,1255,25,117137215,116276624,860591,29.049804146220445
1747352277104368,116480844,1,1256,25,117235183,116371264,863919,28.93789811313329
1747352277198389,116575484,1,1257,25,117329204,116465904,863300,28.95864705200973
1747352277292782,116670124,1,1258,25,117423597,116560544,863053,28.96693482323797
1747352277387138,116764764,1,1259,25,117517953,116655184,862769,28.97646994734396
1747352277484468,116859404,1,1260,25,117615283,116749824,865459,28.88640594181816
1747352277578892,116954044,1,1261,25,117709707,116844464,865243,28.89361716881848
1747352277673390,117048684,1,1262,25,117804205,116939104,865101,28.898359844688656
1747352277768048,117143324,1,1263,25,117898863,117033744,865119,28.89775857425395
1747352277866280,117237964,1,1264,25,117997095,117128384,868711,28.77827033386247
1747352277960170,117332604,1,1265,25,118090985,117223024,867961,28.80313746815813
1747352278054846,117427244,1,1266,25,118185661,117317664,867997,28.801942863857825
1747352278152357,117521884,1,1267,25,118283172,117412304,870868,28.70699118580543
1747352278246716,117616524,1,1268,25,118377531,117506944,870587,28.7162569622565
1747352278340699,117711164,1,1269,25,118471514,117601584,869930,28.737944432310645
1747352278435367,117805804,1,1270,25,118566182,117696224,869958,28.737019488297136
1747352278533818,117900444,1,1271,25,118664633,117790864,873769,28.61168111938052
1747352278627649,117995084,1,1272,25,118758464,117885504,872960,28.63819648093842
1747352278722008,118089724,1,1273,25,118852823,117980144,872679,28.647417893635577
1747352278820634,118184364,1,1274,25,118951449,118074784,876665,28.517164481301293
1747352278914734,118279004,1,1275,25,119045549,118169424,876125,28.534741047225
1747352279008447,118373644,1,1276,25,119139262,118264064,875198,28.56496472798156
1747352279103258,118468284,1,1277,25,119234073,118358704,875369,28.559384670921634
1747352279201403,118562924,1,1278,25,119332218,118453344,878874,28.44548820422495
1747352279295320,118657564,1,1279,25,119426135,118547984,878151,28.46890796685308
1747352279389329,118752204,1,1280,25,119520144,118642624,877520,28.48937915944936
1747352279483416,118846844,1,1281,25,119614231,118737264,876967,28.507344061977246
1747352279581838,118941484,1,1282,25,119712653,118831904,880749,28.384931461744493
1747352279675866,119036124,1,1283,25,119806681,118926544,880137,28.40466881860437
1747352279770938,119130764,1,1284,25,119901753,119021184,880569,28.390733718765933
1747352279869061,119225404,1,1285,25,119999876,119115824,884052,28.278879522924
1747352279963416,119320044,1,1286,25,120094231,119210464,883767,28.28799898615812
1747352280057323,119414684,1,1287,25,120188138,119305104,883034,28.311480645139373
1747352280151127,119509324,1,1288,25,120281942,119399744,882198,28.33830954048864
1747352280249307,119603964,1,1289,25,120380122,119494384,885738,28.225050748641245
1747352280343515,119698604,1,1290,25,120474330,119589024,885306,28.2388236383804
1747352280438044,119793244,1,1291,25,120568859,119683664,885195,28.24236467670965
1747352280536291,119887892,1,1292,25,120667106,119778312,888794,28.128002664284413
1747352280630440,119982524,1,1293,25,120761255,119872944,888311,28.14329666074157
1747352280724368,120077164,1,1294,25,120855183,119967584,887599,28.165872201298107
1747352280818926,120171804,1,1295,25,120949741,120062224,887517,28.16847451936132
1747352280917718,120266444,1,1296,25,121048533,120156864,891669,28.03730980890891
1747352281011320,120361084,1,1297,25,121142135,120251504,890631,28.06998633553065
1747352281105798,120455724,1,1298,25,121236613,120346144,890469,28.07509301278316
1747352281200119,120550364,1,1299,25,121330934,120440784,890150,28.08515418749649
1747352281298245,120645004,1,1300,25,121429060,120535424,893636,27.975596327811324
1747352281392282,120739644,1,1301,25,121523097,120630064,893033,27.994486205996868
1747352281486449,120834284,1,1302,25,121617264,120724704,892560,28.00932150219593
1747352281584773,120928924,1,1303,25,121715588,120819344,896244,27.8941895287444
1747352281679294,121023564,1,1304,25,121810109,120913984,896125,27.89789370902497
1747352281773035,121118204,1,1305,25,121903850,121008624,895226,27.92590921175212
1747352281867595,121212844,1,1306,25,121998410,121103264,895146,27.92840497527777
1747352281966136,121307484,1,1307,25,122096951,121197904,899047,27.807222536752803
1747352282059761,121402124,1,1308,25,122190576,121292544,898032,27.8386516293406
1747352282154237,121496764,1,1309,25,122285052,121387184,897868,27.8437364957878
1747352282252355,121591404,1,1310,25,122383170,121481824,901346,27.736296605299188
1747352282347289,121686052,1,1311,25,122478104,121576472,901632,27.72749858035208
1747352282445187,121780684,1,1312,25,122576002,121671104,904898,27.627423201288984
1747352282535646,121875324,1,1313,25,122666461,121765744,900717,27.755665764052416
1747352282633823,121969964,1,1314,25,122764638,121860384,904254,27.64709915576818
1747352282727985,122064604,1,1315,25,122858800,121955024,903776,27.661721488510427
1747352282822569,122159244,1,1316,25,122953384,122049664,903720,27.66343557739123
1747352282916171,122253884,1,1317,25,123046986,122144304,902682,27.69524594486209
1747352283013944,122348524,1,1318,25,123144759,122238944,905815,27.59945463477641
1747352283108651,122443164,1,1319,25,123239466,122333584,905882,27.597413349641567
1747352283203266,122537804,1,1320,25,123334081,122428224,905857,27.5981749878844
1747352283300842,122632444,1,1321,25,123431657,122522864,908793,27.50901470411854
1747352283395475,122727084,1,1322,25,123526290,122617504,908786,27.50922659459983
1747352283489388,122821724,1,1323,25,123620203,122712144,908059,27.531250722695333
1747352283584573,122916364,1,1324,25,123715388,122806784,908604,27.51473689307993
1747352283682518,123011004,1,1325,25,123813333,122901424,911909,27.415016191308563
1747352283776406,123105644,1,1326,25,123907221,122996064,911157,27.43764246995853
1747352283870463,123200284,1,1327,25,124001278,123090704,910574,27.45520957110569
1747352283964968,123294924,1,1328,25,124095783,123185344,910439,27.459280632749696
1747352284062593,123389564,1,1329,25,124193408,123279984,913424,27.36954579691359
1747352284156709,123484204,1,1330,25,124287524,123374624,912900,27.38525577828897
1747352284251314,123578844,1,1331,25,124382129,123469264,912865,27.386305751671934
1747352284349334,123673484,1,1332,25,124480149,123563904,916245,27.28527850083766
1747352284444684,123768124,1,1333,25,124575499,123658544,916955,27.26415145781418
1747352284538298,123862764,1,1334,25,124669113,123753184,915929,27.294692055825287
1747352284632507,123957404,1,1335,25,124763322,123847824,915498,27.30754190615381
1747352284730430,124052044,1,1336,25,124861245,123942464,918781,27.209966248757866
1747352284824801,124146684,1,1337,25,124955616,124037104,918512,27.21793509502325
1747352284923134,124241324,1,1338,25,125053949,124131744,922205,27.108939986228656
1747352285017104,124335964,1,1339,25,125147919,124226384,921535,27.128649481571507
1747352285111007,124430604,1,1340,25,125241822,124321024,920798,27.15036305465477
1747352285205902,124525244,1,1341,25,125336717,124415664,921053,27.14284628571863
1747352285299672,124619884,1,1342,25,125430487,124510304,920183,27.16850887269163
1747352285397827,124714524,1,1343,25,125528642,124604944,923698,27.06512301639713
1747352285492453,124809164,1,1344,25,125623268,124699584,923684,27.06553323430957
1747352285586521,124903804,1,1345,25,125717336,124794224,923112,27.082304205773514
1747352285684784,124998444,1,1346,25,125815599,124888864,926735,26.97642799721603
1747352285778792,125093084,1,1347,25,125909607,124983504,926103,26.994837507275108
1747352285873118,125187724,1,1348,25,126003933,125078144,925789,27.00399335053668
1747352285971199,125282364,1,1349,25,126102014,125172784,929230,26.90399578145346
1747352286065688,125377004,1,1350,25,126196503,125267424,929079,26.90836839493735
1747352286159519,125471644,1,1351,25,126290334,125362064,928270,26.93181940599179
1747352286254186,125566284,1,1352,25,126385001,125456704,928297,26.93103608004765
1747352286450243,125758684,1,1354,25,126581058,125649104,931954,26.825358333136617
1747352286544980,125853324,1,1355,25,126675795,125743744,932051,26.822566576292505
1747352286639311,125947964,1,1356,25,126770126,125838384,931742,26.83146192830204
1747352286733139,126042604,1,1357,25,126863954,125933024,930930,26.854865564542983
1747352286831926,126137244,1,1358,25,126962741,126027664,935077,26.735766145461817
1747352286925930,126231884,1,1359,25,127056745,126122304,934441,26.75396306454876
1747352287020063,126326524,1,1360,25,127150878,126216944,933934,26.76848685239
1747352287114529,126421164,1,1361,25,127245344,126311584,933760,26.77347498286497
1747352287212749,126515804,1,1362,25,127343564,126406224,937340,26.671218554633324
1747352287305467,126610452,1,1363,25,127436282,126500872,935410,26.72624838306197
1747352287405140,126705084,1,1364,25,127535955,126595504,940451,26.582990501365835
1747352287495156,126799724,1,1365,25,127625971,126690144,935827,26.71433929561768
1747352287593204,126894364,1,1366,25,127724019,126784784,939235,26.617406719298152
1747352287691271,126989004,1,1367,25,127822086,126879424,942662,26.520640484075948
1747352287781748,127083644,1,1368,25,127912563,126974064,938499,26.63828091452415
1747352287879644,127178284,1,1369,25,128010459,127068704,941755,26.54618239350999
1747352287974036,127272924,1,1370,25,128104851,127163344,941507,26.553174856904945
1747352288068043,127367564,1,1371,25,128198858,127257984,940874,26.57103926774468
1747352288162893,127462204,1,1372,25,128293708,127352624,941084,26.565110022059667
1747352288261071,127556844,1,1373,25,128391886,127447264,944622,26.465612700106497
1747352288355005,127651484,1,1374,25,128485820,127541904,943916,26.4854075998288
1747352288449097,127746124,1,1375,25,128579912,127636544,943368,26.50079290372368
1747352288547886,127840764,1,1376,25,128678701,127731184,947517,26.384750880459137
1747352288641966,127935404,1,1377,25,128772781,127825824,946957,26.400353975946107
1747352288736190,128030044,1,1378,25,128867005,127920464,946541,26.411956798490504
1747352288830186,128124684,1,1379,25,128961001,128015104,945897,26.42993898912884
1747352288928048,128219324,1,1380,25,129058863,128109744,949119,26.340216558724457
1747352289022273,128313964,1,1381,25,129153088,128204384,948704,26.35173879313253
1747352289121423,128408612,1,1382,25,129252238,128299032,953206,26.227279307935536
1747352289210998,128503244,1,1383,25,129341813,128393664,948149,26.367163810751265
1747352289309452,128597884,1,1384,25,129440267,128488304,951963,26.261524870189284
1747352289403705,128692524,1,1385,25,129534520,128582944,951576,26.272205267892424
1747352289497938,128787164,1,1386,25,129628753,128677584,951169,26.28344700048046
1747352289595738,128881804,1,1387,25,129726553,128772224,954329,26.19641653978869
1747352289689931,128976444,1,1388,25,129820746,128866864,953882,26.208692479782613
1747352289784064,129071084,1,1389,25,129914879,128961504,953375,26.22263012980202
1747352289879140,129165724,1,1390,25,130009955,129056144,953811,26.210643408390133
1747352289977092,129260364,1,1391,25,130107907,129150784,957123,26.11994487646833
1747352290070877,129355004,1,1392,25,130201692,129245424,956268,26.14329874052044
1747352290165150,129449644,1,1393,25,130295965,129340064,955901,26.153335962615376
1747352290263571,129544284,1,1394,25,130394386,129434704,959682,26.050295827159413
1747352290358072,129638924,1,1395,25,130488887,129529344,959543,26.054069489329816
1747352290455780,129733564,1,1396,25,130586595,129623984,962611,25.97103087332266
1747352290546049,129828204,1,1397,25,130676864,129718624,958240,26.08949741192185
1747352290644968,129922844,1,1398,25,130775783,129813264,962519,25.97351325012805
1747352290738676,130017484,1,1399,25,130869491,129907904,961587,25.998687586250647
1747352290836861,130112124,1,1400,25,130967676,130002544,965132,25.903192516671297
1747352290931498,130206764,1,1401,25,131062313,130097184,965129,25.90327303396748
1747352291025950,130301404,1,1402,25,131156765,130191824,964941,25.908319783282085
1747352291120072,130396044,1,1403,25,131250887,130286464,964423,25.9222353676758
1747352291218143,130490684,1,1404,25,131348958,130381104,967854,25.830342179708925
1747352291311940,130585324,1,1405,25,131442755,130475744,967011,25.8528599984902
1747352291406930,130679964,1,1406,25,131537745,130570384,967361,25.843506198823395
1747352291500120,130774604,1,1407,25,131630935,130665024,965911,25.88230178556824
1747352291595343,130869244,1,1408,25,131726158,130759664,966494,25.866689291397567
1747352291692849,130963884,1,1409,25,131823664,130854304,969360,25.7902120987043
1747352291787409,131058524,1,1410,25,131918224,130948944,969280,25.7923407065038
1747352291885594,131153164,1,1411,25,132016409,131043584,972825,25.698352735589648
1747352291980119,131247804,1,1412,25,132110934,131138224,972710,25.70139095927872
1747352292074269,131342444,1,1413,25,132205084,131232864,972220,25.714344489930262
1747352292172822,131437084,1,1414,25,132303637,131327504,976133,25.611264038814383
1747352292262298,131531724,1,1415,25,132393113,131422144,970969,25.747474945132133
1747352292360519,131626364,1,1416,25,132491334,131516784,974550,25.65286542506798
1747352292459003,131721004,1,1417,25,132589818,131611424,978394,25.55207820162429
1747352292557429,131815644,1,1418,25,132688244,131706064,982180,25.45358284632145
1747352292647848,131910284,1,1419,25,132778663,131800704,977959,25.56344386625615
1747352292745886,132004924,1,1420,25,132876701,131895344,981357,25.474929103272306
1747352292835967,132099564,1,1421,25,132966782,131989984,976798,25.59382799719082
1747352292930096,132194204,1,1422,25,133060911,132084624,976287,25.607224105206768
1747352293028648,132288844,1,1423,25,133159463,132179264,980199,25.505025000025505
1747352293122649,132383484,1,1424,25,133253464,132273904,979560,25.521662787373923
1747352293221170,132478124,1,1425,25,133351985,132368544,983441,25.42094543546588
1747352293315493,132572764,1,1426,25,133446308,132463184,983124,25.429142203831866
1747352293409405,132667412,1,1427,25,133540220,132557832,982388,25.44819358542653
1747352293503646,132762044,1,1428,25,133634461,132652464,981997,25.458326247432527
1747352293597439,132856684,1,1429,25,133728254,132747104,981150,25.48030372522041
1747352293691617,132951324,1,1430,25,133822432,132841744,980688,25.49230744130651
1747352293790470,133045964,1,1431,25,133921285,132936384,984901,25.38326187099008
1747352293888650,133140604,1,1432,25,134019465,133031024,988441,25.292354323626803
1747352293982489,133235244,1,1433,25,134113304,133125664,987640,25.31286703657203
1747352294080511,133329884,1,1434,25,134211326,133220304,991022,25.226483367674987
1747352294171249,133424524,1,1435,25,134302064,133314944,987120,25.326201474997973
1747352294264907,133519164,1,1436,25,134395722,133409584,986138,25.35142140349525
1747352294359641,133613804,1,1437,25,134490456,133504224,986232,25.349005102247748
1747352294457406,133708444,1,1438,25,134588221,133598864,989357,25.2689372996805
1747352294551667,133803084,1,1439,25,134682482,133693504,988978,25.278620960223584
1747352294650696,133897724,1,1440,25,134781511,133788144,993367,25.1669322616918
1747352294744527,133992364,1,1441,25,134875342,133882784,992558,25.18744496543275
1747352294838959,134087004,1,1442,25,134969774,133977424,992350,25.19272434121026
1747352294937262,134181644,1,1443,25,135068077,134072064,996013,25.100073995018136
1747352295030928,134276284,1,1444,25,135161743,134166704,995039,25.124643355687567
1747352295125053,134370924,1,1445,25,135255868,134261344,994524,25.137653792165903
1747352295220034,134465572,1,1446,25,135350849,134355992,994857,25.129239679672555
1747352295317902,134560204,1,1447,25,135448717,134450624,998093,25.047766089933504
1747352295412390,134654844,1,1448,25,135543205,134545264,997941,25.051581205702544
1747352295518569,134752604,1,1449,25,135649384,134643024,1006360,24.84200484915935
1747352295604934,134847244,1,1450,25,135735749,134737664,998085,25.04796685653025
1747352295703135,134941884,1,1451,25,135833950,134832304,1001646,24.958917621594853
1747352295797120,135036524,1,1452,25,135927935,134926944,1000991,24.97524952771803
1747352295890518,135131172,1,1453,25,136021333,135021592,999741,25.006476677459464
1747352295989743,135225804,1,1454,25,136120558,135116224,1004334,24.89211756248419
1747352296083344,135320444,1,1455,25,136214159,135210864,1003295,24.91789553421476
1747352296177578,135415084,1,1456,25,136308393,135305504,1002889,24.92798305694848
1747352296276445,135509724,1,1457,25,136407260,135400144,1007116,24.82335699164744
1747352296366102,135604364,1,1458,25,136496917,135494784,1002133,24.946788500129227
1747352296464214,135699004,1,1459,25,136595029,135589424,1005605,24.860656022991133
1747352296558641,135793644,1,1460,25,136689456,135684064,1005392,24.86592294348871
1747352296652680,135888284,1,1461,25,136783495,135778704,1004791,24.88079610585684
1747352296747364,135982924,1,1462,25,136878179,135873344,1004835,24.87970661849956
1747352296841512,136077564,1,1463,25,136972327,135967984,1004343,24.891894502177045
1747352296943747,136172204,1,1464,25,137074562,136062624,1011938,24.705070864025267
1747352297038444,136266844,1,1465,25,137169259,136157264,1011995,24.70367936600477
1747352297132550,136361484,1,1466,25,137263365,136251904,1011461,24.71672165313344
1747352297226145,136456124,1,1467,25,137356960,136346544,1010416,24.742284366043293
1747352297320138,136550764,1,1468,25,137450953,136441184,1009769,24.75813775229781
1747352297414789,136645404,1,1469,25,137545604,136535824,1009780,24.75786805046644
1747352297513021,136740044,1,1470,25,137643836,136630464,1013372,24.67011127206988
1747352297607257,136834684,1,1471,25,137738072,136725104,1012968,24.679950403171667
1747352297704735,136929324,1,1472,25,137835550,136819744,1015806,24.610998556811044
1747352297799800,137023964,1,1473,25,137930615,136914384,1016231,24.600705941857704
1747352297890509,137118604,1,1474,25,138021324,137009024,1012300,24.696236293588857
1747352297987925,137213244,1,1475,25,138118740,137103664,1015076,24.628697752680587
1747352298082731,137307884,1,1476,25,138213546,137198304,1015242,24.62467076815183
1747352298176515,137402524,1,1477,25,138307330,137292944,1014386,24.645450548410565
1747352298275002,137497164,1,1478,25,138405817,137387584,1018233,24.55233723519077
1747352298368837,137591804,1,1479,25,138499652,137482224,1017428,24.57176330904988
1747352298467082,137686444,1,1480,25,138597897,137576864,1021033,24.48500685090492
1747352298558034,137781084,1,1481,25,138688849,137671504,1017345,24.57376799414161
1747352298655383,137875724,1,1482,25,138786198,137766144,1020054,24.508506412405616
1747352298749489,137970364,1,1483,25,138880304,137860784,1019520,24.52134337727558
1747352298844439,138065004,1,1484,25,138975254,137955424,1019830,24.513889569830265
1747352298937932,138159644,1,1485,25,139068747,138050064,1018683,24.5414913177112
1747352299037217,138254284,1,1486,25,139168032,138144704,1023328,24.43009474967948
1747352299130579,138348924,1,1487,25,139261394,138239344,1022050,24.460642825693466
1747352299228754,138443564,1,1488,25,139359569,138333984,1025585,24.376331557111307
1747352299322953,138538204,1,1489,25,139453768,138428624,1025144,24.386817851931045
1747352299417359,138632844,1,1490,25,139548174,138523264,1024910,24.392385672888352
1747352299516197,138727484,1,1491,25,139647012,138617904,1029108,24.292882768378053
1747352299606212,138822124,1,1492,25,139737027,138712544,1024483,24.40255231175139
1747352299704584,138916764,1,1493,25,139835399,138807184,1028215,24.313981025369205
1747352299798457,139011404,1,1494,25,139929272,138901824,1027448,24.332131650458223
1747352299896991,139106044,1,1495,25,140027806,138996464,1031342,24.24026171725771
1747352400409688,109580,1,1,50,0,0,0,0.0
1747352400589891,288924,1,3,50,180203,179344,859,58207.217694994186
1747352400671489,377324,1,4,50,261801,267744,-5943,0.0
1747352400761928,465724,1,5,50,352240,356144,-3904,0.0
1747352400851490,554124,1,6,50,441802,444544,-2742,0.0
1747352400941624,642524,1,7,50,531936,532944,-1008,0.0
1747352401031542,730924,1,8,50,621854,621344,510,98039.2156862745
1747352401118375,819324,1,9,50,708687,709744,-1057,0.0
1747352401228589,907724,1,10,50,818901,798144,20757,2408.8259382377028
1747352401679229,1370524,1,15,50,1269541,1260944,8597,5815.982319413749
1747352401769466,1461004,1,16,50,1359778,1351424,8354,5985.156811108451
1747352401858946,1551484,1,17,50,1449258,1441904,7354,6799.020940984498
1747352401949840,1641964,1,18,50,1540152,1532384,7768,6436.663233779609
1747352402039263,1732444,1,19,50,1629575,1622864,6711,7450.454477723141
1747352402133515,1822924,1,20,50,1723827,1713344,10483,4769.627015167414
1747352402223528,1913404,1,21,50,1813840,1803824,10016,4992.012779552715
1747352402314275,2003884,1,22,50,1904587,1894304,10283,4862.3942429252165
1747352402408072,2094364,1,23,50,1998384,1984784,13600,3676.470588235294
1747352402498343,2184844,1,24,50,2088655,2075264,13391,3733.8510940183705
1747352402588859,2275324,1,25,50,2179171,2165744,13427,3723.840023832576
1747352402682801,2365804,1,26,50,2273113,2256224,16889,2960.506838770797
1747352402773017,2456284,1,27,50,2363329,2346704,16625,3007.518796992481
1747352402863271,2546764,1,28,50,2453583,2437184,16399,3048.966400390268
1747352402952976,2637244,1,29,50,2543288,2527664,15624,3200.2048131080387
1747352403047217,2727724,1,30,50,2637529,2618144,19385,2579.3139025019345
1747352403133159,2818204,1,31,50,2723471,2708624,14847,3367.6837071462246
1747352403227071,2908684,1,32,50,2817383,2799104,18279,2735.379397122381
1747352403317969,2999164,1,33,50,2908281,2889584,18697,2674.225811627534
1747352403416206,3089644,1,34,50,3006518,2980064,26454,1890.073334845392
1747352403497172,3180124,1,35,50,3087484,3070544,16940,2951.59386068477
1747352403592018,3270604,1,36,50,3182330,3161024,21306,2346.7567821271005
1747352403689833,3361084,1,37,50,3280145,3251504,28641,1745.7491009392131
1747352403776575,3451564,1,38,50,3366887,3341984,24903,2007.79022607718
1747352403866253,3542052,1,39,50,3456565,3432472,24093,2075.291578466775
1747352403960169,3632524,1,40,50,3550481,3522944,27537,1815.7388241275376
1747352404046427,3723004,1,41,50,3636739,3613424,23315,2144.542140253056
1747352404140062,3813484,1,42,50,3730374,3703904,26470,1888.930865130336
1747352404230718,3903964,1,43,50,3821030,3794384,26646,1876.4542520453351
1747352404320899,3994444,1,44,50,3911211,3884864,26347,1897.7492693665315
1747352404419107,4084924,1,45,50,4009419,3975344,34075,1467.3514306676448
1747352404505256,4175404,1,46,50,4095568,4065824,29744,1681.0112963959118
1747352404591437,4265884,1,47,50,4181749,4156304,25445,1965.0225977598743
1747352404685190,4356364,1,48,50,4275502,4246784,28718,1741.068319520858
1747352404783807,4446844,1,49,50,4374119,4337264,36855,1356.66802333469
1747352404869843,4537324,1,50,50,4460155,4427744,32411,1542.686125080991
1747352404955100,4627804,1,51,50,4545412,4518224,27188,1839.0466382227453
1747352405057607,4718284,1,52,50,4647919,4608704,39215,1275.0223128904756
1747352405156019,4808764,1,53,50,4746331,4699184,47147,1060.5128640210403
1747352405238803,4899244,1,54,50,4829115,4789664,39451,1267.3949963245543
1747352405328587,4989724,1,55,50,4918899,4880144,38755,1290.1561088891756
1747352405426573,5080204,1,56,50,5016885,4970624,46261,1080.8240202330255
1747352405521068,5170684,1,57,50,5111380,5061104,50276,994.5103031267404
1747352405615067,5261164,1,58,50,5205379,5151584,53795,929.4544102611768
1747352405693060,5351644,1,59,50,5283372,5242064,41308,1210.4192892417934
1747352405782871,5442124,1,60,50,5373183,5332544,40639,1230.3452348729054
1747352405869050,5532604,1,61,50,5459362,5423024,36338,1375.9700588915184
1747352405959083,5623084,1,62,50,5549395,5513504,35891,1393.106907024045
1747352406052819,5713564,1,63,50,5643131,5603984,39147,1277.2370807469283
1747352406143843,5804052,1,64,50,5734155,5694472,39683,1259.9853841695435
1747352406237643,5894524,1,65,50,5827955,5784944,43011,1162.493315663435
1747352406331685,5985004,1,66,50,5921997,5875424,46573,1073.583406694866
1747352406418179,6075484,1,67,50,6008491,5965904,42587,1174.0672036067344
1747352406516221,6165964,1,68,50,6106533,6056384,50149,997.0288540150352
1747352406601720,6256444,1,69,50,6192032,6146864,45168,1106.9783917817924
1747352406704854,6346924,1,70,50,6295166,6237344,57822,864.7227698799765
1747352406786050,6437404,1,71,50,6376362,6327824,48538,1030.1207301495735
1747352406880828,6527884,1,72,50,6471140,6418304,52836,946.3244757362404
1747352407159473,6805564,1,75,50,6749785,6695984,53801,929.3507555621644
1747352407253131,6896044,1,76,50,6843443,6786464,56979,877.5162779269555
1747352407360163,6986524,1,77,50,6950475,6876944,73531,679.9853123172539
1747352407445534,7077004,1,78,50,7035846,6967424,68422,730.7591125661337
1747352407531941,7167484,1,79,50,7122253,7057904,64349,777.0128517925687
1747352407609456,7257964,1,80,50,7199768,7148384,51384,973.065545695158
1747352407699899,7348444,1,81,50,7290211,7238864,51347,973.7667244434924
1747352407793598,7438924,1,82,50,7383910,7329344,54566,916.3215188945496
1747352407884199,7529404,1,83,50,7474511,7419824,54687,914.2940735458152
1747352407973757,7619884,1,84,50,7564069,7510304,53765,929.9730307821072
1747352408064193,7710364,1,85,50,7654505,7600784,53721,930.7347219895386
1747352408157870,7800852,1,86,50,7748182,7691272,56910,878.5802143735723
1747352408265419,7891324,1,87,50,7855731,7781744,73987,675.7943963128658
1747352408338791,7981804,1,88,50,7929103,7872224,56879,879.0590551873275
1747352408429237,8072284,1,89,50,8019549,7962704,56845,879.5848359574281
1747352408522886,8162764,1,90,50,8113198,8053184,60014,833.1389342486754
1747352408613389,8253244,1,91,50,8203701,8143664,60037,832.8197611472925
1747352408703360,8343724,1,92,50,8293672,8234144,59528,839.9408681628813
1747352408813208,8434204,1,93,50,8403520,8324624,78896,633.7456905293044
1747352408891286,8524684,1,94,50,8481598,8415104,66494,751.9475441393208
1747352408977187,8615164,1,95,50,8567499,8505584,61915,807.5587498990552
1747352409067623,8705644,1,96,50,8657935,8596064,61871,808.1330510255208
1747352409161854,8796124,1,97,50,8752166,8686544,65622,761.9395934290329
1747352409248005,8886604,1,98,50,8838317,8777024,61293,815.7538381218084
1747352409354317,8977084,1,99,50,8944629,8867504,77125,648.2982171799027
1747352409432384,9067564,1,100,50,9022696,8957984,64712,772.6542217826677
1747352409530371,9159084,1,101,50,9120683,9049504,71179,702.4543755883054
1747352409620815,9250604,1,102,50,9211127,9141024,70103,713.2362381067858
1747352409714547,9342124,1,103,50,9304859,9232544,72315,691.4194842010647
1747352409813564,9433644,1,104,50,9403876,9324064,79812,626.472209692778
1747352409895066,9525164,1,105,50,9485378,9415584,69794,716.3939593661347
1747352409992911,9616684,1,106,50,9583223,9507104,76119,656.8662226251001
1747352410091860,9708204,1,107,50,9682172,9598624,83548,598.4583712356969
1747352410178057,9799724,1,108,50,9768369,9690144,78225,639.1818472355385
1747352410271861,9891244,1,109,50,9862173,9781664,80509,621.048578419804
1747352410362158,9982764,1,110,50,9952470,9873184,79286,630.6283580960069
1747352410464475,10074284,1,111,50,10054787,9964704,90083,555.0436819377685
1747352410558257,10166844,1,112,50,10148569,10057264,91305,547.6151360823613
1747352410636500,10259404,1,113,50,10226812,10149824,76988,649.451862627942
1747352410746731,10351964,1,114,50,10337043,10242384,94659,528.2117918000401
1747352410836968,10444524,1,115,50,10427280,10334944,92336,541.5006064806793
1747352410914495,10537084,1,116,50,10504807,10427504,77303,646.8054279911518
1747352411021801,10629644,1,117,50,10612113,10520064,92049,543.1889537094373
1747352411123289,10722204,1,118,50,10713601,10612624,100977,495.1622646741337
1747352411201800,10814764,1,119,50,10792112,10705184,86928,575.188661881097
1747352411287549,10907324,1,120,50,10877861,10797744,80117,624.0872723641675
1747352411385850,10999884,1,121,50,10976162,10890304,85858,582.3569149060075
1747352411479655,11092444,1,122,50,11069967,10982864,87103,574.0330413418596
1747352411570146,11185004,1,123,50,11160458,11075424,85034,588.0000940800151
1747352411660264,11277564,1,124,50,11250576,11167984,82592,605.3855094924448
1747352411766446,11370124,1,125,50,11356758,11260544,96214,519.6748913879477
1747352411857264,11462692,1,126,50,11447576,11353112,94464,529.3021680216801
1747352411942572,11555244,1,127,50,11532884,11445664,87220,573.2630130703967
1747352412040513,11647804,1,128,50,11630825,11538224,92601,539.9509724517013
1747352412127161,11740364,1,129,50,11717473,11630784,86689,576.7744465849185
1747352412221844,11832924,1,130,50,11812156,11723344,88812,562.9869837409359
1747352412339957,11925484,1,131,50,11930269,11815904,114365,437.1966947929874
1747352412409634,12018044,1,132,50,11999946,11908464,91482,546.5556065674122
1747352412500066,12110604,1,133,50,12090378,12001024,89354,559.57203930434
1747352412594223,12203164,1,134,50,12184535,12093584,90951,549.7465668326901
1747352412700121,12295724,1,135,50,12290433,12186144,104289,479.43694924680455
1747352412782829,12388284,1,136,50,12373141,12278704,94437,529.453498099262
1747352412892891,12480844,1,137,50,12483203,12371264,111939,446.6718480601042
1747352412970931,12573404,1,138,50,12561243,12463824,97419,513.2469025549431
1747352413057270,12665964,1,139,50,12647582,12556384,91198,548.2576372288866
1747352413159259,12758524,1,140,50,12749571,12648944,100627,496.8845339719956
1747352413269995,12851084,1,141,50,12860307,12741504,118803,420.8647929766083
1747352413343402,12943644,1,142,50,12933714,12834064,99650,501.7561465127948
1747352413528067,13131884,1,144,50,13118379,13022304,96075,520.4267499349467
1747352413630709,13224444,1,145,50,13221021,13114864,106157,471.0004992605292
1747352413729066,13317004,1,146,50,13319378,13207424,111954,446.6120013577005
1747352413811030,13409564,1,147,50,13401342,13299984,101358,493.3009727895183
1747352413909257,13502124,1,148,50,13499569,13392544,107025,467.1805652884841
1747352414007468,13594684,1,149,50,13597780,13485104,112676,443.7502218751109
1747352414100939,13687244,1,150,50,13691251,13577664,113587,440.1912190655621
1747352414183688,13779804,1,151,50,13774000,13670224,103776,481.8069688559976
1747352414281951,13872364,1,152,50,13872263,13762784,109479,456.70859251545954
1747352414372175,13964924,1,153,50,13962487,13855344,107143,466.66604444527405
1747352414465624,14057492,1,154,50,14055936,13947912,108024,462.8601051618159
1747352414568536,14150044,1,155,50,14158848,14040464,118384,422.3543722124612
1747352414761119,14338284,1,157,50,14351431,14228704,122727,407.4083127592135
1747352414850330,14430844,1,158,50,14440642,14321264,119378,418.8376417765418
1747352415047826,14619084,1,160,50,14638138,14509504,128634,388.6997216909993
1747352415232001,14807324,1,162,50,14822313,14697744,124569,401.3839719352327
1747352415318219,14899884,1,163,50,14908531,14790304,118227,422.915239327734
1747352415600474,15183804,1,166,50,15190786,15074224,116562,428.9562636193614
1747352415887834,15467724,1,169,50,15478146,15358144,120002,416.65972233796106
1747352416173604,15751644,1,172,50,15763916,15642064,121852,410.3338476184224
1747352416288248,15844204,1,173,50,15878560,15734624,143936,347.3766118274789
1747352416550920,16128124,1,176,50,16141232,16018544,122688,407.5378195096505
1747352416849558,16412044,1,179,50,16439870,16302464,137406,363.88512874255855
1747352426753414,26263964,1,282,50,26343726,26154384,189342,264.07241922024696
1747352426847250,26356524,1,283,50,26437562,26246944,190618,262.3047141403225
1747352426941602,26449084,1,284,50,26531914,26339504,192410,259.8617535471129
1747352427035687,26541644,1,285,50,26625999,26432064,193935,257.81834119679274
1747352427125423,26634204,1,286,50,26715735,26524624,191111,261.62805908608084
1747352427219906,26726764,1,287,50,26810218,26617184,193034,259.0217267424391
1747352427314478,26819324,1,288,50,26904790,26709744,195046,256.3497841534817
1747352427408053,26911884,1,289,50,26998365,26802304,196061,255.0226715154977
1747352427498234,27004444,1,290,50,27088546,26894864,193682,258.155120248655
1747352427592314,27097004,1,291,50,27182626,26987424,195202,256.1449165479862
1747352427686738,27189564,1,292,50,27277050,27079984,197066,253.7221032547472
1747352427780742,27282124,1,293,50,27371054,27172544,198510,251.87647977431868
1747352427874627,27374684,1,294,50,27464939,27265104,199835,250.2064202967448
1747352427964888,27467244,1,295,50,27555200,27357664,197536,253.1184189211081
1747352428059486,27559804,1,296,50,27649798,27450224,199574,250.5336366460561
1747352428153165,27652364,1,297,50,27743477,27542784,200693,249.1367411917705
1747352428247274,27744924,1,298,50,27837586,27635344,202242,247.22856775546128
1747352428338179,27837484,1,299,50,27928491,27727904,200587,249.26839725405927
1747352428432564,27930044,1,300,50,28022876,27820464,202412,247.0209276129873
1747352428526293,28022604,1,301,50,28116605,27913024,203581,245.602487461993
1747352428620914,28115164,1,302,50,28211226,28005584,205642,243.1409925987882
1747352428710252,28207724,1,303,50,28300564,28098144,202420,247.0111649046537
1747352428804365,28300284,1,304,50,28394677,28190704,203973,245.1304829560776
1747352428899119,28392844,1,305,50,28489431,28283264,206167,242.52183909161025
1747352428993147,28485404,1,306,50,28583459,28375824,207635,240.8071856864209
1747352429083014,28577964,1,307,50,28673326,28468384,204942,243.97146509744212
1747352429177546,28670524,1,308,50,28767858,28560944,206914,241.6462878297264
1747352429271661,28763084,1,309,50,28861973,28653504,208469,239.84381370851304
1747352435243575,34692132,1,371,50,34833887,34582552,251335,198.93767282710328
1747352435337091,34784684,1,372,50,34927403,34675104,252299,198.17755916591028
1747352435431371,34877244,1,373,50,35021683,34767664,254019,196.83566977273355
1747352435526086,34969804,1,374,50,35116398,34860224,256174,195.17983870338128
1747352435906871,35349404,1,378,50,35497183,35239824,257359,194.28114035258145
1747352436001287,35441964,1,379,50,35591599,35332384,259215,192.8900719479969
1747352436090990,35534524,1,380,50,35681302,35424944,256358,195.0397491008668
1747352436185089,35627084,1,381,50,35775401,35517504,257897,193.8758496609112
1747352436280014,35719644,1,382,50,35870326,35610064,260262,192.11410040651344
1747352436372984,35812204,1,383,50,35963296,35702624,260672,191.81193223668052
1747352436463858,35904764,1,384,50,36054170,35795184,258986,193.0606287598557
1747352436557675,35997324,1,385,50,36147987,35887744,260243,192.1281264049369
1747352436652116,36089892,1,386,50,36242428,35980312,262116,190.75523813883927
1747352436746424,36182444,1,387,50,36336736,36072864,263872,189.4858113024497
1747352436840995,36275004,1,388,50,36431307,36165424,265883,188.0526396949034
1747352436931000,36367564,1,389,50,36521312,36257984,263328,189.87726333697896
1747352437024551,36460124,1,390,50,36614863,36350544,264319,189.16536457840712
1747352437119853,36552684,1,391,50,36710165,36443104,267061,187.22314377614103
1747352437212776,36645244,1,392,50,36803088,36535664,267424,186.96900801723103
1747352437303214,36737804,1,393,50,36893526,36628224,265302,188.4644669094089
1747352437397603,36830364,1,394,50,36987915,36720784,267131,187.1740831277538
1747352437492312,36922924,1,395,50,37082624,36813344,269280,185.68033273915623
1747352437586546,37015484,1,396,50,37176858,36905904,270954,184.5331679916148
1747352437676445,37108044,1,397,50,37266757,36998464,268293,186.3634161159628
1747352437770421,37200604,1,398,50,37360733,37091024,269709,185.38498900667017
1747352437863971,37293164,1,399,50,37454283,37183584,270699,184.70699928703087
1747352437958579,37385724,1,400,50,37548891,37276144,272747,183.3200731813732
1747352438048662,37478284,1,401,50,37638974,37368704,270270,185.00018500018496
1747352438142929,37570844,1,402,50,37733241,37461264,271977,183.83907462763395
1747352438236989,37663404,1,403,50,37827301,37553824,273477,182.8307316520219
1747352438332218,37755964,1,404,50,37922530,37646384,276146,181.06364024827445
1747352438425500,37848524,1,405,50,38015812,37738944,276868,180.5914731930017
1747352438515676,37941084,1,406,50,38105988,37831504,274484,182.15998018099413
1747352438610328,38033644,1,407,50,38200640,37924064,276576,180.7821358324656
1747352438704086,38126204,1,408,50,38294398,38016624,277774,180.00244803329323
1747352438799036,38218772,1,409,50,38389348,38109192,280156,178.4719941746741
1747352438888162,38311324,1,410,50,38478474,38201744,276730,180.6815307339284
1747352438982768,38403884,1,411,50,38573080,38294304,278776,179.35546818951414
1747352439076891,38496444,1,412,50,38667203,38386864,280339,178.35549103050235
1747352439171264,38589004,1,413,50,38761576,38479424,282152,177.20944739005924
1747352439260845,38681564,1,414,50,38851157,38571984,279173,179.100414438359
1747352439355131,38774124,1,415,50,38945443,38664544,280899,177.99992168003445
1747352439449692,38866684,1,416,50,39040004,38757104,282900,176.74089784376105
1747352439543431,38959244,1,417,50,39133743,38849664,284079,176.00737822929537
1747352439638152,39051804,1,418,50,39228464,38942224,286240,174.678591391839
1747352439728145,39144364,1,419,50,39318457,39034784,283673,176.2592844578088
1747352439822159,39236924,1,420,50,39412471,39127344,285127,175.36045341198832
1747352439917021,39329484,1,421,50,39507333,39219904,287429,173.95600304770915
1747352440010883,39422044,1,422,50,39601195,39312464,288731,173.1715679992796
1747352440100813,39514604,1,423,50,39691125,39405024,286101,174.76345766005713
1747352440195049,39607164,1,424,50,39785361,39497584,287777,173.74564332799355
1747352440288863,39699724,1,425,50,39879175,39590144,289031,172.99182440637856
1747352440383803,39792284,1,426,50,39974115,39682704,291411,171.57897265374336
1747352440473554,39884844,1,427,50,40063866,39775264,288602,173.24897263359227
1747352440567925,39977404,1,428,50,40158237,39867824,290413,172.1686012678496
1747352440661639,40069964,1,429,50,40251951,39960384,291567,171.48717104473414
1747352440756127,40162524,1,430,50,40346439,40052944,293495,170.36065350346684
1747352440846524,40255084,1,431,50,40436836,40145504,291332,171.62549943020335
1747352440939951,40347644,1,432,50,40530263,40238064,292199,171.1162598092396
1747352441035221,40440204,1,433,50,40625533,40330624,294909,169.54382538342338
1747352441129172,40532764,1,434,50,40719484,40423184,296300,168.74789065136684
1747352441223465,40625324,1,435,50,40813777,40515744,298033,167.76665671251172
1747352441312790,40717884,1,436,50,40903102,40608304,294798,169.60766355266995
1747352441407670,40810444,1,437,50,40997982,40700864,297118,168.28330831521484
1747352441501416,40903004,1,438,50,41091728,40793424,298304,167.61424586998498
1747352441595841,40995564,1,439,50,41186153,40885984,300169,166.57283063874016
1747352441685504,41088124,1,440,50,41275816,40978544,297272,168.19613014343767
1747352441779930,41180684,1,441,50,41370242,41071104,299138,167.146935528084
1747352441874352,41273244,1,442,50,41464664,41163664,301000,166.11295681063123
1747352441968423,41365804,1,443,50,41558735,41256224,302511,165.28324589849626
1747352442059063,41458364,1,444,50,41649375,41348784,300591,166.33897887827646
1747352442152490,41550924,1,445,50,41742802,41441344,301458,165.86058422732188
1747352442246637,41643484,1,446,50,41836949,41533904,303045,164.99199788810242
1747352442341102,41736044,1,447,50,41931414,41626464,304950,163.96130513198884
1747352442431106,41828604,1,448,50,42021418,41719024,302394,165.34719604224952
1747352442525917,41921164,1,449,50,42116229,41811584,304645,164.12545749971278
1747352442620026,42013732,1,450,50,42210338,41904152,306186,163.29943237117308
1747352442713393,42106284,1,451,50,42303705,41996704,307001,162.86591900352116
1747352442808169,42198844,1,452,50,42398481,42089264,309217,161.69874230718233
1747352442898643,42291404,1,453,50,42488955,42181824,307131,162.79698239513434
1747352442992790,42383964,1,454,50,42583102,42274384,308718,161.96010598669335
1747352443086517,42476524,1,455,50,42676829,42366944,309885,161.350178291947
1747352443180816,42569084,1,456,50,42771128,42459504,311624,160.4497728031217
1747352443271336,42661644,1,457,50,42861648,42552064,309584,161.50705462814614
1747352443365494,42754204,1,458,50,42955806,42644624,311182,160.677674158531
1747352443458908,42846764,1,459,50,43049220,42737184,312036,160.237921265495
1747352443552961,42939324,1,460,50,43143273,42829744,313529,159.47488111147612
1747352443643175,43031884,1,461,50,43233487,42922304,311183,160.67715781389086
1747352443738301,43124444,1,462,50,43328613,43014864,313749,159.3630577308613
1747352443831832,43217004,1,463,50,43422144,43107424,314720,158.8713777325877
1747352443925913,43309564,1,464,50,43516225,43199984,316241,158.10726629374432
1747352444016101,43402124,1,465,50,43606413,43292544,313869,159.30212923225932
1747352444110705,43494684,1,466,50,43701017,43385104,315913,158.27142282843695
1747352444204702,43587244,1,467,50,43795014,43477664,317350,157.5547502757208
1747352444299234,43679804,1,468,50,43889546,43570224,319322,156.5817575989127
1747352444393125,43772364,1,469,50,43983437,43662784,320653,155.9318016672228
1747352444483717,43864924,1,470,50,44074029,43755344,318685,156.89473931939062
1747352444577782,43957484,1,471,50,44168094,43847904,320190,156.15728161404166
1747352444671976,44050044,1,472,50,44262288,43940464,321824,155.36442279009646
1747352444765510,44142612,1,473,50,44355822,44033032,322790,154.89947024381175
1747352444856336,44235164,1,474,50,44446648,44125584,321064,155.73219046669823
1747352444949635,44327724,1,475,50,44539947,44218144,321803,155.3745614553003
1747352445043987,44420284,1,476,50,44634299,44310704,323595,154.5141303172175
1747352445138483,44512844,1,477,50,44728795,44403264,325531,153.59520291462258
1747352445228344,44605404,1,478,50,44818656,44495824,322832,154.87931803538683
1747352445322905,44697964,1,479,50,44913217,44588384,324833,153.92524774268625
1747352445417520,44790524,1,480,50,45007832,44680944,326888,152.95758792002152
1747352445511509,44883084,1,481,50,45101821,44773504,328317,152.29183989863455
1747352445601217,44975644,1,482,50,45191529,44866064,325465,153.62634999155054
1747352445695258,45068204,1,483,50,45285570,44958624,326946,152.9304533470359
1747352445789423,45160764,1,484,50,45379735,45051184,328551,152.18337487939468
1747352445883969,45253324,1,485,50,45474281,45143744,330537,151.26899560412298
1747352445978154,45345884,1,486,50,45568466,45236304,332162,150.52895876108644
1747352446067714,45438444,1,487,50,45658026,45328864,329162,151.90088770878776
1747352446162942,45531004,1,488,50,45753254,45421424,331830,150.6795648374167
1747352446257035,45623564,1,489,50,45847347,45513984,333363,149.98665118804425
1747352446350513,45716124,1,490,50,45940825,45606544,334281,149.57475896027594
1747352446441364,45808684,1,491,50,46031676,45699104,332572,150.34338428971773
1747352446535346,45901244,1,492,50,46125658,45791664,333994,149.70328808301946
1747352446629348,45993804,1,493,50,46219660,45884224,335436,149.05973121549266
1747352446723438,46086364,1,494,50,46313750,45976784,336966,148.38292290616857
1747352446813922,46178924,1,495,50,46404234,46069344,334890,149.30275612887812
1747352446907390,46271484,1,496,50,46497702,46161904,335798,148.89904049458306
1747352447002052,46364044,1,497,50,46592364,46254464,337900,147.9727730097662
1747352447096617,46456604,1,498,50,46686929,46347024,339905,147.09992497903826
1747352447186415,46549164,1,499,50,46776727,46439584,337143,148.3050219046517
1747352447280971,46641724,1,500,50,46871283,46532144,339139,147.43217382843022
1747352447375151,46734284,1,501,50,46965463,46624704,340759,146.7312675527279
1747352447469427,46826844,1,502,50,47059739,46717264,342475,145.99605810643115
1747352447563654,46919404,1,503,50,47153966,46809824,344142,145.28886331804895
1747352447653751,47011964,1,504,50,47244063,46902384,341679,146.33618103541627
1747352447747518,47104524,1,505,50,47337830,46994944,342886,145.8210600607782
1747352447841676,47197084,1,506,50,47431988,47087504,344484,145.1446221014619
1747352447935473,47289644,1,507,50,47525785,47180064,345721,144.62529033527034
1747352448026210,47382204,1,508,50,47616522,47272624,343898,145.39194761237346
1747352448120154,47474764,1,509,50,47710466,47365184,345282,144.80917047514785
1747352448214516,47567324,1,510,50,47804828,47457744,347084,144.05734634843438
1747352448308224,47659884,1,511,50,47898536,47550304,348232,143.58243929334466
1747352448399034,47752444,1,512,50,47989346,47642864,346482,144.30764080096512
1747352448492747,47845004,1,513,50,48083059,47735424,347635,143.8290160657011
1747352448587349,47937572,1,514,50,48177661,47827992,349669,142.99237278683557
1747352448681750,48030124,1,515,50,48272062,47920544,351518,142.24022667402522
1747352448771494,48122684,1,516,50,48361806,48013104,348702,143.38891087518854
1747352448865530,48215244,1,517,50,48455842,48105664,350178,142.7845267264077
1747352448959845,48307804,1,518,50,48550157,48198224,351933,142.07249675364346
1747352449054383,48400364,1,519,50,48644695,48290784,353911,141.2784570132039
1747352449148655,48492924,1,520,50,48738967,48383344,355623,140.5983302542299
1747352449238647,48585484,1,521,50,48828959,48475904,353055,141.62099389613516
1747352449332177,48678044,1,522,50,48922489,48568464,354025,141.2329637737448
1747352449426534,48770604,1,523,50,49016846,48661024,355822,140.51969805127283
1747352449520788,48863164,1,524,50,49111100,48753584,357516,139.85388066548072
1747352449610899,48955724,1,525,50,49201211,48846144,355067,140.81849341110268
1747352449705179,49048284,1,526,50,49295491,48938704,356787,140.13963513244596
1747352449799901,49140844,1,527,50,49390213,49031264,358949,139.29555452167298
1747352449893229,49233404,1,528,50,49483541,49123824,359717,138.9981568844397
1747352449983425,49325964,1,529,50,49573737,49216384,357353,139.91767244153542
1747352450078366,49418524,1,530,50,49668678,49308944,359734,138.99158822908038
1747352450172022,49511084,1,531,50,49762334,49401504,360830,138.56940941717707
1747352450266698,49603644,1,532,50,49857010,49494064,362946,137.76154028422962
1747352450360719,49696204,1,533,50,49951031,49586624,364407,137.20921936186738
1747352450450941,49788764,1,534,50,50041253,49679184,362069,138.09522494331193
1747352450545127,49881324,1,535,50,50135439,49771744,363695,137.47783169963844
1747352450639126,49973884,1,536,50,50229438,49864304,365134,136.93602896470884
1747352450733530,50066452,1,537,50,50323842,49956872,366970,136.2509196937079
1747352450823339,50159004,1,538,50,50413651,50049424,364227,137.27702778761596
1747352450917665,50251564,1,539,50,50507977,50141984,365993,136.61463470612824
1747352451011924,50344124,1,540,50,50602236,50234544,367692,135.9833773919476
1747352451105877,50436684,1,541,50,50696189,50327104,369085,135.4701491526342
1747352451195920,50529244,1,542,50,50786232,50419664,366568,136.40034045524976
1747352451289946,50621804,1,543,50,50880258,50512224,368034,135.85701321073597
1747352451384227,50714364,1,544,50,50974539,50604784,369755,135.22467579883977
1747352451478778,50806924,1,545,50,51069090,50697344,371746,134.50043847142942
1747352451569175,50899484,1,546,50,51159487,50789904,369583,135.28760792568923
1747352451663249,50992044,1,547,50,51253561,50882464,371097,134.73566210451713
1747352451757558,51084604,1,548,50,51347870,50975024,372846,134.10362455276442
1747352451851324,51177164,1,549,50,51441636,51067584,374052,133.671254264113
1747352451945787,51269724,1,550,50,51536099,51160144,375955,132.99464031599527
1747352452035846,51362284,1,551,50,51626158,51252704,373454,133.88529778767935
1747352452129532,51454844,1,552,50,51719844,51345264,374580,133.48283410753376
1747352452224094,51547404,1,553,50,51814406,51437824,376582,132.77320742892653
1747352452317824,51639964,1,554,50,51908136,51530384,377752,132.3619729346238
1747352452408501,51732524,1,555,50,51998813,51622944,375869,133.02506990467424
1747352452502912,51825084,1,556,50,52093224,51715504,377720,132.37318648734512
1747352452596862,51917644,1,557,50,52187174,51808064,379110,131.8878425786711
1747352452691074,52010204,1,558,50,52281386,51900624,380762,131.31562498358556
1747352452781104,52102764,1,559,50,52371416,51993184,378232,132.193997334969
1747352452874943,52195324,1,560,50,52465255,52085744,379511,131.7484868686283
1747352452969083,52287884,1,561,50,52559395,52178304,381091,131.20225877808713
1747352453064102,52380444,1,562,50,52654414,52270864,383550,130.3611002476861
1747352453153939,52473004,1,563,50,52744251,52363424,380827,131.29321187835944
1747352453248465,52565564,1,564,50,52838777,52455984,382793,130.61889846470547
1747352453341904,52658124,1,565,50,52932216,52548544,383672,130.3196480326946
1747352453435980,52750684,1,566,50,53026292,52641104,385188,129.80674371994974
1747352453530049,52843244,1,567,50,53120361,52733664,386697,129.30020144971385
1747352453621058,52935804,1,568,50,53211370,52826224,385146,129.82089908761873
1747352453714979,53028364,1,569,50,53305291,52918784,386507,129.36376314012423
1747352453808791,53120924,1,570,50,53399103,53011344,387759,128.9460721736955
1747352453903316,53213484,1,571,50,53493628,53103904,389724,128.29592224240744
1747352453993495,53306044,1,572,50,53583807,53196464,387343,129.08455813064907
1747352454088129,53398604,1,573,50,53678441,53289024,389417,128.3970653566742
1747352454181929,53491164,1,574,50,53772241,53381584,390657,127.9895150989231
1747352454275948,53583724,1,575,50,53866260,53474144,392116,127.51328688449335
1747352454366598,53676284,1,576,50,53956910,53566704,390206,128.13744534937956
1747352454459969,53768844,1,577,50,54050281,53659264,391017,127.8716782134792
1747352454554512,53861412,1,578,50,54144824,53751832,392992,127.22905300871264
1747352454648284,53953964,1,579,50,54238596,53844384,394212,126.83530689070857
1747352454739263,54046524,1,580,50,54329575,53936944,392631,127.34603227967226
1747352454833697,54139084,1,581,50,54424009,54029504,394505,126.74110594289046
1747352454927374,54231644,1,582,50,54517686,54122064,395622,126.3832648336038
1747352455021120,54324204,1,583,50,54611432,54214624,396808,126.00552408217575
1747352455115357,54416764,1,584,50,54705669,54307184,398485,125.4752374618869
1747352455205801,54509324,1,585,50,54796113,54399744,396369,126.14508198168878
1747352455299732,54601884,1,586,50,54890044,54492304,397740,125.71026298587016
1747352455393998,54694444,1,587,50,54984310,54584864,399446,125.17336511067828
1747352455488314,54787004,1,588,50,55078626,54677424,401202,124.625500371384
1747352455578169,54879564,1,589,50,55168481,54769984,398497,125.47145900721964
1747352455673066,54972124,1,590,50,55263378,54862544,400834,124.73991727248686
1747352455766754,55064684,1,591,50,55357066,54955104,401962,124.38986769893673
1747352455860859,55157244,1,592,50,55451171,55047664,403507,123.91358762053694
1747352455951530,55249804,1,593,50,55541842,55140224,401618,124.4964120134058
1747352456045583,55342364,1,594,50,55635895,55232784,403111,124.03531533498216
1747352456139777,55434924,1,595,50,55730089,55325344,404745,123.53457114973624
1747352456233759,55527484,1,596,50,55824071,55417904,406167,123.10207377753486
1747352456323663,55620044,1,597,50,55913975,55510464,403511,123.91235926653796
1747352456418134,55712604,1,598,50,56008446,55603024,405422,123.32828509553008
1747352456512619,55805164,1,599,50,56102931,55695584,407347,122.7454725332456
1747352456606650,55897724,1,600,50,56196962,55788144,408818,122.30381245444184
1747352456700974,55990292,1,601,50,56291286,55880712,410574,121.780726495102
1747352456790491,56082844,1,602,50,56380803,55973264,407539,122.6876446180611
1747352456885317,56175404,1,603,50,56475629,56065824,409805,122.00924830102124
1747352456979338,56267964,1,604,50,56569650,56158384,411266,121.5758171110668
1747352457073482,56360524,1,605,50,56663794,56250944,412850,121.10936175366356
1747352457163571,56453084,1,606,50,56753883,56343504,410379,121.83859310539768
1747352457257861,56545644,1,607,50,56848173,56436064,412109,121.32712461994278
1747352457352079,56638204,1,608,50,56942391,56528624,413767,120.8409563836652
1747352457446086,56730764,1,609,50,57036398,56621184,415214,120.4198317012432
1747352457535970,56823324,1,610,50,57126282,56713744,412538,121.20095603314118
1747352457629881,56915884,1,611,50,57220193,56806304,413889,120.80533669655392
1747352457724717,57008444,1,612,50,57315029,56898864,416165,120.14465416361298
1747352457818698,57101004,1,613,50,57409010,56991424,417586,119.73581489800902
1747352457909419,57193564,1,614,50,57499731,57083984,415747,120.26544990102154
1747352458002628,57286124,1,615,50,57592940,57176544,416396,120.0780026705348
1747352458097037,57378684,1,616,50,57687349,57269104,418245,119.54715537543784
1747352458191709,57471244,1,617,50,57782021,57361664,420357,118.94651451028533
1747352458285642,57563804,1,618,50,57875954,57454224,421730,118.5592677779622
1747352458375781,57656364,1,619,50,57966093,57546784,419309,119.24380349575137
1747352458470424,57748924,1,620,50,58060736,57639344,421392,118.6543645821468
1747352458564203,57841484,1,621,50,58154515,57731904,422611,118.3121120841625
1747352458658525,57934044,1,622,50,58248837,57824464,424373,117.82087927365784
1747352458748888,58026604,1,623,50,58339200,57917024,422176,118.43401803986964
1747352458843099,58119164,1,624,50,58433411,58009584,423827,117.97266337444287
1747352458936786,58211724,1,625,50,58527098,58102144,424954,117.65979376591348
1747352459031356,58304284,1,626,50,58621668,58194704,426964,117.10589183162983
1747352459121322,58396844,1,627,50,58711634,58287264,424370,117.82171218512148
1747352459215500,58489404,1,628,50,58805812,58379824,425988,117.37419833422538
1747352459309790,58581964,1,629,50,58900102,58472384,427718,116.89945244296476
1747352459403636,58674524,1,630,50,58993948,58564944,429004,116.54902984587557
1747352459493659,58767084,1,631,50,59083971,58657504,426467,117.24236576335332
1747352459588047,58859644,1,632,50,59178359,58750064,428295,116.74196523424276
1747352459682628,58952204,1,633,50,59272940,58842624,430316,116.1936809228567
1747352459776845,59044764,1,634,50,59367157,58935184,431973,115.74797498917756
1747352459870732,59137324,1,635,50,59461044,59027744,433300,115.39349180706208
1747352459960829,59229884,1,636,50,59551141,59120304,430837,116.05317092078906
1747352460054755,59322444,1,637,50,59645067,59212864,432203,115.68637885438092
1747352460148774,59415004,1,638,50,59739086,59305424,433662,115.2971669180145
1747352460243655,59507564,1,639,50,59833967,59397984,435983,114.68337068188438
1747352460333779,59600124,1,640,50,59924091,59490544,433547,115.32774993253328
1747352460427681,59692684,1,641,50,60017993,59583104,434889,114.97186638429577
1747352460522061,59785252,1,642,50,60112373,59675672,436701,114.49481452984996
1747352460616216,59877804,1,643,50,60206528,59768224,438304,114.07607505293127
1747352460706089,59970364,1,644,50,60296401,59860784,435617,114.779726227397
1747352460800986,60062924,1,645,50,60391298,59953344,437954,114.16724130844791
1747352460894468,60155484,1,646,50,60484780,60045904,438876,113.9273963488548
1747352460988631,60248044,1,647,50,60578943,60138464,440479,113.5127894859914
1747352461083303,60340604,1,648,50,60673615,60231024,442591,112.9711178040222
1747352461172859,60433164,1,649,50,60763171,60323584,439587,113.7431270715467
1747352461267654,60525724,1,650,50,60857966,60416144,441822,113.16774628696623
1747352461361665,60618284,1,651,50,60951977,60508704,443273,112.79730549796628
1747352461455538,60710844,1,652,50,61045850,60601264,444586,112.46418015861948
1747352461546528,60803404,1,653,50,61136840,60693824,443016,112.86274084908896
1747352461640140,60895964,1,654,50,61230452,60786384,444068,112.59536827693056
1747352461734129,60988524,1,655,50,61324441,60878944,445497,112.2342013526466
1747352461828808,61081084,1,656,50,61419120,60971504,447616,111.70288818987704
1747352461918962,61173644,1,657,50,61509274,61064064,445210,112.3065519642416
1747352462012938,61266204,1,658,50,61603250,61156624,446626,111.95049101485358
1747352462106912,61358764,1,659,50,61697224,61249184,448040,111.59717882331935
1747352462201124,61451324,1,660,50,61791436,61341744,449692,111.18721258105548
1747352462291825,61543884,1,661,50,61882137,61434304,447833,111.648761926879
1747352462386005,61636444,1,662,50,61976317,61526864,449453,111.24633721434722
1747352462480332,61729004,1,663,50,62070644,61619424,451220,110.81069101546916
1747352462574211,61821564,1,664,50,62164523,61711984,452539,110.4877148709835
1747352462668654,61914132,1,665,50,62258966,61804552,454414,110.03182120269182
1747352462758848,62006684,1,666,50,62349160,61897104,452056,110.60576565735218
1747352462852602,62099244,1,667,50,62442914,61989664,453250,110.31439602868174
1747352462947241,62191804,1,668,50,62537553,62082224,455329,109.81070830103069
1747352463041083,62284364,1,669,50,62631395,62174784,456611,109.50239919756642
1747352463131581,62376924,1,670,50,62721893,62267344,454549,109.99914200669237
1747352463225062,62469484,1,671,50,62815374,62359904,455470,109.77671416339166
1747352463319108,62562044,1,672,50,62909420,62452464,456956,109.41972531272158
1747352463413328,62654604,1,673,50,63003640,62545024,458616,109.02367121949516
1747352463504045,62747164,1,674,50,63094357,62637584,456773,109.46356286382952
1747352463598376,62839724,1,675,50,63188688,62730144,458544,109.04078997871524
1747352463692652,62932284,1,676,50,63282964,62822704,460260,108.63425020640508
1747352463786560,63024844,1,677,50,63376872,62915264,461608,108.31701356995544
1747352463876069,63117404,1,678,50,63466381,63007824,458557,109.03769869394644
1747352463970354,63209964,1,679,50,63560666,63100384,460282,108.62905783845557
1747352464063890,63302524,1,680,50,63654202,63192944,461258,108.39920391624644
1747352464159305,63395084,1,681,50,63749617,63285504,464113,107.73238413920748
1747352464252818,63487644,1,682,50,63843130,63378064,465066,107.5116220063389
1747352464342832,63580204,1,683,50,63933144,63470624,462520,108.10343336504368
1747352464437396,63672764,1,684,50,64027708,63563184,464524,107.63706503862018
1747352464531615,63765324,1,685,50,64121927,63655744,466183,107.25401827179456
1747352464625610,63857884,1,686,50,64215922,63748304,467618,106.92488313110276
1747352464716083,63950444,1,687,50,64306395,63840864,465531,107.40423301563162
1747352464810734,64043004,1,688,50,64401046,63933424,467622,106.92396850447584
1747352464904728,64135564,1,689,50,64495040,64025984,469056,106.59708009278212
1747352464998902,64228124,1,690,50,64589214,64118544,470670,106.23154226953068
1747352465089069,64320684,1,691,50,64679381,64211104,468277,106.7744091638069
1747352465182385,64413244,1,692,50,64772697,64303664,469033,106.60230730033922
1747352465277415,64505804,1,693,50,64867727,64396224,471503,106.0438639838983
1747352465371399,64598364,1,694,50,64961711,64488784,472927,105.7245621417259
1747352465461104,64690924,1,695,50,65051416,64581344,470072,106.36668425262512
1747352465555812,64783484,1,696,50,65146124,64673904,472220,105.88285121341748
1747352465649994,64876044,1,697,50,65240306,64766464,473842,105.52040553602257
1747352465743667,64968604,1,698,50,65333979,64859024,474955,105.27313113873946
1747352465838211,65061164,1,699,50,65428523,64951584,476939,104.8352095341333
1747352465928213,65153724,1,700,50,65518525,65044144,474381,105.40051140328131
1747352466022754,65246284,1,701,50,65613066,65136704,476362,104.96219261821892
1747352466116574,65338844,1,702,50,65706886,65229264,477622,104.68529506597268
1747352466210252,65431404,1,703,50,65800564,65321824,478740,104.44082382921836
1747352466300747,65523964,1,704,50,65891059,65414384,476675,104.89327109665916
1747352466395118,65616524,1,705,50,65985430,65506944,478486,104.49626530347804
1747352466489128,65709092,1,706,50,66079440,65599512,479928,104.18229401076827
1747352466583245,65801644,1,707,50,66173557,65692064,481493,103.84366958605835
1747352466673978,65894204,1,708,50,66264290,65784624,479666,104.23919977651116
1747352466768202,65986764,1,709,50,66358514,65877184,481330,103.8788357260092
1747352466861883,66079324,1,710,50,66452195,65969744,482451,103.6374678464756
1747352466956254,66171884,1,711,50,66546566,66062304,484262,103.24989365260952
1747352467046833,66264444,1,712,50,66637145,66154864,482281,103.67399918304888
1747352467140829,66357004,1,713,50,66731141,66247424,483717,103.3662244659584
1747352467235345,66449564,1,714,50,66825657,66339984,485673,102.94992721440146
1747352467328803,66542124,1,715,50,66919115,66432544,486571,102.75992609506116
1747352467423534,66634684,1,716,50,67013846,66525104,488742,102.30346481374632
1747352467513281,66727244,1,717,50,67103593,66617664,485929,102.89569052268952
1747352467607803,66819804,1,718,50,67198115,66710224,487891,102.48190681935104
1747352467701808,66912364,1,719,50,67292120,66802784,489336,102.17927967695
1747352467795703,67004924,1,720,50,67386015,66895344,490671,101.90127396972716
1747352467885614,67097484,1,721,50,67475926,66987904,488022,102.45439754765154
1747352467980270,67190044,1,722,50,67570582,67080464,490118,102.01624914816432
1747352468074889,67282604,1,723,50,67665201,67173024,492177,101.58946882930329
1747352468168270,67375164,1,724,50,67758582,67265584,492998,101.42028973748371
1747352468258967,67467724,1,725,50,67849279,67358144,491135,101.80500269783258
1747352468353418,67560284,1,726,50,67943730,67450704,493026,101.41452986252246
1747352468447226,67652844,1,727,50,68037538,67543264,494274,101.158466761351
1747352468541686,67745404,1,728,50,68131998,67635824,496174,100.77110046072546
1747352468631707,67837972,1,729,50,68222019,67728392,493627,101.291055797191
1747352468726194,67930524,1,730,50,68316506,67820944,495562,100.89554889196508
1747352468819805,68023084,1,731,50,68410117,67913504,496613,100.68202000350372
1747352468914422,68115644,1,732,50,68504734,68006064,498670,100.26670944712936
1747352469008006,68208204,1,733,50,68598318,68098624,499694,100.06123747733612
1747352469098029,68300764,1,734,50,68688341,68191184,497157,100.57185154790136
1747352469192481,68393324,1,735,50,68782793,68283744,499049,100.19056244977948
1747352469286511,68485884,1,736,50,68876823,68376304,500519,99.89630763267728
1747352469380907,68578444,1,737,50,68971219,68468864,502355,99.53120801027164
1747352469471526,68671004,1,738,50,69061838,68561424,500414,99.9172685016806
1747352469565162,68763564,1,739,50,69155474,68653984,501490,99.70288540150352
1747352469659463,68856124,1,740,50,69249775,68746544,503231,99.35794893398857
1747352470257381,69430204,1,746,50,69847693,69320624,527069,94.86423978644162
1747352470335067,69525884,1,747,50,69925379,69416304,509075,98.21735500662966
1747352470425321,69618444,1,748,50,70015633,69508864,506769,98.66428293759088
1747352470519646,69711004,1,749,50,70109958,69601424,508534,98.32184278730624
1747352470613896,69803564,1,750,50,70204208,69693984,510224,97.99617422935808
1747352470707968,69896124,1,751,50,70298280,69786544,511736,97.706629981084
1747352470798242,69988684,1,752,50,70388554,69879104,509450,98.14505839630976
1747352470892795,70081244,1,753,50,70483107,69971664,511443,97.76260502147844
1747352470987015,70173804,1,754,50,70577327,70064224,513103,97.44632169369504
1747352471080796,70266364,1,755,50,70671108,70156784,514324,97.21498510666429
1747352471174804,70358924,1,756,50,70765116,70249344,515772,96.94205966977655
1747352471264792,70451484,1,757,50,70855104,70341904,513200,97.42790335151987
1747352471358692,70544044,1,758,50,70949004,70434464,514540,97.17417499125432
1747352471555674,70732284,1,760,50,71145986,70622704,523282,95.550773770166
1747352471646283,70827964,1,761,50,71236595,70718384,518211,96.485794396491
1747352471740596,70923644,1,762,50,71330908,70814064,516844,96.74098954423386
1747352471834381,71016204,1,763,50,71424693,70906624,518069,96.51224064748132
1747352471928408,71108764,1,764,50,71518720,70999184,519536,96.23972159773336
1747352472023125,71201324,1,765,50,71613437,71091744,521693,95.84180734646624
1747352472113309,71293884,1,766,50,71703621,71184304,519317,96.28030663352057
1747352472207016,71386444,1,767,50,71797328,71276864,520464,96.06812382796888
1747352472301480,71479004,1,768,50,71891792,71369424,522368,95.717961283999
1747352472395268,71571564,1,769,50,71985580,71461984,523596,95.49347206624957
1747352472489267,71664124,1,770,50,72079579,71554544,525035,95.23174645499824
1747352472579631,71756684,1,771,50,72169943,71647104,522839,95.631733669447
1747352472673429,71849244,1,772,50,72263741,71739664,524077,95.40582776958348
1747352472767647,71941804,1,773,50,72357959,71832224,525735,95.1049483104606
1747352472862743,72034364,1,774,50,72453055,71924784,528271,94.64839069341303
1747352472952652,72126924,1,775,50,72542964,72017344,525620,95.1257562497622
1747352473047100,72219484,1,776,50,72637412,72109904,527508,94.78529235575574
1747352473140902,72312044,1,777,50,72731214,72202464,528750,94.5626477541371
1747352473234842,72404604,1,778,50,72825154,72295024,530130,94.31648840850356
1747352473325026,72497172,1,779,50,72915338,72387592,527746,94.74254660385868
1747352473419026,72589724,1,780,50,73009338,72480144,529194,94.48330857870648
1747352473513204,72682284,1,781,50,73103516,72572704,530812,94.1953083200832
1747352473607222,72774844,1,782,50,73197534,72665264,532270,93.9372874668871
1747352473698179,72867404,1,783,50,73288491,72757824,530667,94.22104634356386
1747352473792079,72959964,1,784,50,73382391,72850384,532007,93.98372577804427
1747352473886547,73052524,1,785,50,73476859,72942944,533915,93.64786529691057
1747352473980271,73145084,1,786,50,73570583,73035504,535079,93.44414563083208
1747352474074670,73237644,1,787,50,73664982,73128064,536918,93.12408971202306
1747352474165100,73330204,1,788,50,73755412,73220624,534788,93.4949924082066
1747352474259037,73422764,1,789,50,73849349,73313184,536165,93.25487489858531
1747352474353300,73515324,1,790,50,73943612,73405744,537868,92.9596109082526
1747352474447221,73607884,1,791,50,74037533,73498304,539229,92.72498326314052
1747352474537752,73700444,1,792,50,74128064,73590864,537200,93.07520476545048
1747352474631863,73793004,1,793,50,74222175,73683424,538751,92.80725232992609
1747352474725489,73885564,1,794,50,74315801,73775984,539817,92.62398183087971
1747352474819651,73978124,1,795,50,74409963,73868544,541419,92.34991753152364
1747352474909683,74070684,1,796,50,74499995,73961104,538891,92.78314167429036
1747352475004362,74163244,1,797,50,74594674,74053664,541010,92.4197334614887
1747352475098798,74255804,1,798,50,74689110,74146224,542886,92.10036729626478
1747352475192423,74348364,1,799,50,74782735,74238784,543951,91.92004426869332
1747352475287042,74440924,1,800,50,74877354,74331344,546010,91.57341440632956
1747352475377068,74533484,1,801,50,74967380,74423904,543476,92.00038272159212
1747352475471126,74626044,1,802,50,75061438,74516464,544974,91.74749621082842
1747352475565438,74718604,1,803,50,75155750,74609024,546726,91.45348858477554
1747352475660146,74811164,1,804,50,75250458,74701584,548874,91.09558842284386
1747352475750179,74903724,1,805,50,75340491,74794144,546347,91.51692971682832
1747352475844363,74996284,1,806,50,75434675,74886704,547971,91.24570460845555
1747352475937988,75088844,1,807,50,75528300,74979264,549036,91.06870951995862
1747352476032705,75181404,1,808,50,75623017,75071824,551193,90.71232762389944
1747352476122711,75273964,1,809,50,75713023,75164384,548639,91.13460763817372
1747352476216889,75366524,1,810,50,75807201,75256944,550257,90.86663141041367
1747352476311100,75459084,1,811,50,75901412,75349504,551908,90.5948092798075
1747352476404847,75551644,1,812,50,75995159,75442064,553095,90.40038329762518
1747352476495625,75644204,1,813,50,76085937,75534624,551313,90.6925829791788
1747352476589365,75736764,1,814,50,76179677,75627184,552493,90.49888414875844
1747352476683713,75829324,1,815,50,76274025,75719744,554281,90.20695279109331
1747352476777549,75921884,1,816,50,76367861,75812304,555557,89.9997660006084
1747352476872258,76014444,1,817,50,76462570,75904864,557706,89.65297127877412
1747352476961597,76107004,1,818,50,76551909,75997424,554485,90.17376484485604
1747352477056602,76199564,1,819,50,76646914,76089984,556930,89.7778895013736
1747352477150953,76292132,1,820,50,76741265,76182552,558713,89.49138466439835
1747352477244302,76384684,1,821,50,76834614,76275104,559510,89.36390770495613
1747352477334467,76477244,1,822,50,76924779,76367664,557115,89.7480771474471
1747352477428540,76569804,1,823,50,77018852,76460224,558628,89.50500153948603
1747352477523058,76662364,1,824,50,77113370,76552784,560586,89.19238083005997
1747352477617733,76754924,1,825,50,77208045,76645344,562701,88.85713727183709
1747352477707656,76847484,1,826,50,77297968,76737904,560064,89.27551137012912
1747352477801396,76940044,1,827,50,77391708,76830464,561244,89.08781207460571
1747352477896719,77032604,1,828,50,77487031,76923024,564007,88.65138198639379
1747352477989957,77125164,1,829,50,77580269,77015584,564685,88.54494098479684
1747352478080094,77217724,1,830,50,77670406,77108144,562262,88.92651468532463
1747352478174854,77310284,1,831,50,77765166,77200704,564462,88.57992212053247
1747352478269042,77402844,1,832,50,77859354,77293264,566090,88.32517797523363
1747352478363012,77495404,1,833,50,77953324,77385824,567500,88.10572687224669
1747352478457202,77587964,1,834,50,78047514,77478384,569130,87.85339026233022
1747352478547113,77680524,1,835,50,78137425,77570944,566481,88.26421362764152
1747352478641716,77773084,1,836,50,78232028,77663504,568524,87.94703477777543
1747352478735097,77865644,1,837,50,78325409,77756064,569345,87.82021445696371
1747352478829417,77958204,1,838,50,78419729,77848624,571105,87.54957494681364
1747352478919856,78050764,1,839,50,78510168,77941184,568984,87.87593324241102
1747352479013911,78143324,1,840,50,78604223,78033744,570479,87.6456451508294
1747352479108564,78235884,1,841,50,78698876,78126304,572572,87.32526215043698
1747352479202601,78328444,1,842,50,78792913,78218864,574049,87.10057852204254
1747352479293001,78421012,1,843,50,78883313,78311432,571881,87.43077668256159
1747352479386721,78513564,1,844,50,78977033,78403984,573049,87.25257351465581
1747352479480663,78606124,1,845,50,79070975,78496544,574431,87.04265612406016
1747352479575159,78698684,1,846,50,79165471,78589104,576367,86.75028237216912
1747352479664853,78791244,1,847,50,79255165,78681664,573501,87.18380613111398
1747352479759844,78883804,1,848,50,79350156,78774224,575932,86.81580464360376
1747352479853948,78976364,1,849,50,79444260,78866784,577476,86.58368486309388
1747352479947532,79068924,1,850,50,79537844,78959344,578500,86.4304235090752
1747352480042032,79161484,1,851,50,79632344,79051904,580440,86.14154779133072
1747352480132587,79254044,1,852,50,79722899,79144464,578435,86.4401358838936
1747352480226266,79346604,1,853,50,79816578,79237024,579554,86.27323769657357
1747352480320943,79439164,1,854,50,79911255,79329584,581671,85.95924500275929
1747352480415058,79531724,1,855,50,80005370,79422144,583226,85.73006004533406
1747352480505121,79624284,1,856,50,80095433,79514704,580729,86.09867941845508
1747352480598755,79716844,1,857,50,80189067,79607264,581803,85.93974249015561
1747352480693240,79809404,1,858,50,80283552,79699824,583728,85.65633308664309
1747352480788141,79901964,1,859,50,80378453,79792384,586069,85.31418655482547
1747352480877823,79994524,1,860,50,80468135,79884944,583191,85.73520510433117
1747352480971438,80087084,1,861,50,80561750,79977504,584246,85.58038908268092
1747352481065774,80179644,1,862,50,80656086,80070064,586022,85.32102890335175
1747352481159871,80272204,1,863,50,80750183,80162624,587559,85.09783698317955
1747352481250735,80364764,1,864,50,80841047,80255184,585863,85.34418456191976
1747352481344695,80457324,1,865,50,80935007,80347744,587263,85.14072911114782
1747352481438419,80549884,1,866,50,81028731,80440304,588427,84.97230752497761
1747352481532887,80642444,1,867,50,81123199,80532864,590335,84.69767166100603
1747352481627072,80735004,1,868,50,81217384,80625424,591960,84.46516656530846
1747352481717293,80827564,1,869,50,81307605,80717984,589621,84.80023608385727
1747352481811225,80920124,1,870,50,81401537,80810544,590993,84.6033709367116
1747352481905329,81012684,1,871,50,81495641,80903104,592537,84.38291617232342
1747352481999318,81105244,1,872,50,81589630,80995664,593966,84.1799025533448
1747352482089310,81197804,1,873,50,81679622,81088224,591398,84.54543302479887
1747352482184178,81290364,1,874,50,81774490,81180784,593706,84.21676722148673
1747352482278851,81382924,1,875,50,81869163,81273344,595819,83.91810264526643
1747352482372540,81475484,1,876,50,81962852,81365904,596948,83.75938942755482
1747352482462786,81568044,1,877,50,82053098,81458464,594634,84.08533652633385
1747352482557099,81660604,1,878,50,82147411,81551024,596387,83.83817890061319
1747352482651187,81753164,1,879,50,82241499,81643584,597915,83.62392647784384
1747352482745215,81845724,1,880,50,82335527,81736144,599383,83.41911599094402
1747352482835179,81938284,1,881,50,82425491,81828704,596787,83.78198586765463
1747352482929347,82030844,1,882,50,82519659,81921264,598395,83.55684790146977
1747352483023631,82123404,1,883,50,82613943,82013824,600119,83.31680883291482
1747352483117629,82215972,1,884,50,82707941,82106392,601549,83.11874843113362
1747352483212089,82308524,1,885,50,82802401,82198944,603457,82.85594499690947
1747352483302369,82401084,1,886,50,82892681,82291504,601177,83.17018116128861
1747352483396568,82493644,1,887,50,82986880,82384064,602816,82.94404926212974
1747352483490610,82586204,1,888,50,83080922,82476624,604298,82.74063458757104
1747352483585240,82678764,1,889,50,83175552,82569184,606368,82.45817721251781
1747352483675328,82771324,1,890,50,83265640,82661744,603896,82.79571316915495
1747352483768978,82863884,1,891,50,83359290,82754304,604986,82.64654058110435
1747352483863165,82956444,1,892,50,83453477,82846864,606613,82.42487384873058
1747352483957828,83049004,1,893,50,83548140,82939424,608716,82.14011131627885
1747352484047587,83141564,1,894,50,83637899,83031984,605915,82.51982538804948
1747352484142236,83234124,1,895,50,83732548,83124544,608004,82.2363010769666
1747352484236240,83326684,1,896,50,83826552,83217104,609448,82.04145390582954
1747352484330726,83419244,1,897,50,83921038,83309664,611374,81.78300025843429
1747352484424751,83511804,1,898,50,84015063,83402224,612839,81.58749687927825
1747352484515006,83604364,1,899,50,84105318,83494784,610534,81.8955209701671
1747352484609291,83696924,1,900,50,84199603,83587344,612259,81.6647856544371
1747352484703361,83789484,1,901,50,84293673,83679904,613769,81.46387321614483
1747352484797543,83882044,1,902,50,84387855,83772464,615391,81.24915703999571
1747352484886940,83974604,1,903,50,84477252,83865024,612228,81.66892072887879
1747352484981594,84067164,1,904,50,84571906,83957584,614322,81.39054111687355
1747352485075963,84159724,1,905,50,84666275,84050144,616131,81.1515732855513
1747352485170089,84252284,1,906,50,84760401,84142704,617697,80.94583590336362
1747352485260473,84344852,1,907,50,84850785,84235272,615513,81.23305275436913
1747352485354585,84437404,1,908,50,84944897,84327824,617073,81.0276904029183
1747352485448645,84529964,1,909,50,85038957,84420384,618573,80.83120343112292
1747352485542775,84622524,1,910,50,85133087,84512944,620143,80.62656516319623
1747352485632682,84715084,1,911,50,85222994,84605504,617490,80.97297122220603
1747352485726576,84807644,1,912,50,85316888,84698064,618824,80.79841764378885
1747352485821497,84900204,1,913,50,85411809,84790624,621185,80.49131901124464
1747352485915740,84992764,1,914,50,85506052,84883184,622868,80.27383008920029
1747352486009410,85085324,1,915,50,85599722,84975744,623978,80.13103026068227
1747352486099998,85177884,1,916,50,85690310,85068304,622006,80.38507667128614
1747352486194225,85270444,1,917,50,85784537,85160864,623673,80.17021740559555
1747352486288388,85363004,1,918,50,85878700,85253424,625276,79.9646875939585
1747352486381982,85455564,1,919,50,85972294,85345984,626310,79.83267072216634
1747352486472334,85548124,1,920,50,86062646,85438544,624102,80.11510938917036
1747352486566808,85640684,1,921,50,86157120,85531104,626016,79.8701630629249
1747352486660479,85733244,1,922,50,86250791,85623664,627127,79.72866739910737
1747352486754444,85825804,1,923,50,86344756,85716224,628532,79.55044452788403
1747352486845654,85918364,1,924,50,86435966,85808784,627182,79.72167568584557
1747352486939639,86010924,1,925,50,86529951,85901344,628607,79.54095325060014
1747352487033249,86103484,1,926,50,86623561,85993904,629657,79.40831277981503
1747352487127438,86196044,1,927,50,86717750,86086464,631286,79.20340384548366
1747352487217559,86288604,1,928,50,86807871,86179024,628847,79.51059637717918
1747352487311553,86381164,1,929,50,86901865,86271584,630281,79.32969580234848
1747352487406201,86473724,1,930,50,86996513,86364144,632369,79.06775948852648
1747352487500160,86566284,1,931,50,87090472,86456704,633768,78.89322275659232
1747352487594827,86658844,1,932,50,87185139,86549264,635875,78.63180656575585
1747352487684545,86751404,1,933,50,87274857,86641824,633033,78.98482385594433
1747352487778518,86843964,1,934,50,87368830,86734384,634446,78.8089136033642
1747352487872721,86936524,1,935,50,87463033,86826944,636089,78.60535239565532
1747352487966860,87029084,1,936,50,87557172,86919504,637668,78.41070902099526
1747352488057298,87121644,1,937,50,87647610,87012064,635546,78.67251150978842
1747352488151336,87214204,1,938,50,87741648,87104624,637024,78.48997839955794
1747352488246122,87306764,1,939,50,87836434,87197184,639250,78.21666014861165
1747352488340384,87399324,1,940,50,87930696,87289744,640952,78.0089616695166
1747352488429957,87491884,1,941,50,88020269,87382304,637965,78.37420548149193
1747352488524696,87584444,1,942,50,88115008,87474864,640144,78.10742582918843
1747352488618289,87677004,1,943,50,88208601,87567424,641177,77.98158698768047
1747352488712646,87769564,1,944,50,88302958,87659984,642974,77.76364207572934
1747352488802503,87862124,1,945,50,88392815,87752544,640271,78.0919329471427
1747352488896579,87954684,1,946,50,88486891,87845104,641787,77.90746774241298
1747352488991396,88047244,1,947,50,88581708,87937664,644044,77.63444733589631
1747352489085473,88139812,1,948,50,88675785,88030232,645553,77.4529744265769
1747352489179433,88232364,1,949,50,88769745,88122784,646961,77.28441127054026
1747352489270130,88324924,1,950,50,88860442,88215344,645098,77.50760349590296
1747352489364275,88417484,1,951,50,88954587,88307904,646683,77.31763476077151
1747352489457828,88510044,1,952,50,89048140,88400464,647676,77.19909337384742
1747352489552003,88602604,1,953,50,89142315,88493024,649291,77.00707386980568
1747352489642607,88695164,1,954,50,89232919,88585584,647335,77.23975993882611
1747352489736889,88787724,1,955,50,89327201,88678144,649057,77.0348366938497
1747352489831132,88880284,1,956,50,89421444,88770704,650740,76.83560254479515
1747352489924815,88972844,1,957,50,89515127,88863264,651863,76.70323365492443
1747352490014952,89065404,1,958,50,89605264,88955824,649440,76.98940625769895
1747352490108950,89157964,1,959,50,89699262,89048384,650878,76.81931176042208
1747352490203768,89250524,1,960,50,89794080,89140944,653136,76.5537345973886
1747352490297337,89343084,1,961,50,89887649,89233504,654145,76.43565264582011
1747352490388021,89435644,1,962,50,89978333,89326064,652269,76.65549029618148
1747352490772970,89815244,1,966,50,90363282,89705664,657618,76.03198209294757
1747352490866638,89907804,1,967,50,90456950,89798224,658726,75.90409365957925
1747352490956940,90000364,1,968,50,90547252,89890784,656468,76.16517484477536
1747352491051286,90092924,1,969,50,90641598,89983344,658254,75.95852057108654
1747352491145489,90185484,1,970,50,90735801,90075904,659897,75.76940037611931
1747352491239858,90278044,1,971,50,90830170,90168464,661706,75.56225876748888
1747352491330247,90370604,1,972,50,90920559,90261024,659535,75.81098804460719
1747352491424445,90463164,1,973,50,91014757,90353584,661173,75.6231727550883
1747352491518100,90555724,1,974,50,91108412,90446144,662268,75.4981367059861
1747352491612472,90648284,1,975,50,91202784,90538704,664080,75.29213347789423
1747352491702769,90740844,1,976,50,91293081,90631264,661817,75.54958545942459
1747352491797028,90833404,1,977,50,91387340,90723824,663516,75.35613308495952
1747352491894754,90925964,1,978,50,91485066,90816384,668682,74.77395832398659
1747352491985616,91018524,1,979,50,91575928,90908944,666984,74.96431698511508
1747352492083622,91114204,1,980,50,91673934,91004624,669310,74.70379943523928
1747352492177722,91206764,1,981,50,91768034,91097184,670850,74.53230975627935
1747352492267853,91299324,1,982,50,91858165,91189744,668421,74.80315549631145
1747352492362199,91391884,1,983,50,91952511,91282304,670207,74.60381643283344
1747352492460647,91487564,1,984,50,92050959,91377984,672975,74.29696496898102
1747352493418067,92444364,1,994,50,93008379,92334784,673595,74.22857948767434
1747352493513120,92536924,1,995,50,93103432,92427344,676088,73.95486978026528
1747352493607331,92629484,1,996,50,93197643,92519904,677739,73.77471268438146
1747352493700799,92722044,1,997,50,93291111,92612464,678647,73.67600534593095
1747352493794973,92814604,1,998,50,93385285,92705024,680261,73.50120027460048
1747352493886127,92907164,1,999,50,93476439,92797584,678855,73.6534311450899
1747352493979684,92999724,1,1000,50,93569996,92890144,679852,73.54541870877779
1747352494074530,93093324,1,1001,50,93664842,92983744,681098,73.41087479334838
1747352494168408,93186924,1,1002,50,93758720,93077344,681376,73.38092330812944
1747352494262120,93280524,1,1003,50,93852432,93170944,681488,73.36886342826286
1747352494356438,93374124,1,1004,50,93946750,93264544,682206,73.29164504563138
1747352494451227,93467724,1,1005,50,94041539,93358144,683395,73.16412909078937
1747352494545183,93561324,1,1006,50,94135495,93451744,683751,73.12603564747985
1747352494638873,93654924,1,1007,50,94229185,93545344,683841,73.11641156350672
1747352494737006,93748524,1,1008,50,94327318,93638944,688374,72.63493391673711
1747352494831503,93842124,1,1009,50,94421815,93732544,689271,72.54040863462993
1747352494924921,93935724,1,1010,50,94515233,93826144,689089,72.55956777716668
1747352495019765,94029324,1,1011,50,94610077,93919744,690333,72.42881334080799
1747352495113969,94122924,1,1012,50,94704281,94013344,690937,72.36549786738877
1747352495208693,94216524,1,1013,50,94799005,94106944,692061,72.24796658098057
1747352495302686,94310124,1,1014,50,94892998,94200544,692454,72.20696248415057
1747352495397323,94403724,1,1015,50,94987635,94294144,693491,72.09898902797585
1747352495491501,94497324,1,1016,50,95081813,94387744,694069,72.0389471363798
1747352495585551,94590924,1,1017,50,95175863,94481344,694519,71.99227090979512
1747352495679885,94684524,1,1018,50,95270197,94574944,695253,71.91626645264385
1747352495774036,94778124,1,1019,50,95364348,94668544,695804,71.85931670412933
1747352495867399,94871724,1,1020,50,95457711,94762144,695567,71.88380127291835
1747352495962148,94965324,1,1021,50,95552460,94855744,696716,71.76525298686983
1747352496056634,95058924,1,1022,50,95646946,94949344,697602,71.67410643891502
1747352496150665,95152524,1,1023,50,95740977,95042944,698033,71.62985131075465
1747352496244333,95246124,1,1024,50,95834645,95136544,698101,71.62287405404089
1747352496338449,95339724,1,1025,50,95928761,95230144,698617,71.56997324714399
1747352496432716,95433324,1,1026,50,96023028,95323744,699284,71.50170746077416
1747352496527800,95526932,1,1027,50,96118112,95417352,700760,71.35110451509789
1747352496621225,95620524,1,1028,50,96211537,95510944,700593,71.36811244188851
1747352496715288,95714124,1,1029,50,96305600,95604544,701056,71.32097863794047
1747352496809790,95807724,1,1030,50,96400102,95698144,701958,71.22933280908545
1747352496904445,95901324,1,1031,50,96494757,95791744,703013,71.12244012557377
1747352496997945,95994924,1,1032,50,96588257,95885344,702913,71.13255836782076
1747352497092960,96088524,1,1033,50,96683272,95978944,704328,70.98965254824458
1747352497187093,96182124,1,1034,50,96777405,96072544,704861,70.93597177315812
1747352497281127,96275724,1,1035,50,96871439,96166144,705295,70.8923216526418
1747352497375040,96369324,1,1036,50,96965352,96259744,705608,70.86087459325857
1747352497468963,96462924,1,1037,50,97059275,96353344,705931,70.82845207251134
1747352497563337,96556524,1,1038,50,97153649,96446944,706705,70.75087907967256
1747352497657228,96650124,1,1039,50,97247540,96540544,706996,70.721757973171
1747352497751898,96743724,1,1040,50,97342210,96634144,708066,70.61488618292645
1747352505099140,104037244,1,1115,50,104689452,103927664,761788,65.63505857272627
1747352505197651,104131884,1,1116,50,104787963,104022304,765659,65.30322245281516
1747352505783287,104715324,1,1122,50,105373599,104605744,767855,65.11646079012314
1747352508936995,107840532,1,1154,50,108527307,107730952,796355,62.78606902700429
1747352509036171,107935164,1,1155,50,108626483,107825584,800899,62.4298444622855
1747352509122125,108029804,1,1156,50,108712437,107920224,792213,63.11433919918002
1747352509219480,108124444,1,1157,50,108809792,108014864,794928,62.8987782541312
1747352509314604,108219084,1,1158,50,108904916,108109504,795412,62.86050499615293
1747352509412086,108313724,1,1159,50,109002398,108204144,798254,62.636704607806536
1747352509507097,108408364,1,1160,50,109097409,108298784,798625,62.60760682422914
1747352509600668,108503004,1,1161,50,109190980,108393424,797556,62.691522601547724
1747352509694705,108597644,1,1162,50,109285017,108488064,796953,62.7389570024832
1747352509793337,108692284,1,1163,50,109383649,108582704,800945,62.42625898157801
1747352509883575,108786924,1,1164,50,109473887,108677344,796543,62.77125026520853
1747352509981476,108881564,1,1165,50,109571788,108771984,799804,62.51531625248186
1747352510080711,108976204,1,1166,50,109671023,108866624,804399,62.158207556200345
1747352510174058,109070844,1,1167,50,109764370,108961264,803106,62.25828221928363
1747352510268102,109165484,1,1168,50,109858414,109055904,802510,62.3045195698496
1747352510367389,109260124,1,1169,50,109957701,109150544,807157,61.945817232583
1747352510460924,109354764,1,1170,50,110051236,109245184,806052,62.03073747103165
1747352510554693,109449404,1,1171,50,110145005,109339824,805181,62.09783887101161
1747352510649093,109544044,1,1172,50,110239405,109434464,804941,62.11635386941403
1747352510743576,109638692,1,1173,50,110333888,109529112,804776,62.12908933666014
1747352510837907,109733324,1,1174,50,110428219,109623744,804475,62.15233537400167
1747352510935624,109827964,1,1175,50,110525936,109718384,807552,61.91551751466159
1747352511034759,109922604,1,1176,50,110625071,109813024,812047,61.572790737481945
1747352511124347,110017244,1,1177,50,110714659,109907664,806995,61.95825252944566
1747352511222740,110111884,1,1178,50,110813052,110002304,810748,61.67144414787332
1747352511317313,110206524,1,1179,50,110907625,110096944,810681,61.67654108089372
1747352511419102,110301164,1,1180,50,111009414,110191584,817830,61.13740019319419
1747352511722771,110591324,1,1183,50,111313083,110481744,831339,60.14393646875703
1747352511808544,110685964,1,1184,50,111398856,110576384,822472,60.79234308280404
1747352511923107,110780604,1,1185,50,111513419,110671024,842395,59.35457831539836
1747352512008952,110875244,1,1186,50,111599264,110765664,833600,59.98080614203455
1747352512107753,110969892,1,1187,50,111698065,110860312,837753,59.68346278676412
1747352512193099,111064524,1,1188,50,111783411,110954944,828467,60.352434074018646
1747352512377857,111256924,1,1190,50,111968169,111147344,820825,60.91432400328937
1747352512574756,111449324,1,1192,50,112165068,111339744,825324,60.58226829705667
1747352512672450,111543964,1,1193,50,112262762,111434384,828378,60.35891827161031
1747352512766952,111638604,1,1194,50,112357264,111529024,828240,60.36897517627741
1747352512865209,111733244,1,1195,50,112455521,111623664,831857,60.10648464820276
1747352512971521,111827884,1,1196,50,112561833,111718304,843529,59.274784862168346
1747352513045276,111922524,1,1197,50,112635588,111812944,822644,60.77963250203004
1747352513344077,112212684,1,1200,50,112934389,112103104,831285,60.14784339907492
1747352513438248,112307324,1,1201,50,113028560,112197744,830816,60.1817971728999
1747352513548714,112401964,1,1202,50,113139026,112292384,846642,59.05683866380359
1747352513622646,112496604,1,1203,50,113212958,112387024,825934,60.53752479011641
1747352513721440,112591244,1,1204,50,113311752,112481664,830088,60.23457753876697
1747352513810902,112685884,1,1205,50,113401214,112576304,824910,60.61267289764944
1747352513925464,112780524,1,1206,50,113515776,112670944,844832,59.18336426650505
1747352514004043,112875164,1,1207,50,113594355,112765584,828771,60.33029630621728
1747352514101939,112969804,1,1208,50,113692251,112860224,832027,60.09420367367886
1747352514208612,113064444,1,1209,50,113798924,112954864,844060,59.237494964812925
1747352514296247,113159084,1,1210,50,113886559,113049504,837055,59.73323138861843
1747352514389068,113253724,1,1211,50,113979380,113144144,835236,59.86332006762161
1747352514482981,113348364,1,1212,50,114073293,113238784,834509,59.91547125315605
1747352514581633,113443004,1,1213,50,114171945,113333424,838521,59.62879880169966
1747352514675623,113537644,1,1214,50,114265935,113428064,837871,59.67505737756767
1747352514769802,113632292,1,1215,50,114360114,113522712,837402,59.70847932056528
1747352514863360,113726924,1,1216,50,114453672,113617344,836328,59.78515606317139
1747352514957897,113821564,1,1217,50,114548209,113711984,836225,59.792519955753534
1747352515052445,113916204,1,1218,50,114642757,113806624,836133,59.799098947177065
1747352515150889,114010844,1,1219,50,114741201,113901264,839937,59.52827414437035
1747352515249161,114105484,1,1220,50,114839473,113995904,843569,59.27197419535332
1747352515343208,114200124,1,1221,50,114933520,114090544,842976,59.31366966556581
1747352515437543,114294764,1,1222,50,115027855,114185184,842671,59.335137912661054
1747352515531691,114389404,1,1223,50,115122003,114279824,842179,59.36980143176213
1747352515629707,114484044,1,1224,50,115220019,114374464,845555,59.13275895713467
1747352515719701,114578684,1,1225,50,115310013,114469104,840909,59.45946588750982
1747352515817813,114673324,1,1226,50,115408125,114563744,844381,59.214975230375856
1747352515912309,114767964,1,1227,50,115502621,114658384,844237,59.22507542313355
1747352516010922,114862604,1,1228,50,115601234,114753024,848210,58.94766626189269
1747352516109251,114957244,1,1229,50,115699563,114847664,851899,58.69240367696171
1747352516198916,115051884,1,1230,50,115789228,114942304,846924,59.03717452805682
1747352516309100,115146524,1,1231,50,115899412,115036944,862468,57.97316538120835
1747352516387513,115241164,1,1232,50,115977825,115131584,846241,59.08482335410362
1747352516498169,115335804,1,1233,50,116088481,115226224,862257,57.98735179882564
1747352516583892,115430444,1,1234,50,116174204,115320864,853340,58.59329223990438
1747352516678622,115525084,1,1235,50,116268934,115415504,853430,58.587113178585234
1747352516768191,115619724,1,1236,50,116358503,115510144,848359,58.93731309504585
1747352516866455,115714364,1,1237,50,116456767,115604784,851983,58.68661698648916
1747352516973618,115809004,1,1238,50,116563930,115699424,864506,57.83649853210967
1747352517062858,115903644,1,1239,50,116653170,115794064,859106,58.20003585122208
1747352517152933,115998284,1,1240,50,116743245,115888704,854541,58.510943301725725
1747352517243058,116092924,1,1241,50,116833370,115983344,850026,58.8217301588422
1747352517349560,116187564,1,1242,50,116939872,116077984,861888,58.01217791638821
1747352517562344,116379964,1,1244,50,117152656,116270384,882272,56.67186536578289
1747352517632226,116474604,1,1245,50,117222538,116365024,857514,58.308085932124726
1747352517735000,116569244,1,1246,50,117325312,116459664,865648,57.7601981405837
1747352517923650,116761644,1,1248,50,117513962,116652064,861898,58.01150484164019
1747352518017712,116856284,1,1249,50,117608024,116746704,861320,58.05043421724795
1747352518127828,116950924,1,1250,50,117718140,116841344,876796,57.02580759948722
1747352518218449,117045564,1,1251,50,117808761,116935984,872777,57.28840242123704
1747352518300457,117140204,1,1252,50,117890769,117030624,860145,58.12973394020775
1747352518402731,117234844,1,1253,50,117993043,117125264,867779,57.618356747512905
1747352518590889,117427244,1,1255,50,118181201,117317664,863537,57.90139855038058
1747352518705560,117521884,1,1256,50,118295872,117412304,883568,56.5887401988302
1747352518787265,117616524,1,1257,50,118377577,117506944,870633,57.42947947068397
1747352518872979,117711164,1,1258,50,118463291,117601584,861707,58.02436326964966
1747352518971362,117805804,1,1259,50,118561674,117696224,865450,57.77341267548674
1747352519073884,117900444,1,1260,50,118664196,117790864,873332,57.25199580457375
1747352519160172,117995084,1,1261,50,118750484,117885504,864980,57.80480473536961
1747352519258432,118089724,1,1262,50,118848744,117980144,868600,57.56389592447616
1747352519352155,118184364,1,1263,50,118942467,118074784,867683,57.62473161281252
1747352519451043,118279004,1,1264,50,119041355,118169424,871931,57.34398708154659
1747352519540590,118373644,1,1265,50,119130902,118264064,866838,57.68090462116336
1747352519639600,118468284,1,1266,50,119229912,118358704,871208,57.391575834932645
1747352519733779,118562924,1,1267,50,119324091,118453344,870747,57.42196068433196
1747352519831668,118657564,1,1268,50,119421980,118547984,873996,57.20849981006778
1747352519929927,118752204,1,1269,50,119520239,118642624,877615,56.97259048671684
1747352520023880,118846844,1,1270,50,119614192,118737264,876928,57.01722376295431
1747352520118250,118941484,1,1271,50,119708562,118831904,876658,57.03478437429419
1747352520212241,119036124,1,1272,50,119802553,118926544,876009,57.07703916283965
1747352520315029,119130764,1,1273,50,119905341,119021184,884157,56.55104240536466
1747352520405616,119225404,1,1274,50,119995928,119115824,880104,56.81146773563125
1747352520495748,119320044,1,1275,50,120086060,119210464,875596,57.10396118757966
1747352520593558,119414684,1,1276,50,120183870,119305104,878766,56.89796828734839
1747352520687575,119509324,1,1277,50,120277887,119399744,878143,56.938334644812976
1747352520786476,119603964,1,1278,50,120376788,119494384,882404,56.66338774529581
1747352520884237,119698604,1,1279,50,120474549,119589024,885525,56.46367973800852
1747352520974501,119793244,1,1280,50,120564813,119683664,881149,56.74409208885217
1747352521072634,119887892,1,1281,50,120662946,119778312,884634,56.520549741475
1747352521162675,119982524,1,1282,50,120752987,119872944,880043,56.81540561086219
1747352521273600,120077164,1,1283,50,120863912,119967584,896328,55.78315081086388
1747352521355620,120171804,1,1284,50,120945932,120062224,883708,56.579775219869006
1747352521453539,120266444,1,1285,50,121043851,120156864,886987,56.37061197063768
1747352521547689,120361084,1,1286,50,121138001,120251504,886497,56.40177011315323
1747352521642282,120455724,1,1287,50,121232594,120346144,886450,56.40476056179142
1747352521740072,120550364,1,1288,50,121330384,120440784,889600,56.20503597122303
1747352521834501,120645004,1,1289,50,121424813,120535424,889389,56.218370139500266
1747352521925107,120739644,1,1290,50,121515419,120630064,885355,56.47452151961642
1747352522023300,120834284,1,1291,50,121613612,120724704,888908,56.248790651001
1747352522121109,120928924,1,1292,50,121711421,120819344,892077,56.04897335095513
1747352522211811,121023564,1,1293,50,121802123,120913984,888139,56.29749397335327
1747352522318836,121118204,1,1294,50,121909148,121008624,900524,55.52322869795808
1747352522403586,121212844,1,1295,50,121993898,121103264,890634,56.13978356990638
1747352522498358,121307484,1,1296,50,122088670,121197904,890766,56.13146438009534
1747352522596691,121402124,1,1297,50,122187003,121292544,894459,55.89971144568952
1747352522690769,121496764,1,1298,50,122281081,121387184,893897,55.93485602927407
1747352522793248,121591404,1,1299,50,122383560,121481824,901736,55.44860136447918
1747352522887390,121686052,1,1300,50,122477702,121576472,901230,55.47973325344252
1747352522977884,121780684,1,1301,50,122568196,121671104,897092,55.73564361291818
1747352523071490,121875324,1,1302,50,122661802,121765744,896058,55.79995937762957
1747352523166578,121969964,1,1303,50,122756890,121860384,896506,55.77207514506316
1747352523268629,122064604,1,1304,50,122858941,121955024,903917,55.31481319634435
1747352523354960,122159244,1,1305,50,122945272,122049664,895608,55.82799617689882
1747352523452695,122253884,1,1306,50,123043007,122144304,898703,55.63573282830924
1747352523550755,122348524,1,1307,50,123141067,122238944,902123,55.424814576282834
1747352523645107,122443164,1,1308,50,123235419,122333584,901835,55.44251442891438
1747352523739036,122537804,1,1309,50,123329348,122428224,901124,55.48625938272646
1747352523845794,122632444,1,1310,50,123436106,122522864,913242,54.75000054750001
1747352523931851,122727084,1,1311,50,123522163,122617504,904659,55.26944406676992
1747352524025628,122821724,1,1312,50,123615940,122712144,903796,55.322218730775525
1747352524120303,122916364,1,1313,50,123710615,122806784,903831,55.32007643021759
1747352524214247,123011004,1,1314,50,123804559,122901424,903135,55.36270878661552
1747352524317152,123105644,1,1315,50,123907464,122996064,911400,54.86065393899495
1747352524406531,123200284,1,1316,50,123996843,123090704,906139,55.17917229034398
1747352524501392,123294924,1,1317,50,124091704,123185344,906360,55.16571781632023
1747352524598834,123389564,1,1318,50,124189146,123279984,909162,54.9956993363119
1747352524688913,123484204,1,1319,50,124279225,123374624,904601,55.27298775924413
1747352524787645,123578844,1,1320,50,124377957,123469264,908693,55.024084041585006
1747352524886043,123673484,1,1321,50,124476355,123563904,912451,54.79746309664848
1747352524980232,123768124,1,1322,50,124570544,123658544,912000,54.82456140350877
1747352525078867,123862764,1,1323,50,124669179,123753184,915995,54.58545079394538
1747352525192708,123957404,1,1324,50,124783020,123847824,935196,53.46472824947925
1747352525271210,124052044,1,1325,50,124861522,123942464,919058,54.403530571519966
1747352525357060,124146684,1,1326,50,124947372,124037104,910268,54.92887808865082
1747352525455319,124241324,1,1327,50,125045631,124131744,913887,54.71135928183681
1747352525549874,124335964,1,1328,50,125140186,124226384,913802,54.716448420992734
1747352525664449,124430604,1,1329,50,125254761,124321024,933737,53.54826894510981
1747352525746479,124525244,1,1330,50,125336791,124415664,921127,54.28133145592302
1747352525844518,124619884,1,1331,50,125434830,124510304,924526,54.08176730562472
1747352525938213,124714524,1,1332,50,125528525,124604944,923581,54.13710329684132
1747352526024869,124809164,1,1333,50,125615181,124699584,915597,54.60917849228427
1747352526127368,124903804,1,1334,50,125717680,124794224,923456,54.14443135352415
1747352526225165,124998444,1,1335,50,125815477,124888864,926613,53.95995955161432
1747352526315073,125093084,1,1336,50,125905385,124983504,921881,54.2369351358798
1747352526421349,125187724,1,1337,50,126011661,125078144,933517,53.56088855371675
1747352526503505,125282364,1,1338,50,126093817,125172784,921033,54.28687137160124
1747352526597842,125377004,1,1339,50,126188154,125267424,920730,54.30473645911396
1747352526692121,125471644,1,1340,50,126282433,125362064,920369,54.32603662226781
1747352526786014,125566284,1,1341,50,126376326,125456704,919622,54.37016513306554
1747352526896880,125660924,1,1342,50,126487192,125551344,935848,53.42747967618673
1747352526983148,125755564,1,1343,50,126573460,125645984,927476,53.90975076444027
1747352527094060,125850204,1,1344,50,126684372,125740624,943748,52.98024472634644
1747352527188061,125944852,1,1345,50,126778373,125835272,943101,53.016591011991295
1747352527269908,126039484,1,1346,50,126860220,125929904,930316,53.74517905743855
1747352527363588,126134124,1,1347,50,126953900,126024544,929356,53.80069639621416
1747352527462381,126228764,1,1348,50,127052693,126119184,933509,53.56134756065555
1747352527573075,126323404,1,1349,50,127163387,126213824,949563,52.65580061565162
1747352527670615,126418044,1,1350,50,127260927,126308464,952463,52.49547751461212
1747352527753274,126512684,1,1351,50,127343586,126403104,940482,53.16422855514512
1747352527838487,126607324,1,1352,50,127428799,126497744,931055,53.70252025927577
1747352527953685,126701964,1,1353,50,127543997,126592384,951613,52.54236753806432
1747352528035289,126796604,1,1354,50,127625601,126687024,938577,53.27213430544324
1747352528130123,126891244,1,1355,50,127720435,126781664,938771,53.26112545018966
1747352528220350,126985884,1,1356,50,127810662,126876304,934358,53.51267929423197
1747352528322452,127080524,1,1357,50,127912764,126970944,941820,53.08870060096409
1747352528429092,127175164,1,1358,50,128019404,127065584,953820,52.42079218301147
1747352528527328,127269804,1,1359,50,128117640,127160224,957416,52.22390267135707
1747352528605104,127364444,1,1360,50,128195416,127254864,940552,53.16027184036608
1747352528703142,127459084,1,1361,50,128293454,127349504,943950,52.968907251443405
1747352528801041,127553724,1,1362,50,128391353,127444144,947209,52.78666059971981
1747352529091741,127843884,1,1365,50,128682053,127734304,947749,52.75658428550175
1747352529178102,127938524,1,1366,50,128768414,127828944,939470,53.22149722715999
1747352529281062,128033164,1,1367,50,128871374,127923584,947790,52.75430211333734
1747352529370722,128127804,1,1368,50,128961034,128018224,942810,53.03295467803693
1747352529567310,128320204,1,1370,50,129157622,128210624,946998,52.79842196076444
1747352529665739,128414844,1,1371,50,129256051,128305264,950787,52.58801392951312
1747352529762971,128509484,1,1372,50,129353283,128399904,953379,52.44504022010135
1747352529948498,128701884,1,1374,50,129538810,128592304,946506,52.82586692530212
1747352530042921,128796524,1,1375,50,129633233,128686944,946289,52.83798078599666
1747352530153287,128891164,1,1376,50,129743599,128781584,962015,51.97424156587995
1747352530247728,128985804,1,1377,50,129838040,128876224,961816,51.98499505102847
1747352530350062,129080444,1,1378,50,129940374,128970864,969510,51.57244381182247
1747352530530145,129272852,1,1380,50,130120457,129163272,957185,52.23650600458637
1747352530619609,129367484,1,1381,50,130209921,129257904,952017,52.52007054495876
1747352530717937,129462124,1,1382,50,130308249,129352544,955705,52.317399197451095
1747352530808443,129556764,1,1383,50,130398755,129447184,951571,52.54468662874342
1747352622474565,7109244,1,76,75,0,0,0,0.0
1747352622564533,7199724,1,77,75,89968,90480,-512,0.0
1747352622654819,7290204,1,78,75,180254,180960,-706,0.0
1747352622744008,7380684,1,79,75,269443,271440,-1997,0.0
1747352622838899,7471164,1,80,75,364334,361920,2414,31068.76553438277
1747352622929089,7561644,1,81,75,454524,452400,2124,35310.73446327684
1747352623019322,7652124,1,82,75,544757,542880,1877,39957.37879595099
1747352623108635,7742604,1,83,75,634070,633360,710,105633.8028169014
1747352623202924,7833084,1,84,75,728359,723840,4519,16596.5921664085
1747352623293711,7923564,1,85,75,819146,814320,4826,15540.82055532532
1747352623383685,8014044,1,86,75,909120,904800,4320,17361.11111111111
1747352623474052,8104524,1,87,75,999487,995280,4207,17827.430473021155
1747352623567871,8195004,1,88,75,1093306,1085760,7546,9939.04055128545
1747352623657581,8285484,1,89,75,1183016,1176240,6776,11068.476977567889
1747352623748386,8375964,1,90,75,1273821,1266720,7101,10561.892691170258
1747352623838130,8466452,1,91,75,1363565,1357208,6357,11798.01793298726
1747352623932641,8556924,1,92,75,1458076,1447680,10396,7214.313197383609
1747352624022195,8647404,1,93,75,1547630,1538160,9470,7919.746568109821
1747352624112752,8737884,1,94,75,1638187,1628640,9547,7855.870954226459
1747352624202746,8828364,1,95,75,1728181,1719120,9061,8277.232093587905
1747352624296545,8918844,1,96,75,1821980,1809600,12380,6058.158319870759
1747352624386378,9009324,1,97,75,1911813,1900080,11733,6392.227051904883
1747352624477397,9099804,1,98,75,2002832,1990560,12272,6111.4732724902215
1747352624567188,9190284,1,99,75,2092623,2081040,11583,6475.006475006475
1747352624661274,9280764,1,100,75,2186709,2171520,15189,4937.783922575548
1747352624751356,9372284,1,101,75,2276791,2263040,13751,5454.148789178969
1747352624845934,9463804,1,102,75,2371369,2354560,16809,4461.895413171515
1747352624940178,9555324,1,103,75,2465613,2446080,19533,3839.6559668253726
1747352625030022,9646844,1,104,75,2555457,2537600,17857,4200.033600268802
1747352625124215,9738364,1,105,75,2649650,2629120,20530,3653.190452995616
1747352625214198,9829884,1,106,75,2739633,2720640,18993,3948.8232506713
1747352625308791,9921404,1,107,75,2834226,2812160,22066,3398.894226411674
1747352625398999,10012924,1,108,75,2924434,2903680,20754,3613.761202659728
1747352625492705,10105484,1,109,75,3018140,2996240,21900,3424.657534246576
1747352625586607,10198052,1,110,75,3112042,3088808,23234,3228.027890160971
1747352625681135,10290604,1,111,75,3206570,3181360,25210,2975.0099166997225
1747352625771599,10383164,1,112,75,3297034,3273920,23114,3244.786709353639
1747352625865564,10475724,1,113,75,3390999,3366480,24519,3058.8523186100574
1747352625959104,10568284,1,114,75,3484539,3459040,25499,2941.291815365308
1747352626054147,10660844,1,115,75,3579582,3551600,27982,2680.294475019656
1747352626144384,10753404,1,116,75,3669819,3644160,25659,2922.9510113410497
1747352626238400,10845964,1,117,75,3763835,3736720,27115,2765.996680803983
1747352626332801,10938524,1,118,75,3858236,3829280,28956,2590.136759220887
1747352626426705,11031084,1,119,75,3952140,3921840,30300,2475.247524752476
1747352626520137,11123644,1,120,75,4045572,4014400,31172,2406.0053894520724
1747352626611212,11216204,1,121,75,4136647,4106960,29687,2526.3583386667565
1747352626705356,11308764,1,122,75,4230791,4199520,31271,2398.3882830737743
1747352626798886,11401324,1,123,75,4324321,4292080,32241,2326.2305759746905
1747352626893647,11493884,1,124,75,4419082,4384640,34442,2177.5738923407466
1747352626983965,11586444,1,125,75,4509400,4477200,32200,2329.192546583851
1747352627078064,11679004,1,126,75,4603499,4569760,33739,2222.946738196153
1747352627171732,11771564,1,127,75,4697167,4662320,34847,2152.26561827417
1747352627265922,11864124,1,128,75,4791357,4754880,36477,2056.090138991693
1747352627355906,11956684,1,129,75,4881341,4847440,33901,2212.3241202324416
1747352627450380,12049244,1,130,75,4975815,4940000,35815,2094.094653078319
1747352627545192,12141804,1,131,75,5070627,5032560,38067,1970.2104184726927
1747352627639308,12234364,1,132,75,5164743,5125120,39623,1892.8400171617493
1747352627728946,12326932,1,133,75,5254381,5217688,36693,2043.98659144796
1747352627822942,12419484,1,134,75,5348377,5310240,38137,1966.5941211946408
1747352627917757,12512044,1,135,75,5443192,5402800,40392,1856.8033273915628
1747352628011773,12604604,1,136,75,5537208,5495360,41848,1792.200344102466
1747352628105275,12697164,1,137,75,5630710,5587920,42790,1752.745968684272
1747352628196395,12789724,1,138,75,5721830,5680480,41350,1813.7847642079807
1747352628289834,12882284,1,139,75,5815269,5773040,42229,1776.0306898103197
1747352628383942,12974844,1,140,75,5909377,5865600,43777,1713.2284076113026
1747352628478677,13067404,1,141,75,6004112,5958160,45952,1632.1378830083563
1747352628568861,13159964,1,142,75,6094296,6050720,43576,1721.1308977418764
1747352628663074,13252524,1,143,75,6188509,6143280,45229,1658.228127970992
1747352628756796,13345084,1,144,75,6282231,6235840,46391,1616.6928930180422
1747352628851273,13437644,1,145,75,6376708,6328400,48308,1552.537881924319
1747352628941767,13530204,1,146,75,6467202,6420960,46242,1621.902166861295
1747352629035133,13622764,1,147,75,6560568,6513520,47048,1594.1166468287706
1747352629129834,13715324,1,148,75,6655269,6606080,49189,1524.7311390758098
1747352629224052,13807884,1,149,75,6749487,6698640,50847,1475.013275119476
1747352629314364,13900444,1,150,75,6839799,6791200,48599,1543.2416304862238
1747352629407874,13993004,1,151,75,6933309,6883760,49549,1513.653151425861
1747352629502131,14085564,1,152,75,7027566,6976320,51246,1463.5288607891348
1747352629596362,14178124,1,153,75,7121797,7068880,52917,1417.3139066840524
1747352629691020,14270684,1,154,75,7216455,7161440,55015,1363.264564209761
1747352629784595,14363244,1,155,75,7310030,7254000,56030,1338.5686239514546
1747352629875218,14455804,1,156,75,7400653,7346560,54093,1386.5010260107592
1747352629969361,14548364,1,157,75,7494796,7439120,55676,1347.0795315755445
1747352630063130,14640924,1,158,75,7588565,7531680,56885,1318.4495033840203
1747352630153275,14733484,1,159,75,7678710,7624240,54470,1376.9047181935011
1747352630247512,14826044,1,160,75,7772947,7716800,56147,1335.7792936399094
1747352630342236,14918604,1,161,75,7867671,7809360,58311,1286.2067191439007
1747352630436523,15011164,1,162,75,7961958,7901920,60038,1249.2088344048768
1747352630526893,15103724,1,163,75,8052328,7994480,57848,1296.5011754943991
1747352630620400,15196284,1,164,75,8145835,8087040,58795,1275.618675057403
1747352630715102,15288844,1,165,75,8240537,8179600,60937,1230.7793294714213
1747352630809531,15381404,1,166,75,8334966,8272160,62806,1194.1534248320224
1747352630899543,15473964,1,167,75,8424978,8364720,60258,1244.6480135417703
1747352630993707,15566524,1,168,75,8519142,8457280,61862,1212.3759335294687
1747352631087771,15659084,1,169,75,8613206,8549840,63366,1183.600037875201
1747352631181549,15751644,1,170,75,8706984,8642400,64584,1161.2783351913786
1747352631276079,15844204,1,171,75,8801514,8734960,66554,1126.9044685518527
1747352631365862,15936764,1,172,75,8891297,8827520,63777,1175.972529281716
1747352631459857,16029324,1,173,75,8985292,8920080,65212,1150.0950745261607
1747352631554595,16121892,1,174,75,9080030,9012648,67382,1113.056899468701
1747352631648356,16214444,1,175,75,9173791,9105200,68591,1093.4379145952091
1747352631738573,16307004,1,176,75,9264008,9197760,66248,1132.109648593165
1747352631833391,16399564,1,177,75,9358826,9290320,68506,1094.794616529939
1747352631927522,16492124,1,178,75,9452957,9382880,70077,1070.251295004067
1747352632021475,16584684,1,179,75,9546910,9475440,71470,1049.391353015251
1747352632111366,16677244,1,180,75,9636801,9568000,68801,1090.1004345867066
1747352632205032,16769804,1,181,75,9730467,9660560,69907,1072.853934512996
1747352632300202,16862364,1,182,75,9825637,9753120,72517,1034.2402471144696
1747352632393939,16954924,1,183,75,9919374,9845680,73694,1017.7219312291368
1747352632484540,17047484,1,184,75,10009975,9938240,71735,1045.514741757859
1747352632577820,17140044,1,185,75,10103255,10030800,72455,1035.1252501552688
1747352632672172,17232604,1,186,75,10197607,10123360,74247,1010.1418239120774
1747352632766419,17325164,1,187,75,10291854,10215920,75934,987.6998446018912
1747352632860745,17417724,1,188,75,10386180,10308480,77700,965.2509652509652
1747352632950737,17510284,1,189,75,10476172,10401040,75132,998.2430921578024
1747352633044991,17602844,1,190,75,10570426,10493600,76826,976.2320047900448
1747352633139185,17695404,1,191,75,10664620,10586160,78460,955.9010960999236
1747352633233323,17787964,1,192,75,10758758,10678720,80038,937.0548989230116
1747352633324216,17880524,1,193,75,10849651,10771280,78371,956.9866404664992
1747352633418342,17973084,1,194,75,10943777,10863840,79937,938.238863104695
1747352633512229,18065644,1,195,75,11037664,10956400,81264,922.917897223863
1747352633605729,18158204,1,196,75,11131164,11048960,82204,912.364361831541
1747352633696863,18250772,1,197,75,11222298,11141528,80770,928.562585118237
1747352633789629,18343324,1,198,75,11315064,11234080,80984,926.108861009582
1747352633884820,18435884,1,199,75,11410255,11326640,83615,896.9682473240448
1747352633979072,18528444,1,200,75,11504507,11419200,85307,879.1775586997551
1747352634069179,18621004,1,201,75,11594614,11511760,82854,905.2067492215224
1747352634163783,18713564,1,202,75,11689218,11604320,84898,883.4130368206554
1747352634257575,18806124,1,203,75,11783010,11696880,86130,870.7767328456983
1747352634352220,18898684,1,204,75,11877655,11789440,88215,850.1955449753443
1747352634445578,18991244,1,205,75,11971013,11882000,89013,842.5735566714975
1747352634535892,19083804,1,206,75,12061327,11974560,86767,864.3839247640232
1747352634630391,19176364,1,207,75,12155826,12067120,88706,845.4895948413862
1747352634724135,19268924,1,208,75,12249570,12159680,89890,834.3530982311714
1747352634818485,19361484,1,209,75,12343920,12252240,91680,818.062827225131
1747352634908603,19454044,1,210,75,12434038,12344800,89238,840.4491360182882
1747352635003435,19546604,1,211,75,12528870,12437360,91510,819.5825592831385
1747352635096968,19639164,1,212,75,12622403,12529920,92483,810.959852080923
1747352635191153,19731724,1,213,75,12716588,12622480,94108,796.9566880605262
1747352635281691,19824284,1,214,75,12807126,12715040,92086,814.4560519514367
1747352635376052,19916844,1,215,75,12901487,12807600,93887,798.8326392365291
1747352635469507,20009404,1,216,75,12994942,12900160,94782,791.2894853453187
1747352635564084,20101964,1,217,75,13089519,12992720,96799,774.8013925763696
1747352635654119,20194524,1,218,75,13179554,13085280,94274,795.5533869359526
1747352635748839,20287084,1,219,75,13274274,13177840,96434,777.7339942343987
1747352635842504,20379644,1,220,75,13367939,13270400,97539,768.9231999507889
1747352635937094,20472204,1,221,75,13462529,13362960,99569,753.246492382167
1747352636031339,20564764,1,222,75,13556774,13455520,101254,740.7114780650642
1747352636120982,20657324,1,223,75,13646417,13548080,98337,762.6834253638001
1747352636214934,20749884,1,224,75,13740369,13640640,99729,752.038023042445
1747352636309604,20842444,1,225,75,13835039,13733200,101839,736.4565637918676
1747352636403921,20935004,1,226,75,13929356,13825760,103596,723.9661763002433
1747352636494415,21027564,1,227,75,14019850,13918320,101530,738.6979217965134
1747352636587968,21120124,1,228,75,14113403,14010880,102523,731.5431659237439
1747352636682460,21212684,1,229,75,14207895,14103440,104455,718.0125412857211
1747352636776009,21305244,1,230,75,14301444,14196000,105444,711.2780243541596
1747352636866221,21397804,1,231,75,14391656,14288560,103096,727.4773027081555
1747352636960444,21490364,1,232,75,14485879,14381120,104759,715.9289416661098
1747352637055247,21582924,1,233,75,14580682,14473680,107002,700.9214781032131
1747352637149158,21675484,1,234,75,14674593,14566240,108353,692.1820346460181
1747352637243179,21768044,1,235,75,14768614,14658800,109814,682.9730271185823
1747352637332799,21860604,1,236,75,14858234,14751360,106874,701.7609521492599
1747352637427240,21953164,1,237,75,14952675,14843920,108755,689.623465587789
1747352637521469,22045732,1,238,75,15046904,14936488,110416,679.249384147225
1747352637615779,22138284,1,239,75,15141214,15029040,112174,668.6041328650133
1747352637706069,22230844,1,240,75,15231504,15121600,109904,682.4137429028971
1747352637800479,22323404,1,241,75,15325914,15214160,111754,671.1169175152567
1747352637894344,22415964,1,242,75,15419779,15306720,113059,663.3704525955474
1747352637988452,22508524,1,243,75,15513887,15399280,114607,654.4102890748384
1747352638078308,22601084,1,244,75,15603743,15491840,111903,670.2233184096941
1747352638173015,22693644,1,245,75,15698450,15584400,114050,657.6063130206051
1747352638267367,22786204,1,246,75,15792802,15676960,115842,647.4335733153779
1747352638361549,22878764,1,247,75,15886984,15769520,117464,638.4934958795886
1747352638451638,22971324,1,248,75,15977073,15862080,114993,652.2136130025306
1747352638545646,23063884,1,249,75,16071081,15954640,116441,644.1030221313798
1747352638640030,23156444,1,250,75,16165465,16047200,118265,634.1690271847124
1747352638733813,23249004,1,251,75,16259248,16139760,119488,627.6780931976433
1747352638828532,23341564,1,252,75,16353967,16232320,121647,616.5380157340502
1747352638918120,23434124,1,253,75,16443555,16324880,118675,631.9780914261639
1747352639012111,23526684,1,254,75,16537546,16417440,120106,624.4484039098796
1747352639106289,23619244,1,255,75,16631724,16510000,121724,616.1480069665802
1747352639200842,23711804,1,256,75,16726277,16602560,123717,606.2222653313611
1747352639290976,23804364,1,257,75,16816411,16695120,121291,618.3476102926021
1747352639385678,23896924,1,258,75,16911113,16787680,123433,607.6170878128215
1747352639479697,23989484,1,259,75,17005132,16880240,124892,600.5188482849181
1747352639574120,24082044,1,260,75,17099555,16972800,126755,591.692635398998
1747352639664133,24174612,1,261,75,17189568,17065368,124200,603.8647342995168
1747352639757898,24267164,1,262,75,17283333,17157920,125413,598.0241282801624
1747352639852407,24359724,1,263,75,17377842,17250480,127362,588.8726621755311
1747352639946804,24452284,1,264,75,17472239,17343040,129199,580.4998490700392
1747352640036997,24544844,1,265,75,17562432,17435600,126832,591.3334174340861
1747352640130266,24637404,1,266,75,17655701,17528160,127541,588.0461969092293
1747352640224621,24729964,1,267,75,17750056,17620720,129336,579.8849508257562
1747352640318722,24822524,1,268,75,17844157,17713280,130877,573.0571452585252
1747352640413790,24915084,1,269,75,17939225,17805840,133385,562.2821156801739
1747352640503914,25007644,1,270,75,18029349,17898400,130949,572.7420598859097
1747352640598017,25100204,1,271,75,18123452,17990960,132492,566.0719137759261
1747352640690971,25192764,1,272,75,18216406,18083520,132886,564.3935403277998
1747352640785591,25285324,1,273,75,18311026,18176080,134946,555.7778667022365
1747352640876690,25377884,1,274,75,18402125,18268640,133485,561.8608832453085
1747352640970411,25470444,1,275,75,18495846,18361200,134646,557.0161757497439
1747352641064634,25563004,1,276,75,18590069,18453760,136309,550.2204549956349
1747352641158493,25655564,1,277,75,18683928,18546320,137608,545.026451950468
1747352641248484,25748124,1,278,75,18773919,18638880,135039,555.395108079888
1747352641343245,25840684,1,279,75,18868680,18731440,137240,546.4879044010493
1747352641436993,25933244,1,280,75,18962428,18824000,138428,541.7979021585229
1747352641531890,26025804,1,281,75,19057325,18916560,140765,532.8028984477676
1747352641621693,26118364,1,282,75,19147128,19009120,138008,543.446756709756
1747352641715541,26210924,1,283,75,19240976,19101680,139296,538.42177808408
1747352641809608,26303484,1,284,75,19335043,19194240,140803,532.6591052747456
1747352641904640,26396044,1,285,75,19430075,19286800,143275,523.4688536032105
1747352641998066,26488604,1,286,75,19523501,19379360,144141,520.3238495639687
1747352642088677,26581164,1,287,75,19614112,19471920,142192,527.4558343648025
1747352642183166,26673724,1,288,75,19708601,19564480,144121,520.3960560917562
1747352642277333,26766284,1,289,75,19802768,19657040,145728,514.6574440052701
1747352642371857,26858844,1,290,75,19897292,19749600,147692,507.8135579449124
1747352642461849,26951404,1,291,75,19987284,19842160,145124,516.7994266971693
1747352642555785,27043964,1,292,75,20081220,19934720,146500,511.9453924914676
1747352642649782,27136524,1,293,75,20175217,20027280,147937,506.9725626449096
1747352642744152,27229084,1,294,75,20269587,20119840,149747,500.8447581587611
1747352642834542,27321644,1,295,75,20359977,20212400,147577,508.2092738028283
1747352642928183,27414204,1,296,75,20453618,20304960,148658,504.5137160462269
1747352643022667,27506764,1,297,75,20548102,20397520,150582,498.0674981073435
1747352643116532,27599324,1,298,75,20641967,20490080,151887,493.7881451342116
1747352643207202,27691884,1,299,75,20732637,20582640,149997,500.010000200004
1747352643300644,27784444,1,300,75,20826079,20675200,150879,497.08706977114105
1747352643394644,27877004,1,301,75,20920079,20767760,152319,492.38768636873925
1747352643488839,27969572,1,302,75,21014274,20860328,153946,487.1838177023112
1747352643583307,28062124,1,303,75,21108742,20952880,155862,481.1949031835855
1747352643674039,28154684,1,304,75,21199474,21045440,154034,486.9054883986652
1747352643767790,28247244,1,305,75,21293225,21138000,155225,483.16959252697694
1747352643861488,28339804,1,306,75,21386923,21230560,156363,479.65311486732793
1747352643956595,28432364,1,307,75,21482030,21323120,158910,471.96526335661696
1747352644046389,28524924,1,308,75,21571824,21415680,156144,480.32585305871504
1747352644140214,28617484,1,309,75,21665649,21508240,157409,476.4657675228227
1747352644234495,28710044,1,310,75,21759930,21600800,159130,471.3127631496261
1747352644328456,28802604,1,311,75,21853891,21693360,160531,467.1994817200416
1747352644419102,28895164,1,312,75,21944537,21785920,158617,472.83708555829446
1747352644513302,28987724,1,313,75,22038737,21878480,160257,467.99827776633776
1747352644607101,29080284,1,314,75,22132536,21971040,161496,464.4077871897756
1747352644701074,29172844,1,315,75,22226509,22063600,162909,460.3797211940408
1747352644792201,29265404,1,316,75,22317636,22156160,161476,464.4653075379623
1747352644886270,29357964,1,317,75,22411705,22248720,162985,460.1650458631163
1747352644980428,29450524,1,318,75,22505863,22341280,164583,455.6971254625325
1747352645074308,29543084,1,319,75,22599743,22433840,165903,452.0713911140848
1747352645168238,29635644,1,320,75,22693673,22526400,167273,448.3688341812486
1747352645259074,29728204,1,321,75,22784509,22618960,165549,453.03807331968176
1747352645352674,29820764,1,322,75,22878109,22711520,166589,450.2097977657589
1747352645447015,29913324,1,323,75,22972450,22804080,168370,445.44752628140407
1747352645541540,30005884,1,324,75,23066975,22896640,170335,440.3088032406728
1747352645631228,30098452,1,325,75,23156663,22989208,167455,447.881520408468
1747352645725295,30191004,1,326,75,23250730,23081760,168970,443.8657749896431
1747352645819255,30283564,1,327,75,23344690,23174320,170370,440.2183483007572
1747352645914353,30376124,1,328,75,23439788,23266880,172908,433.7566798528697
1747352646004468,30468684,1,329,75,23529903,23359440,170463,439.9781770824167
1747352646098432,30561244,1,330,75,23623867,23452000,171867,436.38394805285486
1747352646192231,30653804,1,331,75,23717666,23544560,173106,433.26054556167895
1747352646286909,30746364,1,332,75,23812344,23637120,175224,428.0235584166553
1747352646377147,30838924,1,333,75,23902582,23729680,172902,433.7717319637714
1747352646470737,30931484,1,334,75,23996172,23822240,173932,431.2029988731228
1747352646564725,31024044,1,335,75,24090160,23914800,175360,427.69160583941607
1747352646659834,31116604,1,336,75,24185269,24007360,177909,421.56383319562246
1747352646753201,31209164,1,337,75,24278636,24099920,178716,419.6602430672128
1747352646843847,31301724,1,338,75,24369282,24192480,176802,424.2033461159942
1747352646937421,31394284,1,339,75,24462856,24285040,177816,421.78431637198
1747352647031736,31486844,1,340,75,24557171,24377600,179571,417.6620946589371
1747352647126170,31579404,1,341,75,24651605,24470160,181445,413.3483975860454
1747352647216756,31671964,1,342,75,24742191,24562720,179471,417.89481308958
1747352647310618,31764524,1,343,75,24836053,24655280,180773,414.8849662283638
1747352647405132,31857084,1,344,75,24930567,24747840,182727,410.448373803543
1747352647498761,31949644,1,345,75,25024196,24840400,183796,408.06111123201816
1747352647589475,32042204,1,346,75,25114910,24932960,181950,412.2011541632317
1747352647682907,32134764,1,347,75,25208342,25025520,182822,410.2350920567546
1747352647777203,32227324,1,348,75,25302638,25118080,184558,406.3763153046739
1747352647871725,32319884,1,349,75,25397160,25210640,186520,402.101651297448
1747352647961239,32412444,1,350,75,25486674,25303200,183474,408.7772654436051
1747352648056295,32505004,1,351,75,25581730,25395760,185970,403.2908533634457
1747352648150179,32597564,1,352,75,25675614,25488320,187294,400.4399500250943
1747352648244660,32690124,1,353,75,25770095,25580880,189215,396.37449462251936
1747352648338160,32782684,1,354,75,25863595,25673440,190155,394.4150824327522
1747352648428526,32875244,1,355,75,25953961,25766000,187961,399.01894541952856
1747352648522458,32967804,1,356,75,26047893,25858560,189333,396.1274579708767
1747352648617388,33060364,1,357,75,26142823,25951120,191703,391.2301841911707
1747352648710869,33152924,1,358,75,26236304,26043680,192624,389.35958136057815
1747352648801533,33245484,1,359,75,26326968,26136240,190728,393.230149742041
1747352648895312,33338044,1,360,75,26420747,26228800,191947,390.7328585494954
1747352648990048,33430604,1,361,75,26515483,26321360,194123,386.35298238745537
1747352649084248,33523164,1,362,75,26609683,26413920,195763,383.1163192227336
1747352649174038,33615724,1,363,75,26699473,26506480,192993,388.6151311187453
1747352649268294,33708284,1,364,75,26793729,26599040,194689,385.2297767208214
1747352649362297,33800844,1,365,75,26887732,26691600,196132,382.3955295413293
1747352649456142,33893412,1,366,75,26981577,26784168,197409,379.9218880598149
1747352649546665,33985964,1,367,75,27072100,26876720,195380,383.86733544886886
1747352649641160,34078524,1,368,75,27166595,26969280,197315,380.10288117983936
1747352649735628,34171084,1,369,75,27261063,27061840,199223,376.46255703407735
1747352649829780,34263644,1,370,75,27355215,27154400,200815,373.47807683688967
1747352649923924,34356204,1,371,75,27449359,27246960,202399,370.5551904900716
1747352650013249,34448764,1,372,75,27538684,27339520,199164,376.5740796529493
1747352650108385,34541324,1,373,75,27633820,27432080,201740,371.7656389412115
1747352650201789,34633884,1,374,75,27727224,27524640,202584,370.2167989574695
1747352650296543,34726444,1,375,75,27821978,27617200,204778,366.250280791882
1747352650386274,34819004,1,376,75,27911709,27709760,201949,371.3808931958069
1747352650480397,34911564,1,377,75,28005832,27802320,203512,368.52863713196274
1747352650575014,35004124,1,378,75,28100449,27894880,205569,364.8410022912015
1747352650668713,35096684,1,379,75,28194148,27987440,206708,362.8306596745167
1747352650759357,35189244,1,380,75,28284792,28080000,204792,366.2252431735615
1747352650852867,35281804,1,381,75,28378302,28172560,205742,364.5342224728057
1747352650947882,35374364,1,382,75,28473317,28265120,208197,360.23573826712203
1747352651041663,35466924,1,383,75,28567098,28357680,209418,358.13540383348135
1747352651136212,35559484,1,384,75,28661647,28450240,211407,354.7659254423931
1747352651226358,35652044,1,385,75,28751793,28542800,208993,358.8636939993205
1747352651319861,35744604,1,386,75,28845296,28635360,209936,357.25173386174833
1747352651414303,35837164,1,387,75,28939738,28727920,211818,354.0775571481177
1747352651509008,35929724,1,388,75,29034443,28820480,213963,350.5278950098849
1747352651598472,36022292,1,389,75,29123907,28913048,210859,355.6879241578496
1747352651693477,36114844,1,390,75,29218912,29005600,213312,351.5976597659766
1747352651787114,36207404,1,391,75,29312549,29098160,214389,349.8313812742258
1747352651881675,36299964,1,392,75,29407110,29190720,216390,346.5964231249134
1747352651971924,36392524,1,393,75,29497359,29283280,214079,350.3379593514544
1747352652065900,36485084,1,394,75,29591335,29375840,215495,348.0359173066661
1747352652159897,36577644,1,395,75,29685332,29468400,216932,345.73045931443954
1747352652254024,36670204,1,396,75,29779459,29560960,218499,343.2509988604067
1747352652344578,36762764,1,397,75,29870013,29653520,216493,346.431524344898
1747352652438158,36855324,1,398,75,29963593,29746080,217513,344.806977054245
1747352652533692,36947884,1,399,75,30059127,29838640,220487,340.1561089769465
1747352652626277,37040444,1,400,75,30151712,29931200,220512,340.11754462342185
1747352652721005,37133004,1,401,75,30246440,30023760,222680,336.8061792707024
1747352652811113,37225564,1,402,75,30336548,30116320,220228,340.55615089816007
1747352652905785,37318124,1,403,75,30431220,30208880,222340,337.3212197535306
1747352652999727,37410684,1,404,75,30525162,30301440,223722,335.2374822324134
1747352653093723,37503244,1,405,75,30619158,30394000,225158,333.09942351593105
1747352653183399,37595804,1,406,75,30708834,30486560,222274,337.42138081826937
1747352653277665,37688364,1,407,75,30803100,30579120,223980,334.851326011251
1747352653372606,37780924,1,408,75,30898041,30671680,226361,331.32916005849063
1747352653466479,37873484,1,409,75,30991914,30764240,227674,329.41837891019617
1747352653556234,37966044,1,410,75,31081669,30856800,224869,333.52752046747213
1747352653650802,38058604,1,411,75,31176237,30949360,226877,330.5755982316409
1747352653745315,38151164,1,412,75,31270750,31041920,228830,327.7542280295416
1747352653839401,38243724,1,413,75,31364836,31134480,230356,325.5830106443939
1747352653929314,38336284,1,414,75,31454749,31227040,227709,329.3677456754015
1747352654023539,38428844,1,415,75,31548974,31319600,229374,326.97690235161787
1747352654117932,38521404,1,416,75,31643367,31412160,231207,324.3846423334934
1747352654211664,38613964,1,417,75,31737099,31504720,232379,322.7486132567917
1747352654306222,38706524,1,418,75,31831657,31597280,234377,319.99726935663483
1747352654395714,38799084,1,419,75,31921149,31689840,231309,324.2415989001725
1747352654490783,38891644,1,420,75,32016218,31782400,233818,320.76230230350103
1747352654584151,38984204,1,421,75,32109586,31874960,234626,319.65766794813874
1747352654678252,39076764,1,422,75,32203687,31967520,236167,317.57188768964335
1747352654769264,39169324,1,423,75,32294699,32060080,234619,319.66720512831444
1747352654862994,39261884,1,424,75,32388429,32152640,235789,318.0809961448583
1747352654957521,39354444,1,425,75,32482956,32245200,237756,315.44945237975065
1747352655052032,39447004,1,426,75,32577467,32337760,239707,312.8819767466115
1747352655141134,39539564,1,427,75,32666569,32430320,236249,317.4616612133808
1747352655235335,39632124,1,428,75,32760770,32522880,237890,315.2717642607928
1747352655330351,39724684,1,429,75,32855786,32615440,240346,312.05012773251894
1747352655423416,39817252,1,430,75,32948851,32708008,240843,311.4061857724742
1747352655514693,39909804,1,431,75,33040128,32800560,239568,313.0635143257864
1747352655608469,40002364,1,432,75,33133904,32893120,240784,311.4824905309323
1747352655702742,40094924,1,433,75,33228177,32985680,242497,309.2821766867219
1747352655797073,40187484,1,434,75,33322508,33078240,244268,307.03980873466844
1747352655891255,40280044,1,435,75,33416690,33170800,245890,305.0144373500346
1747352655981602,40372604,1,436,75,33507037,33263360,243677,307.78448519967003
1747352656075485,40465164,1,437,75,33600920,33355920,245000,306.12244897959187
1747352656170004,40557724,1,438,75,33695439,33448480,246959,303.69413546378144
1747352656263542,40650284,1,439,75,33788977,33541040,247937,302.4961986311039
1747352656353423,40742844,1,440,75,33878858,33633600,245258,305.80042241231683
1747352656452412,40835404,1,441,75,33977847,33726160,251687,297.9891690870009
1747352656542590,40927964,1,442,75,34068025,33818720,249305,300.836324983454
1747352656636116,41020524,1,443,75,34161551,33911280,250271,299.6751521350856
1747352656726446,41113084,1,444,75,34251881,34003840,248041,302.36936635475587
1747352656820517,41205644,1,445,75,34345952,34096400,249552,300.53856510867473
1747352656915268,41298204,1,446,75,34440703,34188960,251743,297.9228816690037
1747352657009415,41390764,1,447,75,34534850,34281520,253330,296.0565270595666
1747352657099219,41483324,1,448,75,34624654,34374080,250574,299.3127778620288
1747352657193762,41575884,1,449,75,34719197,34466640,252557,296.9626658536489
1747352657288071,41668444,1,450,75,34813506,34559200,254306,294.9202928755122
1747352657382090,41761004,1,451,75,34907525,34651760,255765,293.2379332590464
1747352657476190,41853564,1,452,75,35001625,34744320,257305,291.4828705233089
1747352657566190,41946132,1,453,75,35091625,34836888,254737,294.4213051107613
1747352657660808,42038684,1,454,75,35186243,34929440,256803,292.05266293618064
1747352657754325,42131244,1,455,75,35279760,35022000,257760,290.9683426443204
1747352657848953,42223804,1,456,75,35374388,35114560,259828,288.6524931878012
1747352657939068,42316364,1,457,75,35464503,35207120,257383,291.3945365467028
1747352658032942,42408924,1,458,75,35558377,35299680,258697,289.91445590787674
1747352658127648,42501484,1,459,75,35653083,35392240,260843,287.52928006502
1747352658221529,42594044,1,460,75,35746964,35484800,262164,286.08046871423994
1747352658311753,42686604,1,461,75,35837188,35577360,259828,288.6524931878012
1747352658405479,42779164,1,462,75,35930914,35669920,260994,287.3629278833996
1747352658499826,42871724,1,463,75,36025261,35762480,262781,285.40876242955164
1747352658594304,42964284,1,464,75,36119739,35855040,264699,283.3407001915383
1747352658684556,43056844,1,465,75,36209991,35947600,262391,285.83297445415434
1747352658778349,43149404,1,466,75,36303784,36040160,263624,284.49610050678234
1747352658872268,43241964,1,467,75,36397703,36132720,264983,283.03702501669915
1747352658966643,43334524,1,468,75,36492078,36225280,266798,281.11155256036403
1747352659061179,43427084,1,469,75,36586614,36317840,268774,279.0448480879847
1747352659151392,43519644,1,470,75,36676827,36410400,266427,281.50300082198873
1747352659245658,43612204,1,471,75,36771093,36502960,268133,279.7119340029016
1747352659340085,43704764,1,472,75,36865520,36595520,270000,277.77777777777777
1747352659434091,43797324,1,473,75,36959526,36688080,271446,276.29804823058726
1747352659523371,43889884,1,474,75,37048806,36780640,268166,279.67751318213345
1747352659617706,43982444,1,475,75,37143141,36873200,269941,277.83849063313835
1747352659712688,44075004,1,476,75,37238123,36965760,272363,275.36779959098703
1747352659806526,44167564,1,477,75,37331961,37058320,273641,274.08173482774873
1747352659896836,44260124,1,478,75,37422271,37150880,271391,276.35404269117254
1747352659991127,44352684,1,479,75,37516562,37243440,273122,274.6025585635724
1747352660084761,44445244,1,480,75,37610196,37336000,274196,273.5269661118324
1747352660178930,44537804,1,481,75,37704365,37428560,275805,271.93125577853914
1747352660268729,44630364,1,482,75,37794164,37521120,273044,274.6810037942603
1747352660363794,44722924,1,483,75,37889229,37613680,275549,272.18389469749485
1747352660460454,44815484,1,484,75,37985889,37706240,279649,268.1933423684691
1747352660552239,44908044,1,485,75,38077674,37798800,278874,268.9386604703199
1747352660646309,45000604,1,486,75,38171744,37891360,280384,267.4902990184889
1747352660735819,45093164,1,487,75,38261254,37983920,277334,270.4320422306677
1747352660830386,45185724,1,488,75,38355821,38076480,279341,268.4890510164996
1747352660924584,45278284,1,489,75,38450019,38169040,280979,266.92386263742134
1747352661019246,45370844,1,490,75,38544681,38261600,283081,264.9418364355078
1747352661109372,45463404,1,491,75,38634807,38354160,280647,267.2396284300207
1747352661203567,45555964,1,492,75,38729002,38446720,282282,265.6917550534572
1747352661296894,45648524,1,493,75,38822329,38539280,283049,264.97178933682864
1747352661391950,45741092,1,494,75,38917385,38631848,285537,262.66298238056714
1747352661481441,45833644,1,495,75,39006876,38724400,282476,265.50928220450584
1747352661575388,45926204,1,496,75,39100823,38816960,283863,264.2119614039167
1747352661670335,46018764,1,497,75,39195770,38909520,286250,262.0087336244541
1747352661763693,46111324,1,498,75,39289128,39002080,287048,261.2803433572085
1747352661854236,46203884,1,499,75,39379671,39094640,285031,263.12927365795304
1747352661948569,46296444,1,500,75,39474004,39187200,286804,261.5026289730966
1747352662042693,46389004,1,501,75,39568128,39279760,288368,260.0843366809077
1747352662136953,46481564,1,502,75,39662388,39372320,290068,258.5600617786174
1747352662231028,46574124,1,503,75,39756463,39464880,291583,257.2166415737543
1747352662321831,46666684,1,504,75,39847266,39557440,289826,258.77595522830944
1747352662415760,46759244,1,505,75,39941195,39650000,291195,257.5593674341936
1747352662509266,46851804,1,506,75,40034701,39742560,292141,256.72534837629775
1747352662603448,46944364,1,507,75,40128883,39835120,293763,255.30785020577807
1747352662693749,47036924,1,508,75,40219184,39927680,291504,257.28634941544544
1747352662787894,47129484,1,509,75,40313329,40020240,293089,255.8949670577879
1747352662882044,47222044,1,510,75,40407479,40112800,294679,254.51423413273423
1747352662977005,47314604,1,511,75,40502440,40205360,297080,252.45725057223643
1747352663066228,47407164,1,512,75,40591663,40297920,293743,255.32523328215484
1747352663161175,47499724,1,513,75,40686610,40390480,296130,253.2671461857968
1747352663254734,47592284,1,514,75,40780169,40483040,297129,252.41561745908345
1747352663349424,47684844,1,515,75,40874859,40575600,299259,250.61902900163403
1747352663443919,47777404,1,516,75,40969354,40668160,301194,249.0089444012829
1747352663533434,47869972,1,517,75,41058869,40760728,298141,251.55882619297583
1747352663627431,47962524,1,518,75,41152866,40853280,299586,250.34547675792592
1747352663722015,48055084,1,519,75,41247450,40945840,301610,248.6654951758894
1747352663816053,48147644,1,520,75,41341488,41038400,303088,247.45288497070155
1747352663906325,48240204,1,521,75,41431760,41130960,300800,249.33510638297872
1747352664000929,48332764,1,522,75,41526364,41223520,302844,247.6522566073622
1747352664095110,48425324,1,523,75,41620545,41316080,304465,246.333732941389
1747352664189034,48517884,1,524,75,41714469,41408640,305829,245.23508234994063
1747352664279248,48610444,1,525,75,41804683,41501200,303483,247.1308112810273
1747352664373885,48703004,1,526,75,41899320,41593760,305560,245.4509752585417
1747352664467096,48795564,1,527,75,41992531,41686320,306211,244.92915016116336
1747352664561907,48888124,1,528,75,42087342,41778880,308462,243.14178083524064
1747352664652115,48980684,1,529,75,42177550,41871440,306110,245.00996373852536
1747352664751033,49073244,1,530,75,42276468,41964000,312468,240.0245785168401
1747352664840392,49165804,1,531,75,42365827,42056560,309267,242.5089000766328
1747352664934393,49258364,1,532,75,42459828,42149120,310708,241.3841935193172
1747352665028323,49350924,1,533,75,42553758,42241680,312078,240.3245342510526
1747352665119027,49443484,1,534,75,42644462,42334240,310222,241.76235083262955
1747352665212984,49536044,1,535,75,42738419,42426800,311619,240.67852088608203
1747352665306936,49628604,1,536,75,42832371,42519360,313011,239.60819268332423
1747352665400993,49721164,1,537,75,42926428,42611920,314508,238.46770193445
1747352665491468,49813724,1,538,75,43016903,42704480,312423,240.0591505747016
1747352665585296,49906284,1,539,75,43110731,42797040,313691,239.08878482328151
1747352665679727,49998844,1,540,75,43205162,42889600,315562,237.67120248952665
1747352665774196,50091404,1,541,75,43299631,42982160,317471,236.2420504550022
1747352665863714,50183964,1,542,75,43389149,43074720,314429,238.5276167274647
1747352665958764,50276524,1,543,75,43484199,43167280,316919,236.65352976628097
1747352666052532,50369084,1,544,75,43577967,43259840,318127,235.754902916131
1747352666146643,50461644,1,545,75,43672078,43352400,319678,234.61107739663035
1747352666236688,50554204,1,546,75,43762123,43444960,317163,236.47146735274924
1747352666330672,50646764,1,547,75,43856107,43537520,318587,235.4145021611052
1747352666425691,50739324,1,548,75,43951126,43630080,321046,233.61138279249704
1747352666519403,50831884,1,549,75,44044838,43722640,322198,232.77611903239625
1747352666613026,50924444,1,550,75,44138461,43815200,323261,232.01066630369888
1747352666704114,51017004,1,551,75,44229549,43907760,321789,233.07198195090567
1747352666798158,51109564,1,552,75,44323593,44000320,323273,232.002053991518
1747352666892490,51202124,1,553,75,44417925,44092880,325045,230.73728253011123
1747352666986257,51294684,1,554,75,44511692,44185440,326252,229.8836482228461
1747352667076481,51387244,1,555,75,44601916,44278000,323916,231.54151076204943
1747352667170358,51479804,1,556,75,44695793,44370560,325233,230.6039055077437
1747352667264949,51572364,1,557,75,44790384,44463120,327264,229.17277794074508
1747352667359409,51664932,1,558,75,44884844,44555688,329156,227.8554849372334
1747352667449352,51757484,1,559,75,44974787,44648240,326547,229.6759731370982
1747352667543759,51850044,1,560,75,45069194,44740800,328394,228.3841970316145
1747352667636955,51942604,1,561,75,45162390,44833360,329030,227.9427407835152
1747352667731946,52035164,1,562,75,45257381,44925920,331461,226.27096400481503
1747352667821468,52127724,1,563,75,45346903,45018480,328423,228.36403053379328
1747352667915793,52220284,1,564,75,45441228,45111040,330188,227.1433244091245
1747352668010370,52312844,1,565,75,45535805,45203600,332205,225.7642118571364
1747352668104153,52405404,1,566,75,45629588,45296160,333428,224.93611814244755
1747352668198173,52497964,1,567,75,45723608,45388720,334888,223.9554716800841
1747352668289143,52590524,1,568,75,45814578,45481280,333298,225.023852528368
1747352668382924,52683084,1,569,75,45908359,45573840,334519,224.20251166600403
1747352668476821,52775644,1,570,75,46002256,45666400,335856,223.30998999571244
1747352668571245,52868204,1,571,75,46096680,45758960,337720,222.07746061826364
1747352668661886,52960764,1,572,75,46187321,45851520,335801,223.3465653765176
1747352668756042,53053324,1,573,75,46281477,45944080,337397,222.29006185591453
1747352668849425,53145884,1,574,75,46374860,46036640,338220,221.74915735320204
1747352668944260,53238444,1,575,75,46469695,46129200,340495,220.26755165274088
1747352669033588,53331004,1,576,75,46559023,46221760,337263,222.3783812632871
1747352669128409,53423564,1,577,75,46653844,46314320,339524,220.8974917826133
1747352669222160,53516124,1,578,75,46747595,46406880,340715,220.12532468485392
1747352669316464,53608684,1,579,75,46841899,46499440,342459,219.00431876516603
1747352669406948,53701244,1,580,75,46932383,46592000,340383,220.34002873233976
1747352669501229,53793812,1,581,75,47026664,46684568,342096,219.2367054861793
1747352669595194,53886364,1,582,75,47120629,46777120,343509,218.33489078888763
1747352669689218,53978924,1,583,75,47214653,46869680,344973,217.40831891191488
1747352669783033,54071484,1,584,75,47308468,46962240,346228,216.62026179280707
1747352669873255,54164044,1,585,75,47398690,47054800,343890,218.0929948530053
1747352669967904,54256604,1,586,75,47493339,47147360,345979,216.7761627150781
1747352670061615,54349164,1,587,75,47587050,47239920,347130,216.0573848414139
1747352670156118,54441724,1,588,75,47681553,47332480,349073,214.8547724974432
1747352670246338,54534284,1,589,75,47771773,47425040,346733,216.3047647613581
1747352670340257,54626844,1,590,75,47865692,47517600,348092,215.46028061546943
1747352670435264,54719404,1,591,75,47960699,47610160,350539,213.95622170428967
1747352670529397,54811964,1,592,75,48054832,47702720,352112,213.0004089607852
1747352670619744,54904524,1,593,75,48145179,47795280,349899,214.34756886987387
1747352670713641,54997084,1,594,75,48239076,47887840,351236,213.5316425423362
1747352670807627,55089644,1,595,75,48333062,47980400,352662,212.6682205624649
1747352670901178,55182204,1,596,75,48426613,48072960,353653,212.0722855454358
1747352670992363,55274764,1,597,75,48517798,48165520,352278,212.9000391736072
1747352671085698,55367324,1,598,75,48611133,48258080,353053,212.4326942413745
1747352671180033,55459884,1,599,75,48705468,48350640,354828,211.3700158950252
1747352671273979,55552444,1,600,75,48799414,48443200,356214,210.54759217773588
1747352671368264,55645004,1,601,75,48893699,48535760,357939,209.53290923872504
1747352671458778,55737564,1,602,75,48984213,48628320,355893,210.7374969443063
1747352671552648,55830124,1,603,75,49078083,48720880,357203,209.9646419542949
1747352671647271,55922684,1,604,75,49172706,48813440,359266,208.75896967706385
1747352671741510,56015244,1,605,75,49266945,48906000,360945,207.7878901217637
1747352671831255,56107804,1,606,75,49356690,48998560,358130,209.4211599139977
1747352671925495,56200364,1,607,75,49450930,49091120,359810,208.44334509880213
1747352672020480,56292924,1,608,75,49545915,49183680,362235,207.0479108865792
1747352672113736,56385484,1,609,75,49639171,49276240,362931,206.65085098820435
1747352672204391,56478044,1,610,75,49729826,49368800,361026,207.74127071180467
1747352672298915,56570604,1,611,75,49824350,49461360,362990,206.61726218353124
1747352672393151,56663164,1,612,75,49918586,49553920,364666,205.6676520432396
1747352672486482,56755724,1,613,75,50011917,49646480,365437,205.23373385836683
1747352672577451,56848284,1,614,75,50102886,49739040,363846,206.1311653831566
1747352672671605,56940844,1,615,75,50197040,49831600,365440,205.2320490367776
1747352672765526,57033404,1,616,75,50290961,49924160,366801,204.4705439734352
1747352672859733,57125964,1,617,75,50385168,50016720,368448,203.5565398645128
1747352672953429,57218524,1,618,75,50478864,50109280,369584,202.9308628079137
1747352673044219,57311084,1,619,75,50569654,50201840,367814,203.9074097233928
1747352673138583,57403644,1,620,75,50664018,50294400,369618,202.91219583461844
1747352673232226,57496204,1,621,75,50757661,50386960,370701,202.3193894810103
1747352673326578,57588772,1,622,75,50852013,50479528,372485,201.3503899485885
1747352673416950,57681324,1,623,75,50942385,50572080,370305,202.53574755944425
1747352673510398,57773884,1,624,75,51035833,50664640,371193,202.0512240263152
1747352673605341,57866444,1,625,75,51130776,50757200,373576,200.76236160781207
1747352673698816,57959004,1,626,75,51224251,50849760,374491,200.2718356382396
1747352673789078,58051564,1,627,75,51314513,50942320,372193,201.50835722326852
1747352673883798,58144124,1,628,75,51409233,51034880,374353,200.34566305065005
1747352673978012,58236684,1,629,75,51503447,51127440,376007,199.4643716739316
1747352674071833,58329244,1,630,75,51597268,51220000,377268,198.79767168166927
1747352674166204,58421804,1,631,75,51691639,51312560,379079,197.84794198570748
1747352674256530,58514364,1,632,75,51781965,51405120,376845,199.0208175775186
1747352674350471,58606924,1,633,75,51875906,51497680,378226,198.29414159788064
1747352674444622,58699484,1,634,75,51970057,51590240,379817,197.4635153244852
1747352674538784,58792044,1,635,75,52064219,51682800,381419,196.63414774827683
1747352674628374,58884604,1,636,75,52153809,51775360,378449,198.17729733728984
1747352674723504,58977164,1,637,75,52248939,51867920,381019,196.840577504009
1747352674817714,59069724,1,638,75,52343149,51960480,382669,195.99183628671256
1747352674910980,59162284,1,639,75,52436415,52053040,383375,195.63090968373
1747352675001748,59254844,1,640,75,52527183,52145600,381583,196.5496366452384
1747352675095745,59347404,1,641,75,52621180,52238160,383020,195.8122291264164
1747352675189818,59439964,1,642,75,52715253,52330720,384533,195.04177794883665
1747352675284345,59532524,1,643,75,52809780,52423280,386500,194.0491591203105
1747352675374597,59625084,1,644,75,52900032,52515840,384192,195.2148925537232
1747352675468298,59717652,1,645,75,52993733,52608408,385325,194.6408875624473
1747352675562919,59810204,1,646,75,53088354,52700960,387394,193.60134643283064
1747352675656964,59902764,1,647,75,53182399,52793520,388879,192.8620470634825
1747352675751218,59995324,1,648,75,53276653,52886080,390573,192.0255624428724
1747352675841588,60087884,1,649,75,53367023,52978640,388383,193.10834923258744
1747352675935247,60180444,1,650,75,53460682,53071200,389482,192.56345607755944
1747352676029546,60273004,1,651,75,53554981,53163760,391221,191.70750036424425
1747352676123490,60365564,1,652,75,53648925,53256320,392605,191.03169852650885
1747352676213582,60458124,1,653,75,53739017,53348880,390137,192.24016178932013
1747352676308547,60550684,1,654,75,53833982,53441440,392542,191.0623576585436
1747352676402151,60643244,1,655,75,53927586,53534000,393586,190.5555583786009
1747352676498835,60735804,1,656,75,54024270,53626560,397710,188.57961831485247
1747352676586267,60828364,1,657,75,54111702,53719120,392582,191.04289040251464
1747352676680474,60920924,1,658,75,54205909,53811680,394229,190.24475622036937
1747352676774808,61013484,1,659,75,54300243,53904240,396003,189.39250460223784
1747352676869181,61106044,1,660,75,54394616,53996800,397816,188.52937036217747
1747352676959435,61198604,1,661,75,54484870,54089360,395510,189.6285808197012
1747352677053263,61291164,1,662,75,54578698,54181920,396778,189.0225768565797
1747352677147368,61383724,1,663,75,54672803,54274480,398323,188.2894033234335
1747352677241675,61476284,1,664,75,54767110,54367040,400070,187.4671932411828
1747352677335723,61568844,1,665,75,54861158,54459600,401558,186.77252103058584
1747352677425960,61661404,1,666,75,54951395,54552160,399235,187.8592808746728
1747352677520468,61753964,1,667,75,55045903,54644720,401183,186.94710394009715
1747352677614479,61846524,1,668,75,55139914,54737280,402634,186.2733897286369
1747352677708460,61939084,1,669,75,55233895,54829840,404055,185.61829453910977
1747352677798913,62031644,1,670,75,55324348,54922400,401948,186.5913003672117
1747352677892933,62124204,1,671,75,55418368,55014960,403408,185.91599571649547
1747352677986761,62216764,1,672,75,55512196,55107520,404676,185.3334519467426
1747352678081166,62309324,1,673,75,55606601,55200080,406521,184.49231405019663
1747352678171380,62401884,1,674,75,55696815,55292640,404175,185.563184264242
1747352678266229,62494444,1,675,75,55791664,55385200,406464,184.51818611242325
1747352678360068,62587004,1,676,75,55885503,55477760,407743,183.9393931962045
1747352678453993,62679564,1,677,75,55979428,55570320,409108,183.32567439404752
1747352678544804,62772124,1,678,75,56070239,55662880,407359,184.1127850372767
1747352678638397,62864684,1,679,75,56163832,55755440,408392,183.6470841740289
1747352678732528,62957244,1,680,75,56257963,55848000,409963,182.9433387891102
1747352678826732,63049804,1,681,75,56352167,55940560,411607,182.21264458573347
1747352678920820,63142364,1,682,75,56446255,56033120,413135,181.5387222094473
1747352679011509,63234924,1,683,75,56536944,56125680,411264,182.3646125116713
1747352679105314,63327484,1,684,75,56630749,56218240,412509,181.81421496258264
1747352679199442,63420044,1,685,75,56724877,56310800,414077,181.12573265358856
1747352679293712,63512612,1,686,75,56819147,56403368,415779,180.3842906928921
1747352679383548,63605164,1,687,75,56908983,56495920,413063,181.5703657795542
1747352679477957,63697724,1,688,75,57003392,56588480,414912,180.76122165664043
1747352679572465,63790284,1,689,75,57097900,56681040,416860,179.91651873530682
1747352679666581,63882844,1,690,75,57192016,56773600,418416,179.24744751634736
1747352679757131,63975404,1,691,75,57282566,56866160,416406,180.11267849166438
1747352679850887,64067964,1,692,75,57376322,56958720,417602,179.59684101129784
1747352679944865,64160524,1,693,75,57470300,57051280,419020,178.98906973414157
1747352680038790,64253084,1,694,75,57564225,57143840,420385,178.40788800742178
1747352680129776,64345644,1,695,75,57655211,57236400,418811,179.0783909687186
1747352680223776,64438204,1,696,75,57749211,57328960,420251,178.46477462278497
1747352680317339,64530764,1,697,75,57842774,57421520,421254,178.0398524405703
1747352680411931,64623324,1,698,75,57937366,57514080,423286,177.1851655854434
1747352680506421,64715884,1,699,75,58031856,57606640,425216,176.38094521372668
1747352680596589,64808444,1,700,75,58122024,57699200,422824,177.37876752502223
1747352680690931,64901004,1,701,75,58216366,57791760,424606,176.63433865748482
1747352680784888,64993564,1,702,75,58310323,57884320,426003,176.05509820353376
1747352680878657,65086124,1,703,75,58404092,57976880,427212,175.55686638015786
1747352680968925,65178684,1,704,75,58494360,58069440,424920,176.50381248234962
1747352681062881,65271244,1,705,75,58588316,58162000,426316,175.92583904896838
1747352681157070,65363804,1,706,75,58682505,58254560,427945,175.25616609611046
1747352681251867,65456364,1,707,75,58777302,58347120,430182,174.3448121957683
1747352681341963,65548924,1,708,75,58867398,58439680,427718,175.34917866444715
1747352681436199,65641492,1,709,75,58961634,58532248,429386,174.668014327435
1747352681529643,65734044,1,710,75,59055078,58624800,430278,174.30591385104515
1747352681624623,65826604,1,711,75,59150058,58717360,432698,173.3310530670352
1747352681714374,65919164,1,712,75,59239809,58809920,429889,174.46364061420505
1747352681808130,66011724,1,713,75,59333565,58902480,431085,173.97960958975608
1747352681902726,66104284,1,714,75,59428161,58995040,433121,173.16177234537233
1747352681996938,66196844,1,715,75,59522373,59087600,434773,172.5038123342526
1747352682091095,66289404,1,716,75,59616530,59180160,436370,171.87249352613608
1747352682181019,66381964,1,717,75,59706454,59272720,433734,172.9170413202562
1747352682275348,66474524,1,718,75,59800783,59365280,435503,172.21465753393204
1747352682369756,66567084,1,719,75,59895191,59457840,437351,171.48697499262607
1747352682463826,66659644,1,720,75,59989261,59550400,438861,170.89693547615303
1747352682554563,66752204,1,721,75,60079998,59642960,437038,171.6097913682563
1747352682648525,66844764,1,722,75,60173960,59735520,438440,171.06103457713712
1747352682742915,66937324,1,723,75,60268350,59828080,440270,170.35001249233426
1747352682836516,67029884,1,724,75,60361951,59920640,441311,169.94817713585203
1747352682926524,67122444,1,725,75,60451959,60013200,438759,170.93666454705203
1747352683021041,67215004,1,726,75,60546476,60105760,440716,170.17762005463837
1747352683306981,67498924,1,729,75,60832416,60389680,442736,169.40117812872683
1747352683401494,67591484,1,730,75,60926929,60482240,444689,168.65719637769317
1747352683495503,67684044,1,731,75,61020938,60574800,446138,168.1094190586769
1747352683586734,67776604,1,732,75,61112169,60667360,444809,168.6116962561459
1747352683679818,67869164,1,733,75,61205253,60759920,445333,168.41329971055367
1747352683775067,67961724,1,734,75,61300502,60852480,448022,167.40249362754508
1747352683868501,68054284,1,735,75,61393936,60945040,448896,167.0765611633875
1747352683958667,68146844,1,736,75,61484102,61037600,446502,167.97237190426918
1747352684053640,68239404,1,737,75,61579075,61130160,448915,167.06948976977824
1747352684147405,68331964,1,738,75,61672840,61222720,450120,166.6222340709144
1747352684241406,68424524,1,739,75,61766841,61315280,451561,166.0905171172887
1747352684331309,68517084,1,740,75,61856744,61407840,448904,167.07358366154008
1747352684426009,68609644,1,741,75,61951444,61500400,451044,166.2808949902892
1747352684519901,68702204,1,742,75,62045336,61592960,452376,165.79128866252853
1747352684614586,68794764,1,743,75,62140021,61685520,454501,165.01613857835298
1747352684704315,68887324,1,744,75,62229750,61778080,451670,166.05043505213982
1747352684802219,68979884,1,745,75,62327654,61870640,457014,164.10875815620528
1747352684892921,69072444,1,746,75,62418356,61963200,455156,164.77866929140777
1747352684987258,69165004,1,747,75,62512693,62055760,456933,164.1378495315506
1747352685081235,69257564,1,748,75,62606670,62148320,458350,163.6304134395113
1747352685171439,69350124,1,749,75,62696874,62240880,455994,164.47584836642588
1747352685269998,69442684,1,750,75,62795433,62333440,461993,162.34012203648106
1747352685359441,69535244,1,751,75,62884876,62426000,458876,163.44284730515434
1747352685453938,69627804,1,752,75,62979373,62518560,460813,162.75582503097786
1747352685543916,69720364,1,753,75,63069351,62611120,458231,163.67290733276448
1747352685637830,69812924,1,754,75,63163265,62703680,459585,163.1907046574627
1747352685732501,69905484,1,755,75,63257936,62796240,461696,162.44455225949542
1747352685826830,69998044,1,756,75,63352265,62888800,463465,161.82451749323033
1747352685916935,70090604,1,757,75,63442370,62981360,461010,162.6862757857747
1747352686010550,70183164,1,758,75,63535985,63073920,462065,162.3148258361919
1747352686104464,70275724,1,759,75,63629899,63166480,463419,161.84058055453056
1747352686199115,70368292,1,760,75,63724550,63259048,465502,161.11638618094014
1747352686293455,70460844,1,761,75,63818890,63351600,467290,160.4999037000578
1747352686383470,70553404,1,762,75,63908905,63444160,464745,161.3788206435787
1747352686477956,70645964,1,763,75,64003391,63536720,466671,160.7127933812043
1747352686571855,70738524,1,764,75,64097290,63629280,468010,160.25298604730668
1747352686665721,70831084,1,765,75,64191156,63721840,469316,159.80703832812006
1747352686755892,70923644,1,766,75,64281327,63814400,466927,160.62468008917884
1747352686850167,71016204,1,767,75,64375602,63906960,468642,160.03687249542295
1747352686944691,71108764,1,768,75,64470126,63999520,470606,159.36898382086076
1747352687039121,71201324,1,769,75,64564556,64092080,472476,158.7382216239555
1747352687129381,71293884,1,770,75,64654816,64184640,470176,159.51473490777923
1747352687223663,71386444,1,771,75,64749098,64277200,471898,158.9326506999394
1747352687317761,71479004,1,772,75,64843196,64369760,473436,158.41634349732593
1747352687411495,71571564,1,773,75,64936930,64462320,474610,158.02448325993976
1747352687501324,71664124,1,774,75,65026759,64554880,471879,158.93905005308565
1747352687596310,71756684,1,775,75,65121745,64647440,474305,158.12610029411456
1747352687690510,71849244,1,776,75,65215945,64740000,475945,157.58123312567628
1747352687784152,71941804,1,777,75,65309587,64832560,477027,157.22380494185865
1747352687878610,72034364,1,778,75,65404045,64925120,478925,156.60072036331368
1747352687968863,72126924,1,779,75,65494298,65017680,476618,157.358723338187
1747352688062414,72219484,1,780,75,65587849,65110240,477609,157.03221672958423
1747352688157139,72312044,1,781,75,65682574,65202800,479774,156.32360236277916
1747352688251165,72404604,1,782,75,65776600,65295360,481240,155.84739423156844
1747352688341196,72497172,1,783,75,65866631,65387928,478703,156.67334443276937
1747352688435216,72589724,1,784,75,65960651,65480480,480171,156.19435576076023
1747352688530093,72682284,1,785,75,66055528,65573040,482488,155.44428047951453
1747352688623759,72774844,1,786,75,66149194,65665600,483594,155.08877281355848
1747352688713633,72867404,1,787,75,66239068,65758160,480908,155.9549851530854
1747352688807968,72959964,1,788,75,66333403,65850720,482683,155.3814822564706
1747352688902853,73052524,1,789,75,66428288,65943280,485008,154.63662455052287
1747352688996893,73145084,1,790,75,66522328,66035840,486488,154.16618703852922
1747352689086462,73237644,1,791,75,66611897,66128400,483497,155.11988698999167
1747352689181154,73330204,1,792,75,66706589,66220960,485629,154.43888235669615
1747352689275566,73422764,1,793,75,66801001,66313520,487481,153.85215013508218
1747352689368901,73515324,1,794,75,66894336,66406080,488256,153.60794337396774
1747352689463420,73607884,1,795,75,66988855,66498640,490215,152.99409442795508
1747352689553651,73700444,1,796,75,67079086,66591200,487886,153.72443562635533
1747352689647239,73793004,1,797,75,67172674,66683760,488914,153.4012116650372
1747352689742240,73885564,1,798,75,67267675,66776320,491355,152.6391305675123
1747352689836326,73978124,1,799,75,67361761,66868880,492881,152.166547300464
1747352689926354,74070684,1,800,75,67451789,66961440,490349,152.95228500516978
1747352690019795,74163244,1,801,75,67545230,67054000,491230,152.67797162225435
1747352690114984,74255804,1,802,75,67640419,67146560,493859,151.86520849068256
1747352690208700,74348364,1,803,75,67734135,67239120,495015,151.51056028605194
1747352690299516,74440924,1,804,75,67824951,67331680,493271,152.04623827470093
1747352690393665,74533484,1,805,75,67919100,67424240,494860,151.55801640868123
1747352690487785,74626044,1,806,75,68013220,67516800,496420,151.08174529632169
1747352690581143,74718604,1,807,75,68106578,67609360,497218,150.83926969659183
1747352690672156,74811164,1,808,75,68197591,67701920,495671,151.3100423466372
1747352690765882,74903724,1,809,75,68291317,67794480,496837,150.95494095649076
1747352690860464,74996284,1,810,75,68385899,67887040,498859,150.3430829152125
1747352690954588,75088844,1,811,75,68480023,67979600,500423,149.87320726665243
1747352691048500,75181404,1,812,75,68573935,68072160,501775,149.46938368790794
1747352691138445,75273964,1,813,75,68663880,68164720,499160,150.2524240724417
1747352691233295,75366524,1,814,75,68758730,68257280,501450,149.56625785222857
1747352691326967,75459084,1,815,75,68852402,68349840,502562,149.23531822939262
1747352691421625,75551644,1,816,75,68947060,68442400,504660,148.61490904767567
1747352691511446,75644204,1,817,75,69036881,68534960,501921,149.4259056704143
1747352691605988,75736764,1,818,75,69131423,68627520,503903,148.83816925082803
1747352691699375,75829324,1,819,75,69224810,68720080,504730,148.59429794147366
1747352691793986,75921884,1,820,75,69319421,68812640,506781,147.9929200187063
1747352691884105,76014444,1,821,75,69409540,68905200,504340,148.7092041083396
1747352691978776,76107004,1,822,75,69504211,68997760,506451,148.08935119093456
1747352692072307,76199564,1,823,75,69597742,69090320,507422,147.8059682079216
1747352692166746,76292132,1,824,75,69692181,69182888,509293,147.26297043155904
1747352692256675,76384684,1,825,75,69782110,69275440,506670,148.0253419385399
1747352692350377,76477244,1,826,75,69875812,69368000,507812,147.6924531125692
1747352692445589,76569804,1,827,75,69971024,69460560,510464,146.92515045135406
1747352692539585,76662364,1,828,75,70065020,69553120,511900,146.51299081851923
1747352692633914,76754924,1,829,75,70159349,69645680,513669,146.00842176576745
1747352692723734,76847484,1,830,75,70249169,69738240,510929,146.79143286053446
1747352692818313,76940044,1,831,75,70343748,69830800,512948,146.21365128629023
1747352692912235,77032604,1,832,75,70437670,69923360,514310,145.82644708444323
1747352693006543,77125164,1,833,75,70531978,70015920,516058,145.33250138550318
1747352693096831,77217724,1,834,75,70622266,70108480,513786,145.97517254265395
1747352693190418,77310284,1,835,75,70715853,70201040,514813,145.6839667995952
1747352693284947,77402844,1,836,75,70810382,70293600,516782,145.12889380822088
1747352693378916,77495404,1,837,75,70904351,70386160,518191,144.73427751543352
1747352693468838,77587964,1,838,75,70994273,70478720,515553,145.4748590348616
1747352693563327,77680524,1,839,75,71088762,70571280,517482,144.9325773650098
1747352693657972,77773084,1,840,75,71183407,70663840,519567,144.35096917240702
1747352693751898,77865644,1,841,75,71277333,70756400,520933,143.97244943207667
1747352693841937,77958204,1,842,75,71367372,70848960,518412,144.67257702368002
1747352693935752,78050764,1,843,75,71461187,70941520,519667,144.32319158230175
1747352694030172,78143324,1,844,75,71555607,71034080,521527,143.80847012714588
1747352694124464,78235884,1,845,75,71649899,71126640,523259,143.33246059790656
1747352694218945,78328444,1,846,75,71744380,71219200,525180,142.8081800525534
1747352694309146,78421012,1,847,75,71834581,71311768,522813,143.45473429314114
1747352694403043,78513564,1,848,75,71928478,71404320,524158,143.08662655153597
1747352694497226,78606124,1,849,75,72022661,71496880,525781,142.64494152508362
1747352694591019,78698684,1,850,75,72116454,71589440,527014,142.3112099488818
1747352694689790,78791244,1,851,75,72215225,71682000,533225,140.65357025645835
1747352694779877,78886932,1,852,75,72305312,71777688,527624,142.14668021166588
1747352694874242,78979484,1,853,75,72399677,71870240,529437,141.65991421075594
1747352694964065,79072044,1,854,75,72489500,71962800,526700,142.39605088285552
1747352695058609,79164604,1,855,75,72584044,72055360,528684,141.86167918832422
1747352695152105,79257164,1,856,75,72677540,72147920,529620,141.6109663532344
1747352695246534,79349724,1,857,75,72771969,72240480,531489,141.11298634590744
1747352695336688,79442284,1,858,75,72862123,72333040,529083,141.75469633308953
1747352695431284,79534844,1,859,75,72956719,72425600,531119,141.2112916314423
1747352695524775,79627404,1,860,75,73050210,72518160,532050,140.964195094446
1747352695619230,79719964,1,861,75,73144665,72610720,533945,140.46390545842738
1747352695713589,79812524,1,862,75,73239024,72703280,535744,139.99223509735992
1747352695803502,79905084,1,863,75,73328937,72795840,533097,140.6873420784585
1747352695897649,79997644,1,864,75,73423084,72888400,534684,140.26976681553964
1747352695992179,80090204,1,865,75,73517614,72980960,536654,139.75485135674012
1747352696086693,80182764,1,866,75,73612128,73073520,538608,139.2478388735407
1747352696176665,80275324,1,867,75,73702100,73166080,536020,139.9201522331256
1747352696270816,80367884,1,868,75,73796251,73258640,537611,139.50607409446607
1747352696364507,80460444,1,869,75,73889942,73351200,538742,139.2132040939819
1747352696458803,80553004,1,870,75,73984238,73443760,540478,138.76605523259042
1747352696549193,80645564,1,871,75,74074628,73536320,538308,139.32544194030183
1747352696643223,80738124,1,872,75,74168658,73628880,539778,138.94601113791225
1747352696737335,80830684,1,873,75,74262770,73721440,541330,138.54765115548742
1747352696831525,80923244,1,874,75,74356960,73814000,542960,138.13172241049065
1747352696925836,81015804,1,875,75,74451271,73906560,544711,137.68769127115112
1747352697015649,81108364,1,876,75,74541084,73999120,541964,138.38557542567403
1747352697110504,81200924,1,877,75,74635939,74091680,544259,137.8020391027066
1747352697204774,81293484,1,878,75,74730209,74184240,545969,137.3704367830408
1747352697300339,81386044,1,879,75,74825774,74276800,548974,136.61849195043845
1747352697388405,81478604,1,880,75,74913840,74369360,544480,137.74610637672643
1747352697483320,81571164,1,881,75,75008755,74461920,546835,137.15288889701648
1747352697576806,81663724,1,882,75,75102241,74554480,547761,136.92102942706762
1747352697671512,81756284,1,883,75,75196947,74647040,549907,136.38669811440843
1747352697760930,81848844,1,884,75,75286365,74739600,546765,137.1704479986832
1747352697855305,81941404,1,885,75,75380740,74832160,548580,136.71661380290934
1747352697949872,82033964,1,886,75,75475307,74924720,550587,136.21825433582703
1747352698044408,82126524,1,887,75,75569843,75017280,552563,135.73112930109326
1747352698134229,82219084,1,888,75,75659664,75109840,549824,136.4072866953789
1747352698227954,82311644,1,889,75,75753389,75202400,550989,136.11886988669465
1747352698322176,82404204,1,890,75,75847611,75294960,552651,135.70951649413465
1747352698416677,82496764,1,891,75,75942112,75387520,554592,135.23455080491604
1747352698510323,82589324,1,892,75,76035758,75480080,555678,134.9702525563366
1747352698601009,82681892,1,893,75,76126444,75572648,553796,135.4289305087072
1747352698695561,82774444,1,894,75,76220996,75665200,555796,134.94159727669864
1747352698789473,82867004,1,895,75,76314908,75757760,557148,134.6141420233044
1747352698883502,82959564,1,896,75,76408937,75850320,558617,134.2601460392362
1747352698973716,83052124,1,897,75,76499151,75942880,556271,134.8263705999414
1747352699068312,83144684,1,898,75,76593747,76035440,558307,134.33469399452272
1747352699162392,83237244,1,899,75,76687827,76128000,559827,133.9699585764888
1747352699256478,83329804,1,900,75,76781913,76220560,561353,133.60577034415064
1747352699346293,83422364,1,901,75,76871728,76313120,558608,134.26230916850457
1747352699440764,83514924,1,902,75,76966199,76405680,560519,133.80456327082578
1747352699534960,83607484,1,903,75,77060395,76498240,562155,133.41516129893003
1747352699629128,83700044,1,904,75,77154563,76590800,563763,133.034626252521
1747352699719480,83792604,1,905,75,77244915,76683360,561555,133.55771028661485
1747352699813490,83885164,1,906,75,77338925,76775920,563005,133.2137370005595
1747352699907301,83977724,1,907,75,77432736,76868480,564256,132.9183916520161
1747352700001461,84070284,1,908,75,77526896,76961040,565856,132.54255499632416
1747352700095644,84162844,1,909,75,77621079,77053600,567479,132.1634809393828
1747352700190272,84255404,1,910,75,77715707,77146160,569547,131.68360117777812
1747352700279975,84347964,1,911,75,77805410,77238720,566690,132.34749157387637
1747352700374839,84440524,1,912,75,77900274,77331280,568994,131.8115832504385
1747352700468886,84533084,1,913,75,77994321,77423840,570481,131.4680068223131
1747352700558524,84625644,1,914,75,78083959,77516400,567559,132.14485190085963
1747352700652950,84718204,1,915,75,78178385,77608960,569425,131.71181454976514
1747352700746944,84810772,1,916,75,78272379,77701528,570851,131.3827951602082
1747352700840947,84903324,1,917,75,78366382,77794080,572302,131.0496905479974
1747352700931863,84995884,1,918,75,78457298,77886640,570658,131.4272296191414
1747352701025728,85088444,1,919,75,78551163,77979200,571963,131.12736313362927
1747352701119546,85181004,1,920,75,78644981,78071760,573221,130.8395889194569
1747352701213639,85273564,1,921,75,78739074,78164320,574754,130.4906098957119
1747352701304391,85366124,1,922,75,78829826,78256880,572946,130.90238870678914
1747352701398281,85458684,1,923,75,78923716,78349440,574276,130.59922406647675
1747352701493095,85551244,1,924,75,79018530,78442000,576530,130.0886337224429
1747352701587102,85643804,1,925,75,79112537,78534560,577977,129.76294904468517
1747352701681108,85736364,1,926,75,79206543,78627120,579423,129.4391144293547
1747352701770906,85828924,1,927,75,79296341,78719680,576661,130.0590815054252
1747352701865282,85921484,1,928,75,79390717,78812240,578477,129.65078991904605
1747352701959275,86014044,1,929,75,79484710,78904800,579910,129.33041334000103
1747352702245793,86297964,1,932,75,79771228,79188720,582508,128.75359651712938
1747352702336300,86390524,1,933,75,79861735,79281280,580455,129.20898260847093
1747352702430846,86483084,1,934,75,79956281,79373840,582441,128.7684074438441
1747352702525179,86575644,1,935,75,80050614,79466400,584214,128.3776150520186
1747352702618651,86668204,1,936,75,80144086,79558960,585126,128.17752073912283
1747352702709669,86760764,1,937,75,80235104,79651520,583584,128.51620332291495
1747352702803654,86853324,1,938,75,80329089,79744080,585009,128.20315584888436
1747352702897897,86945884,1,939,75,80423332,79836640,586692,127.83538892638728
1747352702992134,87038444,1,940,75,80517569,79929200,588369,127.4710258358275
1747352703085045,87131004,1,941,75,80610480,80021760,588720,127.3950264981655
1747352703176530,87223564,1,942,75,80701965,80114320,587645,127.62807477303474
1747352703274759,87316124,1,943,75,80800194,80206880,593314,126.40861331436642
1747352703364597,87408684,1,944,75,80890032,80299440,590592,126.99122236671
1747352703458191,87501244,1,945,75,80983626,80392000,591626,126.76927653619008
1747352703548879,87593804,1,946,75,81074314,80484560,589754,127.17166818707462
1747352703642696,87686364,1,947,75,81168131,80577120,591011,126.9011913483844
1747352703737019,87778924,1,948,75,81262454,80669680,592774,126.52376791154808
1747352703831002,87871484,1,949,75,81356437,80762240,594197,126.22076516710788
1747352703921359,87964044,1,950,75,81446794,80854800,591994,126.69047321425556
1747352704015415,88056604,1,951,75,81540850,80947360,593490,126.37112672496588
1747352704109336,88149164,1,952,75,81634771,81039920,594851,126.08199364210532
1747352704203404,88241724,1,953,75,81728839,81132480,596359,125.7631728539353
1747352704294161,88334284,1,954,75,81819596,81225040,594556,126.14455156452884
1747352704388516,88426844,1,955,75,81913951,81317600,596351,125.76485995663629
1747352704482823,88519404,1,956,75,82008258,81410160,598098,125.39751010703932
1747352704576511,88611964,1,957,75,82101946,81502720,599226,125.16145828118272
1747352704671267,88704524,1,958,75,82196702,81595280,601422,124.70445045242776
1747352704760526,88797084,1,959,75,82285961,81687840,598121,125.39268810157142
1747352704855582,88889644,1,960,75,82381017,81780400,600617,124.87159038122464
1747352704948893,88982204,1,961,75,82474328,81872960,601368,124.71564832182624
1747352705043523,89074764,1,962,75,82568958,81965520,603438,124.28783072991756
1747352705134028,89167324,1,963,75,82659463,82058080,601383,124.71253760083007
1747352705228159,89259884,1,964,75,82753594,82150640,602954,124.38759839059033
1747352705321684,89352444,1,965,75,82847119,82243200,603919,124.18883989409176
1747352705416680,89445004,1,966,75,82942115,82335760,606355,123.68991762251488
1747352705506587,89537572,1,967,75,83032022,82428328,603694,124.23512574251194
1747352705600568,89630124,1,968,75,83126003,82520880,605123,123.9417440751715
1747352705695105,89722684,1,969,75,83220540,82613440,607100,123.5381321034426
1747352705789341,89815244,1,970,75,83314776,82706000,608776,123.1980235751738
1747352705879545,89907804,1,971,75,83404980,82798560,606420,123.67665974077372
1747352705972889,90000364,1,972,75,83498324,82891120,607204,123.51697287896656
1747352706069506,90092924,1,973,75,83594941,82983680,611261,122.69717845568422
1747352706161841,90185484,1,974,75,83687276,83076240,611036,122.74235887901858
1747352706256278,90278044,1,975,75,83781713,83168800,612913,122.366469629458
1747352706345656,90370604,1,976,75,83871091,83261360,609731,123.00506288838848
1747352706440114,90463164,1,977,75,83965549,83353920,611629,122.62335500769258
1747352706534815,90555724,1,978,75,84060250,83446480,613770,122.19561073366243
1747352706628126,90648284,1,979,75,84153561,83539040,614521,122.04627669355482
1747352706720706,90740844,1,980,75,84246141,83631600,614541,122.04230474451664
1747352706812878,90833404,1,981,75,84338313,83724160,614153,122.11940672763954
1747352706907024,90925964,1,982,75,84432459,83816720,615739,121.80485562876478
1747352707000371,91018524,1,983,75,84525806,83909280,616526,121.64937082945409
1747352707091347,91111084,1,984,75,84616782,84001840,614942,121.9627216875738
1747352707185701,91203644,1,985,75,84711136,84094400,616736,121.60794894411872
1747352707279416,91296204,1,986,75,84804851,84186960,617891,121.3806318590172
1747352707374425,91388764,1,987,75,84899860,84279520,620340,120.90144114517844
1747352707468289,91481324,1,988,75,84993724,84372080,621644,120.6478305911422
1747352707557826,91573884,1,989,75,85083261,84464640,618621,121.23739737254311
1747352707652641,91666452,1,990,75,85178076,84557208,620868,120.79862386207697
1747352707746638,91759004,1,991,75,85272073,84649760,622313,120.51813155116476
1747352707840421,91851564,1,992,75,85365856,84742320,623536,120.28174796643658
1747352707931380,91944124,1,993,75,85456815,84834880,621935,120.59138012814844
1747352708025316,92036684,1,994,75,85550751,84927440,623311,120.3251667305727
1747352708119379,92129244,1,995,75,85644814,85020000,624814,120.035722631055
1747352708213637,92221804,1,996,75,85739072,85112560,626512,119.71039660852466
1747352708303479,92314364,1,997,75,85828914,85205120,623794,120.2319996665566
1747352708397418,92406924,1,998,75,85922853,85297680,625173,119.96679319164456
1747352708492276,92499484,1,999,75,86017711,85390240,627471,119.52743632773466
1747352708586248,92592044,1,1000,75,86111683,85482800,628883,119.2590672668843
1747352708680418,92685644,1,1001,75,86205853,85576400,629453,119.151072439086
1747352708775039,92779244,1,1002,75,86300474,85670000,630474,118.95811722608704
1747352708869114,92872844,1,1003,75,86394549,85763600,630949,118.8685614843672
1747352708962714,92966444,1,1004,75,86488149,85857200,630949,118.8685614843672
1747352709057567,93060044,1,1005,75,86583002,85950800,632202,118.63296857649928
1747352709151141,93153644,1,1006,75,86676576,86044400,632176,118.63784768798564
1747352709245299,93247244,1,1007,75,86770734,86138000,632734,118.53322249159994
1747352709340005,93340844,1,1008,75,86865440,86231600,633840,118.32639151836426
1747352709434611,93434444,1,1009,75,86960046,86325200,634846,118.13888722619345
1747352709528682,93528044,1,1010,75,87054117,86418800,635317,118.0513035224935
1747352709623033,93621644,1,1011,75,87148468,86512400,636068,117.91192136689789
1747352709716866,93715244,1,1012,75,87242301,86606000,636301,117.868744509281
1747352709811343,93808844,1,1013,75,87336778,86699600,637178,117.70651215202032
1747352709904498,93902444,1,1014,75,87429933,86793200,636733,117.788774886805
1747352709999719,93996052,1,1015,75,87525154,86886808,638346,117.49114116795594
1747352710093752,94089644,1,1016,75,87619187,86980400,638787,117.410028695011
1747352710187466,94183244,1,1017,75,87712901,87074000,638901,117.38907905919696
1747352710282438,94276844,1,1018,75,87807873,87167600,640273,117.13753352085752
1747352710375858,94370444,1,1019,75,87901293,87261200,640093,117.17047366554549
1747352710470135,94464044,1,1020,75,87995570,87354800,640770,117.04667821527228
1747352710564349,94557644,1,1021,75,88089784,87448400,641384,116.93462886507928
1747352710658279,94651244,1,1022,75,88183714,87542000,641714,116.87449549176112
1747352710753128,94744844,1,1023,75,88278563,87635600,642963,116.64745871846436
1747352710847416,94838444,1,1024,75,88372851,87729200,643651,116.52277398776668
1747352710941057,94932044,1,1025,75,88466492,87822800,643692,116.51535206278778
1747352711035553,95025644,1,1026,75,88560988,87916400,644588,116.3533916237969
1747352711133618,95119244,1,1027,75,88659053,88010000,649053,115.55296716909098
1747352711227524,95212844,1,1028,75,88752959,88103600,649359,115.4985146891011
1747352711322573,95306444,1,1029,75,88848008,88197200,650808,115.24136150754138
1747352711416124,95400044,1,1030,75,88941559,88290800,650759,115.2500388008464
1747352711510961,95493644,1,1031,75,89036396,88384400,651996,115.03138056061694
1747352711604951,95587244,1,1032,75,89130386,88478000,652386,114.96261415787586
1747352711698682,95680844,1,1033,75,89224117,88571600,652517,114.93953414240548
1747352711793244,95774444,1,1034,75,89318679,88665200,653479,114.77032926842332
1747352711887626,95868044,1,1035,75,89413061,88758800,654261,114.63315099020116
1747352711981751,95961644,1,1036,75,89507186,88852400,654786,114.5412394278436
1747352712075829,96055244,1,1037,75,89601264,88946000,655264,114.45768423108856
1747352712170348,96148844,1,1038,75,89695783,89039600,656183,114.29738350429685
1747352712264190,96242444,1,1039,75,89789625,89133200,656425,114.2552462200556
1747352712358324,96336044,1,1040,75,89883759,89226800,656959,114.16237542982137
1747352712452846,96429644,1,1041,75,89978281,89320400,657881,114.00238036970212
1747352712547157,96523244,1,1042,75,90072592,89414000,658592,113.87930615616348
1747352712640976,96616844,1,1043,75,90166411,89507600,658811,113.84145073473272
1747352712735440,96710444,1,1044,75,90260875,89601200,659675,113.6923485049456
1747352712829702,96804044,1,1045,75,90355137,89694800,660337,113.57836983237348
1747352712923811,96897644,1,1046,75,90449246,89788400,660846,113.49088895143495
1747352713017792,96991252,1,1047,75,90543227,89882008,661219,113.42686764899376
1747352713112034,97084844,1,1048,75,90637469,89975600,661869,113.31547481450256
1747352713205864,97178444,1,1049,75,90731299,90069200,662099,113.27611127641032
1747352713300501,97272044,1,1050,75,90825936,90162800,663136,113.09897215654104
1747352713394481,97365644,1,1051,75,90919916,90256400,663516,113.03419962743928
1747352713489028,97459244,1,1052,75,91014463,90350000,664463,112.8731020387892
1747352713583501,97552844,1,1053,75,91108936,90443600,665336,112.7249990982
1747352713676950,97646444,1,1054,75,91202385,90537200,665185,112.750588182235
1747352713771188,97740044,1,1055,75,91296623,90630800,665823,112.6425491459442
1747352713865589,97833644,1,1056,75,91391024,90724400,666624,112.5072004608295
1747352713960130,97927244,1,1057,75,91485565,90818000,667565,112.34861024769124
1747352714054542,98020844,1,1058,75,91579977,90911600,668377,112.21211980663608
1747352714147890,98114444,1,1059,75,91673325,91005200,668125,112.25444340505146
1747352714242230,98208044,1,1060,75,91767665,91098800,668865,112.1302504989796
1747352714336369,98301644,1,1061,75,91861804,91192400,669404,112.03996390819296
1747352714430970,98395244,1,1062,75,91956405,91286000,670405,111.87267398065347
1747352714524804,98488844,1,1063,75,92050239,91379600,670639,111.83363926046653
1747352714619370,98582444,1,1064,75,92144805,91473200,671605,111.67278385360444
1747352714713748,98676044,1,1065,75,92239183,91566800,672383,111.54356966193376
1747352714807877,98769644,1,1066,75,92333312,91660400,672912,111.45588130394464
1747352714902163,98863244,1,1067,75,92427598,91754000,673598,111.34237334433892
1747352714996443,98956844,1,1068,75,92521878,91847600,674278,111.23008610691733
1747352715090826,99050444,1,1069,75,92616261,91941200,675061,111.10107086618838
1747352715184562,99144044,1,1070,75,92709997,92034800,675197,111.07869258897772
1747352715278752,99237644,1,1071,75,92804187,92128400,675787,110.98171465269382
1747352715372734,99331244,1,1072,75,92898169,92222000,676169,110.91901580817812
1747352715467097,99424844,1,1073,75,92992532,92315600,676932,110.79399407916895
1747352715565228,99518444,1,1074,75,93090663,92409200,681463,110.05733253309424
1747352715659474,99612044,1,1075,75,93184909,92502800,682109,109.95310133717632
1747352715754173,99705644,1,1076,75,93279608,92596400,683208,109.7762321284294
1747352715847604,99799244,1,1077,75,93373039,92690000,683039,109.80339336406853
1747352715942016,99892844,1,1078,75,93467451,92783600,683851,109.67301356582064
1747352716036120,99986452,1,1079,75,93561555,92877208,684347,109.5935249222982
1747352716130790,100080044,1,1080,75,93656225,92970800,685425,109.421162052741
1747352716225364,100174684,1,1081,75,93750799,93065440,685359,109.4316992991994
1747352716319044,100269324,1,1082,75,93844479,93160080,684399,109.58519810812116
1747352716417294,100363964,1,1083,75,93942729,93254720,688009,109.01020190142862
1747352716511266,100458604,1,1084,75,94036701,93349360,687341,109.11614467927856
1747352716605467,100553244,1,1085,75,94130902,93444000,686902,109.1858809553619
1747352716703774,100647884,1,1086,75,94229209,93538640,690569,108.60609149845996
1747352716797897,100742524,1,1087,75,94323332,93633280,690052,108.6874612348055
1747352716892406,100837164,1,1088,75,94417841,93727920,689921,108.70809846344726
1747352716986439,100931804,1,1089,75,94511874,93822560,689314,108.80382525235234
1747352717085335,101026444,1,1090,75,94610770,93917200,693570,108.13616505904234
1747352717178741,101121084,1,1091,75,94704176,94011840,692336,108.32890388481894
1747352717273662,101215724,1,1092,75,94799097,94106480,692617,108.28495402220852
1747352717367737,101310364,1,1093,75,94893172,94201120,692052,108.3733592273413
1747352717465600,101405004,1,1094,75,94991035,94295760,695275,107.87098630038474
1747352717559847,101499644,1,1095,75,95085282,94390400,694882,107.93199420908874
1747352717654023,101594284,1,1096,75,95179458,94485040,694418,108.0041127966153
1747352717752133,101688924,1,1097,75,95277568,94579680,697888,107.46710073822734
1747352717846485,101783572,1,1098,75,95371920,94674328,697592,107.51270083372516
1747352717940640,101878204,1,1099,75,95466075,94768960,697115,107.58626625449172
1747352718035128,101972844,1,1100,75,95560563,94863600,696963,107.60972964131524
1747352718133023,102067484,1,1101,75,95658458,94958240,700218,107.10950018422834
1747352718228001,102162124,1,1102,75,95753436,95052880,700556,107.0578226437287
1747352718321707,102256764,1,1103,75,95847142,95147520,699622,107.2007455454517
1747352718420208,102351404,1,1104,75,95945643,95242160,703483,106.61238437886917
1747352718514434,102446044,1,1105,75,96039869,95336800,703069,106.67516275073996
1747352718608321,102540684,1,1106,75,96133756,95431440,702316,106.78953633407184
1747352718702625,102635324,1,1107,75,96228060,95526080,701980,106.84065073079005
1747352718800614,102729964,1,1108,75,96326049,95620720,705329,106.33335649037542
1747352718895296,102824604,1,1109,75,96420731,95715360,705371,106.32702506907712
1747352718989400,102919244,1,1110,75,96514835,95810000,704835,106.40788269595012
1747352719083941,103013884,1,1111,75,96609376,95904640,704736,106.42283067701948
1747352719181544,103108524,1,1112,75,96706979,95999280,707699,105.97725869331454
1747352719276430,103203164,1,1113,75,96801865,96093920,707945,105.94043322574493
1747352719370906,103297804,1,1114,75,96896341,96188560,707781,105.96498069318052
1747352719468289,103392444,1,1115,75,96993724,96283200,710524,105.55589958959864
1747352719562763,103487084,1,1116,75,97088198,96377840,710358,105.58056641862272
1747352719657407,103581732,1,1117,75,97182842,96472488,710354,105.58116094229074
1747352719751623,103676364,1,1118,75,97277058,96567120,709938,105.64302798272526
1747352719849472,103771004,1,1119,75,97374907,96661760,713147,105.1676582808313
1747352719943529,103865644,1,1120,75,97468964,96756400,712564,105.25370352698144
1747352720038206,103960284,1,1121,75,97563641,96851040,712601,105.24823849531504
1747352720136708,104054924,1,1122,75,97662143,96945680,716463,104.68091164512336
1747352720229943,104149564,1,1123,75,97755378,97040320,715058,104.8865966117434
1747352720324461,104244204,1,1124,75,97849896,97134960,714936,104.90449494779952
1747352720419193,104338844,1,1125,75,97944628,97229600,715028,104.89099727563116
1747352720516830,104433484,1,1126,75,98042265,97324240,718025,104.45318756310714
1747352720611031,104528124,1,1127,75,98136466,97418880,717586,104.51708924087148
1747352720705777,104622764,1,1128,75,98231212,97513520,717692,104.50165251946518
1747352720800161,104717404,1,1129,75,98325596,97608160,717436,104.53894145261738
1747352720897857,104812044,1,1130,75,98423292,97702800,720492,104.09553471794274
1747352720991810,104906684,1,1131,75,98517245,97797440,719805,104.19488611498949
1747352721086904,105001324,1,1132,75,98612339,97892080,720259,104.12920907617956
1747352721184857,105095964,1,1133,75,98710292,97986720,723572,103.65243541762256
1747352721278463,105190604,1,1134,75,98803898,98081360,722538,103.80076895609642
1747352721373048,105285244,1,1135,75,98898483,98176000,722483,103.8086709306655
1747352721467198,105379884,1,1136,75,98992633,98270640,721993,103.87912348180662
1747352721566031,105474524,1,1137,75,99091466,98365280,726186,103.27932513157786
1747352721659496,105569164,1,1138,75,99184931,98459920,725011,103.44670632583508
1747352721753505,105663804,1,1139,75,99278940,98554560,724380,103.5368176923714
1747352721848150,105758444,1,1140,75,99373585,98649200,724385,103.53610303912976
1747352721946196,105853084,1,1141,75,99471631,98743840,727791,103.05156288000263
1747352722040491,105947724,1,1142,75,99565926,98838480,727446,103.1004363210465
1747352722134865,106042364,1,1143,75,99660300,98933120,727180,103.13815011413956
1747352722233047,106137004,1,1144,75,99758482,99027760,730722,102.6382126171102
1747352722327816,106231644,1,1145,75,99853251,99122400,730851,102.62009629869836
1747352722421809,106326284,1,1146,75,99947244,99217040,730204,102.71102322090812
1747352722515244,106420924,1,1147,75,100040679,99311680,728999,102.88079956213932
1747352722613633,106515564,1,1148,75,100139068,99406320,732748,102.35442471354408
1747352722708629,106610204,1,1149,75,100234064,99500960,733104,102.30472074903425
1747352722802092,106704844,1,1150,75,100327527,99595600,731927,102.46923531991578
1747352722900877,106799484,1,1151,75,100426312,99690240,736072,101.89220619721983
1747352722995094,106894124,1,1152,75,100520529,99784880,735649,101.95079446855767
1747352723088938,106988764,1,1153,75,100614373,99879520,734853,102.06122857224508
1747352723183378,107083404,1,1154,75,100708813,99974160,734653,102.0890134526096
1747352723281856,107178044,1,1155,75,100807291,100068800,738491,101.55844824107538
1747352723376159,107272684,1,1156,75,100901594,100163440,738154,101.60481417156852
1747352723470258,107367324,1,1157,75,100995693,100258080,737613,101.6793359119213
1747352723564276,107461964,1,1158,75,101089711,100352720,736991,101.76515045638278
1747352723662586,107556604,1,1159,75,101188021,100447360,740661,101.26090073596424
1747352723756824,107651244,1,1160,75,101282259,100542000,740259,101.315890789575
1747352723850977,107745884,1,1161,75,101376412,100636640,739772,101.38258814878098
1747352723949422,107840532,1,1162,75,101474857,100731288,743569,100.86488274793597
1747352724043499,107935164,1,1163,75,101568934,100825920,743014,100.94022454489418
1747352724138310,108029804,1,1164,75,101663745,100920560,743185,100.91699913211382
1747352724231848,108124444,1,1165,75,101757283,101015200,742083,101.06686179308782
1747352724329906,108219084,1,1166,75,101855341,101109840,745501,100.60348678271392
1747352724423988,108313724,1,1167,75,101949423,101204480,744943,100.6788438846999
1747352724518625,108408364,1,1168,75,102044060,101299120,744940,100.67924933551694
1747352724616629,108503004,1,1169,75,102142064,101393760,748304,100.22664585516048
1747352724711267,108597644,1,1170,75,102236702,101488400,748302,100.2269137326908
1747352724805006,108692284,1,1171,75,102330441,101583040,747401,100.3477383626728
1747352724899602,108786924,1,1172,75,102425037,101677680,747357,100.35364624938282
1747352724997695,108881564,1,1173,75,102523130,101772320,750810,99.8921165141647
1747352725091843,108976204,1,1174,75,102617278,101866960,750318,99.95761796998072
1747352725186458,109070844,1,1175,75,102711893,101961600,750293,99.96094858941774
1747352725280830,109165484,1,1176,75,102806265,102056240,750025,99.99666677777408
1747352725378579,109260124,1,1177,75,102904014,102150880,753134,99.58387219273064
1747352725472833,109354764,1,1178,75,102998268,102245520,752748,99.6349375886751
1747352725567421,109449404,1,1179,75,103092856,102340160,752696,99.64182086792012
1747352725665742,109544044,1,1180,75,103191177,102434800,756377,99.15690191531472
1747352725759572,109638692,1,1181,75,103285007,102529448,755559,99.26425335413911
1747352725853903,109733324,1,1182,75,103379338,102624080,755258,99.30381406089045
1747352725948354,109827964,1,1183,75,103473789,102718720,755069,99.32867062480383
1747352726046033,109922604,1,1184,75,103571468,102813360,758108,98.930495391158
1747352726140867,110017244,1,1185,75,103666302,102908000,758302,98.90518553294068
1747352726234408,110111884,1,1186,75,103759843,103002640,757203,99.04873594003192
1747352726333325,110206524,1,1187,75,103858760,103097280,761480,98.49240951830645
1747352726427136,110301164,1,1188,75,103952571,103191920,760651,98.59975205449015
1747352726521857,110395804,1,1189,75,104047292,103286560,760732,98.5892535084629
1747352726615482,110490444,1,1190,75,104140917,103381200,759717,98.7209710984485
1747352726714130,110585084,1,1191,75,104239565,103475840,763725,98.20288716488264
1747352726808093,110679724,1,1192,75,104333528,103570480,763048,98.29001583124524
1747352726902678,110774364,1,1193,75,104428113,103665120,762993,98.29710102189664
1747352726996986,110869004,1,1194,75,104522421,103759760,762661,98.33989151143167
1747352727094649,110963644,1,1195,75,104620084,103854400,765684,97.95163540050464
1747352727188960,111058284,1,1196,75,104714395,103949040,765355,97.99374146637837
1747352727283185,111152924,1,1197,75,104808620,104043680,764940,98.04690563965802
1747352727381542,111247564,1,1198,75,104906977,104138320,768657,97.57277953625608
1747352727476161,111342204,1,1199,75,105001596,104232960,768636,97.57544533433251
1747352727570340,111436844,1,1200,75,105095775,104327600,768175,97.63400266866272
1747352727663422,111531484,1,1201,75,105188857,104422240,766617,97.83242479621508
1747352727762827,111626124,1,1202,75,105288262,104516880,771382,97.22809191814171
1747352727856855,111720764,1,1203,75,105382290,104611520,770770,97.30529211048692
1747352727950849,111815404,1,1204,75,105476284,104706160,770124,97.3869143150973
1747352728045313,111910044,1,1205,75,105570748,104800800,769948,97.40917568459167
1747352728143650,112004684,1,1206,75,105669085,104895440,773645,96.94368864272371
1747352728237651,112099324,1,1207,75,105763086,104990080,773006,97.02382646447764
1747352728331798,112193964,1,1208,75,105857233,105084720,772513,97.085744835362
1747352728430083,112288604,1,1209,75,105955518,105179360,776158,96.62980990983796
1747352728523925,112383244,1,1210,75,106049360,105274000,775360,96.72926124638876
1747352728618445,112477884,1,1211,75,106143880,105368640,775240,96.744234043651
1747352728712135,112572524,1,1212,75,106237570,105463280,774290,96.86293249299358
1747352728810294,112667164,1,1213,75,106335729,105557920,777809,96.42470066558757
1747352728904909,112761804,1,1214,75,106430344,105652560,777784,96.42780000617138
1747352728999069,112856444,1,1215,75,106524504,105747200,777304,96.48734600619578
1747352729097336,112951084,1,1216,75,106622771,105841840,780931,96.03921473215944
1747352729191367,113045724,1,1217,75,106716802,105936480,780322,96.1141682536184
1747352729285869,113140364,1,1218,75,106811304,106031120,780184,96.13116905755564
1747352729380095,113235004,1,1219,75,106905530,106125760,779770,96.18220757402824
1747352729478186,113329644,1,1220,75,107003621,106220400,783221,95.7584130149728
1747352729572650,113424284,1,1221,75,107098085,106315040,783045,95.77993601900276
1747352729666911,113518924,1,1222,75,107192346,106409680,782666,95.82631671747592
1747352729760818,113613564,1,1223,75,107286253,106504320,781933,95.9161462682864
1747352729859255,113708204,1,1224,75,107384690,106598960,785730,95.4526364018174
1747352729953341,113802844,1,1225,75,107478776,106693600,785176,95.51998532813026
1747352730048059,113897492,1,1226,75,107573494,106788248,785246,95.5114702908388
1747352730146094,113992124,1,1227,75,107671529,106882880,788649,95.09934077136975
1747352730240466,114086764,1,1228,75,107765901,106977520,788381,95.13166857141408
1747352730334334,114181404,1,1229,75,107859769,107072160,787609,95.22491490066771
1747352730428556,114276044,1,1230,75,107953991,107166800,787191,95.27547952148844
1747352730526466,114370684,1,1231,75,108051901,107261440,790461,94.88134139445212
1747352730621665,114465324,1,1232,75,108147100,107356080,791020,94.8142904098506
1747352730715979,114559964,1,1233,75,108241414,107450720,790694,94.8533819657162
1747352730814187,114654604,1,1234,75,108339622,107545360,794262,94.42727966338563
1747352730907222,114749244,1,1235,75,108432657,107640000,792657,94.6184793674944
1747352731001963,114843884,1,1236,75,108527398,107734640,792758,94.60642465922766
1747352731096282,114938524,1,1237,75,108621717,107829280,792437,94.64474778436646
1747352731194880,115033164,1,1238,75,108720315,107923920,796395,94.1743732695459
1747352731288463,115127804,1,1239,75,108813898,108018560,795338,94.29953051407075
1747352731382806,115222444,1,1240,75,108908241,108113200,795041,94.33475757853998
1747352731476812,115317084,1,1241,75,109002247,108207840,794407,94.41004422166472
1747352731575202,115411724,1,1242,75,109100637,108302480,798157,93.96647526739729
1747352731669991,115506364,1,1243,75,109195426,108397120,798306,93.94893687383032
1747352731763817,115601004,1,1244,75,109289252,108491760,797492,94.04483054375468
1747352731862511,115695652,1,1245,75,109387946,108586408,801538,93.57011146071676
1747352731956170,115790284,1,1246,75,109481605,108681040,800565,93.68383579097262
1747352732050441,115884924,1,1247,75,109575876,108775680,800196,93.72703687596538
1747352732144931,115979564,1,1248,75,109670366,108870320,800046,93.74460968494311
1747352732243203,116074204,1,1249,75,109768638,108964960,803678,93.32095690064926
1747352732337291,116168844,1,1250,75,109862726,109059600,803126,93.38509773061762
1747352732431845,116263484,1,1251,75,109957280,109154240,803040,93.39509862522416
1747352732526105,116358124,1,1252,75,110051540,109248880,802660,93.43931428001892
1747352732624179,116452764,1,1253,75,110149614,109343520,806094,93.04125821554312
1747352732718225,116547404,1,1254,75,110243660,109438160,805500,93.1098696461825
1747352732813015,116642044,1,1255,75,110338450,109532800,805650,93.09253397877492
1747352732911155,116736684,1,1256,75,110436590,109627440,809150,92.6898597293456
1747352733005125,116831324,1,1257,75,110530560,109722080,808480,92.76667326340788
1747352733099047,116925964,1,1258,75,110624482,109816720,807762,92.84913130352751
1747352733193379,117020604,1,1259,75,110718814,109911360,807454,92.88454822194204
1747352733291967,117115244,1,1260,75,110817402,110006000,811402,92.43260430711288
1747352733385949,117209884,1,1261,75,110911384,110100640,810744,92.50762262810456
1747352733480253,117304524,1,1262,75,111005688,110195280,810408,92.54597684129476
1747352733578728,117399164,1,1263,75,111104163,110289920,814243,92.11009489796044
1747352733672613,117493804,1,1264,75,111198048,110384560,813488,92.19558247939736
1747352733766977,117588444,1,1265,75,111292412,110479200,813212,92.22687318927905
1747352733861755,117683084,1,1266,75,111387190,110573840,813350,92.21122517981188
1747352733959626,117777724,1,1267,75,111485061,110668480,816581,91.84636919056408
1747352734053551,117872364,1,1268,75,111578986,110763120,815866,91.92686053837272
1747352734147328,117967004,1,1269,75,111672763,110857760,815003,92.02420113790993
1747352734241628,118061644,1,1270,75,111767063,110952400,814663,92.06260748309424
1747352734342625,118156284,1,1271,75,111868060,111047040,821020,91.3497844145088
1747352734434640,118250924,1,1272,75,111960075,111141680,818395,91.6427886289628
1747352734528051,118345564,1,1273,75,112053486,111236320,817166,91.78061740209456
1747352734627243,118440204,1,1274,75,112152678,111330960,821718,91.2721882689682
1747352734720673,118534844,1,1275,75,112246108,111425600,820508,91.40678701487371
1747352734814926,118629484,1,1276,75,112340361,111520240,820121,91.44992019470298
1747352734909016,118724124,1,1277,75,112434451,111614880,819571,91.511290663042
1747352735007790,118818764,1,1278,75,112533225,111709520,823705,91.05201498109152
1747352735101852,118913404,1,1279,75,112627287,111804160,823127,91.1159517304134
1747352735196236,119008044,1,1280,75,112721671,111898800,822871,91.14429843802978
1747352735294656,119102684,1,1281,75,112820091,111993440,826651,90.72752588456314
1747352735388736,119197324,1,1282,75,112914171,112088080,826091,90.78902929580396
1747352735482398,119291964,1,1283,75,113007833,112182720,825113,90.89664082374172
1747352735576688,119386604,1,1284,75,113102123,112277360,824763,90.93521411605516
1747352735675533,119481244,1,1285,75,113200968,112372000,828968,90.47393868038333
1747352735769820,119575884,1,1286,75,113295255,112466640,828615,90.51248167122246
1747352735864018,119670524,1,1287,75,113389453,112561280,828173,90.5607886274969
1747352735957413,119765164,1,1288,75,113482848,112655920,826928,90.69713445426927
1747352736055986,119859804,1,1289,75,113581421,112750560,830861,90.26780652840849
1747352736150390,119954452,1,1290,75,113675825,112845208,830617,90.29432337647796
1747352736244706,120049084,1,1291,75,113770141,112939840,830301,90.32868803000358
1747352736342657,120143724,1,1292,75,113868092,113034480,833612,89.96991406073809
1747352736437132,120238364,1,1293,75,113962567,113129120,833447,89.98772567421803
1747352736530973,120333004,1,1294,75,114056408,113223760,832648,90.07407692085972
1747352736625466,120427644,1,1295,75,114150901,113318400,832501,90.08998187389564
1747352736723986,120522284,1,1296,75,114249421,113413040,836381,89.67205137371604
1747352736818096,120616924,1,1297,75,114343531,113507680,835851,89.72891101404437
1747352736912217,120711564,1,1298,75,114437652,113602320,835332,89.78466047032796
1747352737010584,120806204,1,1299,75,114536019,113696960,839059,89.38584771750259
1747352737104495,120900844,1,1300,75,114629930,113791600,838330,89.46357639593
1747352737198560,120995484,1,1301,75,114723995,113886240,837755,89.5249804537126
1747352737293140,121090124,1,1302,75,114818575,113980880,837695,89.5313926906571
1747352737390997,121184764,1,1303,75,114916432,114075520,840912,89.18888064387237
1747352737485847,121279404,1,1304,75,115011282,114170160,841122,89.16661316669877
1747352737579874,121374044,1,1305,75,115105309,114264800,840509,89.23164415848017
1747352737674385,121468684,1,1306,75,115199820,114359440,840380,89.24534139317927
1747352737772570,121563324,1,1307,75,115298005,114454080,843925,88.87045649791155
1747352737866569,121657964,1,1308,75,115392004,114548720,843284,88.93800902187164
1747352737960673,121752612,1,1309,75,115486108,114643368,842740,88.99541970239932
1747352738059454,121847244,1,1310,75,115584889,114738000,846889,88.55942160070565
1747352738152732,121941884,1,1311,75,115678167,114832640,845527,88.70207574684191
1747352738247455,122036524,1,1312,75,115772890,114927280,845610,88.69336928371236
1747352738341250,122131164,1,1313,75,115866685,115021920,844765,88.78208732606109
1747352738440125,122225804,1,1314,75,115965560,115116560,849000,88.33922261484099
1747352738534348,122320444,1,1315,75,116059783,115211200,848583,88.3826331661134
1747352738627988,122415084,1,1316,75,116153423,115305840,847583,88.48690924664605
1747352738722190,122509724,1,1317,75,116247625,115400480,847145,88.53265969816265
1747352738820624,122604364,1,1318,75,116346059,115495120,850939,88.1379276305352
1747352738915502,122699004,1,1319,75,116440937,115589760,851177,88.11328313617497
1747352739009470,122793644,1,1320,75,116534905,115684400,850505,88.18290309874722
1747352739107761,122888284,1,1321,75,116633196,115779040,854156,87.80597455265783
1747352739202125,122982924,1,1322,75,116727560,115873680,853880,87.83435611561343
1747352739296328,123077564,1,1323,75,116821763,115968320,853443,87.87933113283489
1747352739390191,123172204,1,1324,75,116915626,116062960,852666,87.9594120089226
1747352739488728,123266844,1,1325,75,117014163,116157600,856563,87.55923382168037
1747352739582250,123361484,1,1326,75,117107685,116252240,855445,87.67366692189445
1747352739677216,123456124,1,1327,75,117202651,116346880,855771,87.64026824933306
1747352739775526,123550764,1,1328,75,117300961,116441520,859441,87.26602524198869
1747352739868898,123645404,1,1329,75,117394333,116536160,858173,87.3949658169157
1747352739963619,123740044,1,1330,75,117489054,116630800,858254,87.38671768497439
1747352740057308,123834684,1,1331,75,117582743,116725440,857303,87.48365513709855
1747352740156423,123929324,1,1332,75,117681858,116820080,861778,87.02937415436458
1747352740250340,124023964,1,1333,75,117775775,116914720,861055,87.10244990157423
1747352740344866,124118604,1,1334,75,117870301,117009360,860941,87.11398342046668
1747352740438647,124213244,1,1335,75,117964082,117104000,860082,87.20098781278995
1747352740536747,124307884,1,1336,75,118062182,117198640,863542,86.85159494268953
1747352740631035,124402524,1,1337,75,118156470,117293280,863190,86.88701212942689
1747352740725062,124497164,1,1338,75,118250497,117387920,862577,86.94875935713564
1747352740824064,124591804,1,1339,75,118349499,117482560,866939,86.51127703333222
1747352740917500,124686444,1,1340,75,118442935,117577200,865735,86.63159049824715
1747352741012429,124781084,1,1341,75,118537864,117671840,866024,86.60268075711528
1747352741105797,124875724,1,1342,75,118631232,117766480,864752,86.73006827390975
1747352741204884,124970364,1,1343,75,118730319,117861120,869199,86.286339491877
1747352741299150,125065004,1,1344,75,118824585,117955760,868825,86.32348286478866
1747352741393147,125159644,1,1345,75,118918582,118050400,868182,86.38741646336828
1747352741490522,125254284,1,1346,75,119015957,118145040,870917,86.11612817294873
1747352741585202,125348924,1,1347,75,119110637,118239680,870957,86.11217316124677
1747352741679459,125443564,1,1348,75,119204894,118334320,870574,86.1500573185048
1747352741773477,125538204,1,1349,75,119298912,118428960,869952,86.21165305672038
1747352741871973,125632844,1,1350,75,119397408,118523600,873808,85.83121234870818
1747352741966488,125727484,1,1351,75,119491923,118618240,873683,85.84349243375458
1747352742060190,125822124,1,1352,75,119585625,118712880,872745,85.93575442998814
1747352742157259,125916764,1,1353,75,119682694,118807520,875174,85.69724420515234
1747352742252611,126011412,1,1354,75,119778046,118902168,875878,85.62836376755666
1747352742346892,126106044,1,1355,75,119872327,118996800,875527,85.66269229846709
1747352742441429,126200684,1,1356,75,119966864,119091440,875424,85.6727711371861
1747352742539882,126295324,1,1357,75,120065317,119186080,879237,85.30123277341603
1747352742633890,126389964,1,1358,75,120159325,119280720,878605,85.36259183592172
1747352742728407,126484604,1,1359,75,120253842,119375360,878482,85.37454381535422
1747352742821901,126579244,1,1360,75,120347336,119470000,877336,85.48606235239407
1747352742920314,126673884,1,1361,75,120445749,119564640,881109,85.12000217907206
1747352743014558,126768524,1,1362,75,120539993,119659280,880713,85.15827517023139
1747352743109270,126863164,1,1363,75,120634705,119753920,880785,85.15131388477324
1747352743207691,126957804,1,1364,75,120733126,119848560,884566,84.78734204118179
1747352743301512,127052444,1,1365,75,120826947,119943200,883747,84.8659175080651
1747352743395724,127147084,1,1366,75,120921159,120037840,883319,84.90703811420336
1747352743489561,127241724,1,1367,75,121014996,120132480,882516,84.98429490230205
1747352743588077,127336364,1,1368,75,121113512,120227120,886392,84.61267700972031
1747352743682226,127431004,1,1369,75,121207661,120321760,885901,84.65957257075
1747352743776223,127525644,1,1370,75,121301658,120416400,885258,84.72106436767587
1747352743871030,127620284,1,1371,75,121396465,120511040,885425,84.70508512861055
1747352743968867,127714924,1,1372,75,121494302,120605680,888622,84.40034120244603
1747352744062976,127809572,1,1373,75,121588411,120700328,888083,84.45156590093494
1747352744157970,127904204,1,1374,75,121683405,120794960,888445,84.4171558171862
1747352744255934,127998844,1,1375,75,121781369,120889600,891769,84.10249739562599
1747352744349949,128093484,1,1376,75,121875384,120984240,891144,84.16148231935578
1747352744443874,128188124,1,1377,75,121969309,121078880,890429,84.22906262037736
1747352744538329,128282764,1,1378,75,122063764,121173520,890244,84.24656610996536
1747352744636369,128377404,1,1379,75,122161804,121268160,893644,83.92603766152965
1747352744730654,128472044,1,1380,75,122256089,121362800,893289,83.95939052199232
1747352744824633,128566684,1,1381,75,122350068,121457440,892628,84.02156329400377
1747352744919129,128661324,1,1382,75,122444564,121552080,892484,84.03511995733257
1747352745017655,128755964,1,1383,75,122543090,121646720,896370,83.67080558251615
1747352745111544,128850604,1,1384,75,122636979,121741360,895619,83.74096574547882
1747352745205894,128945244,1,1385,75,122731329,121836000,895329,83.7680897189748
1747352745304416,129039884,1,1386,75,122829851,121930640,899211,83.40645299045497
1747352745398357,129134524,1,1387,75,122923792,122025280,898512,83.47133928094449
1747352745493026,129229164,1,1388,75,123018461,122119920,898541,83.46864528162877
1747352745587139,129323804,1,1389,75,123112574,122214560,898014,83.51762890110845
1747352745685323,129418444,1,1390,75,123210758,122309200,901558,83.18932337131943
1747352745778963,129513084,1,1391,75,123304398,122403840,900558,83.28169868015165
1747352745873634,129607724,1,1392,75,123399069,122498480,900589,83.27883196441441
1747352745972348,129702364,1,1393,75,123497783,122593120,904663,82.90379953640195
1747352746065670,129797004,1,1394,75,123591105,122687760,903345,83.02475798283048
1747352746160012,129891644,1,1395,75,123685447,122782400,903047,83.05215564638385
1747352746254534,129986284,1,1396,75,123779969,122877040,902929,83.06300938390505
1747352746353086,130080924,1,1397,75,123878521,122971680,906841,82.70468582695312
1747352746446846,130175564,1,1398,75,123972281,123066320,905961,82.7850205472421
1747352746541025,130270204,1,1399,75,124066460,123160960,905500,82.82716731087797
1747352746634959,130364844,1,1400,75,124160394,123255600,904794,82.89179636469738
1747352746733491,130459484,1,1401,75,124258926,123350240,908686,82.53676187373857
1747352746827837,130554124,1,1402,75,124353272,123444880,908392,82.5634747994258
1747352746921918,130648764,1,1403,75,124447353,123539520,907833,82.61431342548684
1747352747019940,130743404,1,1404,75,124545375,123634160,911215,82.30768808678522
1747352747114476,130838044,1,1405,75,124639911,123728800,911111,82.3170832094004
1747352747208714,130932684,1,1406,75,124734149,123823440,910709,82.35341914925624
1747352747302946,131027324,1,1407,75,124828381,123918080,910301,82.39033023142895
1747352747401201,131121964,1,1408,75,124926636,124012720,913916,82.0644348058246
1747352747495364,131216604,1,1409,75,125020799,124107360,913439,82.10728904721607
1747352747589539,131311244,1,1410,75,125114974,124202000,912974,82.14910829881245
1747352747687651,131405884,1,1411,75,125213086,124296640,916446,81.83788242842459
1747352747781437,131500524,1,1412,75,125306872,124391280,915592,81.91421506522556
1747352747875866,131595164,1,1413,75,125401301,124485920,915381,81.93309671055003
1747352747970322,131689804,1,1414,75,125495757,124580560,915197,81.94956932769665
1747352748069223,131784444,1,1415,75,125594658,124675200,919458,81.56979437886233
1747352748163427,131879084,1,1416,75,125688862,124769840,919022,81.60849250616415
1747352748256980,131973724,1,1417,75,125782415,124864480,917935,81.70513162696706
1747352748351465,132068372,1,1418,75,125876900,124959128,917772,81.71964278709744
1747352748449277,132163004,1,1419,75,125974712,125053760,920952,81.43746905376176
1747352748544464,132257644,1,1420,75,126069899,125148400,921499,81.38912793177204
1747352748637966,132352284,1,1421,75,126163401,125243040,920361,81.48976325593979
1747352748736556,132446924,1,1422,75,126261991,125337680,924311,81.14152054881961
1747352748830822,132541564,1,1423,75,126356257,125432320,923937,81.17436578468012
1747352748924570,132636204,1,1424,75,126450005,125526960,923045,81.25280999301226
1747352749019482,132730844,1,1425,75,126544917,125621600,923317,81.22887372375901
1747352749117265,132825484,1,1426,75,126642700,125716240,926460,80.95330613302248
1747352749211828,132920124,1,1427,75,126737263,125810880,926383,80.9600348883777
1747352749306241,133014764,1,1428,75,126831676,125905520,926156,80.97987811988477
1747352749404318,133109404,1,1429,75,126929753,126000160,929593,80.68046984002676
1747352749498252,133204044,1,1430,75,127023687,126094800,928887,80.74179098211084
1747352749592788,133298684,1,1431,75,127118223,126189440,928783,80.75083200273906
1747352749687131,133393324,1,1432,75,127212566,126284080,928486,80.77666222215521
1747352749785001,133487964,1,1433,75,127310436,126378720,931716,80.49663202091625
1747352749878885,133582604,1,1434,75,127404320,126473360,930960,80.56200051559681
1747352749973397,133677244,1,1435,75,127498832,126568000,930832,80.57307870808052
1747352750067230,133771884,1,1436,75,127592665,126662640,930025,80.64299346791753
1747352750166033,133866532,1,1437,75,127691468,126757288,934180,80.28431351559657
1747352750260035,133961164,1,1438,75,127785470,126851920,933550,80.33849284987414
1747352750354041,134055804,1,1439,75,127879476,126946560,932916,80.39309005312376
1747352750452598,134150444,1,1440,75,127978033,127041200,936833,80.05695785694995
1747352750546835,134245084,1,1441,75,128072270,127135840,936430,80.09141099708468
1747352750641104,134339724,1,1442,75,128166539,127230480,936059,80.12315463021028
1747352750735429,134434364,1,1443,75,128260864,127325120,935744,80.15012653033308
1747352750833207,134529004,1,1444,75,128358642,127419760,938882,79.88224292296583
1747352750927434,134623644,1,1445,75,128452869,127514400,938469,79.91739737807002
1747352751022233,134718284,1,1446,75,128547668,127609040,938628,79.90385967603778
1747352751115931,134812924,1,1447,75,128641366,127703680,937686,79.98413114838016
1747352751214815,134907564,1,1448,75,128740250,127798320,941930,79.62375123416814
1747352751308749,135002204,1,1449,75,128834184,127892960,941224,79.68347598446279
1747352751402682,135096844,1,1450,75,128928117,127987600,940517,79.74337518620078
1747352751500705,135191484,1,1451,75,129026140,128082240,943900,79.45756965780274
1747352751594833,135286124,1,1452,75,129120268,128176880,943388,79.5006932460451
1747352751689816,135380764,1,1453,75,129215251,128271520,943731,79.47179863753549
1747352751783577,135475404,1,1454,75,129309012,128366160,942852,79.54588843211872
1747352751881803,135570044,1,1455,75,129407238,128460800,946438,79.24449356429052
1747352751976550,135664684,1,1456,75,129501985,128555440,946545,79.2355355529848
1747352752070176,135759324,1,1457,75,129595611,128650080,945531,79.3205087934716
1747352752168610,135853964,1,1458,75,129694045,128744720,949325,79.00350248861034
1747352752263275,135948604,1,1459,75,129788710,128839360,949350,79.00142202559645
1747352752357532,136043244,1,1460,75,129882967,128934000,948967,79.03330674301635
1747352752451076,136137884,1,1461,75,129976511,129028640,947871,79.12469101808158
1747352752549328,136232524,1,1462,75,130074763,129123280,951483,78.82431950964967
1747352752643610,136327164,1,1463,75,130169045,129217920,951125,78.85398869759496
1747352752738494,136421804,1,1464,75,130263929,129312560,951369,78.8337648168061
1747352752831925,136516444,1,1465,75,130357360,129407200,950160,78.93407426117706
1747352752930179,136611084,1,1466,75,130455614,129501840,953774,78.63498061385611
1747352753025020,136705724,1,1467,75,130550455,129596480,953975,78.61841243219162
1747352753119248,136800364,1,1468,75,130644683,129691120,953563,78.65238059782101
1747352753216996,136895004,1,1469,75,130742431,129785760,956671,78.39685743583739
1747352753311801,136989644,1,1470,75,130837236,129880400,956836,78.38333841954108
1747352753405581,137084284,1,1471,75,130931016,129975040,955976,78.45385239796815
1747352753500046,137178924,1,1472,75,131025481,130069680,955801,78.46821671038218
1747352753598541,137273564,1,1473,75,131123976,130164320,959656,78.15300482672959
1747352753692081,137368204,1,1474,75,131217516,130258960,958556,78.24269004627794
1747352753786076,137462844,1,1475,75,131311511,130353600,957911,78.29537399612282
1747352753885011,137557484,1,1476,75,131410446,130448240,962206,77.94588684751498
1747352753979527,137652124,1,1477,75,131504962,130542880,962082,77.9559330701541
1747352754072985,137746764,1,1478,75,131598420,130637520,960900,78.05182641273807
1747352754167302,137841404,1,1479,75,131692737,130732160,960577,78.07807182557983
1747352754265817,137936044,1,1480,75,131791252,130826800,964452,77.76436774458449
1747352754360022,138030684,1,1481,75,131885457,130921440,964017,77.7994578933774
1747352754454407,138125332,1,1482,75,131979842,131016088,963754,77.82068868196656
1747352754548381,138219964,1,1483,75,132073816,131110720,963096,77.873856811782
1747352754646564,138314604,1,1484,75,132171999,131205360,966639,77.58842753085692
1747352754740798,138409244,1,1485,75,132266233,131300000,966233,77.62102929624635
1747352754834701,138503884,1,1486,75,132360136,131394640,965496,77.68028039474011
1747352754933750,138598524,1,1487,75,132459185,131489280,969905,77.32716090751155
1747352755027947,138693164,1,1488,75,132553382,131583920,969462,77.36249589978772
1747352755122048,138787804,1,1489,75,132647483,131678560,968923,77.40553170891805
1747352755216261,138882444,1,1490,75,132741696,131773200,968496,77.43965901769342
1747352755313956,138977084,1,1491,75,132839391,131867840,971551,77.19615336714182
1747352755408772,139071724,1,1492,75,132934207,131962480,971727,77.1821715358326
1747352755502295,139166364,1,1493,75,133027730,132057120,970610,77.2709945292136
1747352755597479,139261004,1,1494,75,133122914,132151760,971154,77.22771053818447
1747352755695537,139355644,1,1495,75,133220972,132246400,974572,76.95685901092993
1747352755788962,139450284,1,1496,75,133314397,132341040,973357,77.05292097349688
1747352755883186,139544924,1,1497,75,133408621,132435680,972941,77.08586646055619
1747352755981626,139639564,1,1498,75,133507061,132530320,976741,76.78596475421837
1747352756076206,139734204,1,1499,75,133601641,132624960,976681,76.79068191149413
1747352756169818,139828844,1,1500,75,133695253,132719600,975653,76.87159266665505
1747352847177226,841164,1,9,100,0,0,0,0.0
1747352847266470,929564,1,10,100,89244,88400,844,118483.41232227487
1747352847385795,1019004,1,11,100,208569,177840,30729,3254.254938331869
1747352847459806,1109484,1,12,100,282580,268320,14260,7012.622720897616
1747352847544904,1199964,1,13,100,367678,358800,8878,11263.798152737105
1747352847722017,1384044,1,15,100,544791,542880,1911,52328.62375719519
1747352848118960,1755324,1,19,100,941734,914160,27574,3626.60477261188
1747352848196218,1848924,1,20,100,1018992,1007760,11232,8903.133903133903
1747352848479339,2126604,1,23,100,1302113,1285440,16673,5997.720866070893
1747352848565450,2217084,1,24,100,1388224,1375920,12304,8127.43823146944
1747352848655430,2307564,1,25,100,1478204,1466400,11804,8471.704506946797
1747352849044662,2678844,1,29,100,1867436,1837680,29756,3360.666756284447
1747352849142032,2772444,1,30,100,1964806,1931280,33526,2982.759649227465
1747352849219909,2866044,1,31,100,2042683,2024880,17803,5617.030837499298
1747352849310689,2956524,1,32,100,2133463,2115360,18103,5523.946307241893
1747352849420646,3047004,1,33,100,2243420,2205840,37580,2660.989888238425
1747352850362874,3979884,1,43,100,3185648,3138720,46928,2130.923968632799
1747352850432925,4070364,1,44,100,3255699,3229200,26499,3773.7273104645456
1747352850522997,4160844,1,45,100,3345771,3319680,26091,3832.7392587482273
1747352853181386,6778524,1,73,100,6004160,5937360,66800,1497.005988023952
1747352853357002,6965724,1,75,100,6179776,6124560,55216,1811.0692552883224
1747352853443685,7059324,1,76,100,6266459,6218160,48299,2070.4362409159608
1747352853533775,7149804,1,77,100,6356549,6308640,47909,2087.290488217245
1747352853840824,7427484,1,80,100,6663598,6586320,77278,1294.029348585626
1747352854020551,7614684,1,82,100,6843325,6773520,69805,1432.562137382709
1747352854397629,7989084,1,86,100,7220403,7147920,72483,1379.6338451774898
1747352854573635,8173164,1,88,100,7396409,7332000,64409,1552.578055861759
1747352854654857,8263644,1,89,100,7477631,7422480,55151,1813.2037497053543
1747352854746037,8354124,1,90,100,7568811,7512960,55851,1790.4782367370326
1747352854835788,8444604,1,91,100,7658562,7603440,55122,1814.1576865861184
1747352854929717,8535084,1,92,100,7752491,7693920,58571,1707.3295658260915
1747352855020246,8625564,1,93,100,7843020,7784400,58620,1705.90242238144
1747352855114006,8716044,1,94,100,7936780,7874880,61900,1615.5088852988692
1747352855208181,8806524,1,95,100,8030955,7965360,65595,1524.5064410397133
1747352855294565,8897004,1,96,100,8117339,8055840,61499,1626.0426998812989
1747352855384052,8987484,1,97,100,8206826,8146320,60506,1652.728655009421
1747352855474259,9077964,1,98,100,8297033,8236800,60233,1660.21948101539
1747352855564490,9168444,1,99,100,8387264,8327280,59984,1667.111229661243
1747352855658723,9258924,1,100,100,8481497,8417760,63737,1568.9473931939062
1747352856044114,9634364,1,104,100,8866888,8793200,73688,1357.0730648138094
1747352856137856,9725884,1,105,100,8960630,8884720,75910,1317.3494928204452
1747352856609629,10201164,1,110,100,9432403,9360000,72403,1381.1582392994767
1747352856728268,10293724,1,111,100,9551042,9452560,98482,1015.4139842813915
1747352856814169,10389404,1,112,100,9636943,9548240,88703,1127.3575865528787
1747352856908224,10485084,1,113,100,9730998,9643920,87078,1148.3956912193664
1747352857002526,10580764,1,114,100,9825300,9739600,85700,1166.8611435239206
1747352857108578,10673324,1,115,100,9931352,9832160,99192,1008.145818211146
1747352858349662,11914044,1,128,100,11172436,11072880,99556,1004.4598015187432
1747352858456130,12009724,1,129,100,11278904,11168560,110344,906.2567969259768
1747352858746674,12296764,1,132,100,11569448,11455600,113848,878.3641346356545
1747352858816424,12392444,1,133,100,11639198,11551280,87918,1137.4235082690689
1747352858906341,12485004,1,134,100,11729115,11643840,85275,1172.6766344180592
1747352859000835,12577564,1,135,100,11823609,11736400,87209,1146.6706417915582
1747352859095435,12670124,1,136,100,11918209,11828960,89249,1120.4607334535965
1747352859189442,12762684,1,137,100,12012216,11921520,90696,1102.5844579694806
1747352859283602,12855244,1,138,100,12106376,12014080,92296,1083.470572939239
1747352859374088,12947804,1,139,100,12196862,12106640,90222,1108.3771142293454
1747352859475705,13040364,1,140,100,12298479,12199200,99279,1007.262361627333
1747352863428513,16963244,1,181,100,16251287,16122080,129207,773.9518756723708
1747352863518845,17058924,1,182,100,16341619,16217760,123859,807.3696703509636
1747352866229524,19734844,1,210,100,19052298,18893680,158618,630.4454727710599
1747352866315875,19830524,1,211,100,19138649,18989360,149289,669.8417164024141
1747352866402157,19923084,1,212,100,19224931,19081920,143011,699.2469110767703
1747352866492295,20015644,1,213,100,19315069,19174480,140589,711.293202170867
1747352866590464,20108204,1,214,100,19413238,19267040,146198,684.0038851420676
1747352866680082,20200764,1,215,100,19502856,19359600,143256,698.0510414921539
1747352866774547,20293324,1,216,100,19597321,19452160,145161,688.8902666694222
1747352866873456,20385884,1,217,100,19696230,19544720,151510,660.0224407629859
1747352866958593,20478444,1,218,100,19781367,19637280,144087,694.0251375904836
1747352867057127,20571004,1,219,100,19879901,19729840,150061,666.3956657625898
1747352867147131,20663564,1,220,100,19969905,19822400,147505,677.9431205721841
1747352867241536,20756124,1,221,100,20064310,19914960,149350,669.5681285570806
1747352867331322,20848684,1,222,100,20154096,20007520,146576,682.239930138631
1747352867426275,20941244,1,223,100,20249049,20100080,148969,671.280602004444
1747352867524087,21033804,1,224,100,20346861,20192640,154221,648.4201243669798
1747352867618313,21126364,1,225,100,20441087,20285200,155887,641.490310288863
1747352867707574,21218924,1,226,100,20530348,20377760,152588,655.3595302382887
1747352867798560,21311484,1,227,100,20621334,20470320,151014,662.1902605056484
1747352867896773,21404044,1,228,100,20719547,20562880,156667,638.2965142627356
1747352867986545,21496604,1,229,100,20809319,20655440,153879,649.8612546221382
1747352868085320,21589164,1,230,100,20908094,20748000,160094,624.6330280959936
1747352868179233,21681724,1,231,100,21002007,20840560,161447,619.3983164753757
1747352868265231,21774284,1,232,100,21088005,20933120,154885,645.6403137811925
1747352868359840,21866844,1,233,100,21182614,21025680,156934,637.2105471089758
1747352868454054,21959404,1,234,100,21276828,21118240,158588,630.5647337755694
1747352868552691,22055084,1,235,100,21375465,21213920,161545,619.022563372435
1747352868670937,22147644,1,236,100,21493711,21306480,187231,534.0995882092175
1747352868748315,22243324,1,237,100,21571089,21402160,168929,591.964671548402
1747352868859032,22339004,1,238,100,21681806,21497840,183966,543.5787047606623
1747352868949237,22434684,1,239,100,21772011,21593520,178491,560.2523376528789
1747352869146473,22622924,1,241,100,21969247,21781760,187487,533.3703136750815
1747352869343011,22814284,1,243,100,22165785,21973120,192665,519.0356317961227
1747352869608536,23101324,1,246,100,22431310,22260160,171150,584.28279287175
1747352869793297,23289564,1,248,100,22616071,22448400,167671,596.406057099916
1747352870473028,23956204,1,255,100,23295802,23115040,180762,553.2136179064183
1747352870575634,24051884,1,256,100,23398408,23210720,187688,532.7991134222752
1747352870862315,24335804,1,259,100,23685089,23494640,190449,525.0749544497477
1747352870960663,24431484,1,260,100,23783437,23590320,193117,517.820802932937
1747352871046862,24527164,1,261,100,23869636,23686000,183636,544.5555337733342
1747352871156587,24622844,1,262,100,23979361,23781680,197681,505.8655105953532
1747352871234432,24718524,1,263,100,24057206,23877360,179846,556.0312711986923
1747352871349171,24811084,1,264,100,24171945,23969920,202025,494.9882440292043
1747352871439343,24903644,1,265,100,24262117,24062480,199637,500.909150107445
1747352871812206,25286364,1,269,100,24634980,24445200,189780,526.9259142164611
1747352872771007,26243164,1,279,100,25593781,25402000,191781,521.4280872453476
1747352872967909,26431404,1,281,100,25790683,25590240,200443,498.8949476908647
1747352873065435,26527084,1,282,100,25888209,25685920,202289,494.3422529153834
1747352873147150,26619644,1,283,100,25969924,25778480,191444,522.345960176344
1747352873241357,26712204,1,284,100,26064131,25871040,193091,517.8905283001279
1747352873332319,26804764,1,285,100,26155093,25963600,191493,522.2123001885186
1747352873425863,26897324,1,286,100,26248637,26056160,192477,519.5425946996264
1747352873519926,26989884,1,287,100,26342700,26148720,193980,515.5170636148056
1747352873610314,27082444,1,288,100,26433088,26241280,191808,521.3546880213547
1747352873704752,27175004,1,289,100,26527526,26333840,193686,516.2995776669454
1747352873798863,27267564,1,290,100,26621637,26426400,195237,512.1979952570466
1747352873893189,27360124,1,291,100,26715963,26518960,197003,507.6064831500028
1747352873986620,27452684,1,292,100,26809394,26611520,197874,505.37210548126586
1747352874077684,27545244,1,293,100,26900458,26704080,196378,509.2220106121867
1747352874171138,27637804,1,294,100,26993912,26796640,197272,506.914311204834
1747352874265297,27730364,1,295,100,27088071,26889200,198871,502.8385234649597
1747352874359773,27822924,1,296,100,27182547,26981760,200787,498.04021176669806
1747352874450286,27915484,1,297,100,27273060,27074320,198740,503.1699708161417
1747352874544396,28008044,1,298,100,27367170,27166880,200290,499.2760497278946
1747352874638185,28100604,1,299,100,27460959,27259440,201519,496.23112460859767
1747352874732852,28193164,1,300,100,27555626,27352000,203626,491.0964218714702
1747352874831239,28285724,1,301,100,27654013,27444560,209453,477.4340782896402
1747352874917176,28378284,1,302,100,27739950,27537120,202830,493.02371444066455
1747352875010798,28470844,1,303,100,27833572,27629680,203892,490.455731465678
1747352875105248,28563404,1,304,100,27928022,27722240,205782,485.95115219018186
1747352875199209,28655964,1,305,100,28021983,27814800,207183,482.6650835251927
1747352875289379,28748524,1,306,100,28112153,27907360,204793,488.2979398709917
1747352875383610,28841084,1,307,100,28206384,27999920,206464,484.3459392436454
1747352875486609,28933644,1,308,100,28309383,28092480,216903,461.0355781155632
1747352875571890,29026204,1,309,100,28394664,28185040,209624,477.0446132122276
1747352875666699,29118764,1,310,100,28489473,28277600,211873,471.9808564564621
1747352875760709,29211324,1,311,100,28583483,28370160,213323,468.77270617795546
1747352875850730,29303884,1,312,100,28673504,28462720,210784,474.4193107636253
1747352875944656,29396444,1,313,100,28767430,28555280,212150,471.36460051850105
1747352876035544,29489004,1,314,100,28858318,28647840,210478,475.1090375241118
1747352876129694,29581564,1,315,100,28952468,28740400,212068,471.5468623271781
1747352876223627,29674124,1,316,100,29046401,28832960,213441,468.51354706921353
1747352876317255,29766692,1,317,100,29140029,28925528,214501,466.1982927818518
1747352876411464,29859244,1,318,100,29234238,29018080,216158,462.62456166322784
1747352876501510,29951804,1,319,100,29324284,29110640,213644,468.06837542828254
1747352876595658,30044364,1,320,100,29418432,29203200,215232,464.6149271483794
1747352876689950,30136924,1,321,100,29512724,29295760,216964,460.905956748585
1747352876780245,30229484,1,322,100,29603019,29388320,214699,465.7683547664405
1747352876874915,30322044,1,323,100,29697689,29480880,216809,461.2354653173992
1747352876969175,30414604,1,324,100,29791949,29573440,218509,457.6470534394464
1747352877062491,30507164,1,325,100,29885265,29666000,219265,456.0691400816364
1747352877157521,30599724,1,326,100,29980295,29758560,221735,450.9887929284957
1747352877247773,30692284,1,327,100,30070547,29851120,219427,455.7324303754779
1747352877341531,30784844,1,328,100,30164305,29943680,220625,453.257790368272
1747352877435262,30877404,1,329,100,30258036,30036240,221796,450.8647586070082
1747352877530304,30969964,1,330,100,30353078,30128800,224278,445.87520844666
1747352877620381,31062524,1,331,100,30443155,30221360,221795,450.86679140647897
1747352877714482,31155084,1,332,100,30537256,30313920,223336,447.7558476913708
1747352877808203,31247644,1,333,100,30630977,30406480,224497,445.4402508719493
1747352877902923,31340204,1,334,100,30725697,30499040,226657,441.1952862695615
1747352877997129,31432764,1,335,100,30819903,30591600,228303,438.014393152959
1747352878086869,31525324,1,336,100,30909643,30684160,225483,443.4924140622575
1747352878181420,31617884,1,337,100,31004194,30776720,227474,439.61068078110026
1747352878274755,31710444,1,338,100,31097529,30869280,228249,438.1180202322902
1747352878365090,31803004,1,339,100,31187864,30961840,226024,442.4308922946236
1747352878459775,31895572,1,340,100,31282549,31054408,228141,438.3254215594741
1747352878553970,31988124,1,341,100,31376744,31146960,229784,435.19131009992
1747352878647744,32080684,1,342,100,31470518,31239520,230998,432.90418098858
1747352878741651,32173244,1,343,100,31564425,31332080,232345,430.3944565194
1747352878832251,32265804,1,344,100,31655025,31424640,230385,434.0560366343295
1747352878925817,32358364,1,345,100,31748591,31517200,231391,432.168926189869
1747352879020517,32450924,1,346,100,31843291,31609760,233531,428.2086746513311
1747352879115213,32543484,1,347,100,31937987,31702320,235667,424.3275469200185
1747352879204389,32636044,1,348,100,32027163,31794880,232283,430.5093355949424
1747352879298787,32728604,1,349,100,32121561,31887440,234121,427.12956120980175
1747352879393568,32821164,1,350,100,32216342,31980000,236342,423.1156544329827
1747352879487232,32913724,1,351,100,32310006,32072560,237446,421.14838742282456
1747352879578185,33006284,1,352,100,32400959,32165120,235839,424.0180801309368
1747352879671760,33098844,1,353,100,32494534,32257680,236854,422.2010183488562
1747352879766627,33191404,1,354,100,32589401,32350240,239161,418.12837377331584
1747352879859895,33283964,1,355,100,32682669,32442800,239869,416.8942214291968
1747352879954847,33376524,1,356,100,32777621,32535360,242261,412.7779543550138
1747352880048352,33469084,1,357,100,32871126,32627920,243206,411.17406642928216
1747352880138799,33561644,1,358,100,32961573,32720480,241093,414.777699891743
1747352880232745,33654204,1,359,100,33055519,32813040,242479,412.4068476032976
1747352880331658,33746764,1,360,100,33154432,32905600,248832,401.8775720164609
1747352880417569,33839324,1,361,100,33240343,32998160,242183,412.9108979573298
1747352880511295,33931884,1,362,100,33334069,33090720,243349,410.932446815068
1747352880605637,34024444,1,363,100,33428411,33183280,245131,407.945139537635
1747352880703965,34117004,1,364,100,33526739,33275840,250899,398.5667539527858
1747352880790147,34209564,1,365,100,33612921,33368400,244521,408.9628293684388
1747352880888307,34302124,1,366,100,33711081,33460960,250121,399.80649365707
1747352880978344,34394684,1,367,100,33801118,33553520,247598,403.88048368726726
1747352881072709,34487244,1,368,100,33895483,33646080,249403,400.9574864777088
1747352881162268,34579804,1,369,100,33985042,33738640,246402,405.8408616813175
1747352881257366,34672364,1,370,100,34080140,33831200,248940,401.7032216598377
1747352881351167,34764924,1,371,100,34173941,33923760,250181,399.71060951870845
1747352881445651,34857484,1,372,100,34268425,34016320,252105,396.6601217746573
1747352881539288,34950044,1,373,100,34362062,34108880,253182,394.9727863750188
1747352881629806,35042604,1,374,100,34452580,34201440,251140,398.1842796846381
1747352881727444,35135164,1,375,100,34550218,34294000,256218,390.2926414225386
1747352881818112,35227724,1,376,100,34640886,34386560,254326,393.1961340956096
1747352881912055,35320284,1,377,100,34734829,34479120,255709,391.0695360742093
1747352882002262,35412844,1,378,100,34825036,34571680,253356,394.7015267055053
1747352882096262,35505404,1,379,100,34919036,34664240,254796,392.4708394166313
1747352882190907,35597964,1,380,100,35013681,34756800,256881,389.2853110973563
1747352882284775,35690532,1,381,100,35107549,34849368,258181,387.3251711008944
1747352882375776,35783084,1,382,100,35198550,34941920,256630,389.6660561898453
1747352882469901,35875644,1,383,100,35292675,35034480,258195,387.3041693293828
1747352882564300,35968204,1,384,100,35387074,35127040,260034,384.5650953336872
1747352882658380,36060764,1,385,100,35481154,35219600,261554,382.3302262630279
1747352882747786,36153324,1,386,100,35570560,35312160,258400,386.9969040247678
1747352882842098,36245884,1,387,100,35664872,35404720,260152,384.3906639195548
1747352882936904,36338444,1,388,100,35759678,35497280,262398,381.1004657047691
1747352883030411,36431004,1,389,100,35853185,35589840,263345,379.7300119614954
1747352883124283,36523564,1,390,100,35947057,35682400,264657,377.8475536260141
1747352883215296,36616124,1,391,100,36038070,35774960,263110,380.06917258941127
1747352883308956,36708684,1,392,100,36131730,35867520,264210,378.4868097346807
1747352883402650,36801244,1,393,100,36225424,35960080,265344,376.8692715870719
1747352883497548,36893804,1,394,100,36320322,36052640,267682,373.5776032755285
1747352883587684,36986364,1,395,100,36410458,36145200,265258,376.991457373576
1747352883681406,37078924,1,396,100,36504180,36237760,266420,375.3471961564448
1747352883775344,37171484,1,397,100,36598118,36330320,267798,373.4157835383386
1747352883869630,37264044,1,398,100,36692404,36422880,269524,371.0244727742242
1747352883959793,37356604,1,399,100,36782567,36515440,267127,374.3537718014278
1747352884054480,37449164,1,400,100,36877254,36608000,269254,371.3965252141101
1747352884148794,37541724,1,401,100,36971568,36700560,271008,368.9927972605975
1747352884242718,37634284,1,402,100,37065492,36793120,272372,367.1449341341988
1747352884333262,37726844,1,403,100,37156036,36885680,270356,369.8826732160559
1747352884427463,37819412,1,404,100,37250237,36978248,271989,367.6619275044212
1747352884521333,37911964,1,405,100,37344107,37070800,273307,365.8889088095072
1747352884623299,38004524,1,406,100,37446073,37163360,282713,353.7156055788025
1747352884709397,38097084,1,407,100,37532171,37255920,276251,361.98963985650727
1747352884803543,38189644,1,408,100,37626317,37348480,277837,359.92326436003844
1747352884898575,38282204,1,409,100,37721349,37441040,280309,356.7491589638578
1747352884988751,38374764,1,410,100,37811525,37533600,277925,359.8093010704327
1747352885082211,38467324,1,411,100,37904985,37626160,278825,358.6478974267014
1747352885181151,38559884,1,412,100,38003925,37718720,285205,350.6249890429691
1747352885267093,38652444,1,413,100,38089867,37811280,278587,358.9542943497005
1747352885373559,38745004,1,414,100,38196333,37903840,292493,341.88852382792066
1747352885454882,38837564,1,415,100,38277656,37996400,281256,355.5479705321842
1747352885549298,38930124,1,416,100,38372072,38088960,283112,353.2171013591794
1747352885643347,39022684,1,417,100,38466121,38181520,284601,351.36910973608667
1747352885733514,39115244,1,418,100,38556288,38274080,282208,354.3485655970064
1747352885828169,39207804,1,419,100,38650943,38366640,284303,351.73740692148874
1747352885918319,39300364,1,420,100,38741093,38459200,281893,354.7445307261975
1747352886012713,39392924,1,421,100,38835487,38551760,283727,352.45147624300824
1747352886106727,39485484,1,422,100,38929501,38644320,285181,350.6544966179373
1747352886200894,39578044,1,423,100,39023668,38736880,286788,348.6896243915366
1747352886294855,39670604,1,424,100,39117629,38829440,288189,346.994507076953
1747352886384763,39763164,1,425,100,39207537,38922000,285537,350.21730984075623
1747352886487205,39855724,1,426,100,39309979,39014560,295419,338.5022628876274
1747352886573728,39948284,1,427,100,39396502,39107120,289382,345.56399499623336
1747352886667212,40040844,1,428,100,39489986,39199680,290306,344.4641171729141
1747352886757694,40133404,1,429,100,39580468,39292240,288228,346.9475554075246
1747352886851585,40225964,1,430,100,39674359,39384800,289559,345.3527605772917
1747352886945799,40318524,1,431,100,39768573,39477360,291213,343.39126343947555
1747352887039769,40411084,1,432,100,39862543,39569920,292623,341.7366372431422
1747352887130446,40503644,1,433,100,39953220,39662480,290740,343.9499208915182
1747352887224056,40596204,1,434,100,40046830,39755040,291790,342.71222454504954
1747352887318289,40688764,1,435,100,40141063,39847600,293463,340.75846018067017
1747352887422192,40781324,1,436,100,40244966,39940160,304806,328.0775312821926
1747352887621612,40969564,1,438,100,40444386,40128400,315986,316.4697170127791
1747352887699502,41062124,1,439,100,40522276,40220960,301316,331.8774973781678
1747352887793768,41154684,1,440,100,40616542,40313520,303022,330.0090422477576
1747352887880228,41247244,1,441,100,40703002,40406080,296922,336.788786280572
1747352887978238,41339804,1,442,100,40801012,40498640,302372,330.7184527667906
1747352888068314,41432364,1,443,100,40891088,40591200,299888,333.4578242543883
1747352888161984,41524924,1,444,100,40984758,40683760,300998,332.22812111708384
1747352888256205,41617484,1,445,100,41078979,40776320,302659,330.4048450566479
1747352888346563,41710044,1,446,100,41169337,40868880,300457,332.8263278938417
1747352888440801,41802604,1,447,100,41263575,40961440,302135,330.97787412911447
1747352888551358,41895164,1,448,100,41374132,41054000,320132,312.37114690190293
1747352888633387,41990844,1,449,100,41456161,41149680,306481,326.2845005073724
1747352888743939,42086524,1,450,100,41566713,41245360,321353,311.18427399152955
1747352888846128,42179084,1,451,100,41668902,41337920,330982,302.1312337226798
1747352888919868,42274764,1,452,100,41742642,41433600,309042,323.58061363827574
1747352889018094,42367324,1,453,100,41840868,41526160,314708,317.75487118217524
1747352889104673,42459884,1,454,100,41927447,41618720,308727,323.910769061339
1747352889198646,42552444,1,455,100,42021420,41711280,310140,322.43502934158766
1747352889289126,42645004,1,456,100,42111900,41803840,308060,324.6120885541778
1747352889383031,42737564,1,457,100,42205805,41896400,309405,323.2009825309869
1747352889477331,42830124,1,458,100,42300105,41988960,311145,321.3935624869434
1747352889566764,42922684,1,459,100,42389538,42081520,308018,324.6563512521996
1747352889661783,43015244,1,460,100,42484557,42174080,310477,322.08504977824447
1747352889756008,43107804,1,461,100,42578782,42266640,312142,320.3670124494621
1747352889849775,43200364,1,462,100,42672549,42359200,313349,319.13297952123673
1747352889940154,43292924,1,463,100,42762928,42451760,311168,321.3698066639243
1747352890033906,43385484,1,464,100,42856680,42544320,312360,320.1434242540658
1747352890128151,43478052,1,465,100,42950925,42636888,314037,318.4338151236956
1747352890221966,43570604,1,466,100,43044740,42729440,315300,317.15826197272435
1747352890316627,43663164,1,467,100,43139401,42822000,317401,315.0588687496259
1747352890407262,43755724,1,468,100,43230036,42914560,315476,316.9813234604217
1747352890501359,43848284,1,469,100,43324133,43007120,317013,315.4444770403737
1747352890595463,43940844,1,470,100,43418237,43099680,318557,313.91556299186647
1747352890689027,44033404,1,471,100,43511801,43192240,319561,312.9292998832774
1747352890779781,44125964,1,472,100,43602555,43284800,317755,314.7078724174285
1747352890873609,44218524,1,473,100,43696383,43377360,319023,313.4570234747965
1747352890968067,44311084,1,474,100,43790841,43469920,320921,311.6031671345908
1747352891062044,44403644,1,475,100,43884818,43562480,322338,310.2333575315352
1747352891151947,44496204,1,476,100,43974721,43655040,319681,312.8118342973152
1747352891246279,44588764,1,477,100,44069053,43747600,321453,311.0874684635079
1747352891340672,44681324,1,478,100,44163446,43840160,323286,309.3236329442042
1747352891435004,44773884,1,479,100,44257778,43932720,325058,307.63740624750045
1747352891525452,44866444,1,480,100,44348226,44025280,322946,309.6492912127724
1747352891619502,44959004,1,481,100,44442276,44117840,324436,308.2272004339839
1747352891713750,45051564,1,482,100,44536524,44210400,326124,306.63183329040487
1747352891807380,45144124,1,483,100,44630154,44302960,327194,305.62907632780554
1747352891901489,45236684,1,484,100,44724263,44395520,328743,304.18898653355353
1747352891991479,45329244,1,485,100,44814253,44488080,326173,306.58576890177915
1747352892086514,45421804,1,486,100,44909288,44580640,328648,304.2769163360191
1747352892180589,45514364,1,487,100,45003363,44673200,330163,302.88069832173807
1747352892274619,45606932,1,488,100,45097393,44765768,331625,301.5454202789295
1747352892365028,45699484,1,489,100,45187802,44858320,329482,303.50671660363844
1747352892459058,45792044,1,490,100,45281832,44950880,330952,302.1586211897797
1747352892552552,45884604,1,491,100,45375326,45043440,331886,301.3082805541662
1747352892647099,45977164,1,492,100,45469873,45136000,333873,299.5150850772599
1747352892737248,46069724,1,493,100,45560022,45228560,331462,301.69370847940337
1747352893028235,46353644,1,496,100,45851009,45512480,338529,295.3956677271371
1747352893122518,46446204,1,497,100,45945292,45605040,340252,293.8998154309159
1747352893212513,46538772,1,498,100,46035287,45697608,337679,296.13923282170344
1747352893307039,46631324,1,499,100,46129813,45790160,339653,294.41812673522685
1747352893396742,46723884,1,500,100,46219516,45882720,336796,296.91564032826994
1747352893491032,46816444,1,501,100,46313806,45975280,338526,295.3982855083509
1747352893589283,46909004,1,502,100,46412057,46067840,344217,290.5144138726443
1747352893896447,47192924,1,505,100,46719221,46351760,367461,272.1377234590882
1747352893965652,47285484,1,506,100,46788426,46444320,344106,290.6081265656513
1747352894059896,47378044,1,507,100,46882670,46536880,345790,289.19286272014807
1747352894149850,47470612,1,508,100,46972624,46629448,343176,291.3956686947805
1747352894244145,47563164,1,509,100,47066919,46722000,344919,289.92314137522146
1747352894334360,47655724,1,510,100,47157134,46814560,342574,291.9077338034994
1747352894428515,47748284,1,511,100,47251289,46907120,344169,290.55493086245417
1747352894523405,47840844,1,512,100,47346179,46999680,346499,288.6011215039581
1747352894617426,47933404,1,513,100,47440200,47092240,347960,287.3893550982872
1747352894711671,48025964,1,514,100,47534445,47184800,349645,286.0043758669508
1747352894801444,48118524,1,515,100,47624218,47277360,346858,288.30241770407486
1747352894896143,48211084,1,516,100,47718917,47369920,348997,286.5354143445359
1747352894990152,48303644,1,517,100,47812926,47462480,350446,285.3506674352112
1747352895091925,48396204,1,518,100,47914699,47555040,359659,278.0411445285673
1747352895178617,48488764,1,519,100,48001391,47647600,353791,282.6527526138313
1747352895272259,48581324,1,520,100,48095033,47740160,354873,281.79095056541354
1747352895363041,48673884,1,521,100,48185815,47832720,353095,283.2099010181396
1747352895457178,48766444,1,522,100,48279952,47925280,354672,281.95064735868635
1747352895550695,48859004,1,523,100,48373469,48017840,355629,281.1919162947904
1747352895640777,48951564,1,524,100,48463551,48110400,353151,283.1649917457405
1747352895743792,49044124,1,525,100,48566566,48202960,363606,275.0229644175289
1747352895845328,49136684,1,526,100,48668102,48295520,372582,268.3972924081142
1747352895948676,49232364,1,527,100,48771450,48391200,380250,262.98487836949374
1747352896042124,49324924,1,528,100,48864898,48483760,381138,262.37215916544665
1747352896222895,49516284,1,530,100,49045669,48675120,370549,269.8698417753117
1747352897463278,50757004,1,543,100,50286052,49915840,370212,270.1155013883937
1747352897570430,50849564,1,544,100,50393204,50008400,384804,259.8725584973129
1747352897647948,50942124,1,545,100,50470722,50100960,369762,270.4442316949822
1747352897750828,51034684,1,546,100,50573602,50193520,380082,263.1011202845702
1747352897938878,51222924,1,548,100,50761652,50381760,379892,263.2327082433955
1747352898024708,51315484,1,549,100,50847482,50474320,373162,267.9801265938118
1747352898131450,51408044,1,550,100,50954224,50566880,387344,258.1684497500929
1747352898208940,51500604,1,551,100,51031714,50659440,372274,268.6193502635156
1747352898311045,51593164,1,552,100,51133819,50752000,381819,261.9042006814747
1747352898397048,51685724,1,553,100,51219822,50844560,375262,266.48048563403705
1747352898487533,51778284,1,554,100,51310307,50937120,373187,267.9621744594533
1747352898598057,51870844,1,555,100,51420831,51029680,391151,255.65574420108857
1747352898684142,51963404,1,556,100,51506916,51122240,384676,259.9590304568
1747352898770698,52055964,1,557,100,51593472,51214800,378672,264.08078759454094
1747352898862118,52148524,1,558,100,51684892,51307360,377532,264.878208999502
1747352898958632,52241084,1,559,100,51781406,51399920,381486,262.1328174559486
1747352899057154,52333644,1,560,100,51879928,51492480,387448,258.0991513699903
1747352899261350,52521884,1,562,100,52084124,51680720,403404,247.8904522513411
1747352899548906,52808924,1,565,100,52371680,51967760,403920,247.57377698554168
1747352899622442,52904604,1,566,100,52445216,52063440,381776,261.9336993420225
1747352900318695,53571244,1,573,100,53141469,52730080,411389,243.07893502256988
1747352900416316,53666924,1,574,100,53239090,52825760,413330,241.9374349793144
1747352900506579,53759484,1,575,100,53329353,52918320,411033,243.28946824220927
1747352900609488,53855164,1,576,100,53432262,53014000,418262,239.08459291066364
1747352900772039,54046524,1,578,100,53594813,53205360,389453,256.7703933465656
1747352900891436,54142204,1,579,100,53714210,53301040,413170,242.03112520270108
1747352900965232,54234764,1,580,100,53788006,53393600,394406,253.54583855215185
1747352901059854,54327332,1,581,100,53882628,53486168,396460,252.2322554608284
1747352901154128,54419884,1,582,100,53976902,53578720,398182,251.1414378349599
1747352901243856,54512444,1,583,100,54066630,53671280,395350,252.94043252813964
1747352901338546,54605004,1,584,100,54161320,53763840,397480,251.58498540807085
1747352901428794,54697564,1,585,100,54251568,53856400,395168,253.05692768645235
1747352901526767,54790124,1,586,100,54349541,53948960,400581,249.6374016740684
1747352901616773,54882684,1,587,100,54439547,54041520,398027,251.2392375391619
1747352901711378,54975244,1,588,100,54534152,54134080,400072,249.9550080985423
1747352901805547,55067804,1,589,100,54628321,54226640,401681,248.95377177411925
1747352901895628,55160364,1,590,100,54718402,54319200,399202,250.49974699525552
1747352901989354,55252924,1,591,100,54812128,54411760,400368,249.77021140550693
1747352902084056,55345484,1,592,100,54906830,54504320,402510,248.4410325209312
1747352902178150,55438044,1,593,100,55000924,54596880,404044,247.4977972696043
1747352902268149,55530604,1,594,100,55090923,54689440,401483,249.07654869571067
1747352902362365,55623164,1,595,100,55185139,54782000,403139,248.0534009361535
1747352902456577,55715724,1,596,100,55279351,54874560,404791,247.04106563634076
1747352902550933,55808284,1,597,100,55373707,54967120,406587,245.9498213174548
1747352902641015,55900844,1,598,100,55463789,55059680,404109,247.45798782011784
1747352902734694,55993404,1,599,100,55557468,55152240,405228,246.77465525580664
1747352902829594,56085964,1,600,100,55652368,55244800,407568,245.35782985906647
1747352902927822,56178524,1,601,100,55750596,55337360,413236,241.99246919435868
1747352903013019,56271084,1,602,100,55835793,55429920,405873,246.38248910373443
1747352903111539,56363644,1,603,100,55934313,55522480,411833,242.81686994485628
1747352903201583,56456212,1,604,100,56024357,55615048,409309,244.31419783097857
1747352903296486,56548764,1,605,100,56119260,55707600,411660,242.91891366661807
1747352903385783,56641324,1,606,100,56208557,55800160,408397,244.85978104638377
1747352903480676,56733884,1,607,100,56303450,55892720,410730,243.46894553599688
1747352903578439,56826444,1,608,100,56401213,55985280,415933,240.423337412516
1747352903672405,56919004,1,609,100,56495179,56077840,417339,239.6133598824936
1747352903762392,57011564,1,610,100,56585166,56170400,414766,241.09980085156448
1747352903856619,57104124,1,611,100,56679393,56262960,416433,240.13466752154608
1747352903951213,57196684,1,612,100,56773987,56355520,418467,238.96746935839624
1747352904041576,57289244,1,613,100,56864350,56448080,416270,240.2286977202297
1747352904139581,57381804,1,614,100,56962355,56540640,421715,237.12696963589156
1747352904226025,57474364,1,615,100,57048799,56633200,415599,240.6165558627427
1747352904324447,57566924,1,616,100,57147221,56725760,421461,237.26987787719384
1747352904414359,57659484,1,617,100,57237133,56818320,418813,238.77004773013252
1747352904511991,57752044,1,618,100,57334765,56910880,423885,235.913042452552
1747352904598910,57844604,1,619,100,57421684,57003440,418244,239.0948824131368
1747352904693143,57937164,1,620,100,57515917,57096000,419917,238.1422995496729
1747352904786515,58029724,1,621,100,57609289,57188560,420729,237.68268885672248
1747352904880738,58122284,1,622,100,57703512,57281120,422392,236.7469080853804
1747352904979469,58214844,1,623,100,57802243,57373680,428563,233.33792231247213
1747352905069033,58307404,1,624,100,57891807,57466240,425567,234.9806258473989
1747352905159918,58399964,1,625,100,57982692,57558800,423892,235.90914666943468
1747352905257414,58492524,1,626,100,58080188,57651360,428828,233.19372802149115
1747352905351643,58585084,1,627,100,58174417,57743920,430497,232.28965590933268
1747352905442562,58677644,1,628,100,58265336,57836480,428856,233.1785028074692
1747352905532688,58770204,1,629,100,58355462,57929040,426422,234.50947652794648
1747352905626958,58862764,1,630,100,58449732,58021600,428132,233.5728233348593
1747352905732959,58955324,1,631,100,58555733,58114160,441573,226.46312161296092
1747352905815056,59047884,1,632,100,58637830,58206720,431110,231.95936072000185
1747352905917609,59140444,1,633,100,58740383,58299280,441103,226.7044205094955
1747352906011479,59233004,1,634,100,58834253,58391840,442413,226.0331409791304
1747352906114142,59325564,1,635,100,58936916,58484400,452516,220.98666124512727
1747352906191726,59421244,1,636,100,59014500,58580080,434420,230.19198011141293
1747352906282148,59513804,1,637,100,59104922,58672640,432282,231.3304740886736
1747352906474376,59702044,1,639,100,59297150,58860880,436270,229.21585256836363
1747352906564431,59794604,1,640,100,59387205,58953440,433765,230.5395778820329
1747352906658947,59887164,1,641,100,59481721,59046000,435721,229.50466009212315
1747352906753305,59979724,1,642,100,59576079,59138560,437519,228.56150247189265
1747352906843158,60072284,1,643,100,59665932,59231120,434812,229.98445305097377
1747352906937153,60164844,1,644,100,59759927,59323680,436247,229.22793738409663
1747352907031305,60257404,1,645,100,59854079,59416240,437839,228.3944554961984
1747352907125166,60349964,1,646,100,59947940,59508800,439140,227.71781208726148
1747352907215584,60442524,1,647,100,60038358,59601360,436998,228.8339992402711
1747352907309307,60535084,1,648,100,60132081,59693920,438161,228.2266107663621
1747352907404444,60627644,1,649,100,60227218,59786480,440738,226.8921672286029
1747352907498356,60720204,1,650,100,60321130,59879040,442090,226.19828541699653
1747352907592259,60812764,1,651,100,60415033,59971600,443433,225.5132116915069
1747352907682451,60905324,1,652,100,60505225,60064160,441065,226.72395225193569
1747352907789307,60997884,1,653,100,60612081,60156720,455361,219.60598294539932
1747352907878900,61090444,1,654,100,60701674,60249280,452394,221.04625613955972
1747352907965159,61183012,1,655,100,60787933,60341848,446085,224.17252317383455
1747352908055467,61275564,1,656,100,60878241,60434400,443841,225.30590909807796
1747352908251854,61463804,1,658,100,61074628,60622640,451988,221.24481180916308
1747352908358435,61556364,1,659,100,61181209,60715200,466009,214.5881302721621
1747352908432428,61648932,1,660,100,61255202,60807768,447434,223.4966497852197
1747352908526386,61741484,1,661,100,61349160,60900320,448840,222.79654219766508
1747352908620530,61834044,1,662,100,61443304,60992880,450424,222.01303660550948
1747352908735317,61926604,1,663,100,61558091,61085440,472651,211.5725979634022
1747352908820928,62019164,1,664,100,61643702,61178000,465702,214.72959102602093
1747352908911523,62111724,1,665,100,61734297,61270560,463737,215.63946806056015
1747352908996707,62204284,1,666,100,61819481,61363120,456361,219.1247718363313
1747352909099115,62296844,1,667,100,61921889,61455680,466209,214.49607364937185
1747352909177212,62389404,1,668,100,61999986,61548240,451746,221.3633324921527
1747352909279240,62481964,1,669,100,62102014,61640800,461214,216.81909048727923
1747352909365667,62574524,1,670,100,62188441,61733360,455081,219.74110103476085
1747352909459841,62667084,1,671,100,62282615,61825920,456695,218.9645168000525
1747352909554472,62759644,1,672,100,62377246,61918480,458766,217.9760487917588
1747352909644352,62852204,1,673,100,62467126,62011040,456086,219.2568945330486
1747352909738060,62944764,1,674,100,62560834,62103600,457234,218.70639541241465
1747352909833015,63037324,1,675,100,62655789,62196160,459629,217.5667766829334
1747352909927055,63129884,1,676,100,62749829,62288720,461109,216.86846277127532
1747352910017166,63222444,1,677,100,62839940,62381280,458660,218.02642480268608
1747352910111016,63315004,1,678,100,62933790,62473840,459950,217.4149364061311
1747352910205327,63407564,1,679,100,63028101,62566400,461701,216.590390750724
1747352910295773,63500124,1,680,100,63118547,62658960,459587,217.58665932674336
1747352910393391,63592684,1,681,100,63216165,62751520,464645,215.2180697091328
1747352910484214,63685244,1,682,100,63306988,62844080,462908,216.02564656476017
1747352910577780,63777812,1,683,100,63400554,62936648,463906,215.5609110466345
1747352912212247,65401244,1,700,100,65035021,64560080,474941,210.5524686224184
1747352912306988,65493804,1,701,100,65129762,64652640,477122,209.590000041918
1747352912405468,65586364,1,702,100,65228242,64745200,483042,207.02133561884887
1747352912495568,65678924,1,703,100,65318342,64837760,480582,208.08103507830089
1747352912585479,65771484,1,704,100,65408253,64930320,477933,209.23434874762785
1747352912679382,65864044,1,705,100,65502156,65022880,479276,208.6480441332343
1747352912777556,65956604,1,706,100,65600330,65115440,484890,206.2323413557714
1747352912867824,66049164,1,707,100,65690598,65208000,482598,207.21179946870893
1747352912962086,66141724,1,708,100,65784860,65300560,484300,206.48358455502787
1747352913056164,66234284,1,709,100,65878938,65393120,485818,205.8384003886229
1747352913150645,66326844,1,710,100,65973419,65485680,487739,205.02768898939803
1747352913244551,66419404,1,711,100,66067325,65578240,489085,204.4634368259096
1747352913334436,66511964,1,712,100,66157210,65670800,486410,205.58787853868137
1747352913429275,66604524,1,713,100,66252049,65763360,488689,204.62911995154383
1747352913519105,66697084,1,714,100,66341879,65855920,485959,205.77867680195243
1747352913609092,66789644,1,715,100,66431866,65948480,483386,206.8740095906791
1747352913719584,66882204,1,716,100,66542358,66041040,501318,199.47418604558385
1747352913801680,66974764,1,717,100,66624454,66133600,490854,203.7265663517054
1747352913891659,67067324,1,718,100,66714433,66226160,488273,204.8034603592662
1747352913986029,67159884,1,719,100,66808803,66318720,490083,204.04706957801025
1747352914075702,67252444,1,720,100,66898476,66411280,487196,205.25620078982584
1747352914170041,67345004,1,721,100,66992815,66503840,488975,204.50943299759703
1747352914264236,67437564,1,722,100,67087010,66596400,490610,203.82788773159945
1747352914362244,67530124,1,723,100,67185018,66688960,496058,201.5893302799269
1747352914452330,67622684,1,724,100,67275104,66781520,493584,202.599760121884
1747352914547227,67715244,1,725,100,67370001,66874080,495921,201.6450200737617
1747352914637309,67807804,1,726,100,67460083,66966640,493443,202.65765245428548
1747352914734908,67900364,1,727,100,67557682,67059200,498482,200.6090490729856
1747352914825748,67992924,1,728,100,67648522,67151760,496762,201.30364238810537
1747352914914996,68085484,1,729,100,67737770,67244320,493450,202.6547775863816
1747352915009438,68178044,1,730,100,67832212,67336880,495332,201.8847964597482
1747352915120646,68270604,1,731,100,67943420,67429440,513980,194.56009961477105
1747352915215026,68363164,1,732,100,68037800,67522000,515800,193.87359441644043
1747352916835975,69989724,1,749,100,69658749,69148560,510189,196.0057939312686
1747352916946943,70082284,1,750,100,69769717,69241120,528597,189.18003696577924
1747352917033162,70177964,1,751,100,69855936,69336800,519136,192.62775072428036
1747352917229630,70366204,1,753,100,70052404,69525040,527364,189.62234813146137
1747352917307765,70458764,1,754,100,70130539,69617600,512939,194.95495565749533
1747352917401859,70551324,1,755,100,70224633,69710160,514473,194.37366003658116
1747352917492237,70643884,1,756,100,70315011,69802720,512291,195.20155536599316
1747352917590256,70736444,1,757,100,70413030,69895280,517750,193.1434089811685
1747352917680595,70829004,1,758,100,70503369,69987840,515529,193.9755086522776
1747352917774176,70921564,1,759,100,70596950,70080400,516550,193.5921014422612
1747352917868953,71014124,1,760,100,70691727,70172960,518767,192.76476722690532
1747352917970950,71106684,1,761,100,70793724,70265520,528204,189.32079272402328
1747352918053174,71199244,1,762,100,70875948,70358080,517868,193.09939984706529
1747352918146810,71291804,1,763,100,70969584,70450640,518944,192.69901954738856
1747352918240957,71384364,1,764,100,71063731,70543200,520531,192.11151689332624
1747352918335826,71476924,1,765,100,71158600,70635760,522840,191.2631015224543
1747352918425704,71569484,1,766,100,71248478,70728320,520158,192.2492781039607
1747352918519978,71662044,1,767,100,71342752,70820880,521872,191.61786798295367
1747352918613630,71754604,1,768,100,71436404,70913440,522964,191.21775112627256
1747352918704229,71847164,1,769,100,71527003,71006000,521003,191.9374744483237
1747352918798226,71939724,1,770,100,71621000,71098560,522440,191.40953985146615
1747352918892252,72032292,1,771,100,71715026,71191128,523898,190.87685007386932
1747352918986767,72124844,1,772,100,71809541,71283680,525861,190.16432098976725
1747352919080817,72217404,1,773,100,71903591,71376240,527351,189.6270226092299
1747352919175404,72309964,1,774,100,71998178,71468800,529378,188.90093657084356
1747352919265377,72402524,1,775,100,72088151,71561360,526791,189.8286037536708
1747352919359447,72495084,1,776,100,72182221,71653920,528301,189.28603201583945
1747352919453468,72587644,1,777,100,72276242,71746480,529762,188.76401100871715
1747352919543919,72680204,1,778,100,72366693,71839040,527653,189.51849037151308
1747352919638259,72772764,1,779,100,72461033,71931600,529433,188.8813126495704
1747352919732502,72865324,1,780,100,72555276,72024160,531116,188.2827856814707
1747352919826600,72957884,1,781,100,72649374,72116720,532654,187.7391327203025
1747352919916439,73050444,1,782,100,72739213,72209280,529933,188.70310020323325
1747352920010730,73143004,1,783,100,72833504,72301840,531664,188.08871768635828
1747352920104836,73235564,1,784,100,72927610,72394400,533210,187.54336940417477
1747352920199422,73328124,1,785,100,73022196,72486960,535236,186.8334715901023
1747352920289202,73420684,1,786,100,73111976,72579520,532456,187.80894571570232
1747352920387585,73513244,1,787,100,73210359,72672080,538279,185.77726420685187
1747352920477389,73605804,1,788,100,73300163,72764640,535523,186.73334291897828
1747352920571179,73698364,1,789,100,73393953,72857200,536753,186.3054328527274
1747352920661749,73790924,1,790,100,73484523,72949760,534763,186.9987265386723
1747352920756002,73883484,1,791,100,73578776,73042320,536456,186.40857777711497
1747352920850081,73976044,1,792,100,73672855,73134880,537975,185.88224359868025
1747352920944032,74068604,1,793,100,73766806,73227440,539366,185.40286187857595
1747352921034559,74161172,1,794,100,73857333,73320008,537325,186.1071046387196
1747352921129024,74253724,1,795,100,73951798,73412560,539238,185.44687132583385
1747352921226885,74346284,1,796,100,74049659,73505120,544539,183.64157571817628
1747352921317583,74438844,1,797,100,74140357,73597680,542677,184.27167541650007
1747352921423457,74531404,1,798,100,74246231,73690240,555991,179.8590264950332
1747352921505685,74623964,1,799,100,74328459,73782800,545659,183.26463963757584
1747352921604252,74716524,1,800,100,74427026,73875360,551666,181.2691012315423
1747352921690073,74809084,1,801,100,74512847,73967920,544927,183.5108188803271
1747352921784216,74901644,1,802,100,74606990,74060480,546510,182.9792684488847
1747352921874059,74994204,1,803,100,74696833,74153040,543793,183.8935035941985
1747352921984775,75086764,1,804,100,74807549,74245600,561949,177.95209173786233
1747352922070777,75179324,1,805,100,74893551,74338160,555391,180.05333179687824
1747352922169332,75271884,1,806,100,74992106,74430720,561386,178.13055544669797
1747352922279245,75364444,1,807,100,75102019,74523280,578739,172.78946122518096
1747352922755085,75839724,1,812,100,75577859,74998560,579299,172.62242814159873
1747352922832443,75935404,1,813,100,75655217,75094240,560977,178.26042778937463
1747352922918098,76027964,1,814,100,75740872,75186800,554072,180.481959023376
1747352923008813,76120524,1,815,100,75831587,75279360,552227,181.08495238371177
1747352923102327,76213084,1,816,100,75925101,75371920,553181,180.77265849694768
1747352923196859,76305644,1,817,100,76019633,75464480,555153,180.13052257665905
1747352923291048,76398204,1,818,100,76113822,75557040,556782,179.6035072972905
1747352923381291,76490772,1,819,100,76204065,75649608,554457,180.35663721442785
1747352923475139,76583324,1,820,100,76297913,75742160,555753,179.9360507275714
1747352923570155,76675884,1,821,100,76392929,75834720,558209,179.1443706568687
1747352923664140,76768444,1,822,100,76486914,75927280,559634,178.68821408277554
1747352923758149,76861004,1,823,100,76580923,76019840,561083,178.22675076592947
1747352923852669,76953564,1,824,100,76675443,76112400,563043,177.606328468696
1747352923941767,77046124,1,825,100,76764541,76204960,559581,178.70513830884178
1747352924036579,77138684,1,826,100,76859353,76297520,561833,177.98883298061878
1747352924130673,77231244,1,827,100,76953447,76390080,563367,177.5041846611534
1747352924220664,77323804,1,828,100,77043438,76482640,560798,178.31732638133516
1747352924315523,77416364,1,829,100,77138297,76575200,563097,177.58929633793113
1747352924413630,77508924,1,830,100,77236404,76667760,568644,175.85695092184213
1747352924503584,77601484,1,831,100,77326358,76760320,566038,176.6665842222607
1747352924593291,77694044,1,832,100,77416065,76852880,563185,177.5615472713229
1747352924691490,77786604,1,833,100,77514264,76945440,568824,175.8013023360477
1747352924782173,77879164,1,834,100,77604947,77038000,566947,176.38333036421395
1747352924876566,77971724,1,835,100,77699340,77130560,568780,175.81490207109957
1747352924970846,78064284,1,836,100,77793620,77223120,570500,175.28483786152498
1747352925060958,78156844,1,837,100,77883732,77315680,568052,176.0402216698471
1747352925155116,78249404,1,838,100,77977890,77408240,569650,175.54638813306417
1747352925249203,78341964,1,839,100,78071977,77500800,571177,175.0770776834501
1747352925342721,78434524,1,840,100,78165495,77593360,572135,174.783923374728
1747352925433702,78527084,1,841,100,78256476,77685920,570556,175.26763367662423
1747352925527424,78619644,1,842,100,78350198,77778480,571718,174.91140737216602
1747352925621872,78712204,1,843,100,78444646,77871040,573606,174.33569383862792
1747352925716210,78804764,1,844,100,78538984,77963600,575384,173.7969773229704
1747352925805921,78897324,1,845,100,78628695,78056160,572535,174.66181106831897
1747352925900216,78989884,1,846,100,78722990,78148720,574270,174.13411809775891
1747352925994691,79082444,1,847,100,78817465,78241280,576185,173.5553685014362
1747352926088019,79175004,1,848,100,78910793,78333840,576953,173.32434357737978
1747352926178399,79267564,1,849,100,79001173,78426400,574773,173.98172843887934
1747352926272882,79360124,1,850,100,79095656,78518960,576696,173.40158419687322
1747352926366939,79452684,1,851,100,79189713,78611520,578193,172.95263000416818
1747352926461104,79545244,1,852,100,79283878,78704080,579798,172.4738615862766
1747352926551062,79637804,1,853,100,79373836,78796640,577196,173.25137388339488
1747352926650112,79730364,1,854,100,79472886,78889200,583686,171.32499323266276
1747352926747606,79822924,1,855,100,79570380,78981760,588620,169.8888926641976
1747352926834044,79915484,1,856,100,79656818,79074320,582498,171.6744091825208
1747352926928024,80008044,1,857,100,79750798,79166880,583918,171.25692306111472
1747352927018341,80100604,1,858,100,79841115,79259440,581675,171.91730777496022
1747352927112199,80193164,1,859,100,79934973,79352000,582973,171.5345307587144
1747352927207074,80285732,1,860,100,80029848,79444568,585280,170.85839256424276
1747352927300510,80378284,1,861,100,80123284,79537120,586164,170.60071925263236
1747352927390121,80470844,1,862,100,80212895,79629680,583215,171.46335399466747
1747352927489089,80563404,1,863,100,80311863,79722240,589623,169.5998968832627
1747352927579405,80655964,1,864,100,80402179,79814800,587379,170.24782976579007
1747352927673176,80748524,1,865,100,80495950,79907360,588590,169.89755177627893
1747352927764140,80841084,1,866,100,80586914,79999920,586994,170.35949260128723
1747352927862203,80933644,1,867,100,80684977,80092480,592497,168.77722587624916
1747352927952383,81026204,1,868,100,80775157,80185040,590117,169.4579210563329
1747352928045979,81118764,1,869,100,80868753,80277600,591153,169.16094479770888
1747352928140499,81211324,1,870,100,80963273,80370160,593113,168.60193588742786
1747352928230487,81303884,1,871,100,81053261,80462720,590541,169.33625269032973
1747352928325240,81396444,1,872,100,81148014,80555280,592734,168.70974163790166
1747352928427273,81489004,1,873,100,81250047,80647840,602207,166.05585786947012
1747352928513384,81581564,1,874,100,81336158,80740400,595758,167.85339013492057
1747352928607382,81674124,1,875,100,81430156,80832960,597196,167.4492126538021
1747352928697901,81766684,1,876,100,81520675,80925520,595155,168.023456074468
1747352928791911,81859244,1,877,100,81614685,81018080,596605,167.61508871028568
1747352928886139,81951804,1,878,100,81708913,81110640,598273,167.1477736752285
1747352928976341,82044364,1,879,100,81799115,81203200,595915,167.80916741481587
1747352929069753,82136924,1,880,100,81892527,81295760,596767,167.5695874604326
1747352929164152,82229484,1,881,100,81986926,81388320,598606,167.0547906302309
1747352929258305,82322044,1,882,100,82081079,81480880,600199,166.6114072166065
1747352929352703,82414612,1,883,100,82175477,81573448,602029,166.10495507691488
1747352929450855,82507164,1,884,100,82273629,81666000,607629,164.5741068974654
1747352929537010,82599724,1,885,100,82359784,81758560,601224,166.3273588546033
1747352929631169,82692284,1,886,100,82453943,81851120,602823,165.88617222634173
1747352929721259,82784844,1,887,100,82544033,81943680,600353,166.56866876654234
1747352929816043,82877404,1,888,100,82638817,82036240,602577,165.9538946889775
1747352929909897,82969964,1,889,100,82732671,82128800,603871,165.59828175222853
1747352930004192,83062524,1,890,100,82826966,82221360,605606,165.12385940694116
1747352930098514,83155084,1,891,100,82921288,82313920,607368,164.6448281766573
1747352930188662,83247644,1,892,100,83011436,82406480,604956,165.30127810948233
1747352930283023,83340204,1,893,100,83105797,82499040,606757,164.81062435208824
1747352930381045,83432764,1,894,100,83203819,82591600,612219,163.3402426255964
1747352930475105,83525324,1,895,100,83297879,82684160,613719,162.94102023890412
1747352930564831,83617884,1,896,100,83387605,82776720,610885,163.696931501019
1747352930684491,83710444,1,897,100,83507265,82869280,637985,156.74349710416388
1747352933952231,86960444,1,931,100,86775005,86119280,655725,152.50295474474817
1747352934046335,87053004,1,932,100,86869109,86211840,657269,152.14470787455366
1747352934214604,87241244,1,934,100,87037378,86400080,637298,156.91246481237977
1747352934312432,87333804,1,935,100,87135206,86492640,642566,155.62603685847057
1747352934402945,87426364,1,936,100,87225719,86585200,640519,156.12339368543323
1747352934492942,87518924,1,937,100,87315716,86677760,637956,156.75062229997053
1747352934612253,87611484,1,938,100,87435027,86770320,664707,150.44222492015277
1747352934689944,87704044,1,939,100,87512718,86862880,649838,153.88450660010648
1747352934775979,87796604,1,940,100,87598753,86955440,643313,155.44532754662194
1747352934869384,87889164,1,941,100,87692158,87048000,644158,155.24141592590638
1747352934959453,87981724,1,942,100,87782227,87140560,641667,155.84407488619487
1747352935053845,88074284,1,943,100,87876619,87233120,643499,155.40039689261366
1747352935152689,88166844,1,944,100,87975463,87325680,649783,153.8975319452802
1747352935922633,88929164,1,952,100,88745407,88088000,657407,152.11277032340698
1747352936114512,89117404,1,954,100,88937286,88276240,661046,151.27540292203568
1747352936504305,89497004,1,958,100,89327079,88655840,671239,148.978232790407
1747352936585401,89589564,1,959,100,89408175,88748400,659775,151.56682202265924
1747352936680151,89682124,1,960,100,89502925,88840960,661965,151.06538865347866
1747352936765846,89774684,1,961,100,89588620,88933520,655100,152.64845061822624
1747352936860741,89867244,1,962,100,89683515,89026080,657435,152.1062918767635
1747352936950763,89959804,1,963,100,89773537,89118640,654897,152.69576742602274
1747352937045042,90052364,1,964,100,89867816,89211200,656616,152.29601471788686
1747352937138852,90144924,1,965,100,89961626,89303760,657866,152.0066396500199
1747352937228879,90237484,1,966,100,90051653,89396320,655333,152.59417731138214
1747352937323068,90330044,1,967,100,90145842,89488880,656962,152.21580548037784
1747352937416831,90422604,1,968,100,90239605,89581440,658165,151.93758404047617
1747352937511750,90515164,1,969,100,90334524,89674000,660524,151.39495309784354
1747352938014732,90990444,1,974,100,90837506,90149280,688226,145.30110748504126
1747352938084528,91086124,1,975,100,90907302,90244960,662342,150.97940338978958
1747352938178728,91178684,1,976,100,91001502,90337520,663982,150.606492344672
1747352938273562,91271244,1,977,100,91096336,90430080,666256,150.09245695348335
1747352938420561,91363804,1,978,100,91243335,90522640,720695,138.754951817343
1747352938462015,91456364,1,979,100,91284789,90615200,669589,149.34534468158827
1747352938551588,91548924,1,980,100,91374362,90707760,666602,150.0145514114869
1747352938645722,91641484,1,981,100,91468496,90800320,668176,149.66116711764565
1747352938740358,91734052,1,982,100,91563132,90892888,670244,149.19939604084485
1747352938829810,91826604,1,983,100,91652584,90985440,667144,149.89267684338014
1747352938923473,91919164,1,984,100,91746247,91078000,668247,149.6452658971907
1747352939018526,92011724,1,985,100,91841300,91170560,670740,149.08906580791364
1747352939112849,92104284,1,986,100,91935623,91263120,672503,148.6982214205736
1747352939202802,92196844,1,987,100,92025576,91355680,669896,149.2769026834016
1747352939301477,92289404,1,988,100,92124251,91448240,676011,147.92658699340691
1747352939390731,92381964,1,989,100,92213505,91540800,672705,148.65357028712438
1747352939489962,92474524,1,990,100,92312736,91633360,679376,147.1938955747627
1747352939575503,92567084,1,991,100,92398277,91725920,672357,148.73051072570078
1747352939670158,92659644,1,992,100,92492932,91818480,674452,148.26852022086078
1747352939764135,92752204,1,993,100,92586909,91911040,675869,147.9576663525032
1747352939857708,92844764,1,994,100,92680482,92003600,676882,147.7362376307835
1747352939948077,92937324,1,995,100,92770851,92096160,674691,148.21599813840706
1747352940046218,93029884,1,996,100,92868992,92188720,680272,147.00002352000377
1747352940136944,93122444,1,997,100,92959718,92281280,678438,147.3974040369201
1747352940230765,93215004,1,998,100,93053539,92373840,679699,147.12394751206048
1747352940325342,93307564,1,999,100,93148116,92466400,681716,146.68865040574082
1747352940419431,93400124,1,1000,100,93242205,92558960,683245,146.36038317148314
1747352940513645,93493724,1,1001,100,93336419,92652560,683859,146.2289741013864
1747352940611483,93587324,1,1002,100,93434257,92746160,688097,145.3283476021549
1747352940702117,93680924,1,1003,100,93524891,92839760,685131,145.95748842192222
1747352940796234,93774524,1,1004,100,93619008,92933360,685648,145.84743191841878
1747352940890696,93868124,1,1005,100,93713470,93026960,686510,145.66430204949674
1747352940984464,93961724,1,1006,100,93807238,93120560,686678,145.6286643812675
1747352941078386,94055324,1,1007,100,93901160,93214160,687000,145.56040756914118
1747352941173276,94148924,1,1008,100,93996050,93307760,688290,145.28759679786137
1747352941267381,94242524,1,1009,100,94090155,93401360,688795,145.18107709841098
1747352941361834,94336124,1,1010,100,94184608,93494960,689648,145.00150801568336
1747352941456043,94429724,1,1011,100,94278817,93588560,690257,144.87357607383916
1747352941549385,94523324,1,1012,100,94372159,93682160,689999,144.92774627209604
1747352941644002,94616924,1,1013,100,94466776,93775760,691016,144.71444944834852
1747352941738080,94710524,1,1014,100,94560854,93869360,691494,144.6144145863883
1747352941832198,94804124,1,1015,100,94654972,93962960,692012,144.50616463298326
1747352941926225,94897724,1,1016,100,94748999,94056560,692439,144.41705334332698
1747352942020740,94991324,1,1017,100,94843514,94150160,693354,144.2264701725237
1747352942114550,95084924,1,1018,100,94937324,94243760,693564,144.18280072206747
1747352942209136,95178524,1,1019,100,95031910,94337360,694550,143.97811532647037
1747352942303632,95272124,1,1020,100,95126406,94430960,695446,143.79261653672606
1747352942398299,95365724,1,1021,100,95221073,94524560,696513,143.57233820474275
1747352942491863,95459324,1,1022,100,95314637,94618160,696477,143.5797592741756
1747352942585800,95552924,1,1023,100,95408574,94711760,696814,143.51031982709875
1747352942680080,95646524,1,1024,100,95502854,94805360,697494,143.37040892108033
1747352942774987,95740124,1,1025,100,95597761,94898960,698801,143.102256579484
1747352942869309,95833724,1,1026,100,95692083,94992560,699523,142.95455617613715
1747352942963765,95927332,1,1027,100,95786539,95086168,700371,142.78146867874312
1747352943057195,96020924,1,1028,100,95879969,95179760,700209,142.81450252710263
1747352943151426,96114524,1,1029,100,95974200,95273360,700840,142.68591975343872
1747352943245645,96208124,1,1030,100,96068419,95366960,701459,142.56000707097633
1747352943340067,96301724,1,1031,100,96162841,95460560,702281,142.3931446244452
1747352943434004,96395324,1,1032,100,96256778,95554160,702618,142.3248479259
1747352943528286,96488924,1,1033,100,96351060,95647760,703300,142.18683349921795
1747352943622559,96582524,1,1034,100,96445333,95741360,703973,142.05090252040918
1747352943717036,96676124,1,1035,100,96539810,95834960,704850,141.87415762218913
1747352943810875,96769724,1,1036,100,96633649,95928560,705089,141.82606734752636
1747352943909195,96863324,1,1037,100,96731969,96022160,709809,140.88296992571242
1747352943999409,96956924,1,1038,100,96822183,96115760,706423,141.55824484763377
1747352944093632,97050524,1,1039,100,96916406,96209360,707046,141.43351351962957
1747352944191147,97144124,1,1040,100,97013921,96302960,710961,140.65469132624716
1747352944286011,97237724,1,1041,100,97108785,96396560,712225,140.4050686229773
1747352944375641,97331324,1,1042,100,97198415,96490160,708255,141.1920847717277
1747352944474124,97424924,1,1043,100,97296898,96583760,713138,140.22531403459078
1747352944564195,97518524,1,1044,100,97386969,96677360,709609,140.9226771362821
1747352944662509,97612124,1,1045,100,97485283,96770960,714323,139.9926923814577
1747352944756809,97705724,1,1046,100,97579583,96864560,715023,139.8556410073522
1747352944850480,97799324,1,1047,100,97673254,96958160,715094,139.84175506996283
1747352944945340,97892924,1,1048,100,97768114,97051760,716354,139.59578644078206
1747352945039613,97986524,1,1049,100,97862387,97145360,717027,139.4647621358749
1747352945133716,98080124,1,1050,100,97956490,97238960,717530,139.36699510821848
1747352945227592,98173724,1,1051,100,98050366,97332560,717806,139.31340780099356
1747352945321951,98267324,1,1052,100,98144725,97426160,718565,139.16625496649573
1747352945416546,98360924,1,1053,100,98239320,97519760,719560,138.9738173328145
1747352945510691,98454524,1,1054,100,98333465,97613360,720105,138.86863721262873
1747352945604425,98548124,1,1055,100,98427199,97706960,720239,138.8428007925147
1747352945698718,98641724,1,1056,100,98521492,97800560,720932,138.70933735775358
1747352945792713,98735324,1,1057,100,98615487,97894160,721327,138.63337986793783
1747352945887197,98828924,1,1058,100,98709971,97987760,722211,138.46368997425958
1747352945981743,98922532,1,1059,100,98804517,98081368,723149,138.28408806483864
1747352946075920,99016124,1,1060,100,98898694,98174960,723734,138.17231192675763
1747352946169361,99109724,1,1061,100,98992135,98268560,723575,138.2026742217462
1747352946264389,99203324,1,1062,100,99087163,98362160,725003,137.93046373601214
1747352946370845,99296924,1,1063,100,99193619,98455760,737859,135.52724843093327
1747352946551024,99487244,1,1065,100,99373798,98646080,727718,137.4158671353464
1747352946645041,99580844,1,1066,100,99467815,98739680,728135,137.33716961827133
1747352946738897,99674444,1,1067,100,99561671,98833280,728391,137.2889011533641
1747352946833621,99768044,1,1068,100,99656395,98926880,729515,137.07737332337237
1747352946927649,99861644,1,1069,100,99750423,99020480,729943,136.99699839576516
1747352947021375,99955244,1,1070,100,99844149,99114080,730069,136.97335457333486
1747352947115591,100048844,1,1071,100,99938365,99207680,730685,136.85787993458192
1747352947210204,100143484,1,1072,100,100032978,99302320,730658,136.86293724286875
1747352947324745,100238124,1,1073,100,100147519,99396960,750559,133.23402956996054
1747352948020632,100922444,1,1080,100,100843406,100081280,762126,131.21189934472778
1747352948209519,101114844,1,1082,100,101032293,100273680,758613,131.81951798875053
1747352948987794,101896924,1,1090,100,101810568,101055760,754808,132.4840224268953
1747352949196838,102092444,1,1092,100,102019612,101251280,768332,130.15206967821203
1747352949298552,102190204,1,1093,100,102121326,101349040,772286,129.48570866233493
1747352949389168,102284844,1,1094,100,102211942,101443680,768262,130.1639284514918
1747352949467045,102379484,1,1095,100,102289819,101538320,751499,133.06737600449236
1747352949564718,102474124,1,1096,100,102387492,101632960,754532,132.53248371175775
1747352949655385,102568764,1,1097,100,102478159,101727600,750559,133.23402956996054
1747352949749346,102663404,1,1098,100,102572120,101822240,749880,133.3546700805462
1747352949950058,102855804,1,1100,100,102772832,102014640,758192,131.8927131913816
1747352951523127,104416844,1,1116,100,104345901,103575680,770221,129.8328661514033
1747352951641847,104511484,1,1117,100,104464621,103670320,794301,125.89685774032765
1747352952808775,105684604,1,1129,100,105631549,104843440,788109,126.8860018093944
1747352952911069,105782364,1,1130,100,105733843,104941200,792643,126.16020074611144
1747352952993342,105877004,1,1131,100,105816116,105035840,780276,128.15977936012385
1747352953091139,105974764,1,1132,100,105913913,105133600,780313,128.1537024245399
1747352953186275,106069404,1,1133,100,106009049,105228240,780809,128.0722942486575
1747352953284442,106164044,1,1134,100,106107216,105322880,784336,127.49637910283349
1747352953382750,106258684,1,1135,100,106205524,105417520,788004,126.90290912228872
1747352953480453,106353324,1,1136,100,106303227,105512160,791067,126.41154289080444
1747352953582683,106447964,1,1137,100,106405457,105606800,798657,125.21019661757175
1747352953758722,106643492,1,1139,100,106581496,105802328,779168,128.3420263665859
1747352953852797,106738124,1,1140,100,106675571,105896960,778611,128.43383923422607
1747352953951886,106832764,1,1141,100,106774660,105991600,783060,127.70413505989325
1747352954045572,106927404,1,1142,100,106868346,106086240,782106,127.85990645769245
1747352954139940,107022044,1,1143,100,106962714,106180880,781834,127.9043889112011
1747352954234605,107116684,1,1144,100,107057379,106275520,781859,127.90029915879974
1747352954332091,107211324,1,1145,100,107154865,106370160,784705,127.4364251534016
1747352954426327,107305964,1,1146,100,107249101,106464800,784301,127.502068721065
1747352954521019,107400604,1,1147,100,107343793,106559440,784353,127.49361575719097
1747352954619009,107495244,1,1148,100,107441783,106654080,787703,126.95140173390224
1747352954713334,107589884,1,1149,100,107536108,106748720,787388,127.00218951774728
1747352954811957,107684524,1,1150,100,107634731,106843360,791371,126.36298272238936
1747352954901754,107779164,1,1151,100,107724528,106938000,786528,127.14105537247244
1747352955007770,107873804,1,1152,100,107830544,107032640,797904,125.32836030399648
1747352955098575,107968444,1,1153,100,107921349,107127280,794069,125.93364052746044
1747352955188779,108063084,1,1154,100,108011553,107221920,789633,126.64111049056966
1747352955282248,108157724,1,1155,100,108105022,107316560,788462,126.82919405120349
1747352955380810,108252364,1,1156,100,108203584,107411200,792384,126.20143768677814
1747352955479422,108347004,1,1157,100,108302196,107505840,796356,125.57198037058804
1747352955569902,108441644,1,1158,100,108392676,107600480,792196,126.23138718196002
1747352955667166,108536284,1,1159,100,108489940,107695120,794820,125.81464985782944
1747352955761886,108630924,1,1160,100,108584660,107789760,794900,125.8019876714052
1747352955856060,108725564,1,1161,100,108678834,107884400,794434,125.87578074453008
1747352955958781,108820204,1,1162,100,108781555,107979040,802515,124.60826277390454
1747352956049161,108914844,1,1163,100,108871935,108073680,798255,125.2732522815391
1747352956143102,109009484,1,1164,100,108965876,108168320,797556,125.38304520309543
1747352956245501,109104124,1,1165,100,109068275,108262960,805315,124.17501226228246
1747352957035822,109886204,1,1173,100,109858596,109045040,813556,122.91716857843836
1747352957133484,109983964,1,1174,100,109956258,109142800,813458,122.93197681994644
1747352957219496,110078604,1,1175,100,110042270,109237440,804830,124.24984158145196
1747352957318173,110173244,1,1176,100,110140947,109332080,808867,123.62971910091522
1747352957411901,110267884,1,1177,100,110234675,109426720,807955,123.76926932811853
1747352957506152,110362524,1,1178,100,110328926,109521360,807566,123.82888828900673
1747352957617805,110457164,1,1179,100,110440579,109616000,824579,121.27400770575046
1747352957703206,110551804,1,1180,100,110525980,109710640,815340,122.64822037432238
1747352957793503,110646444,1,1181,100,110616277,109805280,810997,123.3050183909435
1747352957887646,110741084,1,1182,100,110710420,109899920,810500,123.38062924120914
1747352957982161,110835732,1,1183,100,110804935,109994568,810367,123.40087886105924
1747352958076335,110930364,1,1184,100,110899109,110089200,809909,123.47066151876322
1747352958173777,111025004,1,1185,100,110996551,110183840,812711,123.04496924490996
1747352958268162,111119644,1,1186,100,111090936,110278480,812456,123.0835885266402
1747352958362906,111214284,1,1187,100,111185680,110373120,812560,123.06783499064686
1747352958460798,111308924,1,1188,100,111283572,110467760,815812,122.57726044725992
1747352958555395,111403564,1,1189,100,111378169,110562400,815769,122.58372161727156
1747352958649502,111498204,1,1190,100,111472276,110657040,815236,122.6638666594704
1747352958743960,111592844,1,1191,100,111566734,110751680,815054,122.69125726638973
1747352958850048,111687484,1,1192,100,111672822,110846320,826502,120.99184272996315
1747352958935820,111782124,1,1193,100,111758594,110940960,817634,122.30411161962444
1747352959030016,111876764,1,1194,100,111852790,111035600,817190,122.370562537476
1747352959124014,111971404,1,1195,100,111946788,111130240,816548,122.46677476400652
1747352959222526,112066044,1,1196,100,112045300,111224880,820420,121.8887886692182
1747352959316196,112160684,1,1197,100,112138970,111319520,819450,122.03307096223077
1747352959411289,112255324,1,1198,100,112234063,111414160,819903,121.96564715582208
1747352959509681,112349964,1,1199,100,112332455,111508800,823655,121.4100563949712
1747352959603129,112444604,1,1200,100,112425903,111603440,822463,121.5860166353988
1747352959697734,112539244,1,1201,100,112520508,111698080,822428,121.59119096139722
1747352959792095,112633892,1,1202,100,112614869,111792728,822141,121.63363705252505
1747352959890437,112728524,1,1203,100,112713211,111887360,825851,121.08721791218996
1747352959984149,112823164,1,1204,100,112806923,111982000,824923,121.22343539942516
1747352960079230,112917804,1,1205,100,112902004,112076640,825364,121.15866454073596
1747352960173375,113012444,1,1206,100,112996149,112171280,824869,121.23137128441002
1747352960271273,113107084,1,1207,100,113094047,112265920,828127,120.75442534780294
1747352960369172,113201724,1,1208,100,113191946,112360560,831386,120.28107281094462
1747352960463474,113296364,1,1209,100,113286248,112455200,831048,120.3299929727284
1747352960557987,113391004,1,1210,100,113380761,112549840,830921,120.34838450346062
1747352960652469,113485644,1,1211,100,113475243,112644480,830763,120.37127315491902
1747352960746745,113580284,1,1212,100,113569519,112739120,830399,120.4240371195052
1747352960840767,113674924,1,1213,100,113663541,112833760,829781,120.5137259108126
1747352960938851,113769564,1,1214,100,113761625,112928400,833225,120.01560202826369
1747352961033002,113864204,1,1215,100,113855776,113023040,832736,120.08607770049572
1747352961127563,113958844,1,1216,100,113950337,113117680,832657,120.09747110755087
1747352961225765,114053484,1,1217,100,114048539,113212320,836219,119.58589795256984
1747352961320089,114148124,1,1218,100,114142863,113306960,835903,119.63110552300924
1747352961414539,114242764,1,1219,100,114237313,113401600,835713,119.65830374781773
1747352961512416,114337404,1,1220,100,114335190,113496240,838950,119.19661481613925
1747352961606759,114432044,1,1221,100,114429533,113590880,838653,119.2388270238108
1747352961700713,114526684,1,1222,100,114523487,113685520,837967,119.33644164985016
1747352961799038,114621324,1,1223,100,114621812,113780160,841652,118.8139516094538
1747352961889108,114715964,1,1224,100,114711882,113874800,837082,119.46260939788456
1747352961987615,114810604,1,1225,100,114810389,113969440,840949,118.91327535914785
1747352962085514,114905244,1,1226,100,114908288,114064080,844208,118.45421981312664
1747352962175755,114999884,1,1227,100,114998529,114158720,839809,119.07469436502824
1747352962282456,115094524,1,1228,100,115105230,114253360,851870,117.38880345592636
1747352962368581,115189164,1,1229,100,115191355,114348000,843355,118.57402873048716
1747352962462268,115283804,1,1230,100,115285042,114442640,842402,118.70817020852276
1747352962556454,115378444,1,1231,100,115379228,114537280,841948,118.7721807047466
1747352962655374,115473084,1,1232,100,115478148,114631920,846228,118.17146206459724
1747352962757684,115567724,1,1233,100,115580458,114726560,853898,117.11000611314232
1747352962850979,115662364,1,1234,100,115673753,114821200,852553,117.29476056034052
1747352962941997,115757004,1,1235,100,115764771,114915840,848931,117.7952036148992
1747352963039681,115851644,1,1236,100,115862455,115010480,851975,117.37433610141142
1747352963134418,115946284,1,1237,100,115957192,115105120,852072,117.36097418997456
1747352963224478,116040924,1,1238,100,116047252,115199760,847492,117.99521411411553
1747352963322702,116135564,1,1239,100,116145476,115294400,851076,117.49831977402722
1747352963420788,116230204,1,1240,100,116243562,115389040,854522,117.02448854447282
1747352963510695,116324844,1,1241,100,116333469,115483680,849789,117.6762702270799
1747352963609716,116419484,1,1242,100,116432490,115578320,854170,117.07271386258004
1747352963703669,116514124,1,1243,100,116526443,115672960,853483,117.16695001540744
1747352963809684,116608764,1,1244,100,116632458,115767600,864858,115.6259177807224
1747352963900327,116703404,1,1245,100,116723101,115862240,860861,116.16277192252872
1747352963990020,116798044,1,1246,100,116812794,115956880,855914,116.83416791873952
1747352964096792,116892692,1,1247,100,116919566,116051528,868038,115.20232985191892
1747352964178182,116987324,1,1248,100,117000956,116146160,854796,116.98697700971928
1747352964277268,117081964,1,1249,100,117100042,116240800,859242,116.3816480106885
1747352964370968,117176604,1,1250,100,117193742,116335440,858302,116.5091075169346
1747352964465409,117271244,1,1251,100,117288183,116430080,858103,116.53612678198306
1747352964563661,117365884,1,1252,100,117386435,116524720,861715,116.04764916474704
1747352964657953,117460524,1,1253,100,117480727,116619360,861367,116.09453345670312
1747352964752256,117555164,1,1254,100,117575030,116714000,861030,116.1399718941268
1747352964846037,117649804,1,1255,100,117668811,116808640,860171,116.25595375803184
1747352964940429,117744444,1,1256,100,117763203,116903280,859923,116.28948173266676
1747352965038466,117839084,1,1257,100,117861240,116997920,863320,115.83190473984156
1747352965132896,117933724,1,1258,100,117955670,117092560,863110,115.86008735850588
1747352965231341,118028364,1,1259,100,118054115,117187200,866915,115.35156272529602
1747352965325477,118123004,1,1260,100,118148251,117281840,866411,115.41866389046308
1747352965419951,118217644,1,1261,100,118242725,117376480,866245,115.4407817649741
1747352965513324,118312284,1,1262,100,118336098,117471120,864978,115.60987678299333
1747352965608261,118406924,1,1263,100,118431035,117565760,865275,115.57019444685216
1747352965706463,118501564,1,1264,100,118529237,117660400,868837,115.09638746968648
1747352965800865,118596204,1,1265,100,118623639,117755040,868599,115.12792439318947
1747352965898631,118690852,1,1266,100,118721405,117849688,871717,114.716129202482
1747352965988342,118785484,1,1267,100,118811116,117944320,866796,115.36739901891563
1747352966086782,118880124,1,1268,100,118909556,118038960,870596,114.86384040358558
1747352966181693,118974764,1,1269,100,119004467,118133600,870867,114.828096597988
1747352966275671,119069404,1,1270,100,119098445,118228240,870205,114.91545095695842
1747352966369387,119164044,1,1271,100,119192161,118322880,869281,115.03760003957294
1747352966467830,119258684,1,1272,100,119290604,118417520,873084,114.5365165322008
1747352966561839,119353324,1,1273,100,119384613,118512160,872453,114.61935485349926
1747352966656536,119447964,1,1274,100,119479310,118606800,872510,114.61186691270014
1747352966754445,119542604,1,1275,100,119577219,118701440,875779,114.18405785021108
1747352966849303,119637244,1,1276,100,119672077,118796080,875997,114.15564208553224
1747352966947253,119731884,1,1277,100,119770027,118890720,879307,113.7259228005691
1747352967050032,119826524,1,1278,100,119872806,118985360,887446,112.68291253777696
1747352967135400,119921164,1,1279,100,119958174,119080000,878174,113.8726493838351
1747352967233772,120015804,1,1280,100,120056546,119174640,881906,113.39076953779654
1747352967528688,120305964,1,1283,100,120351462,119464800,886662,112.78254847957848
1747352967618497,120400604,1,1284,100,120441271,119559440,881831,113.40041345790746
1747352967713119,120495244,1,1285,100,120535893,119654080,881813,113.40272824283608
1747352967811425,120589884,1,1286,100,120634199,119748720,885479,112.93322597147984
1747352968004458,120782284,1,1288,100,120827232,119941120,886112,112.85255137048138
1747352968097973,120876924,1,1289,100,120920747,120035760,884987,112.996010110883
1747352968192924,120971564,1,1290,100,121015698,120130400,885298,112.95631527463068
1747352968286755,121066204,1,1291,100,121109529,120225040,884489,113.05963104120006
1747352968384849,121160844,1,1292,100,121207623,120319680,887943,112.6198415889308
1747352968478743,121255484,1,1293,100,121301517,120414320,887197,112.71453803383014
1747352968576850,121350124,1,1294,100,121399624,120508960,890664,112.27578525684208
1747352968773375,121542524,1,1296,100,121596149,120701360,894789,111.7581910372166
1747352968864062,121637164,1,1297,100,121686836,120796000,890836,112.25410737778896
1747352968962225,121731804,1,1298,100,121784999,120890640,894359,111.81192339988752
1747352969056844,121826444,1,1299,100,121879618,120985280,894338,111.81454886183973
1747352969150689,121921084,1,1300,100,121973463,121079920,893543,111.91403211708894
1747352969261116,122015724,1,1301,100,122083890,121174560,909330,109.97107760658947
1747352969371481,122113484,1,1302,100,122194255,121272320,921935,108.46751669043914
1747352969446117,122208124,1,1303,100,122268891,121366960,901931,110.87322644415148
1747352969535964,122302764,1,1304,100,122358738,121461600,897138,111.46557162889098
1747352969629765,122397404,1,1305,100,122452539,121556240,896299,111.5699113800194
1747352969739923,122492044,1,1306,100,122562697,121650880,911817,109.6711291849132
1747352969831032,122586684,1,1307,100,122653806,121745520,908286,110.09748030906565
1747352969920806,122681324,1,1308,100,122743580,121840160,903420,110.69048725952491
1747352970027217,122775964,1,1309,100,122849991,121934800,915191,109.26680878636265
1747352970108914,122870604,1,1310,100,122931688,122029440,902248,110.83427173016732
1747352970198796,122965244,1,1311,100,123021570,122124080,897490,111.42185428249896
1747352970302025,123059884,1,1312,100,123124799,122218720,906079,110.36565244310928
1747352970395589,123154524,1,1313,100,123218363,122313360,905003,110.49687128108968
1747352970616481,123350052,1,1315,100,123439255,122508888,930367,107.48446580757916
1747352971378996,124132124,1,1323,100,124201770,123290960,910810,109.7923826044949
1747352971477118,124226764,1,1324,100,124299892,123385600,914292,109.37424805204463
1747352971571109,124321404,1,1325,100,124393883,123480240,913643,109.45194129435676
1747352971665408,124416044,1,1326,100,124488182,123574880,913302,109.49280741748076
1747352971759899,124510684,1,1327,100,124582673,123669520,913153,109.51067345778856
1747352971854498,124605324,1,1328,100,124677272,123764160,913112,109.51559063948343
1747352971951973,124699964,1,1329,100,124774747,123858800,915947,109.17662266484852
1747352972045973,124797724,1,1330,100,124868747,123956560,912187,109.62664453670136
1747352972140285,124892364,1,1331,100,124963059,124051200,911859,109.6660777598291
1747352972243379,124987004,1,1332,100,125066153,124145840,920313,108.65868459969596
1747352972333807,125081644,1,1333,100,125156581,124240480,916101,109.15826966677254
1747352972428028,125176284,1,1334,100,125250802,124335120,915682,109.20821857369698
1747352972525676,125270924,1,1335,100,125348450,124429760,918690,108.85064602858418
1747352972619571,125365564,1,1336,100,125442345,124524400,917945,108.93898871936771
1747352972922893,125655724,1,1339,100,125745667,124814560,931107,107.39904221534152
1747352973103763,125848124,1,1341,100,125926537,125006960,919577,108.74565153325932
1747352973218366,125942764,1,1342,100,126041140,125101600,939540,106.43506396747344
1747352973791081,126526204,1,1348,100,126613855,125685040,928815,107.66406657945878
1747352973885397,126620844,1,1349,100,126708171,125779680,928491,107.70163631096048
1747352973987848,126715484,1,1350,100,126810622,125874320,936302,106.80314684791873
1747352974077320,126810132,1,1351,100,126900094,125968968,931126,107.39685069475024
1747352974172128,126904764,1,1352,100,126994902,126063600,931302,107.3765545440684
1747352974282567,126999404,1,1353,100,127105341,126158240,947101,105.5853599563299
1747352974376917,127094044,1,1354,100,127199691,126252880,946811,105.61769983660942
1747352975544556,128267164,1,1366,100,128367330,127426000,941330,106.23267079557648
1747352975859561,128557324,1,1369,100,128682335,127716160,966175,103.50091857065232
1747352975949432,128655084,1,1370,100,128772206,127813920,958286,104.35298021676202
1747352976031833,128749724,1,1371,100,128854607,127908560,946047,105.70299361448215
1747352976126338,128844364,1,1372,100,128949112,128003200,945912,105.71807948308088
1747352976219844,128939004,1,1373,100,129042618,128097840,944778,105.84497098789345
1747352976314533,129033644,1,1374,100,129137307,128192480,944827,105.8394817252259
1747352976408025,129128284,1,1375,100,129230799,128287120,943679,105.96823708061746
1747352976502745,129222924,1,1376,100,129325519,128381760,943759,105.95925442830216
1747352976600822,129317564,1,1377,100,129423596,128476400,947196,105.57477016372536
1747352976699434,129412204,1,1378,100,129522208,128571040,951168,105.13389853317184
1747352976789571,129506844,1,1379,100,129612345,128665680,946665,105.6339887922338
1747352976887110,129601484,1,1380,100,129709884,128760320,949564,105.3114903260865
1747352976981608,129696124,1,1381,100,129804382,128854960,949422,105.327241205702
1747352977075584,129790764,1,1382,100,129898358,128949600,948758,105.40095577586698
1747352977169966,129885404,1,1383,100,129992740,129044240,948500,105.42962572482868
1747352977268796,129980044,1,1384,100,130091570,129138880,952690,104.96593855293956
1747352977362997,130074684,1,1385,100,130185771,129233520,952251,105.01432920522004
1747352977457211,130169324,1,1386,100,130279985,129328160,951825,105.06132955112548
1747352977555086,130263964,1,1387,100,130377860,129422800,955060,104.70546353108703
1747352977649383,130358604,1,1388,100,130472157,129517440,954717,104.7430809339312
1747352977743436,130453244,1,1389,100,130566210,129612080,954130,104.80752098770608
1747352977838443,130547884,1,1390,100,130661217,129706720,954497,104.7672229456981
1747352977936085,130642524,1,1391,100,130758859,129801360,957499,104.4387513720641
1747352978030640,130737172,1,1392,100,130853414,129896008,957406,104.44889628851293
1747352978124003,130831804,1,1393,100,130946777,129990640,956137,104.58752249939076
1747352978218579,130926444,1,1394,100,131041353,130085280,956073,104.59452363993128
1747352978316451,131021084,1,1395,100,131139225,130179920,959305,104.2421336279911
1747352978411219,131115724,1,1396,100,131233993,130274560,959433,104.22822646292131
1747352978505758,131210364,1,1397,100,131328532,130369200,959332,104.23919977651116
1747352978603752,131305004,1,1398,100,131426526,130463840,962686,103.8760301905294
1747352978697865,131399644,1,1399,100,131520639,130558480,962159,103.9329258469754
1747352978795861,131494284,1,1400,100,131618635,130653120,965515,103.57166900566018
1747352978886333,131588924,1,1401,100,131709107,130747760,961347,104.02071260429378
1747352978984732,131683564,1,1402,100,131807506,130842400,965106,103.61556139947322
1747352979079051,131778204,1,1403,100,131901825,130937040,964785,103.65003601838752
1747352979172771,131872844,1,1404,100,131995545,131031680,963865,103.74896899462064
1747352979271567,131967484,1,1405,100,132094341,131126320,968021,103.3035440346852
1747352979364947,132062124,1,1406,100,132187721,131220960,966761,103.43818172226642
1747352979459250,132156764,1,1407,100,132282024,131315600,966424,103.47425146726488
1747352979554290,132251404,1,1408,100,132377064,131410240,966824,103.43144150331396
1747352979651746,132346044,1,1409,100,132474520,131504880,969640,103.1310589497133
1747352979745884,132440684,1,1410,100,132568658,131599520,969138,103.18447940334606
1747352979840736,132535332,1,1411,100,132663510,131694168,969342,103.1627640193038
1747352979935161,132629964,1,1412,100,132757935,131788800,969135,103.18479881543853
1747352980033497,132724604,1,1413,100,132856271,131883440,972831,102.79277695714876
1747352980127549,132819244,1,1414,100,132950323,131978080,972243,102.85494470003898
1747352980221483,132913884,1,1415,100,133044257,132072720,971537,102.92968770103457
1747352980319507,133008524,1,1416,100,133142281,132167360,974921,102.57241355966278
1747352980414423,133103164,1,1417,100,133237197,132262000,975197,102.54338354199204
1747352980508614,133197804,1,1418,100,133331388,132356640,974748,102.59061829313832
1747352980602164,133292444,1,1419,100,133424938,132451280,973658,102.7054674228528
1747352980700989,133387084,1,1420,100,133523763,132545920,977843,102.26590567197393
1747352980794927,133481724,1,1421,100,133617701,132640560,977141,102.3393757912113
1747352980889597,133576364,1,1422,100,133712371,132735200,977171,102.33623388332236
1747352980983836,133671004,1,1423,100,133806610,132829840,976770,102.37824667014752
1747352981080788,133765644,1,1424,100,133903562,132924480,979082,102.13649112127484
1747352981175276,133860284,1,1425,100,133998050,133019120,978930,102.1523500148121
1747352981270198,133954924,1,1426,100,134092972,133113760,979212,102.12293150002247
1747352981368206,134049564,1,1427,100,134190980,133208400,982580,101.77288363288486
1747352981461976,134144204,1,1428,100,134284750,133303040,981710,101.86307565370628
1747352981556751,134238844,1,1429,100,134379525,133397680,981845,101.84906986336948
1747352981655383,134333484,1,1430,100,134478157,133492320,985837,101.43664723478628
1747352981749380,134428124,1,1431,100,134572154,133586960,985194,101.50285121509064
1747352981843236,134522764,1,1432,100,134666010,133681600,984410,101.5836897227781
1747352981937241,134617404,1,1433,100,134760015,133776240,983775,101.64925923102336
1747352982036238,134712044,1,1434,100,134859012,133870880,988132,101.2010541101796
1747352982130271,134806684,1,1435,100,134953045,133965520,987525,101.263259157996
1747352982228796,134901324,1,1436,100,135051570,134060160,991410,100.86644274316376
1747352982519507,135191484,1,1439,100,135342281,134350320,991961,100.8104149255868
1747352982612913,135286124,1,1440,100,135435687,134444960,990727,100.93597933638632
1747352982707260,135380764,1,1441,100,135530034,134539600,990434,100.965839217959
1747352982801751,135475404,1,1442,100,135624525,134634240,990285,100.98103071338048
1747352982900441,135570044,1,1443,100,135723215,134728880,994335,100.56972750632332
1747352982994527,135664684,1,1444,100,135817301,134823520,993781,100.62579179919922
1747352983088218,135759324,1,1445,100,135910992,134918160,992832,100.72197511764328
1747352983182859,135853964,1,1446,100,136005633,135012800,992833,100.72187366858272
1747352983281395,135948604,1,1447,100,136104169,135107440,996729,100.32817345537252
1747352983375571,136043244,1,1448,100,136198345,135202080,996265,100.37490025244288
1747352983469687,136137884,1,1449,100,136292461,135296720,995741,100.42772166657797
1747352983567341,136232524,1,1450,100,136390115,135391360,998755,100.12465519571867
1747352983661661,136327164,1,1451,100,136484435,135486000,998435,100.15674530640452
1747352983755652,136421804,1,1452,100,136578426,135580640,997786,100.22189126726572
1747352983850000,136516444,1,1453,100,136672774,135675280,997494,100.25122958133082
1747352983948212,136611084,1,1454,100,136770986,135769920,1001066,99.89351351459344
1747352984042734,136705724,1,1455,100,136865508,135864560,1000948,99.90528978528356
1747352984137344,136800364,1,1456,100,136960118,135959200,1000918,99.90828419510888
1747352984235142,136895004,1,1457,100,137057916,136053840,1004076,99.5940546333146
1747352984329162,136989644,1,1458,100,137151936,136148480,1003456,99.65559027999235
1747352984436366,137084284,1,1459,100,137259140,136243120,1016020,98.42325938465778
1747352984522092,137178924,1,1460,100,137344866,136337760,1007106,99.2944138948631
1747352984616304,137273564,1,1461,100,137439078,136432400,1006678,99.33662998496044
1747352984709918,137368204,1,1462,100,137532692,136527040,1005652,99.43797655650263
1747352984807347,137462844,1,1463,100,137630121,136621680,1008441,99.1629654089828
1747352984996909,137655244,1,1465,100,137819683,136814080,1005603,99.4428218690676
1747352985095538,137749884,1,1466,100,137918312,136908720,1009592,99.049913232276
1747352985189187,137844524,1,1467,100,138011961,137003360,1008601,99.14723463490516
1747352985283604,137939164,1,1468,100,138106378,137098000,1008378,99.16916077106006
1747352985381683,138033804,1,1469,100,138204457,137192640,1011817,98.83210106175326
1747352985476585,138128444,1,1470,100,138299359,137287280,1012079,98.80651609212325
1747352985570027,138223084,1,1471,100,138392801,137381920,1010881,98.92361217591387
1747352985665189,138317724,1,1472,100,138487963,137476560,1011403,98.8725562411818
1747352985763007,138412364,1,1473,100,138585781,137571200,1014581,98.5628550110834
1747352985856553,138507004,1,1474,100,138679327,137665840,1013487,98.66924785419052
1747352985950964,138601644,1,1475,100,138773738,137760480,1013258,98.69154746372593
1747352986045867,138696284,1,1476,100,138868641,137855120,1013521,98.6659378542724
1747352986143734,138790932,1,1477,100,138966508,137949768,1016740,98.35356138245766
1747352986237921,138885564,1,1478,100,139060695,138044400,1016295,98.3966269636277
1747352986332369,138980204,1,1479,100,139155143,138139040,1016103,98.41521971689878
1747352986430596,139074844,1,1480,100,139253370,138233680,1019690,98.0690209769636
1747352986525075,139169484,1,1481,100,139347849,138328320,1019529,98.0845076501012
1747352986619230,139264124,1,1482,100,139442004,138422960,1019044,98.13118962478558
1747352986712884,139358764,1,1483,100,139535658,138517600,1018058,98.22623072555788
1747352986811587,139453404,1,1484,100,139634361,138612240,1022121,97.83577482509408
1747352986905445,139548044,1,1485,100,139728219,138706880,1021339,97.91068391591824
1747352987000177,139642684,1,1486,100,139822951,138801520,1021431,97.90186512843256
1747352987098220,139737324,1,1487,100,139920994,138896160,1024834,97.57677828799592
1747352987192700,139831964,1,1488,100,140015474,138990800,1024674,97.59201463099484
1747352987286835,139926604,1,1489,100,140109609,139085440,1024169,97.6401355635642
1747352987380830,140021244,1,1490,100,140203604,139180080,1023524,97.70166600880876
1747352987478712,140115884,1,1491,100,140301486,139274720,1026766,97.3931742967726
1747352987573683,140210524,1,1492,100,140396457,139369360,1027097,97.36178764031052
1747352987671793,140305164,1,1493,100,140494567,139464000,1030567,97.0339628573397
1747352987765118,140399804,1,1494,100,140587892,139558640,1029252,97.1579360545328
1747352987860345,140494444,1,1495,100,140683119,139653280,1029839,97.1025568074233
1747352987953719,140589092,1,1496,100,140776493,139747928,1028565,97.22282986490887
1747352988048406,140683724,1,1497,100,140871180,139842560,1028620,97.21763138962882
1747352988155068,140778364,1,1498,100,140977842,139937200,1040642,96.09452626359496
1747352988241129,140873004,1,1499,100,141063903,140031840,1032063,96.89330980763772
1747352988343002,140967644,1,1500,100,141165776,140126480,1039296,96.21897900117004
1747351963754720,109580,1,1,12,0,0,0,0.0
1747351963840605,197404,1,2,12,85885,87824,-1939,0.0
1747351963930698,285804,1,3,12,175978,176224,-246,0.0
1747351964020371,374204,1,4,12,265651,264624,1027,11684.518013631938
1747351964106461,462604,1,5,12,351741,353024,-1283,0.0
1747351964197102,551004,1,6,12,442382,441424,958,12526.096033402922
1747351964286870,639404,1,7,12,532150,529824,2326,5159.071367153912
1747351964376977,727804,1,8,12,622257,618224,4033,2975.45251673692
1747351964663499,1000284,1,11,12,908779,890704,18075,663.9004149377593
1747351964753696,1090764,1,12,12,998976,981184,17792,674.4604316546763
1747351964835861,1181244,1,13,12,1081141,1071664,9477,1266.2234884457107
1747351964926166,1271724,1,14,12,1171446,1162144,9302,1290.0451515803054
1747351965015670,1362204,1,15,12,1260950,1252624,8326,1441.268316118184
1747351965106312,1452684,1,16,12,1351592,1343104,8488,1413.760603204524
1747351965208649,1543164,1,17,12,1453929,1433584,20345,589.8255099533055
1747351965290074,1633644,1,18,12,1535354,1524064,11290,1062.887511071745
1747351965385058,1724124,1,19,12,1630338,1614544,15794,759.7821957705459
1747351965479331,1814604,1,20,12,1724611,1705024,19587,612.6512482769184
1747351965576707,1905084,1,21,12,1821987,1795504,26483,453.1208699920704
1747351965663643,1995564,1,22,12,1908923,1885984,22939,523.1265530319542
1747351965752999,2086044,1,23,12,1998279,1976464,21815,550.0802200320879
1747351965847470,2176524,1,24,12,2092750,2066944,25806,465.0081376424088
1747351965937482,2267004,1,25,12,2182762,2157424,25338,473.5969689793985
1747351966027912,2357484,1,26,12,2273192,2247904,25288,474.5333755140778
1747351966109544,2447964,1,27,12,2354824,2338384,16440,729.92700729927
1747351966199573,2538444,1,28,12,2444853,2428864,15989,750.5159797360685
1747351966293707,2628924,1,29,12,2538987,2519344,19643,610.9046479661965
1747351966383977,2719404,1,30,12,2629257,2609824,19433,617.5063037101837
1747351966477963,2809892,1,31,12,2723243,2700312,22931,523.3090576076054
1747351966568441,2900364,1,32,12,2813721,2790784,22937,523.1721672407028
1747351966658265,2990844,1,33,12,2903545,2881264,22281,538.5754678874378
1747351966756861,3081324,1,34,12,3002141,2971744,30397,394.7758002434451
1747351966838786,3171804,1,35,12,3084066,3062224,21842,549.4002380734365
1747351966940694,3262284,1,36,12,3185974,3152704,33270,360.6853020739405
1747351967031096,3352764,1,37,12,3276376,3243184,33192,361.532899493854
1747351967116850,3443244,1,38,12,3362130,3333664,28466,421.5555399423874
1747351967214670,3533724,1,39,12,3459950,3424144,35806,335.1393621180808
1747351967301810,3624204,1,40,12,3547090,3514624,32466,369.6174459434485
1747351967387070,3714684,1,41,12,3632350,3605104,27246,440.43162299053074
1747351967481558,3805164,1,42,12,3726838,3695584,31254,383.95085429065085
1747351967567551,3895644,1,43,12,3812831,3786064,26767,448.3132215040909
1747351967661461,3986124,1,44,12,3906741,3876544,30197,397.3904692519124
1747351967755839,4076604,1,45,12,4001119,3967024,34095,351.9577650681918
1747351967853908,4167084,1,46,12,4099188,4057504,41684,287.8802418194031
1747351967932398,4257564,1,47,12,4177678,4147984,29694,404.1220448575469
1747351968026479,4348044,1,48,12,4271759,4238464,33295,360.4144766481454
1747351968116354,4438524,1,49,12,4361634,4328944,32690,367.0847353930866
1747351968210282,4529004,1,50,12,4455562,4419424,36138,332.06043499916984
1747351968296761,4619484,1,51,12,4542041,4509904,32137,373.4013753617326
1747351968391270,4709964,1,52,12,4636550,4600384,36166,331.8033512138473
1747351968480881,4800444,1,53,12,4726161,4690864,35297,339.97223560075923
1747351968574592,4890924,1,54,12,4819872,4781344,38528,311.4617940199336
1747351968661733,4981404,1,55,12,4907013,4871824,35189,341.0156583023104
1747351968755806,5071892,1,56,12,5001086,4962312,38774,309.48573786558
1747351968847037,5162364,1,57,12,5092317,5052784,39533,303.54387473756105
1747351968935107,5252844,1,58,12,5180387,5143264,37123,323.2497373595884
1747351969025005,5343324,1,59,12,5270285,5233744,36541,328.39823759612494
1747351969120018,5433804,1,60,12,5365298,5324224,41074,292.1556215610849
1747351969209762,5524284,1,61,12,5455042,5414704,40338,297.48624126134166
1747351969299990,5614764,1,62,12,5545270,5505184,40086,299.356383774884
1747351969389971,5705244,1,63,12,5635251,5595664,39587,303.12981534342083
1747351969484534,5795724,1,64,12,5729814,5686144,43670,274.7881841080833
1747351969578353,5886204,1,65,12,5823633,5776624,47009,255.2702673956051
1747351969664146,5976684,1,66,12,5909426,5867104,42322,283.54047540286376
1747351969767184,6067164,1,67,12,6012464,5957584,54880,218.6588921282799
1747351969860809,6157644,1,68,12,6106089,6048064,58025,206.80741059887976
1747351969951661,6248124,1,69,12,6196941,6138544,58397,205.49000804835865
1747351970037671,6338604,1,70,12,6282951,6229024,53927,222.52304040647545
1747351970131458,6429084,1,71,12,6376738,6319504,57234,209.6655833944858
1747351970225672,6519564,1,72,12,6470952,6409984,60968,196.82456370555045
1747351970308058,6610044,1,73,12,6553338,6500464,52874,226.9546468963952
1747351970406151,6700524,1,74,12,6651431,6590944,60487,198.38973663762465
1747351970496130,6791004,1,75,12,6741410,6681424,59986,200.0466775580969
1747351970582055,6881484,1,76,12,6827335,6771904,55431,216.485360177518
1747351970680017,6971964,1,77,12,6925297,6862384,62913,190.73959277096944
1747351970770738,7062444,1,78,12,7016018,6952864,63154,190.011717389239
1747351970856616,7152924,1,79,12,7101896,7043344,58552,204.9460308785353
1747351970954875,7243404,1,80,12,7200155,7133824,66331,180.91088631258387
1747351971044942,7333884,1,81,12,7290222,7224304,65918,182.0443581419339
1747351971131204,7424364,1,82,12,7376484,7314784,61700,194.48946515397083
1747351971225223,7514844,1,83,12,7470503,7405264,65239,183.9390548598231
1747351971318912,7605324,1,84,12,7564192,7495744,68448,175.3155680224404
1747351971404929,7695804,1,85,12,7650209,7586224,63985,187.5439556145972
1747351971499087,7786284,1,86,12,7744367,7676704,67663,177.34951154988693
1747351971585375,7876764,1,87,12,7830655,7767184,63471,189.0627215578768
1747351971683589,7967244,1,88,12,7928869,7857664,71205,168.52749104697702
1747351971773419,8057724,1,89,12,8018699,7948144,70555,170.0800793707037
1747351971863617,8148204,1,90,12,8108897,8038624,70273,170.76259729910493
1747351971949608,8238684,1,91,12,8194888,8129104,65784,182.41517694272164
1747351972044481,8329164,1,92,12,8289761,8219584,70177,170.9961953346538
1747351972134333,8419644,1,93,12,8379613,8310064,69549,172.54022343958937
1747351972223771,8510124,1,94,12,8469051,8400544,68507,175.1645817215759
1747351972315112,8600612,1,95,12,8560392,8491032,69360,173.01038062283737
1747351972408711,8691084,1,96,12,8653991,8581504,72487,165.54692565563482
1747351972502669,8781564,1,97,12,8747949,8671984,75965,157.9674850259988
1747351972589209,8872044,1,98,12,8834489,8762464,72025,166.60881638320026
1747351972679014,8962524,1,99,12,8924294,8852944,71350,168.18500350385426
1747351972773012,9053004,1,100,12,9018292,8943424,74868,160.28209648982207
1747351972859584,9144524,1,101,12,9104864,9034944,69920,171.62471395881008
1747351972962099,9236044,1,102,12,9207379,9126464,80915,148.30377556695296
1747351973051373,9327564,1,103,12,9296653,9217984,78669,152.53784845364757
1747351973142232,9419084,1,104,12,9387512,9309504,78008,153.8303763716542
1747351973236317,9510604,1,105,12,9481597,9401024,80573,148.9332654859568
1747351973321830,9602124,1,106,12,9567110,9492544,74566,160.93125553201193
1747351973419979,9693644,1,107,12,9665259,9584064,81195,147.79235174579716
1747351973506864,9785164,1,108,12,9752144,9675584,76560,156.7398119122257
1747351973600264,9876684,1,109,12,9845544,9767104,78440,152.9831718510964
1747351973698526,9968204,1,110,12,9943806,9858624,85182,140.87483271113618
1747351973788876,10059724,1,111,12,10034156,9950144,84012,142.836737608913
1747351973878980,10152284,1,112,12,10124260,10042704,81556,147.138162734808
1747351973977765,10247964,1,113,12,10223045,10138384,84661,141.7417701184725
1747351974067502,10340524,1,114,12,10312782,10230944,81838,146.63114934382563
1747351974357926,10624444,1,117,12,10603206,10514864,88342,135.83572932467
1747351974448568,10717004,1,118,12,10693848,10607424,86424,138.8503193557345
1747351974542477,10809564,1,119,12,10787757,10699984,87773,136.71630227974433
1747351974632556,10902124,1,120,12,10877836,10792544,85292,140.69314824368053
1747351974727003,10994684,1,121,12,10972283,10885104,87179,137.64782803198017
1747351974821633,11087244,1,122,12,11066913,10977664,89249,134.45528801443157
1747351974914897,11179804,1,123,12,11160177,11070224,89953,133.40299934410191
1747351975009875,11272364,1,124,12,11255155,11162784,92371,129.9109027725152
1747351975099247,11364924,1,125,12,11344527,11255344,89183,134.55479183252413
1747351975194068,11457484,1,126,12,11439348,11347904,91444,131.22785529941822
1747351975288154,11550044,1,127,12,11533434,11440464,92970,129.07389480477573
1747351975382354,11642604,1,128,12,11627634,11533024,94610,126.83648662932036
1747351975472306,11735164,1,129,12,11717586,11625584,92002,130.43194713158408
1747351975566647,11827724,1,130,12,11811927,11718144,93783,127.95495985413132
1747351975660488,11920284,1,131,12,11905768,11810704,95064,126.23074981065388
1747351975758787,12012844,1,132,12,12004067,11903264,100803,119.0440760691646
1747351975845573,12105404,1,133,12,12090853,11995824,95029,126.27724168411748
1747351975938879,12197964,1,134,12,12184159,12088384,95775,125.29365700861392
1747351976032776,12290524,1,135,12,12278056,12180944,97112,123.56866298706647
1747351976127651,12383084,1,136,12,12372931,12273504,99427,120.69156265400746
1747351976217457,12475644,1,137,12,12462737,12366064,96673,124.12979839251912
1747351976311957,12568204,1,138,12,12557237,12458624,98613,121.6878099236409
1747351976405976,12660772,1,139,12,12651256,12551192,100064,119.92324912056284
1747351976499857,12753324,1,140,12,12745137,12643744,101393,118.35136547887922
1747351976594431,12845884,1,141,12,12839711,12736304,103407,116.0463024746874
1747351976684242,12938444,1,142,12,12929522,12828864,100658,119.21556160464148
1747351976779156,13031004,1,143,12,13024436,12921424,103012,116.49128256902108
1747351976881220,13123564,1,144,12,13126500,13013984,112516,106.65149845355327
1747351976966720,13216124,1,145,12,13212000,13106544,105456,113.79153390987712
1747351977056935,13308684,1,146,12,13302215,13199104,103111,116.37943575370232
1747351977151365,13401244,1,147,12,13396645,13291664,104981,114.30639830064489
1747351977246100,13493804,1,148,12,13491380,13384224,107156,111.98626301840308
1747351977339785,13586364,1,149,12,13585065,13476784,108281,110.82276669037044
1747351977429599,13678924,1,150,12,13674879,13569344,105535,113.706353342493
1747351977524096,13771484,1,151,12,13769376,13661904,107472,111.65698972755696
1747351977618870,13864044,1,152,12,13864150,13754464,109686,109.40320551392156
1747351977712713,13956604,1,153,12,13957993,13847024,110969,108.13830889707936
1747351977802377,14049164,1,154,12,14047657,13939584,108073,111.0360589601473
1747351977908737,14141724,1,155,12,14154017,14032144,121873,98.46315426714696
1747351977991210,14234284,1,156,12,14236490,14124704,111786,107.34796843969728
1747351978085663,14326844,1,157,12,14330943,14217264,113679,105.56039374026864
1747351978179527,14419404,1,158,12,14424807,14309824,114983,104.3632536983728
1747351978269354,14511964,1,159,12,14514634,14402384,112250,106.90423162583518
1747351978364179,14604524,1,160,12,14609459,14494944,114515,104.7897655328996
1747351978458176,14697084,1,161,12,14703456,14587504,115952,103.49109976542016
1747351978552295,14789652,1,162,12,14797575,14680072,117503,102.1250521263287
1747351978642462,14882204,1,163,12,14887742,14772624,115118,104.24086589412605
1747351978736488,14974764,1,164,12,14981768,14865184,116584,102.93007616825638
1747351978830995,15067324,1,165,12,15076275,14957744,118531,101.23933823219242
1747351978924482,15159884,1,166,12,15169762,15050304,119458,100.45371595037588
1747351979014922,15252444,1,167,12,15260202,15142864,117338,102.26865976921373
1747351979109369,15345004,1,168,12,15354649,15235424,119225,100.65003145313484
1747351979203584,15437564,1,169,12,15448864,15327984,120880,99.27200529450695
1747351979297905,15530124,1,170,12,15543185,15420544,122641,97.84656028571196
1747351979391486,15625804,1,171,12,15636766,15516224,120542,99.55036418841566
1747351979481366,15718364,1,172,12,15726646,15608784,117862,101.81398584785596
1747351979580715,15810924,1,173,12,15825995,15701344,124651,96.26878244057409
1747351979674548,15903484,1,174,12,15919828,15793904,125924,95.29557510879576
1747351979765107,15996044,1,175,12,16010387,15886464,123923,96.8343245402387
1747351979859285,16088604,1,176,12,16104565,15979024,125541,95.5863024828542
1747351979952973,16181164,1,177,12,16198253,16071584,126669,94.73509698505552
1747351980047030,16273724,1,178,12,16292310,16164144,128166,93.62857544122464
1747351980137026,16366284,1,179,12,16382306,16256704,125602,95.53987993821757
1747351980231873,16458844,1,180,12,16477153,16349264,127889,93.83136939064345
1747351980325698,16551404,1,181,12,16570978,16441824,129154,92.91233720984252
1747351980419993,16643964,1,182,12,16665273,16534384,130889,91.68073711312638
1747351980510314,16736524,1,183,12,16755594,16626944,128650,93.27633113097552
1747351980604647,16829084,1,184,12,16849927,16719504,130423,92.0083114174647
1747351980698539,16921644,1,185,12,16943819,16812064,131755,91.0781374520891
1747351980792650,17014204,1,186,12,17037930,16904624,133306,90.01845378302552
1747351980886375,17106764,1,187,12,17131655,16997184,134471,89.23857188538793
1747351980977124,17199324,1,188,12,17222404,17089744,132660,90.45680687471732
1747351981071186,17291884,1,189,12,17316466,17182304,134162,89.44410488812034
1747351981164906,17384444,1,190,12,17410186,17274864,135322,88.67737692319061
1747351981259079,17477004,1,191,12,17504359,17367424,136935,87.6328184905247
1747351981349540,17569564,1,192,12,17594820,17459984,134836,88.99700376753982
1747351981443485,17662124,1,193,12,17688765,17552544,136221,88.09214438302463
1747351981537715,17754684,1,194,12,17782995,17645104,137891,87.02525908144838
1747351981632490,17847244,1,195,12,17877770,17737664,140106,85.64943685495267
1747351981722981,17939804,1,196,12,17968261,17830224,138037,86.93321355868355
1747351981816328,18032364,1,197,12,18061608,17922784,138824,86.44038494784763
1747351981910634,18124924,1,198,12,18155914,18015344,140570,85.36672120651633
1747351982004497,18217484,1,199,12,18249777,18107904,141873,84.5826901524603
1747351982095571,18310044,1,200,12,18340851,18200464,140387,85.47800009972433
1747351982193712,18402604,1,201,12,18438992,18293024,145968,82.20979940808945
1747351982283856,18495164,1,202,12,18529136,18385584,143552,83.5934016941596
1747351982377197,18587724,1,203,12,18622477,18478144,144333,83.14106960986054
1747351982472253,18680284,1,204,12,18717533,18570704,146829,81.72772408720348
1747351982562421,18772844,1,205,12,18807701,18663264,144437,83.08120495440919
1747351982656262,18865404,1,206,12,18901542,18755824,145718,82.35084203735984
1747351982750953,18957964,1,207,12,18996233,18848384,147849,81.16389018525658
1747351982844781,19050532,1,208,12,19090061,18940952,149109,80.47803955495644
1747351982935012,19143084,1,209,12,19180292,19033504,146788,81.75055181622476
1747351983029348,19235644,1,210,12,19274628,19126064,148564,80.7732694327024
1747351983123312,19328204,1,211,12,19368592,19218624,149968,80.01707030833245
1747351983217247,19420764,1,212,12,19462527,19311184,151343,79.29008939957579
1747351983307219,19513324,1,213,12,19552499,19403744,148755,80.66955732580418
1747351983402168,19605884,1,214,12,19647448,19496304,151144,79.3944847297941
1747351983496011,19698444,1,215,12,19741291,19588864,152427,78.72620992343876
1747351983590714,19791004,1,216,12,19835994,19681424,154570,77.63472860192792
1747351983680552,19883564,1,217,12,19925832,19773984,151848,79.0263948158685
1747351983774850,19976124,1,218,12,20020130,19866544,153586,78.13212141731668
1747351983868285,20068684,1,219,12,20113565,19959104,154461,77.68951385786704
1747351983962270,20161244,1,220,12,20207550,20051664,155886,76.97933104961318
1747351984053100,20253804,1,221,12,20298380,20144224,154156,77.8432237473728
1747351984147513,20346364,1,222,12,20392793,20236784,156009,76.91863930927062
1747351984241110,20438924,1,223,12,20486390,20329344,157046,76.41073316098469
1747351984343271,20531484,1,224,12,20588551,20421904,166647,72.00849700264632
1747351984429882,20624044,1,225,12,20675162,20514464,160698,74.6742336556771
1747351984519327,20716604,1,226,12,20764607,20607024,157583,76.15034616678194
1747351984613963,20809164,1,227,12,20859243,20699584,159659,75.1601851445894
1747351984708326,20901724,1,228,12,20953606,20792144,161462,74.32089284165934
1747351984802080,20994284,1,229,12,21047360,20884704,162656,73.77532952980523
1747351984892322,21086844,1,230,12,21137602,20977264,160338,74.84189649365715
1747351984986787,21179412,1,231,12,21232067,21069832,162235,73.96677658951522
1747351985080681,21271964,1,232,12,21325961,21162384,163577,73.35994669177207
1747351985175175,21364524,1,233,12,21420455,21254944,165511,72.50273395725964
1747351985265508,21457084,1,234,12,21510788,21347504,163284,73.49158521349305
1747351985359176,21549644,1,235,12,21604456,21440064,164392,72.9962528590199
1747351985453186,21642204,1,236,12,21698466,21532624,165842,72.3580275201698
1747351985548101,21734764,1,237,12,21793381,21625184,168197,71.34491102695054
1747351985641663,21827324,1,238,12,21886943,21717744,169199,70.92240497875284
1747351985731265,21919884,1,239,12,21976545,21810304,166241,72.1843588525093
1747351985826511,22012444,1,240,12,22071791,21902864,168927,71.03660160897903
1747351985920202,22105004,1,241,12,22165482,21995424,170058,70.5641604629009
1747351986014884,22197564,1,242,12,22260164,22087984,172180,69.69450574979672
1747351986104887,22290124,1,243,12,22350167,22180544,169623,70.74512300808263
1747351986199036,22382684,1,244,12,22444316,22273104,171212,70.08854519543023
1747351986293383,22475244,1,245,12,22538663,22365664,172999,69.36456280094104
1747351986387117,22567804,1,246,12,22632397,22458224,174173,68.89701618505738
1747351986477330,22660364,1,247,12,22722610,22550784,171826,69.83809202332591
1747351986571322,22752924,1,248,12,22816602,22643344,173258,69.2608710708885
1747351986665639,22845484,1,249,12,22910919,22735904,175015,68.56555152415507
1747351986759714,22938044,1,250,12,23004994,22828464,176530,67.97711437149493
1747351986850257,23030604,1,251,12,23095537,22921024,174513,68.76278558044386
1747351986944572,23123164,1,252,12,23189852,23013584,176268,68.0781537204711
1747351987038344,23215724,1,253,12,23283624,23106144,177480,67.6132521974307
1747351987133134,23308284,1,254,12,23378414,23198704,179710,66.77424739858661
1747351987226550,23400844,1,255,12,23471830,23291264,180566,66.457694139539
1747351987317397,23493404,1,256,12,23562677,23383824,178853,67.09420585620593
1747351987411646,23585964,1,257,12,23656926,23476384,180542,66.46652856399065
1747351987505353,23678524,1,258,12,23750633,23568944,181689,66.0469263411654
1747351987603637,23771084,1,259,12,23848917,23661504,187413,64.0297097853404
1747351987689984,23863644,1,260,12,23935264,23754064,181200,66.2251655629139
1747351987784533,23956204,1,261,12,24029813,23846624,183189,65.50611663364067
1747351987878467,24048764,1,262,12,24123747,23939184,184563,65.01844898489946
1747351987972862,24141324,1,263,12,24218142,24031744,186398,64.37837315851029
1747351988062492,24233884,1,264,12,24307772,24124304,183468,65.40650140623978
1747351988177315,24326444,1,265,12,24422595,24216864,205731,58.32859413505986
1747351988250929,24419004,1,266,12,24496209,24309424,186785,64.24498755253366
1747351988344844,24511564,1,267,12,24590124,24401984,188140,63.78228978420325
1747351988434974,24604124,1,268,12,24680254,24494544,185710,64.61687577405633
1747351988529967,24696684,1,269,12,24775247,24587104,188143,63.78127275529783
1747351988623858,24789244,1,270,12,24869138,24679664,189474,63.3332277779537
1747351988717320,24881804,1,271,12,24962600,24772224,190376,63.03315543976132
1747351988811542,24974372,1,272,12,25056822,24864792,192030,62.49023590064052
1747351988901606,25066924,1,273,12,25146886,24957344,189542,63.310506378533525
1747351988996342,25159484,1,274,12,25241622,25049904,191718,62.59193189997809
1747351989090708,25252044,1,275,12,25335988,25142464,193524,62.00781298443604
1747351989184920,25344604,1,276,12,25430200,25235024,195176,61.48296921752675
1747351989274803,25437164,1,277,12,25520083,25327584,192499,62.33798617135673
1747351989369498,25529724,1,278,12,25614778,25420144,194634,61.65418169487346
1747351989463435,25622284,1,279,12,25708715,25512704,196011,61.22105392044325
1747351989557059,25714844,1,280,12,25802339,25605264,197075,60.89052391221616
1747351989651559,25810524,1,281,12,25896839,25700944,195895,61.25730620995941
1747351989745949,25903084,1,282,12,25991229,25793504,197725,60.69035276267543
1747351989839810,25995644,1,283,12,26085090,25886064,199026,60.29362997799282
1747351989930415,26088204,1,284,12,26175695,25978624,197071,60.891759822602005
1747351990024780,26180764,1,285,12,26270060,26071184,198876,60.33910577445242
1747351990118372,26273324,1,286,12,26363652,26163744,199908,60.02761270184285
1747351990212583,26365884,1,287,12,26457863,26256304,201559,59.53591752290893
1747351990401272,26554124,1,289,12,26646552,26444544,202008,59.403587976713794
1747351990495098,26646684,1,290,12,26740378,26537104,203274,59.033619646388615
1747351990588953,26739244,1,291,12,26834233,26629664,204569,58.65991425875866
1747351990679644,26831804,1,292,12,26924924,26722224,202700,59.20078934385792
1747351990773802,26924364,1,293,12,27019082,26814784,204298,58.73772626261637
1747351990868031,27016924,1,294,12,27113311,26907344,205967,58.26176037908985
1747351990962003,27109484,1,295,12,27207283,26999904,207379,57.86506830489104
1747351991052140,27202044,1,296,12,27297420,27092464,204956,58.54915201311501
1747351991146697,27294604,1,297,12,27391977,27185024,206953,57.984179982894666
1747351991240533,27387164,1,298,12,27485813,27277584,208229,57.6288605333551
1747351991334992,27479724,1,299,12,27580272,27370144,210128,57.10804842762506
1747351991425411,27572284,1,300,12,27670691,27462704,207987,57.69591368691312
1747351991519474,27664844,1,301,12,27764754,27555264,209490,57.28197049978519
1747351991612942,27757404,1,302,12,27858222,27647824,210398,57.03476268785825
1747351991707505,27849964,1,303,12,27952785,27740384,212401,56.49690914826201
1747351991801432,27942524,1,304,12,28046712,27832944,213768,56.13562366677893
1747351991891809,28035092,1,305,12,28137089,27925512,211577,56.7169399320342
1747351991985756,28127644,1,306,12,28231036,28018064,212972,56.34543508066788
1747351992080413,28220204,1,307,12,28325693,28110624,215069,55.79604685008067
1747351992174751,28312764,1,308,12,28420031,28203184,216847,55.3385566782109
1747351992264398,28405324,1,309,12,28509678,28295744,213934,56.0920657772958
1747351992358987,28497884,1,310,12,28604267,28388304,215963,55.5650736468747
1747351992453657,28590444,1,311,12,28698937,28480864,218073,55.02744493816291
1747351992546659,28683004,1,312,12,28791939,28573424,218515,54.91613848019587
1747351992932265,29065724,1,316,12,29177545,28956144,221401,54.20029719829631
1747351993026625,29158284,1,317,12,29271905,29048704,223201,53.76319998566314
1747351993117008,29250844,1,318,12,29362288,29141264,221024,54.29274648906906
1747351993210815,29343404,1,319,12,29456095,29233824,222271,53.98814960116255
1747351993301148,29435964,1,320,12,29546428,29326384,220044,54.53454763592736
1747351993399416,29528524,1,321,12,29644696,29418944,225752,53.15567525426131
1747351993489112,29621084,1,322,12,29734392,29511504,222888,53.83869925702595
1747351993583629,29713644,1,323,12,29828909,29604064,224845,53.37009940181014
1747351993677333,29806204,1,324,12,29922613,29696624,225989,53.09992964259322
1747351993772238,29898772,1,325,12,30017518,29789192,228326,52.556432469363976
1747351993861586,29991324,1,326,12,30106866,29881744,225122,53.30443048658061
1747351993955750,30083884,1,327,12,30201030,29974304,226726,52.927321965720736
1747351994050478,30176444,1,328,12,30295758,30066864,228894,52.42601378804163
1747351994145025,30269004,1,329,12,30390305,30159424,230881,51.97482685885802
1747351994238613,30361564,1,330,12,30483893,30251984,231909,51.74443423929213
1747351994329157,30454124,1,331,12,30574437,30344544,229893,52.19819655230912
1747351994423609,30546684,1,332,12,30668889,30437104,231785,51.77211640097504
1747351994516901,30639244,1,333,12,30762181,30529664,232517,51.60912965503598
1747351994611894,30731804,1,334,12,30857174,30622224,234950,51.074696743988085
1747351994705903,30827484,1,335,12,30951183,30717904,233279,51.440549728008094
1747351994800287,30920044,1,336,12,31045567,30810464,235103,51.04145842460539
1747351994894005,31012604,1,337,12,31139285,30903024,236261,50.791285908380985
1747351994984607,31105164,1,338,12,31229887,30995584,234303,51.215733473323006
1747351995078753,31197724,1,339,12,31324033,31088144,235889,50.87138442233424
1747351995172501,31290284,1,340,12,31417781,31180704,237077,50.61646638012122
1747351995267305,31382844,1,341,12,31512585,31273264,239321,50.14185967800569
1747351995357433,31475404,1,342,12,31602713,31365824,236889,50.65663665260945
1747351995450790,31567964,1,343,12,31696070,31458384,237686,50.48677667174339
1747351995545716,31660524,1,344,12,31790996,31550944,240052,49.98916901338044
1747351995639291,31753084,1,345,12,31884571,31643504,241067,49.77869223079061
1747351995733865,31845644,1,346,12,31979145,31736064,243081,49.36626062917299
1747351995824185,31938204,1,347,12,32069465,31828624,240841,49.82540348196528
1747351995918334,32030764,1,348,12,32163614,31921184,242430,49.49882440292043
1747351996012740,32123324,1,349,12,32258020,32013744,244276,49.124760516792485
1747351996106882,32215884,1,350,12,32352162,32106304,245858,48.80866191053372
1747351996196489,32308444,1,351,12,32441769,32198864,242905,49.4020296000494
1747351996290751,32401004,1,352,12,32536031,32291424,244607,49.058285331163866
1747351996384956,32493564,1,353,12,32630236,32383984,246252,48.73056868573656
1747351996479505,32586124,1,354,12,32724785,32476544,248241,48.340121092003336
1747351996569025,32678684,1,355,12,32814305,32569104,245201,48.93944151940653
1747351996663146,32771244,1,356,12,32908426,32661664,246762,48.62985386728913
1747351996753833,32863804,1,357,12,32999113,32754224,244889,49.00179264891441
1747351996848074,32956364,1,358,12,33093354,32846784,246570,48.6677211339579
1747351996942452,33048924,1,359,12,33187732,32939344,248388,48.31151263346055
1747351997036448,33141484,1,360,12,33281728,33031904,249824,48.03381580632766
1747351997155112,33234044,1,361,12,33400392,33124464,275928,43.489605984169785
1747351997224908,33326604,1,362,12,33470188,33217024,253164,47.40010428022941
1747351997318323,33419164,1,363,12,33563603,33309584,254019,47.24056074545605
1747351997408782,33511724,1,364,12,33654062,33402144,251918,47.63454774966458
1747351997502989,33604284,1,365,12,33748269,33494704,253565,47.3251434543411
1747351997597118,33696844,1,366,12,33842398,33587264,255134,47.034107567004
1747351997691031,33789404,1,367,12,33936311,33679824,256487,46.78599695111253
1747351997781441,33881964,1,368,12,34026721,33772384,254337,47.18149541749726
1747351998162151,34261564,1,372,12,34407431,34151984,255447,46.97647652937792
1747351998453475,34548604,1,375,12,34698755,34439024,259731,46.20164708871872
1747351998551888,34641164,1,376,12,34797168,34531584,265584,45.18344478583048
1747351998642195,34733724,1,377,12,34887475,34624144,263331,45.57002403818768
1747351998735624,34826284,1,378,12,34980904,34716704,264200,45.42013626040878
1747351998821991,34918844,1,379,12,35067271,34809264,258007,46.510365997821765
1747351998920465,35011404,1,380,12,35165745,34901824,263921,45.46815145441249
1747351999010299,35103964,1,381,12,35255579,34994384,261195,45.942686498593005
1747351999104944,35196524,1,382,12,35350224,35086944,263280,45.57885141294439
1747351999198276,35289084,1,383,12,35443556,35179504,264052,45.44559404965688
1747351999288981,35381644,1,384,12,35534261,35272064,262197,45.76711404020641
1747351999387711,35474204,1,385,12,35632991,35364624,268367,44.71488670365581
1747351999476886,35566764,1,386,12,35722166,35457184,264982,45.28609490455956
1747351999571353,35659324,1,387,12,35816633,35549744,266889,44.9625125051988
1747351999665563,35751884,1,388,12,35910843,35642304,268539,44.68624669042485
1747351999755400,35844444,1,389,12,36000680,35734864,265816,45.14400938995395
1747351999850072,35937004,1,390,12,36095352,35827424,267928,44.7881520408468
1747351999943731,36029564,1,391,12,36189011,35919984,269027,44.605188326822216
1747352000038365,36122124,1,392,12,36283645,36012544,271101,44.2639459094581
1747352000132051,36214684,1,393,12,36377331,36105104,272227,44.0808589890055
1747352000226276,36307244,1,394,12,36471556,36197664,273892,43.81288975216509
1747352000317279,36399804,1,395,12,36562559,36290224,272335,44.06337782510512
1747352000411292,36492364,1,396,12,36656572,36382784,273788,43.82953233888995
1747352000501213,36584924,1,397,12,36746493,36475344,271149,44.25611010920196
1747352000599879,36677484,1,398,12,36845159,36567904,277255,43.281455699626704
1747352000690113,36770044,1,399,12,36935393,36660464,274929,43.64763266152352
1747352000780056,36862604,1,400,12,37025336,36753024,272312,44.06709950351068
1747352000877724,36955172,1,401,12,37123004,36845592,277412,43.25696076593659
1747352000972564,37047724,1,402,12,37217844,36938144,279700,42.90311047550947
1747352001066210,37140284,1,403,12,37311490,37030704,280786,42.73717350580157
1747352001152166,37232844,1,404,12,37397446,37123264,274182,43.76654922642624
1747352001250400,37325404,1,405,12,37495680,37215824,279856,42.879195014578926
1747352001344622,37417964,1,406,12,37589902,37308384,281518,42.62604877840849
1747352001439333,37510524,1,407,12,37684613,37400944,283669,42.302824771124094
1747352001533494,37603084,1,408,12,37778774,37493504,285270,42.06541171521716
1747352001623158,37695644,1,409,12,37868438,37586064,282374,42.496830444729326
1747352001713328,37788204,1,410,12,37958608,37678624,279984,42.85959197668438
1747352001807338,37880764,1,411,12,38052618,37771184,281434,42.63877143486573
1747352001902189,37973324,1,412,12,38147469,37863744,283725,42.294475284166005
1747352001996436,38065884,1,413,12,38241716,37956304,285412,42.04448306308074
1747352002089702,38158444,1,414,12,38334982,38048864,286118,41.9407377375768
1747352002180015,38251004,1,415,12,38425295,38141424,283871,42.27272246900881
1747352002275008,38343564,1,416,12,38520288,38233984,286304,41.91349055549346
1747352002369217,38436124,1,417,12,38614497,38326544,287953,41.67346754505076
1747352002459178,38528684,1,418,12,38704458,38419104,285354,42.05302886940432
1747352002552996,38621244,1,419,12,38798276,38511664,286612,41.86844933219824
1747352002647008,38713804,1,420,12,38892288,38604224,288064,41.65740946456343
1747352002741679,38806364,1,421,12,38986959,38696784,290175,41.35435513052468
1747352002836350,38898924,1,422,12,39081630,38789344,292286,41.05567834244541
1747352002930328,38991484,1,423,12,39175608,38881904,293704,40.85746193446463
1747352003020083,39084052,1,424,12,39265363,38974472,290891,41.25256539391043
1747352003118163,39176604,1,425,12,39363443,39067024,296419,40.48323488035518
1747352003208398,39269164,1,426,12,39453678,39159584,294094,40.80328058375893
1747352003302761,39361724,1,427,12,39548041,39252144,295897,40.55465246352615
1747352003396947,39454284,1,428,12,39642227,39344704,297523,40.33301627101098
1747352003486875,39546844,1,429,12,39732155,39437264,294891,40.69300182101183
1747352003581203,39639404,1,430,12,39826483,39529824,296659,40.45048355182213
1747352003675191,39731964,1,431,12,39920471,39622384,298087,40.25670357982737
1747352003769198,39824524,1,432,12,40014478,39714944,299534,40.06222999726241
1747352003859418,39917084,1,433,12,40104698,39807504,297194,40.377665767142
1747352003954041,40009644,1,434,12,40199321,39900064,299257,40.09931263094932
1747352004047696,40102204,1,435,12,40292976,39992624,300352,39.9531216705732
1747352004141861,40194764,1,436,12,40387141,40085184,301957,39.74075779001646
1747352004231968,40287324,1,437,12,40477248,40177744,299504,40.06624285485336
1747352004326494,40379884,1,438,12,40571774,40270304,301470,39.80495571698676
1747352004420973,40472444,1,439,12,40666253,40362864,303389,39.55318089976894
1747352004515347,40565004,1,440,12,40760627,40455424,305203,39.31809320353994
1747352004609078,40657564,1,441,12,40854358,40547984,306374,39.16781450123053
1747352004695335,40750124,1,442,12,40940615,40640544,300071,39.99053557324767
1747352004789013,40842684,1,443,12,41034293,40733104,301189,39.84209250669846
1747352004883364,40935244,1,444,12,41128644,40825664,302980,39.60657469139877
1747352004973997,41027804,1,445,12,41219277,40918224,301053,39.86009108030812
1747352005067453,41120364,1,446,12,41312733,41010784,301949,39.74181070313198
1747352005162416,41212924,1,447,12,41407696,41103344,304352,39.42803070129324
1747352005256602,41305484,1,448,12,41501882,41195904,305978,39.21850590565335
1747352005346962,41398044,1,449,12,41592242,41288464,303778,39.50253145389067
1747352005440319,41490604,1,450,12,41685599,41381024,304575,39.39916276779119
1747352005534380,41583164,1,451,12,41779660,41473584,306076,39.2059488493054
1747352005628735,41675724,1,452,12,41874015,41566144,307871,38.97736389591744
1747352005722807,41768284,1,453,12,41968087,41658704,309383,38.78687581412036
1747352005813194,41860844,1,454,12,42058474,41751264,307210,39.06122847563556
1747352005907596,41953404,1,455,12,42152876,41843824,309052,38.82841722428588
1747352006002108,42045964,1,456,12,42247388,41936384,311004,38.58471273681367
1747352006095697,42138524,1,457,12,42340977,42028944,312033,38.45747084442991
1747352006186198,42231084,1,458,12,42431478,42121504,309974,38.71292430978082
1747352006284189,42323644,1,459,12,42529469,42214064,315405,38.0463213963
1747352006374184,42416204,1,460,12,42619464,42306624,312840,38.35826620636748
1747352006468669,42508764,1,461,12,42713949,42399184,314765,38.12367957047321
1747352006562917,42601324,1,462,12,42808197,42491744,316453,37.92032308115265
1747352006653004,42693884,1,463,12,42898284,42584304,313980,38.2189948404357
1747352006751132,42786444,1,464,12,42996412,42676864,319548,37.553043674189794
1747352006841187,42879012,1,465,12,43086467,42769432,317035,37.85071048937815
1747352006935318,42971564,1,466,12,43180598,42861984,318614,37.66312842499074
1747352007025381,43064124,1,467,12,43270661,42954544,316117,37.96062850147256
1747352007119656,43156684,1,468,12,43364936,43047104,317832,37.75579551461149
1747352007214098,43249244,1,469,12,43459378,43139664,319714,37.53354560638571
1747352007308180,43341804,1,470,12,43553460,43232224,321236,37.35571355638845
1747352007398660,43434364,1,471,12,43643940,43324784,319156,37.59916780508591
1747352007496487,43526924,1,472,12,43741767,43417344,324423,36.988746173976566
1747352007587077,43619484,1,473,12,43832357,43509904,322453,37.21472586702559
1747352007685206,43712044,1,474,12,43930486,43602464,328022,36.58291212174793
1747352007779337,43804604,1,475,12,44024617,43695024,329593,36.40854022991993
1747352007873472,43897164,1,476,12,44118752,43787584,331168,36.235385061358585
1747352007963769,43989724,1,477,12,44209049,43880144,328905,36.48469922926073
1747352008057284,44082284,1,478,12,44302564,43972704,329860,36.379069908446006
1747352008151467,44174844,1,479,12,44396747,44065264,331483,36.20095148167477
1747352008246301,44267404,1,480,12,44491581,44157824,333757,35.95430208205371
1747352008336215,44359964,1,481,12,44581495,44250384,331111,36.241622899873455
1747352008430536,44452524,1,482,12,44675816,44342944,332872,36.04989305198394
1747352008524247,44545084,1,483,12,44769527,44435504,334023,35.92566978920613
1747352008618436,44637644,1,484,12,44863716,44528064,335652,35.751313860784386
1747352008708862,44730204,1,485,12,44954142,44620624,333518,35.98006704285826
1747352008803122,44822764,1,486,12,45048402,44713184,335218,35.79760036752203
1747352008897436,44915324,1,487,12,45142716,44805744,336972,35.61126740500694
1747352008991205,45007892,1,488,12,45236485,44898312,338173,35.484796243342906
1747352009085874,45100444,1,489,12,45331154,44990864,340290,35.26403949572424
1747352009175951,45193004,1,490,12,45421231,45083424,337807,35.52324256158102
1747352009270461,45285564,1,491,12,45515741,45175984,339757,35.31936060184191
1747352009359789,45378124,1,492,12,45605069,45268544,336525,35.65856919991085
1747352009454193,45470684,1,493,12,45699473,45361104,338369,35.464241700628605
1747352009544261,45563244,1,494,12,45789541,45453664,335877,35.7273644816406
1747352009638392,45655804,1,495,12,45883672,45546224,337448,35.56103458903297
1747352009732444,45748364,1,496,12,45977724,45638784,338940,35.40449637103912
1747352009826676,45840924,1,497,12,46071956,45731344,340612,35.230702382769834
1747352009916681,45933484,1,498,12,46161961,45823904,338057,35.496972404062035
1747352010011972,46026044,1,499,12,46257252,45916464,340788,35.21250748265784
1747352010105400,46118604,1,500,12,46350680,46009024,341656,35.12304774392957
1747352010195663,46211164,1,501,12,46440943,46101584,339359,35.36078312347691
1747352010294064,46303724,1,502,12,46539344,46194144,345200,34.762456546929315
1747352010384218,46396284,1,503,12,46629498,46286704,342794,35.00644702065964
1747352010478427,46488844,1,504,12,46723707,46379264,344443,34.8388557758468
1747352010572251,46581404,1,505,12,46817531,46471824,345707,34.71147532447998
1747352010666729,46673964,1,506,12,46912009,46564384,347625,34.51995685005394
1747352010757318,46766524,1,507,12,47002598,46656944,345654,34.716797722578065
1747352010850545,46859084,1,508,12,47095825,46749504,346321,34.64993459824845
1747352010940850,46951644,1,509,12,47186130,46842064,344066,34.87702940714863
1747352011035518,47044204,1,510,12,47280798,46934624,346174,34.66464841380346
1747352011129812,47136764,1,511,12,47375092,47027184,347908,34.491877162928134
1747352011223802,47229324,1,512,12,47469082,47119744,349338,34.350686154955945
1747352011317791,47321884,1,513,12,47563071,47212304,350767,34.21074388411681
1747352011407891,47414444,1,514,12,47653171,47304864,348307,34.452365298429264
1747352011502339,47507004,1,515,12,47747619,47397424,350195,34.26662288153743
1747352011596078,47599564,1,516,12,47841358,47489984,351374,34.151644686288684
1747352011690242,47692124,1,517,12,47935522,47582544,352978,33.996453036733165
1747352011784411,47784684,1,518,12,48029691,47675104,354587,33.842188235891335
1747352011874519,47877244,1,519,12,48119799,47767664,352135,34.07783946497792
1747352011969567,47969804,1,520,12,48214847,47860224,354623,33.838752703575345
1747352012063741,48062364,1,521,12,48309021,47952784,356237,33.68543974938033
1747352012157626,48154924,1,522,12,48402906,48045344,357562,33.56061326427305
1747352012251359,48247484,1,523,12,48496639,48137904,358735,33.450875994815114
1747352012342190,48340044,1,524,12,48587470,48230464,357006,33.61288045579066
1747352012436613,48432604,1,525,12,48681893,48323024,358869,33.43838559474349
1747352012530313,48525164,1,526,12,48775593,48415584,360009,33.33250002083281
1747352012624788,48617724,1,527,12,48870068,48508144,361924,33.15613222665532
1747352012715328,48710284,1,528,12,48960608,48600704,359904,33.34222459322486
1747352012809856,48802852,1,529,12,49055136,48693272,361864,33.1616297835651
1747352012899623,48895404,1,530,12,49144903,48785824,359079,33.418829839673165
1747352012993319,48987964,1,531,12,49238599,48878384,360215,33.31343780797579
1747352013087097,49080524,1,532,12,49332377,48970944,361433,33.2011742148614
1747352013181741,49173084,1,533,12,49427021,49063504,363517,33.0108358068536
1747352013275568,49265644,1,534,12,49520848,49156064,364784,32.8961796570025
1747352013366149,49358204,1,535,12,49611429,49248624,362805,33.07561913424567
1747352013460551,49450764,1,536,12,49705831,49341184,364647,32.908538943142275
1747352013554557,49543324,1,537,12,49799837,49433744,366093,32.778556268489154
1747352013648286,49635884,1,538,12,49893566,49526304,367262,32.674221672811235
1747352013738951,49728444,1,539,12,49984231,49618864,365367,32.84368867467505
1747352013833196,49821004,1,540,12,50078476,49711424,367052,32.69291544522302
1747352013926286,49913564,1,541,12,50171566,49803984,367582,32.645776996697336
1747352014021498,50006124,1,542,12,50266778,49896544,370234,32.411934074126094
1747352014111044,50098684,1,543,12,50356324,49989104,367220,32.67795871684549
1747352014205422,50191244,1,544,12,50450702,50081664,369038,32.516976571518384
1747352014300118,50283804,1,545,12,50545398,50174224,371174,32.32985068997289
1747352014394087,50376364,1,546,12,50639367,50266784,372583,32.20758864467783
1747352014484094,50468924,1,547,12,50729374,50359344,370030,32.42980298894684
1747352014582279,50561484,1,548,12,50827559,50451904,375655,31.94420412346435
1747352014671769,50654044,1,549,12,50917049,50544464,372585,32.20741575747816
1747352014766898,50746604,1,550,12,51012178,50637024,375154,31.986864061158887
1747352014861086,50839164,1,551,12,51106366,50729584,376782,31.84865519053458
1747352014950475,50931732,1,552,12,51195755,50822152,373603,32.11965642674176
1747352015045223,51024284,1,553,12,51290503,50914704,375799,31.931963629493428
1747352015138545,51116844,1,554,12,51383825,51007264,376561,31.86734685748126
1747352015233654,51209404,1,555,12,51478934,51099824,379110,31.653082218881064
1747352015327827,51301964,1,556,12,51573107,51192384,380723,31.518978364847936
1747352015421981,51394524,1,557,12,51667261,51284944,382317,31.38756581580207
1747352015512361,51487084,1,558,12,51757641,51377504,380137,31.567566429997605
1747352015606450,51579644,1,559,12,51851730,51470064,381666,31.441102953891622
1747352015699927,51672204,1,560,12,51945207,51562624,382583,31.36574285841242
1747352015794290,51764764,1,561,12,52039570,51655184,384386,31.21861878424292
1747352015884305,51857324,1,562,12,52129585,51747744,381841,31.426693309518885
1747352015978458,51949884,1,563,12,52223738,51840304,383434,31.296129190421297
1747352016076970,52042444,1,564,12,52322250,51932864,389386,30.81774896888948
1747352016167365,52135004,1,565,12,52412645,52025424,387221,30.990054774921816
1747352016257220,52227564,1,566,12,52502500,52117984,384516,31.20806416377992
1747352016351786,52320124,1,567,12,52597066,52210544,386522,31.04609828159846
1747352016445480,52412684,1,568,12,52690760,52303104,387656,30.955279938914916
1747352016539491,52505244,1,569,12,52784771,52395664,389107,30.839846109167915
1747352016629759,52597804,1,570,12,52875039,52488224,386815,31.022581854374828
1747352016728256,52690364,1,571,12,52973536,52580784,392752,30.553631808367623
1747352016818729,52782924,1,572,12,53064009,52673344,390665,30.716854594089565
1747352016908688,52875484,1,573,12,53153968,52765904,388064,30.922734394326707
1747352017011078,52968044,1,574,12,53256358,52858464,397894,30.15878600833388
1747352017097266,53060604,1,575,12,53342546,52951024,391522,30.64961866766108
1747352017191645,53153164,1,576,12,53436925,53043584,393341,30.507879931153884
1747352017284789,53245724,1,577,12,53530069,53136144,393925,30.46265151995938
1747352017379475,53338284,1,578,12,53624755,53228704,396051,30.299128142587698
1747352017473940,53430844,1,579,12,53719220,53321264,397956,30.15408738654525
1747352017563979,53523404,1,580,12,53809259,53413824,395435,30.346327462161923
1747352017657712,53615964,1,581,12,53902992,53506384,396608,30.256575762465708
1747352017751898,53708524,1,582,12,53997178,53598944,398234,30.133037359944154
1747352017846505,53801084,1,583,12,54091785,53691504,400281,29.97893979479416
1747352017940500,53893644,1,584,12,54185780,53784064,401716,29.871849764510248
1747352018034826,53986204,1,585,12,54280106,53876624,403482,29.741103692358024
1747352018124998,54078764,1,586,12,54370278,53969184,401094,29.91817379467157
1747352018218711,54171324,1,587,12,54463991,54061744,402247,29.832416400868123
1747352018309347,54263884,1,588,12,54554627,54154304,400323,29.975794545904183
1747352018402971,54356444,1,589,12,54648251,54246864,401387,29.89633446025905
1747352018497607,54449004,1,590,12,54742887,54339424,403463,29.74250426928863
1747352018591835,54541564,1,591,12,54837115,54431984,405131,29.62004882371381
1747352018681639,54634124,1,592,12,54926919,54524544,402375,29.822926374650518
1747352018780072,54726692,1,593,12,55025352,54617112,408240,29.394473838918284
1747352018874205,54819244,1,594,12,55119485,54709664,409821,29.281076372367448
1747352018964605,54911804,1,595,12,55209885,54802224,407661,29.436222743897503
1747352019058786,55004364,1,596,12,55304066,54894784,409282,29.31963780474099
1747352019148853,55096924,1,597,12,55394133,54987344,406789,29.49932274471532
1747352019243468,55189484,1,598,12,55488748,55079904,408844,29.35104832160922
1747352019337418,55282044,1,599,12,55582698,55172464,410234,29.25159786853357
1747352019431553,55374604,1,600,12,55676833,55265024,411809,29.139722541275205
1747352019521655,55467164,1,601,12,55766935,55357584,409351,29.31469570124416
1747352019615884,55559724,1,602,12,55861164,55450144,411020,29.195659578609312
1747352019709896,55652284,1,603,12,55955176,55542704,412472,29.092883880602805
1747352019804263,55744844,1,604,12,56049543,55635264,414279,28.965986690129117
1747352019894788,55837404,1,605,12,56140068,55727824,412244,29.108974296775692
1747352019988528,55929964,1,606,12,56233808,55820384,413424,29.02589109485661
1747352020082726,56022524,1,607,12,56328006,55912944,415062,28.911343365569483
1747352020172604,56115084,1,608,12,56417884,56005504,412380,29.099374363451183
1747352020267445,56207644,1,609,12,56512725,56098064,414661,28.93930222519118
1747352020361384,56300204,1,610,12,56606664,56190624,416040,28.843380444188057
1747352020451479,56392764,1,611,12,56696759,56283184,413575,29.01529347760382
1747352020549799,56485324,1,612,12,56795079,56375744,419335,28.616738407240035
1747352020639771,56577884,1,613,12,56885051,56468304,416747,28.79444843034263
1747352020734417,56670444,1,614,12,56979697,56560864,418833,28.6510375256964
1747352020828619,56763004,1,615,12,57073899,56653424,420475,28.539152149354894
1747352020922011,56855572,1,616,12,57167291,56745992,421299,28.483333689375005
1747352021016372,56948124,1,617,12,57261652,56838544,423108,28.361553078646587
1747352021106265,57040684,1,618,12,57351545,56931104,420441,28.541460038388266
1747352021200942,57133244,1,619,12,57446222,57023664,422558,28.39846837593893
1747352021294674,57225804,1,620,12,57539954,57116224,423730,28.319920704222028
1747352021389309,57318364,1,621,12,57634589,57208784,425805,28.181914256525875
1747352021479725,57410924,1,622,12,57725005,57301344,423661,28.32453305827065
1747352021573722,57503484,1,623,12,57819002,57393904,425098,28.228784891954326
1747352021668214,57596044,1,624,12,57913494,57486464,427030,28.10107018242278
1747352021762229,57688604,1,625,12,58007509,57579024,428485,28.005647805640805
1747352021852178,57781164,1,626,12,58097458,57671584,425874,28.1773482297581
1747352021946125,57873724,1,627,12,58191405,57764144,427261,28.08587725067348
1747352022040122,57966284,1,628,12,58285402,57856704,428698,27.99173310815539
1747352022134561,58058844,1,629,12,58379841,57949264,430577,27.869579657064826
1747352022224513,58151404,1,630,12,58469793,58041824,427969,28.039414069710656
1747352022319330,58243964,1,631,12,58564610,58134384,430226,27.892317061265476
1747352022417044,58336524,1,632,12,58662324,58226944,435380,27.56212963388305
1747352022511525,58429084,1,633,12,58756805,58319504,437301,27.441053187621343
1747352022601605,58521644,1,634,12,58846885,58412064,434821,27.597563135175164
1747352022696252,58614204,1,635,12,58941532,58504624,436908,27.46573649372408
1747352022789770,58706764,1,636,12,59035050,58597184,437866,27.405644649276265
1747352022880310,58799324,1,637,12,59125590,58689744,435846,27.532660618658884
1747352022974273,58891884,1,638,12,59219553,58782304,437249,27.444316625080905
1747352023068261,58984444,1,639,12,59313541,58874864,438677,27.35497872010614
1747352023161845,59077004,1,640,12,59407125,58967424,439701,27.291272933197785
1747352023253276,59169564,1,641,12,59498556,59059984,438572,27.36152786771613
1747352023347080,59262124,1,642,12,59592360,59152544,439816,27.284137002746604
1747352023441315,59354684,1,643,12,59686595,59245104,441491,27.18062202853512
1747352023535267,59447244,1,644,12,59780547,59337664,442883,27.095192183940227
1747352023629798,59539804,1,645,12,59875078,59430224,444854,26.975142406272617
1747352023723785,59632364,1,646,12,59969065,59522784,446281,26.888888390946512
1747352023810015,59724924,1,647,12,60055295,59615344,439951,27.27576480108012
1747352023908156,59817484,1,648,12,60153436,59707904,445532,26.93409227620014
1747352024002400,59910044,1,649,12,60247680,59800464,447216,26.832671460770637
1747352024096330,60002604,1,650,12,60341610,59893024,448586,26.750723384144848
1747352024186097,60095164,1,651,12,60431377,59985584,445793,26.91832307819997
1747352024280460,60187724,1,652,12,60525740,60078144,447596,26.809891062475984
1747352024375250,60280284,1,653,12,60620530,60170704,449826,26.676981766282964
1747352024468844,60372844,1,654,12,60714124,60263264,450860,26.615800913809167
1747352024559142,60465404,1,655,12,60804422,60355824,448598,26.75000780208561
1747352024653735,60557964,1,656,12,60899015,60448384,450631,26.62932643337897
1747352024747586,60650532,1,657,12,60992866,60540952,451914,26.55372482374965
1747352024842079,60743084,1,658,12,61087359,60633504,453855,26.440162607000037
1747352024935822,60835644,1,659,12,61181102,60726064,455038,26.371423925034836
1747352025026289,60928204,1,660,12,61271569,60818624,452945,26.49328284891101
1747352025120745,61020764,1,661,12,61366025,60911184,454841,26.382845873612972
1747352025210435,61113324,1,662,12,61455715,61003744,451971,26.55037601970038
1747352025304635,61205884,1,663,12,61549915,61096304,453611,26.454384924527844
1747352025398712,61298444,1,664,12,61643992,61188864,455128,26.366209066460424
1747352025492861,61391004,1,665,12,61738141,61281424,456717,26.27447631684391
1747352025586988,61483564,1,666,12,61832268,61373984,458284,26.18463660088504
1747352025680989,61576124,1,667,12,61926269,61466544,459725,26.10256131382892
1747352025771470,61668684,1,668,12,62016750,61559104,457646,26.221140357394145
1747352025866235,61761244,1,669,12,62111515,61651664,459851,26.095409165142623
1747352025959598,61853804,1,670,12,62204878,61744224,460654,26.04992033066032
1747352026050397,61946364,1,671,12,62295677,61836784,458893,26.14988679278176
1747352026148891,62038924,1,672,12,62394171,61929344,464827,25.816056296213432
1747352026234797,62131484,1,673,12,62480077,62021904,458173,26.19098026291379
1747352026328815,62224044,1,674,12,62574095,62114464,459631,26.10789959772078
1747352026423233,62316604,1,675,12,62668513,62207024,461489,26.002786631967396
1747352026517450,62409164,1,676,12,62762730,62299584,463146,25.909756318741824
1747352026607034,62501724,1,677,12,62852314,62392144,460170,26.07731925158093
1747352026701012,62594284,1,678,12,62946292,62484704,461588,25.997209632832742
1747352026799639,62686844,1,679,12,63044919,62577264,467655,25.659941623632808
1747352026889031,62779412,1,680,12,63134311,62669832,464479,25.83539837107813
1747352026979822,62871964,1,681,12,63225102,62762384,462718,25.93372205101163
1747352027078302,62964524,1,682,12,63323582,62854944,468638,25.60611815516454
1747352027171987,63057084,1,683,12,63417267,62947504,469763,25.544795992873
1747352027261962,63149644,1,684,12,63507242,63040064,467178,25.686141042600465
1747352027356500,63242204,1,685,12,63601780,63132624,469156,25.577846174833105
1747352027450988,63334764,1,686,12,63696268,63225184,471084,25.47316402170313
1747352027545460,63427324,1,687,12,63790740,63317744,472996,25.37019340544106
1747352027635176,63519884,1,688,12,63880456,63410304,470152,25.5236604332216
1747352027733177,63612444,1,689,12,63978457,63502864,475593,25.23165816149523
1747352027823428,63705004,1,690,12,64068708,63595424,473284,25.35475528435358
1747352027913872,63797564,1,691,12,64159152,63687984,471168,25.46862265688672
1747352028008247,63890124,1,692,12,64253527,63780544,472983,25.370890708545552
1747352028102499,63982684,1,693,12,64347779,63873104,474675,25.280455048190863
1747352028196098,64075244,1,694,12,64441378,63965664,475714,25.225240375519743
1747352028289948,64167804,1,695,12,64535228,64058224,477004,25.15702174405246
1747352028384853,64260364,1,696,12,64630133,64150784,479349,25.033952297803896
1747352028479199,64352924,1,697,12,64724479,64243344,481135,24.941024868280213
1747352028568729,64445484,1,698,12,64814009,64335904,478105,25.099089112224306
1747352028662999,64538044,1,699,12,64908279,64428464,479815,25.009639131748692
1747352028757012,64630604,1,700,12,65002292,64521024,481268,24.934132333751677
1747352028851156,64723164,1,701,12,65096436,64613584,482852,24.852335705350708
1747352028945692,64815724,1,702,12,65190972,64706144,484828,24.751045731682165
1747352029035721,64908284,1,703,12,65281001,64798704,482297,24.880934362021744
1747352029130456,65000844,1,704,12,65375736,64891264,484472,24.769233309664955
1747352029224433,65093404,1,705,12,65469713,64983824,485889,24.69699869723332
1747352029318938,65185964,1,706,12,65564218,65076384,487834,24.598531467671386
1747352029409002,65278524,1,707,12,65654282,65168944,485338,24.72503698453449
1747352029503078,65371084,1,708,12,65748358,65261504,486854,24.648046436919486
1747352029596576,65463644,1,709,12,65841856,65354064,487792,24.600649457145668
1747352029690821,65556204,1,710,12,65936101,65446624,489477,24.515962956379973
1747352029781628,65648764,1,711,12,66026908,65539184,487724,24.604079356357285
1747352029875036,65741324,1,712,12,66120316,65631744,488572,24.5613747820178
1747352029969636,65833884,1,713,12,66214916,65724304,490612,24.459246818259643
1747352030063369,65926444,1,714,12,66308649,65816864,491785,24.40090690037313
1747352030153960,66019004,1,715,12,66399240,65909424,489816,24.49899554118281
1747352030248186,66111564,1,716,12,66493466,66001984,491482,24.415950126352545
1747352030342519,66204124,1,717,12,66587799,66094544,493255,24.32818724594784
1747352030436421,66296684,1,718,12,66681701,66187104,494597,24.262177085586853
1747352030530613,66389244,1,719,12,66775893,66279664,496229,24.18238353663329
1747352030621266,66481804,1,720,12,66866546,66372224,494322,24.275674560306847
1747352030714789,66574372,1,721,12,66960069,66464792,495277,24.228865866979486
1747352030809004,66666924,1,722,12,67054284,66557344,496940,24.14778444077756
1747352030903098,66759484,1,723,12,67148378,66649904,498474,24.073472237268145
1747352030994053,66852044,1,724,12,67239333,66742464,496869,24.15123503378154
1747352031087928,66944604,1,725,12,67333208,66835024,498184,24.0874857482376
1747352031181675,67037164,1,726,12,67426955,66927584,499371,24.03023002937696
1747352031276625,67129724,1,727,12,67521905,67020144,501761,23.915768662769725
1747352031366477,67222284,1,728,12,67611757,67112704,499053,24.04554225703482
1747352031460211,67314844,1,729,12,67705491,67205264,500227,23.98910894453918
1747352031554343,67407404,1,730,12,67799623,67297824,501799,23.913957580624917
1747352031648434,67499964,1,731,12,67893714,67390384,503330,23.84121749150656
1747352031739287,67592524,1,732,12,67984567,67482944,501623,23.92234805820307
1747352031833708,67685084,1,733,12,68078988,67575504,503484,23.83392520914269
1747352031927033,67777644,1,734,12,68172313,67668064,504249,23.797766579606503
1747352032021514,67870204,1,735,12,68266794,67760624,506170,23.7074500661833
1747352032115487,67962764,1,736,12,68360767,67853184,507583,23.641453712988813
1747352032205770,68055324,1,737,12,68451050,67945744,505306,23.747986368655823
1747352032299788,68147884,1,738,12,68545068,68038304,506764,23.67966153870441
1747352032394194,68240444,1,739,12,68639474,68130864,508610,23.59371620691689
1747352032488355,68333004,1,740,12,68733635,68223424,510211,23.51968107312465
1747352032578394,68425564,1,741,12,68823674,68315984,507690,23.636471074868524
1747352032673367,68518124,1,742,12,68918647,68408544,510103,23.52466070577903
1747352032767422,68610684,1,743,12,69012702,68501104,511598,23.45591655948616
1747352032860980,68703252,1,744,12,69106260,68593672,512588,23.41061437255652
1747352032951851,68795804,1,745,12,69197131,68686224,510907,23.487640607781845
1747352033046007,68888364,1,746,12,69291287,68778784,512503,23.414497085870718
1747352033140162,68980924,1,747,12,69385442,68871344,514098,23.34185310971838
1747352033233878,69073484,1,748,12,69479158,68963904,515254,23.28948440963098
1747352033324289,69166044,1,749,12,69569569,69056464,513105,23.38702604730026
1747352033418009,69258604,1,750,12,69663289,69149024,514265,23.33427318600333
1747352033512147,69351164,1,751,12,69757427,69241584,515843,23.262892003962445
1747352033606638,69443724,1,752,12,69851918,69334144,517774,23.17613476149826
1747352033701266,69536284,1,753,12,69946546,69426704,519842,23.08393704240904
1747352033791321,69628844,1,754,12,70036601,69519264,517337,23.19571188606266
1747352033884919,69721404,1,755,12,70130199,69611824,518375,23.14926452857487
1747352033979816,69813964,1,756,12,70225096,69704384,520712,23.04536864908049
1747352034073910,69906524,1,757,12,70319190,69796944,522246,22.977677186613207
1747352034163597,69999084,1,758,12,70408877,69889504,519373,23.10478211227769
1747352034258312,70091644,1,759,12,70503592,69982064,521528,23.00931110122563
1747352034352110,70184204,1,760,12,70597390,70074624,522766,22.95482108629865
1747352034445941,70276764,1,761,12,70691221,70167184,524037,22.899146434316663
1747352034536229,70369324,1,762,12,70781509,70259744,521765,22.998859639876187
1747352034631045,70461884,1,763,12,70876325,70352304,524021,22.89984561687413
1747352034724562,70554444,1,764,12,70969842,70444864,524978,22.858100720411144
1747352034814933,70647004,1,765,12,71060213,70537424,522789,22.95381119342603
1747352034913734,70742684,1,766,12,71159014,70633104,525910,22.81759236371242
1747352035007272,70835244,1,767,12,71252552,70725664,526888,22.775238760419672
1747352035102005,70927804,1,768,12,71347285,70818224,529061,22.681694549399783
1747352035196031,71020364,1,769,12,71441311,70910784,530527,22.619018447694465
1747352035286184,71112924,1,770,12,71531464,71003344,528120,22.72210861167916
1747352035384449,71208604,1,771,12,71629729,71099024,530705,22.611431963143367
1747352035478673,71301164,1,772,12,71723953,71191584,532369,22.54075650535625
1747352035568709,71393724,1,773,12,71813989,71284144,529845,22.648132944540382
1747352035662393,71486284,1,774,12,71907673,71376704,530969,22.60018946492168
1747352035753112,71578844,1,775,12,71998392,71469264,529128,22.678822515534996
1747352035851545,71674524,1,776,12,72096825,71564944,531881,22.561437614804813
1747352035945020,71767084,1,777,12,72190300,71657504,532796,22.522691611798887
1747352036039613,71859644,1,778,12,72284893,71750064,534829,22.437078019329544
1747352036134011,71952204,1,779,12,72379291,71842624,536667,22.36023455886052
1747352036223895,72044764,1,780,12,72469175,71935184,533991,22.47228885880099
1747352036317894,72137324,1,781,12,72563174,72027744,535430,22.41189324468185
1747352036412525,72229884,1,782,12,72657805,72120304,537501,22.32553985946073
1747352036506612,72322444,1,783,12,72751892,72212864,539028,22.262294352055925
1747352036600761,72415004,1,784,12,72846041,72305424,540617,22.196860254117052
1747352036690765,72507564,1,785,12,72936045,72397984,538061,22.302304013857164
1747352036784399,72600124,1,786,12,73029679,72490544,539135,22.257876042178676
1747352036879674,72692684,1,787,12,73124954,72583104,541850,22.14635046599612
1747352036973425,72785244,1,788,12,73218705,72675664,543041,22.097778989063443
1747352037063955,72877804,1,789,12,73309235,72768224,541011,22.18069503207883
1747352037157734,72970364,1,790,12,73403014,72860784,542230,22.13083009055198
1747352037251709,73062924,1,791,12,73496989,72953344,543645,22.073227933669948
1747352037345555,73155484,1,792,12,73590835,73045904,544931,22.02113662096669
1747352037436399,73248044,1,793,12,73681679,73138464,543215,22.090700735436243
1747352037530548,73340604,1,794,12,73775828,73231024,544804,22.02626999801764
1747352037624275,73433164,1,795,12,73869555,73323584,545971,21.97918937086402
1747352037718959,73525724,1,796,12,73964239,73416144,548095,21.8940147237249
1747352037813198,73618284,1,797,12,74058478,73508704,549774,21.82715079287125
1747352037902615,73710844,1,798,12,74147895,73601264,546631,21.952651788866717
1747352037997423,73803404,1,799,12,74242703,73693824,548879,21.862742061547262
1747352038091126,73895972,1,800,12,74336406,73786392,550014,21.81762646041737
1747352038186051,73988524,1,801,12,74431331,73878944,552387,21.72390009178348
1747352038275620,74081084,1,802,12,74520900,73971504,549396,21.842168490487737
1747352038370265,74173644,1,803,12,74615545,74064064,551481,21.7595891789563
1747352038468425,74269324,1,804,12,74713705,74159744,553961,21.66217477403644
1747352038557922,74361892,1,805,12,74803202,74252312,550890,21.78293307193813
1747352038652112,74454444,1,806,12,74897392,74344864,552528,21.71835635479107
1747352038746343,74547004,1,807,12,74991623,74437424,554199,21.65287198280762
1747352038841223,74639564,1,808,12,75086503,74529984,556519,21.56260612845204
1747352038930920,74732124,1,809,12,75176200,74622544,553656,21.67410811045125
1747352039025329,74824684,1,810,12,75270609,74715104,555505,21.60196577888588
1747352039119200,74917244,1,811,12,75364480,74807664,556816,21.55110485330881
1747352039214026,75009804,1,812,12,75459306,74900224,559082,21.463756658236186
1747352039304060,75102364,1,813,12,75549340,74992784,556556,21.56117264030933
1747352039398232,75194924,1,814,12,75643512,75085344,558168,21.49890355591865
1747352039492646,75287484,1,815,12,75737926,75177904,560022,21.42772962490759
1747352039585972,75380044,1,816,12,75831252,75270464,560788,21.39846073739096
1747352039680224,75472604,1,817,12,75925504,75363024,562480,21.33409187882236
1747352039770734,75565164,1,818,12,76016014,75455584,560430,21.41212997162893
1747352039865042,75657724,1,819,12,76110322,75548144,562178,21.345552476261968
1747352039958880,75750284,1,820,12,76204160,75640704,563456,21.297137664697868
1747352040053101,75842844,1,821,12,76298381,75733264,565117,21.23454081190267
1747352040143245,75935404,1,822,12,76388525,75825824,562701,21.3257129452409
1747352040233572,76027964,1,823,12,76478852,75918384,560468,21.41067821891705
1747352040331437,76120524,1,824,12,76576717,76010944,565773,21.209919879527657
1747352040426003,76213084,1,825,12,76671283,76103504,567779,21.13498385815608
1747352040516169,76305644,1,826,12,76761449,76196064,565385,21.22447535749976
1747352040610007,76398204,1,827,12,76855287,76288624,566663,21.17660761334338
1747352040704587,76490772,1,828,12,76949867,76381192,568675,21.101683738514968
1747352040799025,76583324,1,829,12,77044305,76473744,570561,21.031931730349605
1747352040892611,76675884,1,830,12,77137891,76566304,571587,20.994179363771394
1747352040982337,76768444,1,831,12,77227617,76658864,568753,21.09878980858123
1747352041077589,76861004,1,832,12,77322869,76751424,571445,20.99939626735732
1747352041171150,76953564,1,833,12,77416430,76843984,572446,20.9626759554613
1747352041265144,77046124,1,834,12,77510424,76936544,573880,20.910294835157178
1747352041356371,77138684,1,835,12,77601651,77029104,572547,20.95897804023076
1747352041449968,77231244,1,836,12,77695248,77121664,573584,20.921085664872106
1747352041544304,77323804,1,837,12,77789584,77214224,575360,20.85650723025584
1747352041638820,77416364,1,838,12,77884100,77306784,577316,20.78584345488433
1747352041753409,77508924,1,839,12,77998689,77399344,599345,20.021857194103564
1747352041847012,77601484,1,840,12,78092292,77491904,600388,19.987075024817283
1747352041913146,77694044,1,841,12,78158426,77584464,573962,20.907307452409743
1747352042011033,77786604,1,842,12,78256313,77677024,579289,20.71504896519699
1747352042101450,77879164,1,843,12,78346730,77769584,577146,20.791965984343648
1747352042195017,77971724,1,844,12,78440297,77862144,578153,20.7557515052244
1747352042289932,78064284,1,845,12,78535212,77954704,580508,20.671549746084462
1747352042384250,78156844,1,846,12,78629530,78047264,582266,20.60913740455393
1747352042478222,78249404,1,847,12,78723502,78139824,583678,20.559280973413426
1747352042568653,78341964,1,848,12,78813933,78232384,581549,20.6345467019976
1747352042662850,78434524,1,849,12,78908130,78324944,583186,20.576625639161435
1747352042756960,78527084,1,850,12,79002240,78417504,584736,20.52208175997373
1747352042847292,78619644,1,851,12,79092572,78510064,582508,20.6005754427407
1747352042941161,78712204,1,852,12,79186441,78602624,583817,20.55438604905304
1747352043035669,78804764,1,853,12,79280949,78695184,585765,20.486031087552178
1747352043130364,78897324,1,854,12,79375644,78787744,587900,20.411634631740093
1747352043223406,78989884,1,855,12,79468686,78880304,588382,20.39491350857096
1747352043313725,79082444,1,856,12,79559005,78972864,586141,20.472889628945936
1747352043408143,79175004,1,857,12,79653423,79065424,587999,20.4081979731258
1747352043502674,79267564,1,858,12,79747954,79157984,589970,20.340017289014696
1747352043596055,79360124,1,859,12,79841335,79250544,590791,20.31175153311408
1747352043687089,79452684,1,860,12,79932369,79343104,589265,20.364352201471323
1747352043777106,79545244,1,861,12,80022386,79435664,586722,20.452616400953094
1747352043870080,79637804,1,862,12,80115360,79528224,587136,20.438194898626552
1747352043964884,79730364,1,863,12,80210164,79620784,589380,20.360378703043875
1747352044058870,79822924,1,864,12,80304150,79713344,590806,20.31123583714451
1747352044148881,79915484,1,865,12,80394161,79805904,588257,20.399247267775817
1747352044247630,80008044,1,866,12,80492910,79898464,594446,20.18686306241441
1747352044337044,80100604,1,867,12,80582324,79991024,591300,20.29426686960933
1747352044435787,80193164,1,868,12,80681067,80083584,597483,20.0842534431942
1747352044526068,80285732,1,869,12,80771348,80176152,595196,20.161425816033717
1747352044616407,80378284,1,870,12,80861687,80268704,592983,20.236667830275067
1747352044710220,80470844,1,871,12,80955500,80361264,594236,20.19399699782578
1747352044804819,80563404,1,872,12,81050099,80453824,596275,20.12494235042556
1747352044894831,80655964,1,873,12,81140111,80546384,593727,20.21130923808417
1747352044992338,80748524,1,874,12,81237618,80638944,598674,20.044297898355364
1747352045086576,80841084,1,875,12,81331856,80731504,600352,19.98827354618624
1747352045177015,80933644,1,876,12,81422295,80824064,598231,20.059141034149015
1747352045271635,81026204,1,877,12,81516915,80916624,600291,19.990304702219422
1747352045361450,81118764,1,878,12,81606730,81009184,597546,20.08213593597815
1747352045459443,81211324,1,879,12,81704723,81101744,602979,19.90119058872697
1747352045549636,81303884,1,880,12,81794916,81194304,600612,19.979620786797465
1747352045643928,81396444,1,881,12,81889208,81286864,602344,19.92217071972162
1747352045734140,81489004,1,882,12,81979420,81379424,599996,20.00013333422223
1747352045832764,81581564,1,883,12,82078044,81471984,606060,19.8000198000198
1747352045922442,81674124,1,884,12,82167722,81564544,603178,19.89462480395505
1747352046021127,81766684,1,885,12,82266407,81657104,609303,19.69463468914481
1747352046110863,81859244,1,886,12,82356143,81749664,606479,19.786340499835937
1747352046201344,81951804,1,887,12,82446624,81842224,604400,19.854401058901388
1747352046298898,82044364,1,888,12,82544178,81934784,609394,19.69169371539595
1747352046393524,82136924,1,889,12,82638804,82027344,611460,19.62515945442057
1747352046479310,82229484,1,890,12,82724590,82119904,604686,19.845010468243025
1747352046577621,82322044,1,891,12,82822901,82212464,610437,19.658048250679432
1747352046672020,82414612,1,892,12,82917300,82305032,612268,19.59926045457218
1747352046765868,82507164,1,893,12,83011148,82397584,613564,19.55786193453332
1747352046859910,82599724,1,894,12,83105190,82490144,615046,19.510735782364247
1747352046950199,82692284,1,895,12,83195479,82582704,612775,19.583044347435848
1747352047044170,82784844,1,896,12,83289450,82675264,614186,19.538055247107557
1747352047134379,82877404,1,897,12,83379659,82767824,611835,19.61313099119861
1747352047233310,82969964,1,898,12,83478590,82860384,618206,19.41100539302433
1747352047323543,83062524,1,899,12,83568823,82952944,615879,19.48434676291934
1747352047417007,83155084,1,900,12,83662287,83045504,616783,19.455789151127707
1747352047511823,83247644,1,901,12,83757103,83138064,619039,19.38488528186431
1747352047605675,83340204,1,902,12,83850955,83230624,620331,19.344511236742967
1747352047695614,83432764,1,903,12,83940894,83323184,617710,19.426591766362854
1747352047790179,83525324,1,904,12,84035459,83415744,619715,19.363739783610207
1747352047879879,83617884,1,905,12,84125159,83508304,616855,19.45351824983181
1747352047974530,83710444,1,906,12,84219810,83600864,618946,19.387797966219992
1747352048068514,83803004,1,907,12,84313794,83693424,620370,19.34329513032545
1747352048162720,83895564,1,908,12,84408000,83785984,622016,19.29210824158864
1747352048257012,83988124,1,909,12,84502292,83878544,623748,19.23853864060486
1747352048343207,84080684,1,910,12,84588487,83971104,617383,19.436881158049378
1747352048445327,84173244,1,911,12,84690607,84063664,626943,19.140496025954512
1747352048535348,84265804,1,912,12,84780628,84156224,624404,19.21832659624218
1747352048625964,84358364,1,913,12,84871244,84248784,622460,19.278347203033125
1747352048723827,84450924,1,914,12,84969107,84341344,627763,19.115494223138352
1747352048818352,84543484,1,915,12,85063632,84433904,629728,19.055846333655168
1747352048908465,84636044,1,916,12,85153745,84526464,627281,19.1301824859991
1747352049002694,84728604,1,917,12,85247974,84619024,628950,19.079418077748628
1747352049096660,84821164,1,918,12,85341940,84711584,630356,19.03686170989092
1747352049190304,84913724,1,919,12,85435584,84804144,631440,19.004180919802355
1747352049280545,85006284,1,920,12,85525825,84896704,629121,19.074232142942293
1747352049370579,85098844,1,921,12,85615859,84989264,626595,19.151126325617025
1747352049465728,85191404,1,922,12,85711008,85081824,629184,19.07232224595667
1747352049555758,85283964,1,923,12,85801038,85174384,626654,19.149323231001475
1747352049653290,85376524,1,924,12,85898570,85266944,631626,18.998584605446894
1747352049747491,85469084,1,925,12,85992771,85359504,633267,18.949353116457985
1747352049841760,85561644,1,926,12,86087040,85452064,634976,18.898352063700045
1747352049935925,85654204,1,927,12,86181205,85544624,636581,18.850703995249624
1747352050026641,85746764,1,928,12,86271921,85637184,634737,18.9054679339632
1747352050120977,85839324,1,929,12,86366257,85729744,636513,18.85271785493776
1747352050215143,85931884,1,930,12,86460423,85822304,638119,18.80526986345807
1747352050309235,86024444,1,931,12,86554515,85914864,639651,18.76023018802441
1747352050399359,86117004,1,932,12,86644639,86007424,637215,18.831948400461386
1747352050493063,86209572,1,933,12,86738343,86099992,638351,18.798435343564904
1747352050583043,86302124,1,934,12,86828323,86192544,635779,18.874483114415543
1747352050678085,86394684,1,935,12,86923365,86285104,638261,18.80108607607233
1747352050772213,86487244,1,936,12,87017493,86377664,639829,18.75501110452949
1747352050865643,86579804,1,937,12,87110923,86470224,640699,18.72954382635216
1747352050960921,86672364,1,938,12,87206201,86562784,643417,18.65042421944089
1747352051054020,86764924,1,939,12,87299300,86655344,643956,18.634813558690347
1747352051144523,86857484,1,940,12,87389803,86747904,641899,18.69452982478552
1747352051238296,86950044,1,941,12,87483576,86840464,643112,18.65926930301409
1747352051332364,87042604,1,942,12,87577644,86933024,644620,18.615618503924797
1747352051422732,87135164,1,943,12,87668012,87025584,642428,18.67913602769493
1747352051520735,87227724,1,944,12,87766015,87118144,647871,18.52220580948985
1747352051615222,87320284,1,945,12,87860502,87210704,649798,18.46727752316874
1747352051702061,87412844,1,946,12,87947341,87303264,644077,18.631312715715666
1747352051800342,87505404,1,947,12,88045622,87395824,649798,18.46727752316874
1747352051890073,87597964,1,948,12,88135353,87488384,646969,18.548029349165105
1747352051987746,87690524,1,949,12,88233026,87580944,652082,18.40259353884941
1747352052074027,87783084,1,950,12,88319307,87673504,645803,18.581517893227502
1747352052168395,87875644,1,951,12,88413675,87766064,647611,18.52964202275749
1747352052263102,87968204,1,952,12,88508382,87858624,649758,18.46841439428218
1747352052356715,88060764,1,953,12,88601995,87951184,650811,18.43853284594145
1747352052446858,88153324,1,954,12,88692138,88043744,648394,18.50726564403742
1747352052545585,88245884,1,955,12,88790865,88136304,654561,18.33289792700757
1747352052639620,88338452,1,956,12,88884900,88228872,656028,18.29190217490717
1747352052729131,88431004,1,957,12,88974411,88321424,652987,18.37708867098426
1747352052823382,88523564,1,958,12,89068662,88413984,654678,18.32962158496238
1747352052913436,88616124,1,959,12,89158716,88506544,652172,18.40005397349165
1747352053011986,88708684,1,960,12,89257266,88599104,658162,18.232593191341948
1747352053106229,88801244,1,961,12,89351509,88691664,659845,18.18608915730209
1747352053200704,88893804,1,962,12,89445984,88784224,661760,18.13346228239845
1747352053290797,88986364,1,963,12,89536077,88876784,659293,18.20131565176636
1747352053380321,89078924,1,964,12,89625601,88969344,656257,18.285519240175724
1747352053478650,89171484,1,965,12,89723930,89061904,662026,18.126176313317
1747352053569353,89264044,1,966,12,89814633,89154464,660169,18.177163726257973
1747352053659342,89356604,1,967,12,89904622,89247024,657598,18.248230681966795
1747352053757351,89449164,1,968,12,90002631,89339584,663047,18.098264527250706
1747352053847082,89541724,1,969,12,90092362,89432144,660218,18.17581465515936
1747352053946360,89634284,1,970,12,90191640,89524704,666936,17.992730936701573
1747352054036549,89726844,1,971,12,90281829,89617264,664565,18.056924454342315
1747352054130591,89819404,1,972,12,90375871,89709824,666047,18.01674656593304
1747352054220610,89911964,1,973,12,90465890,89802384,663506,18.0857445147444
1747352054314988,90004524,1,974,12,90560268,89894944,665324,18.036325158869964
1747352054408608,90097084,1,975,12,90653888,89987504,666384,18.007635237340633
1747352054502395,90189644,1,976,12,90747675,90080064,667611,17.974539065413843
1747352054593512,90282204,1,977,12,90838792,90172624,666168,18.013474078610802
1747352054691744,90374764,1,978,12,90937024,90265184,671840,17.861395570373897
1747352054785872,90467324,1,979,12,91031152,90357744,673408,17.81980612050941
1747352054871276,90559884,1,980,12,91116556,90450304,666252,18.011202968246252
1747352054970421,90652444,1,981,12,91215701,90542864,672837,17.834928816340362
1747352055059696,90745004,1,982,12,91304976,90635424,669552,17.92243171553516
1747352055154056,90837564,1,983,12,91399336,90727984,671352,17.87437886533443
1747352055243889,90930124,1,984,12,91489169,90820544,668625,17.9472798653954
1747352055342355,91022684,1,985,12,91587635,90913104,674531,17.79013862965527
1747352055436826,91115244,1,986,12,91682106,91005664,676442,17.739880137543203
1747352055531247,91207804,1,987,12,91776527,91098224,678303,17.691208796069013
1747352055621403,91300364,1,988,12,91866683,91190784,675899,17.754131904322982
1747352055715751,91392924,1,989,12,91961031,91283344,677687,17.70728964846603
1747352055809020,91485484,1,990,12,92054300,91375904,678396,17.688783542355793
1747352055902619,91578044,1,991,12,92147899,91468464,679435,17.6617336463385
1747352055993841,91670604,1,992,12,92239121,91561024,678097,17.696583232192445
1747352056088150,91763164,1,993,12,92333430,91653584,679846,17.651056268625542
1747352056180601,91855724,1,994,12,92425881,91746144,679737,17.653886723835836
1747352056272134,91948284,1,995,12,92517414,91838704,678710,17.68059996169203
1747352056371011,92040844,1,996,12,92616291,91931264,685027,17.517557702105172
1747352056460584,92133412,1,997,12,92705864,92023832,682032,17.594482370328667
1747352056554593,92225964,1,998,12,92799873,92116384,683489,17.556976044969268
1747352056649256,92318524,1,999,12,92894536,92208944,685592,17.503121389981214
1747352056739299,92411084,1,1000,12,92984579,92301504,683075,17.567617025948834
1747352056841527,92504684,1,1001,12,93086807,92395104,691703,17.348486272287385
1747352056935527,92598292,1,1002,12,93180807,92488712,692095,17.338660155036518
1747352057030553,92691884,1,1003,12,93275833,92582304,693529,17.30280925527267
1747352057123946,92785484,1,1004,12,93369226,92675904,693322,17.307975226518128
1747352057210121,92879084,1,1005,12,93455401,92769504,685897,17.49533822133644
1747352057311985,92972684,1,1006,12,93557265,92863104,694161,17.28705588472991
1747352057410713,93066284,1,1007,12,93655993,92956704,699289,17.160287091603042
1747352057500936,93159884,1,1008,12,93746216,93050304,695912,17.243559530515352
1747352057599408,93253484,1,1009,12,93844688,93143904,700784,17.12367862279961
1747352057689607,93347084,1,1010,12,93934887,93237504,697383,17.207187442194606
1747352057775485,93440684,1,1011,12,94020765,93331104,689661,17.399852971242392
1747352057873777,93534284,1,1012,12,94119057,93424704,694353,17.282275730068136
1747352057976160,93627884,1,1013,12,94221440,93518304,703136,17.066399672325126
1747352058070293,93721484,1,1014,12,94315573,93611904,703669,17.053472584411136
1747352058164357,93815084,1,1015,12,94409637,93705504,704133,17.042234918687235
1747352058258628,93908684,1,1016,12,94503908,93799104,704804,17.026010068047288
1747352058353480,94002284,1,1017,12,94598760,93892704,706056,16.995819028518984
1747352058446629,94095884,1,1018,12,94691909,93986304,705605,17.006682208884573
1747352058536713,94189484,1,1019,12,94781993,94079904,702089,17.091850178538618
1747352058635938,94283084,1,1020,12,94881218,94173504,707714,16.956002000808237
1747352058729835,94376684,1,1021,12,94975115,94267104,708011,16.94888921217326
1747352058815945,94470284,1,1022,12,95061225,94360704,700521,17.130107448598974
1747352058918037,94563884,1,1023,12,95163317,94454304,709013,16.924936496227854
1747352059012410,94657484,1,1024,12,95257690,94547904,709786,16.906504213946175
1747352059106496,94751084,1,1025,12,95351776,94641504,710272,16.89493602450892
1747352059200496,94844684,1,1026,12,95445776,94735104,710672,16.885426751018755
1747352059294991,94938284,1,1027,12,95540271,94828704,711567,16.864188474170387
1747352059388884,95031884,1,1028,12,95634164,94922304,711860,16.857247211530357
1747352059483013,95125484,1,1029,12,95728293,95015904,712389,16.844729494700225
1747352059573169,95219084,1,1030,12,95818449,95109504,708945,16.926559888284704
1747352059672083,95312684,1,1031,12,95917363,95203104,714259,16.800628343500048
1747352059766158,95406284,1,1032,12,96011438,95296704,714734,16.78946293306321
1747352059860433,95499884,1,1033,12,96105713,95390304,715409,16.77362180235362
1747352059954022,95593492,1,1034,12,96199302,95483912,715390,16.77406729196662
1747352060052722,95687084,1,1035,12,96298002,95577504,720498,16.65514685675741
1747352060142912,95780684,1,1036,12,96388192,95671104,717088,16.734347806684816
1747352060241010,95874284,1,1037,12,96486290,95764704,721586,16.630034396454477
1747352060347994,95967884,1,1038,12,96593274,95858304,734970,16.32719702845014
1747352060441831,96061484,1,1039,12,96687111,95951904,735207,16.321933822719316
1747352060519371,96155084,1,1040,12,96764651,96045504,719147,16.68643545756292
1747352060613748,96248684,1,1041,12,96859028,96139104,719924,16.66842611164512
1747352060707550,96342284,1,1042,12,96952830,96232704,720126,16.663750510327358
1747352060806670,96435884,1,1043,12,97051950,96326304,725646,16.53698911039267
1747352060904958,96529484,1,1044,12,97150238,96419904,730334,16.430838493073033
1747352061002621,96623084,1,1045,12,97247901,96513504,734397,16.339936029150447
1747352061084636,96716684,1,1046,12,97329916,96607104,722812,16.601827307792345
1747352061179051,96810284,1,1047,12,97424331,96700704,723627,16.583129153555628
1747352061273244,96903884,1,1048,12,97518524,96794304,724220,16.56955068901715
1747352061371164,96997484,1,1049,12,97616444,96887904,728540,16.471298761907377
1747352061462059,97091084,1,1050,12,97707339,96981504,725835,16.53268304780012
1747352061555233,97184684,1,1051,12,97800513,97075104,725409,16.5423919471636
1747352061662130,97278284,1,1052,12,97907410,97168704,738706,16.244622353141846
1747352061744149,97371884,1,1053,12,97989429,97262304,727125,16.503352243424445
1747352061842638,97465484,1,1054,12,98087918,97355904,732014,16.39312909315942
1747352061932165,97559084,1,1055,12,98177445,97449504,727941,16.48485248117636
1747352062026697,97652684,1,1056,12,98271977,97543104,728873,16.4637735243314
1747352062124778,97746284,1,1057,12,98370058,97636704,733354,16.36317521960745
1747352062227491,97839884,1,1058,12,98472771,97730304,742467,16.162334487593387
1747352062308901,97936604,1,1059,12,98554181,97827024,727157,16.502625980359124
1747352062407629,98030204,1,1060,12,98652909,97920624,732285,16.387062414223973
1747352062502364,98123812,1,1061,12,98747644,98014232,733412,16.361881180018873
1747352062608034,98217404,1,1062,12,98853314,98107824,745490,16.096795396316516
1747352062690545,98311004,1,1063,12,98935825,98201424,734401,16.339847031798705
1747352062784551,98404604,1,1064,12,99029831,98295024,734807,16.330818840865696
1747352062879145,98498204,1,1065,12,99124425,98388624,735801,16.308757395002182
1747352062989786,98591804,1,1066,12,99235066,98482224,752842,15.939599544127454
1747352063067374,98685404,1,1067,12,99312654,98575824,736830,16.285981841130248
1747352063165524,98779004,1,1068,12,99410804,98669424,741380,16.18603145485446
1747352063259764,98872604,1,1069,12,99505044,98763024,742020,16.17207083367025
1747352063353895,98966204,1,1070,12,99599175,98856624,742551,16.160506147052526
1747352063447458,99059804,1,1071,12,99692738,98950224,742514,16.161311436552037
1747352063550812,99153404,1,1072,12,99796092,99043824,752268,15.951761872098771
1747352063636213,99247004,1,1073,12,99881493,99137424,744069,16.127536559109437
1747352063730416,99340604,1,1074,12,99975696,99231024,744672,16.114477246358128
1747352063824604,99434204,1,1075,12,100069884,99324624,745260,16.101763143064165
1747352063927534,99527804,1,1076,12,100172814,99418224,754590,15.902675625173936
1747352064012804,99621404,1,1077,12,100258084,99511824,746260,16.08018653016375
1747352064107333,99715004,1,1078,12,100352613,99605424,747189,16.060193605633916
1747352064197512,99808604,1,1079,12,100442792,99699024,743768,16.13406331006443
1747352064295779,99902204,1,1080,12,100541059,99792624,748435,16.03345647918657
1747352064390507,99995804,1,1081,12,100635787,99886224,749563,16.009328101840673
1747352064492521,100089404,1,1082,12,100737801,99979824,757977,15.831614943461345
1747352064573833,100184044,1,1083,12,100819113,100074464,744649,16.11497497478678
1747352064664144,100278684,1,1084,12,100909424,100169104,740320,16.209206829479143
1747352064771075,100373324,1,1085,12,101016355,100263744,752611,15.94449190883471
1747352064860602,100467964,1,1086,12,101105882,100358384,747498,16.05355465834022
1747352064955596,100562604,1,1087,12,101200876,100453024,747852,16.045955616886765
1747352065049200,100657244,1,1088,12,101294480,100547664,746816,16.06821492844288
1747352065147213,100751884,1,1089,12,101392493,100642304,750189,15.995969015808017
1747352065241843,100846524,1,1090,12,101487123,100736944,750179,15.996182244504311
1747352065336212,100941164,1,1091,12,101581492,100831584,749908,16.00196290744998
1747352065430715,101035804,1,1092,12,101675995,100926224,749771,16.004886825444036
1747352065528394,101130444,1,1093,12,101773674,101020864,752810,15.94027709515017
1747352065622863,101225084,1,1094,12,101868143,101115504,752639,15.943898734984502
1747352065717278,101319724,1,1095,12,101962558,101210144,752414,15.948666558570148
1747352065814846,101414364,1,1096,12,102060126,101304784,755342,15.886843310712235
1747352065909875,101509004,1,1097,12,102155155,101399424,755731,15.878665821568784
1747352066004152,101603644,1,1098,12,102249432,101494064,755368,15.886296480655783
1747352066094166,101698284,1,1099,12,102339446,101588704,750742,15.984186311675648
1747352066188223,101792924,1,1100,12,102433503,101683344,750159,15.99660871895158
1747352066285953,101887564,1,1101,12,102531233,101777984,753249,15.930986964469918
1747352066384730,101982204,1,1102,12,102630010,101872624,757386,15.84396859725424
1747352066474811,102076844,1,1103,12,102720091,101967264,752827,15.939917138997403
1747352066572466,102171484,1,1104,12,102817746,102061904,755842,15.876333942808152
1747352066667460,102266124,1,1105,12,102912740,102156544,756196,15.868901713312422
1747352066761283,102360764,1,1106,12,103006563,102251184,755379,15.886065140810109
1747352066855216,102455404,1,1107,12,103100496,102345824,754672,15.90094769648271
1747352066949831,102550044,1,1108,12,103195111,102440464,754647,15.901474464219696
1747352067047649,102644684,1,1109,12,103292929,102535104,757825,15.834790353973544
1747352067142547,102739324,1,1110,12,103387827,102629744,758083,15.82940126608828
1747352067236678,102833964,1,1111,12,103481958,102724384,757574,15.840036748885256
1747352067334972,102928604,1,1112,12,103580252,102819024,761228,15.76400237510969
1747352067428464,103023244,1,1113,12,103673744,102913664,760080,15.787811809283234
1747352067527578,103117884,1,1114,12,103772858,103008304,764554,15.695425045189744
1747352067617734,103212524,1,1115,12,103863014,103102944,760070,15.78801952451748
1747352067715729,103307164,1,1116,12,103961009,103197584,763425,15.71863640829158
1747352067810243,103401804,1,1117,12,104055523,103292224,763299,15.72123112960976
1747352067903808,103496444,1,1118,12,104149088,103386864,762224,15.743403513927664
1747352068001997,103591084,1,1119,12,104247277,103481504,765773,15.670440195723796
1747352068096367,103685724,1,1120,12,104341647,103576144,765503,15.675967305157522
1747352068191162,103780372,1,1121,12,104436442,103670792,765650,15.67295761771044
1747352068284801,103875004,1,1122,12,104530081,103765424,764657,15.693310857024784
1747352068383099,103969644,1,1123,12,104628379,103860064,768315,15.618593936080904
1747352068489894,104064284,1,1124,12,104735174,103954704,780470,15.37535075018899
1747352068571466,104158924,1,1125,12,104816746,104049344,767402,15.637175821798744
1747352068674364,104253564,1,1126,12,104919644,104143984,775660,15.470695923471624
1747352068764371,104348204,1,1127,12,105009651,104238624,771027,15.563657303829826
1747352068862851,104442844,1,1128,12,105108131,104333264,774867,15.48652865588546
1747352068952894,104537484,1,1129,12,105198174,104427904,770270,15.578952834720292
1747352069055152,104632124,1,1130,12,105300432,104522544,777888,15.426385289398988
1747352069148268,104726764,1,1131,12,105393548,104617184,776364,15.456667233411132
1747352069243510,104821404,1,1132,12,105488790,104711824,776966,15.444691273492015
1747352069341756,104916044,1,1133,12,105587036,104806464,780572,15.373341600774816
1747352069431348,105010684,1,1134,12,105676628,104901104,775524,15.473408946725051
1747352069538023,105105324,1,1135,12,105783303,104995744,787559,15.236953675851586
1747352069632521,105199964,1,1136,12,105877801,105090384,787417,15.239701454248513
1747352069722511,105294604,1,1137,12,105967791,105185024,782767,15.330232367997118
1747352069816465,105389244,1,1138,12,106061745,105279664,782081,15.343679235271026
1747352069915196,105483884,1,1139,12,106160476,105374304,786172,15.263835394799102
1747352070000822,105578532,1,1140,12,106246102,105468952,777150,15.441034549314804
1747352070103932,105673164,1,1141,12,106349212,105563584,785628,15.274404680077597
1747352070201996,105767804,1,1142,12,106447276,105658224,789052,15.208123165520144
1747352070300495,105862444,1,1143,12,106545775,105752864,792911,15.134107106598345
1747352070381883,105957084,1,1144,12,106627163,105847504,779659,15.391344164564252
1747352070484694,106051724,1,1145,12,106729974,105942144,787830,15.23171242526941
1747352070574396,106146364,1,1146,12,106819676,106036784,782892,15.32778467528088
1747352070668403,106241004,1,1147,12,106913683,106131424,782259,15.340187840600109
1747352070762318,106335644,1,1148,12,107007598,106226064,781534,15.354418361837103
1747352070868242,106430284,1,1149,12,107113522,106320704,792818,15.135882384103288
1747352070955519,106524924,1,1150,12,107200799,106415344,785455,15.27776893647631
1747352071050032,106619564,1,1151,12,107295312,106509984,785328,15.280239594156836
1747352071156013,106714204,1,1152,12,107401293,106604624,796669,15.06271738953066
1747352071245957,106808844,1,1153,12,107491237,106699264,791973,15.152031698050312
1747352071340399,106903484,1,1154,12,107585679,106793904,791775,15.155820782419248
1747352071438691,106998124,1,1155,12,107683971,106888544,795427,15.08623670053946
1747352071533212,107092764,1,1156,12,107778492,106983184,795308,15.088494017412122
1747352071627602,107187404,1,1157,12,107872882,107077824,795058,15.093238480714614
1747352071725417,107282044,1,1158,12,107970697,107172464,798233,15.033204590639576
1747352071819229,107376684,1,1159,12,108064509,107267104,797405,15.048814592333882
1747352071914065,107471324,1,1160,12,108159345,107361744,797601,15.045116543234023
1747352072004238,107565964,1,1161,12,108249518,107456384,793134,15.129851954398626
1747352072098049,107660604,1,1162,12,108343329,107551024,792305,15.145682533872687
1747352072195824,107755244,1,1163,12,108441104,107645664,795440,15.085990143819773
1747352072294824,107849884,1,1164,12,108540104,107740304,799800,15.003750937734434
1747352072385208,107944524,1,1165,12,108630488,107834944,795544,15.084017980149431
1747352072479122,108039164,1,1166,12,108724402,107929584,794818,15.097795973417814
1747352072576992,108133804,1,1167,12,108822272,108024224,798048,15.036689522434742
1747352072671005,108228444,1,1168,12,108916285,108118864,797421,15.048512642631684
1747352072778079,108323084,1,1169,12,109023359,108213504,809855,14.817467324397578
1747352072863628,108417724,1,1170,12,109108908,108308144,800764,14.985688667322709
1747352072962421,108512364,1,1171,12,109207701,108402784,804917,14.90836943436404
1747352073056599,108607004,1,1172,12,109301879,108497424,804455,14.916931338608125
1747352073154795,108701644,1,1173,12,109400075,108592064,808011,14.851282965207156
1747352073249569,108796284,1,1174,12,109494849,108686704,808145,14.848820446825757
1747352073343502,108890924,1,1175,12,109588782,108781344,807438,14.861822208020923
1747352073441393,108985564,1,1176,12,109686673,108875984,810689,14.80222378742033
1747352073539665,109080204,1,1177,12,109784945,108970624,814321,14.736203536443249
1747352073630105,109174844,1,1178,12,109875385,109065264,810121,14.812602068086123
1747352073724169,109269484,1,1179,12,109969449,109159904,809545,14.823141394239975
1747352073822315,109364124,1,1180,12,110067595,109254544,813051,14.75922174623732
1747352073912099,109458764,1,1181,12,110157379,109349184,808195,14.847901805876058
1747352074010329,109553404,1,1182,12,110255609,109443824,811785,14.782239139673685
1747352074109239,109648044,1,1183,12,110354519,109538464,816055,14.704891214440204
1747352074203253,109742684,1,1184,12,110448533,109633104,815429,14.716180072084756
1747352074293503,109837332,1,1185,12,110538783,109727752,811031,14.795981904514132
1747352074392045,109931964,1,1186,12,110637325,109822384,814941,14.724992361410212
1747352074489775,110026604,1,1187,12,110735055,109917024,818031,14.66937072066951
1747352074588644,110121244,1,1188,12,110833924,110011664,822260,14.59392406294846
1747352074673813,110215884,1,1189,12,110919093,110106304,812789,14.763979335350257
1747352074776579,110310524,1,1190,12,111021859,110200944,820915,14.61783497682464
1747352074870802,110405164,1,1191,12,111116082,110295584,820498,14.62526416883405
1747352074965455,110499804,1,1192,12,111210735,110390224,820511,14.625032449290748
1747352075062825,110594444,1,1193,12,111308105,110484864,823241,14.576533481690053
1747352075149823,110689084,1,1194,12,111395103,110579504,815599,14.713112693860587
1747352075251978,110783724,1,1195,12,111497258,110674144,823114,14.578782525871263
1747352075345574,110878364,1,1196,12,111590854,110768784,822070,14.597297067159731
1747352075440428,110973004,1,1197,12,111685708,110863424,822284,14.593498110141994
1747352075538762,111067644,1,1198,12,111784042,110958064,825978,14.528231986808365
1747352075632624,111162284,1,1199,12,111877904,111052704,825200,14.54192922927775
1747352075726335,111256924,1,1200,12,111971615,111147344,824271,14.55831880534436
1747352075825272,111351564,1,1201,12,112070552,111241984,828568,14.482818549594
1747352075919143,111446204,1,1202,12,112164423,111336624,827799,14.496272645895925
1747352076013917,111540844,1,1203,12,112259197,111431264,827933,14.493926440907655
1747352076104039,111635492,1,1204,12,112349319,111525912,823407,14.573594832203272
1747352076205952,111730124,1,1205,12,112451232,111620544,830688,14.445856928232985
1747352076296287,111824764,1,1206,12,112541567,111715184,826383,14.52111188153677
1747352076394224,111919404,1,1207,12,112639504,111809824,829680,14.463407578825572
1747352076485054,112014044,1,1208,12,112730334,111904464,825870,14.530131860946636
1747352076587217,112108684,1,1209,12,112832497,111999104,833393,14.398969033817178
1747352076681521,112203324,1,1210,12,112926801,112093744,833057,14.404776623928496
1747352076775133,112297964,1,1211,12,113020413,112188384,832029,14.422574213158436
1747352076865604,112392604,1,1212,12,113110884,112283024,827860,14.495204503176865
1747352076959300,112487244,1,1213,12,113204580,112377664,826916,14.511752100576118
1747352077058339,112581884,1,1214,12,113303619,112472304,831315,14.43496147669656
1747352077152016,112676524,1,1215,12,113397296,112566944,830352,14.451702410543962
1747352077254862,112771164,1,1216,12,113500142,112661584,838558,14.310280266839026
1747352077344363,112865804,1,1217,12,113589643,112756224,833419,14.398519832161254
1747352077438987,112960444,1,1218,12,113684267,112850864,833403,14.398796260632611
1747352077532843,113055084,1,1219,12,113778123,112945504,832619,14.412354270080312
1747352077635672,113149724,1,1220,12,113880952,113040144,840808,14.27198599442441
1747352077729657,113244364,1,1221,12,113974937,113134784,840153,14.283112718754795
1747352077823650,113339004,1,1222,12,114068930,113229424,839506,14.294120589966004
1747352077922511,113433644,1,1223,12,114167791,113324064,843727,14.222609920033376
1747352078016739,113528284,1,1224,12,114262019,113418704,843315,14.229558350082709
1747352078109973,113622924,1,1225,12,114355253,113513344,841909,14.253321914838777
1747352078208929,113717564,1,1226,12,114454209,113607984,846225,14.1806257201099
1747352078302793,113812204,1,1227,12,114548073,113702624,845449,14.193641485175332
1747352078396977,113906844,1,1228,12,114642257,113797264,844993,14.2013010758669
1747352078491982,114001484,1,1229,12,114737262,113891904,845358,14.195169383858673
1747352078589622,114096124,1,1230,12,114834902,113986544,848358,14.144971816143658
1747352078683786,114190764,1,1231,12,114929066,114081184,847882,14.152912787392586
1747352078778205,114285404,1,1232,12,115023485,114175824,847661,14.156602698484418
1747352078872671,114380044,1,1233,12,115117951,114270464,847487,14.15950923141004
1747352078970206,114474684,1,1234,12,115215486,114365104,850382,14.11130527221884
1747352079065238,114569324,1,1235,12,115310518,114459744,850774,14.104803390794734
1747352079159253,114663964,1,1236,12,115404533,114554384,850149,14.11517275207052
1747352079248745,114758604,1,1237,12,115494025,114649024,845001,14.201166625838312
1747352079343842,114853244,1,1238,12,115589122,114743664,845458,14.193490392189794
1747352079445649,114947884,1,1239,12,115690929,114838304,852625,14.074182671162587
1747352079540092,115042524,1,1240,12,115785372,114932944,852428,14.077435278991306
1747352079634308,115137164,1,1241,12,115879588,115027584,852004,14.084440918117757
1747352079732850,115231804,1,1242,12,115978130,115122224,855906,14.020231193612384
1747352079822172,115326444,1,1243,12,116067452,115216864,850588,14.107887720024266
1747352079921144,115421084,1,1244,12,116166424,115311504,854920,14.03640106676648
1747352080018706,115515724,1,1245,12,116263986,115406144,857842,13.988589973444991
1747352080117071,115610364,1,1246,12,116362351,115500784,861567,13.928110059925697
1747352080208062,115705004,1,1247,12,116453342,115595424,857918,13.987350772451448
1747352080305579,115799644,1,1248,12,116550859,115690064,860795,13.940601420779627
1747352080400345,115894292,1,1249,12,116645625,115784712,860913,13.938690669092
1747352080494118,115988924,1,1250,12,116739398,115879344,860054,13.952612277833715
1747352080588415,116083564,1,1251,12,116833695,115973984,859711,13.958178969444385
1747352080691005,116178204,1,1252,12,116936285,116068624,867661,13.830286252349708
1747352080776467,116272844,1,1253,12,117021747,116163264,858483,13.978145170026664
1747352080875599,116367484,1,1254,12,117120879,116257904,862975,13.90538543990266
1747352080973354,116462124,1,1255,12,117218634,116352544,866090,13.855372998187256
1747352081067879,116556764,1,1256,12,117313159,116447184,865975,13.857212968041802
1747352081162222,116651404,1,1257,12,117407502,116541824,865678,13.861967151758506
1747352081256379,116746044,1,1258,12,117501659,116636464,865195,13.869705673287523
1747352081345898,116840684,1,1259,12,117591178,116731104,860074,13.952287826396333
1747352081448128,116935324,1,1260,12,117693408,116825744,867664,13.83023843331059
1747352081543263,117029964,1,1261,12,117788543,116920384,868159,13.822352817859402
1747352081636807,117124604,1,1262,12,117882087,117015024,867063,13.839824787818186
1747352081726849,117219244,1,1263,12,117972129,117109664,862465,13.913608088444168
1747352081829300,117313884,1,1264,12,118074580,117204304,870276,13.788729092839512
1747352081923691,117408524,1,1265,12,118168971,117298944,870027,13.792675399728974
1747352082022053,117503164,1,1266,12,118267333,117393584,873749,13.733921297764002
1747352082111654,117597804,1,1267,12,118356934,117488224,868710,13.813585661498085
1747352082210170,117692452,1,1268,12,118455450,117582872,872578,13.752352225245192
1747352082300793,117787084,1,1269,12,118546073,117677504,868569,13.815828103466735
1747352082402888,117881724,1,1270,12,118648168,117772144,876024,13.698254842333087
1747352082497196,117976364,1,1271,12,118742476,117866784,875692,13.703448244359889
1747352082591409,118071004,1,1272,12,118836689,117961424,875265,13.71013350242498
1747352082689748,118165644,1,1273,12,118935028,118056064,878964,13.652436277253676
1747352082783702,118260284,1,1274,12,119028982,118150704,878278,13.663099838547703
1747352082877637,118354924,1,1275,12,119122917,118245344,877573,13.674076116744702
1747352082972022,118449564,1,1276,12,119217302,118339984,877318,13.678050604227884
1747352083070380,118544204,1,1277,12,119315660,118434624,881036,13.620328794737103
1747352083156607,118638844,1,1278,12,119401887,118529264,872623,13.7516430348501
1747352083254802,118733484,1,1279,12,119500082,118623904,876178,13.695847190867608
1747352083353403,118828124,1,1280,12,119598683,118718544,880139,13.634210050912412
1747352083443554,118922764,1,1281,12,119688834,118813184,875650,13.704105521612515
1747352083541703,119017404,1,1282,12,119786983,118907824,879159,13.649408127540068
1747352083635231,119112044,1,1283,12,119880511,119002464,878047,13.666694379685826
1747352083730048,119206684,1,1284,12,119975328,119097104,878224,13.66393995153856
1747352083831870,119301324,1,1285,12,120077150,119191744,885406,13.553104451517155
1747352083926834,119395964,1,1286,12,120172114,119286384,885730,13.548146726429048
1747352084020395,119490604,1,1287,12,120265675,119381024,884651,13.56467126584382
1747352084119071,119585244,1,1288,12,120364351,119475664,888687,13.503066884066044
1747352084212971,119679884,1,1289,12,120458251,119570304,887947,13.514320111448091
1747352084303306,119774524,1,1290,12,120548586,119664944,883642,13.580160291158636
1747352084397320,119869164,1,1291,12,120642600,119759584,883016,13.589787727515697
1747352084495316,119963804,1,1292,12,120740596,119854224,886372,13.538333792132422
1747352084589861,120058444,1,1293,12,120835141,119948864,886277,13.539784965648437
1747352084688518,120153084,1,1294,12,120933798,120043504,890294,13.478693555162677
1747352084778598,120247724,1,1295,12,121023878,120138144,885734,13.548085542612116
1747352084873066,120342364,1,1296,12,121118346,120232784,885562,13.550716945849077
1747352084975384,120437004,1,1297,12,121220664,120327424,893240,13.434239398146074
1747352085065324,120531644,1,1298,12,121310604,120422064,888540,13.505300830576
1747352085167318,120626284,1,1299,12,121412598,120516704,895894,13.394441753153831
1747352085257418,120720924,1,1300,12,121502698,120611344,891354,13.462664665217186
1747352085351421,120815564,1,1301,12,121596701,120705984,890717,13.47229254634188
1747352085446454,120910204,1,1302,12,121691734,120800624,891110,13.46635095554982
1747352085539940,121004844,1,1303,12,121785220,120895264,889956,13.48381268287421
1747352085646490,121099484,1,1304,12,121891770,120989904,901866,13.305746086447432
1747352085736709,121194124,1,1305,12,121981989,121084544,897445,13.37129294831438
1747352085834875,121288764,1,1306,12,122080155,121179184,900971,13.31896365143828
1747352085920976,121383404,1,1307,12,122166256,121273824,892432,13.446402639080624
1747352086019347,121478044,1,1308,12,122264627,121368464,896163,13.390421162221603
1747352086118107,121572684,1,1309,12,122363387,121463104,900283,13.329142058663775
1747352086207613,121667324,1,1310,12,122452893,121557744,895149,13.405589460525569
1747352086313972,121761964,1,1311,12,122559252,121652384,906868,13.232355756295291
1747352086400489,121856604,1,1312,12,122645769,121747024,898745,13.351951888466695
1747352086502709,121951252,1,1313,12,122747989,121841672,906317,13.240400433843789
1747352086597194,122045884,1,1314,12,122842474,121936304,906170,13.24254830771268
1747352086690860,122140524,1,1315,12,122936140,122030944,905196,13.25679742287858
1747352086785258,122235164,1,1316,12,123030538,122125584,904954,13.260342514647151
1747352086874950,122329804,1,1317,12,123120230,122220224,900006,13.333244445037034
1747352086977477,122424444,1,1318,12,123222757,122314864,907893,13.217416589840434
1747352087071817,122519084,1,1319,12,123317097,122409504,907593,13.221785536027712
1747352087165931,122613724,1,1320,12,123411211,122504144,907067,13.229452730614168
1747352087264386,122708364,1,1321,12,123509666,122598784,910882,13.174044497530964
1747352087354766,122803004,1,1322,12,123600046,122693424,906622,13.23594618264282
1747352087452644,122897644,1,1323,12,123697924,122788064,909860,13.188842239465412
1747352087543009,122992284,1,1324,12,123788289,122882704,905585,13.251102878249972
1747352087645173,123086924,1,1325,12,123890453,122977344,913109,13.141914054072409
1747352087739858,123181564,1,1326,12,123985138,123071984,913154,13.141266423845266
1747352087829614,123276204,1,1327,12,124074894,123166624,908270,13.211930373126933
1747352087924103,123370844,1,1328,12,124169383,123261264,908119,13.214127223414552
1747352088022282,123465484,1,1329,12,124267562,123355904,911658,13.162830798391502
1747352088123972,123560124,1,1330,12,124369252,123450544,918708,13.061821601640563
1747352088210527,123654764,1,1331,12,124455807,123545184,910623,13.177791468038915
1747352088304991,123749412,1,1332,12,124550271,123639832,910439,13.180454703719851
1747352088402580,123844044,1,1333,12,124647860,123734464,913396,13.13778470674275
1747352088501136,123938684,1,1334,12,124746416,123829104,917312,13.081699574408708
1747352088603415,124033324,1,1335,12,124848695,123923744,924951,12.973660226325505
1747352088693943,124127964,1,1336,12,124939223,124018384,920839,13.031594013720095
1747352088792024,124222604,1,1337,12,125037304,124113024,924280,12.983078720733976
1747352088886315,124317244,1,1338,12,125131595,124207664,923931,12.987982868850596
1747352088981047,124411884,1,1339,12,125226327,124302304,924023,12.986689725255756
1747352089070410,124506524,1,1340,12,125315690,124396944,918746,13.061281355238554
1747352089165011,124601164,1,1341,12,125410291,124491584,918707,13.06183581925467
1747352089271764,124695804,1,1342,12,125517044,124586224,930820,12.891858791173377
1747352089361543,124790444,1,1343,12,125606823,124680864,925959,12.959537085335311
1747352089459760,124885084,1,1344,12,125705040,124775504,929536,12.909666758468742
1747352089549768,124979724,1,1345,12,125795048,124870144,924904,12.974319496942384
1747352089647747,125074364,1,1346,12,125893027,124964784,928243,12.92764933320262
1747352089742408,125169004,1,1347,12,125987688,125059424,928264,12.927356872613826
1747352089832636,125263644,1,1348,12,126077916,125154064,923852,12.989093491165251
1747352089938800,125358284,1,1349,12,126184080,125248704,935376,12.829065530866732
1747352090028866,125452924,1,1350,12,126274146,125343344,930802,12.892108096029016
1747352090127690,125547564,1,1351,12,126372970,125437984,934986,12.834416772015835
1747352090217114,125642204,1,1352,12,126462394,125532624,929770,12.906417716209384
1747352090315486,125736844,1,1353,12,126560766,125627264,933502,12.854819807563349
1747352090409677,125831484,1,1354,12,126654957,125721904,933053,12.861005752084822
1747352090500480,125926124,1,1355,12,126745760,125816544,929216,12.9141125421861
1747352090602015,126020764,1,1356,12,126847295,125911184,936111,12.818992619464998
1747352090696482,126115404,1,1357,12,126941762,126005824,935938,12.8213620987715
1747352090791184,126210044,1,1358,12,127036464,126100464,936000,12.82051282051282
1747352090884709,126304684,1,1359,12,127129989,126195104,934885,12.835803334099916
1747352090983208,126399324,1,1360,12,127228488,126289744,938744,12.783037761093546
1747352091081867,126493964,1,1361,12,127327147,126384384,942763,12.728543653070814
1747352091171640,126588604,1,1362,12,127416920,126479024,937896,12.79459556283426
1747352091269705,126683244,1,1363,12,127514985,126573664,941321,12.748042378742214
1747352091356069,126777884,1,1364,12,127601349,126668304,933045,12.861116023342923
1747352091458878,126872524,1,1365,12,127704158,126762944,941214,12.74949161402189
1747352091552946,126967164,1,1366,12,127798226,126857584,940642,12.757244520231929
1747352091650947,127061804,1,1367,12,127896227,126952224,944003,12.711824009033869
1747352091737387,127156444,1,1368,12,127982667,127046864,935803,12.823211722980156
1747352091835137,127251084,1,1369,12,128080417,127141504,938913,12.780736873384434
1747352091929757,127345724,1,1370,12,128175037,127236144,938893,12.781009124575432
1747352092023883,127440364,1,1371,12,128269163,127330784,938379,12.78800996185976
1747352092117452,127535004,1,1372,12,128362732,127425424,937308,12.802621976980886
1747352092216521,127629644,1,1373,12,128461801,127520064,941737,12.742411097790573
1747352092310312,127724284,1,1374,12,128555592,127614704,940888,12.753909073130917
1747352092404506,127818924,1,1375,12,128649786,127709344,940442,12.759957551874544
1747352092502945,127913564,1,1376,12,128748225,127803984,944241,12.708619939189251
1747352092596765,128008212,1,1377,12,128842045,127898632,943413,12.719773842421082
1747352092691210,128102844,1,1378,12,128936490,127993264,943226,12.722295611020051
1747352092785272,128197484,1,1379,12,129030552,128087904,942648,12.730096494131423
1747352092883954,128292124,1,1380,12,129129234,128182544,946690,12.675743907720584
1747352092978013,128386764,1,1381,12,129223293,128277184,946109,12.683528007872244
1747352093079969,128481404,1,1382,12,129325249,128371824,953425,12.5862023756457
1747352093170482,128576044,1,1383,12,129415762,128466464,949298,12.640919921879116
1747352093264783,128670684,1,1384,12,129510063,128561104,948959,12.645435682679652
1747352093366476,128765324,1,1385,12,129611756,128655744,956012,12.552143696941044
1747352093452810,128859964,1,1386,12,129698090,128750384,947706,12.662154718868509
1747352093551775,128954604,1,1387,12,129797055,128845024,952031,12.604631571871083
1747352093645853,129049244,1,1388,12,129891133,128939664,951469,12.612076694038375
1747352093747830,129143884,1,1389,12,129993110,129034304,958806,12.515566235505409
1747352093841844,129238524,1,1390,12,130087124,129128944,958180,12.52374292930347
1747352093932031,129333164,1,1391,12,130177311,129223584,953727,12.582216923710874
1747352094030460,129427804,1,1392,12,130275740,129318224,957516,12.532427656561351
1747352094121357,129522444,1,1393,12,130366637,129412864,953773,12.581610089612518
1747352094223044,129617084,1,1394,12,130468324,129507504,960820,12.489332028891988
1747352094317343,129711724,1,1395,12,130562623,129602144,960479,12.493766131274084
1747352094415351,129806372,1,1396,12,130660631,129696792,963839,12.450212120489002
1747352094501437,129901004,1,1397,12,130746717,129791424,955293,12.561591051122535
1747352094603834,129995644,1,1398,12,130849114,129886064,963050,12.460412231971342
1747352094698268,130090284,1,1399,12,130943548,129980704,962844,12.463078131036802
1747352094788605,130184924,1,1400,12,131033885,130075344,958541,12.519026311863552
1747352094890618,130279564,1,1401,12,131135898,130169984,965914,12.423466271324362
1747352094984738,130374204,1,1402,12,131230018,130264624,965394,12.4301580494596
1747352095074937,130468844,1,1403,12,131320217,130359264,960953,12.487603451989848
1747352095169653,130563484,1,1404,12,131414933,130453904,961029,12.486615908573
1747352095267901,130658124,1,1405,12,131513181,130548544,964637,12.43991263034696
1747352095361973,130752764,1,1406,12,131607253,130643184,964069,12.447241846797274
1747352095455386,130847404,1,1407,12,131700666,130737824,962842,12.463104019143328
1747352095550253,130942044,1,1408,12,131795533,130832464,963069,12.460166405522346
1747352095647966,131036684,1,1409,12,131893246,130927104,966142,12.420534455597624
1747352095742613,131131324,1,1410,12,131987893,131021744,966149,12.4204444656052
1747352095836885,131225964,1,1411,12,132082165,131116384,965781,12.425177136431552
1747352095935039,131320604,1,1412,12,132180319,131211024,969295,12.38013195157305
1747352096029524,131415244,1,1413,12,132274804,131305664,969140,12.382111975565966
1747352096123495,131509884,1,1414,12,132368775,131400304,968471,12.390665285795858
1747352096217219,131604524,1,1415,12,132462499,131494944,967555,12.402395729441736
1747352096315572,131699164,1,1416,12,132560852,131589584,971268,12.354983382547353
1747352096409975,131793804,1,1417,12,132655255,131684224,971031,12.357998869243104
1747352096504723,131888444,1,1418,12,132750003,131778864,971139,12.35662454087417
1747352096602253,131983084,1,1419,12,132847533,131873504,974029,12.319961725985571
1747352096697269,132077724,1,1420,12,132942549,131968144,974405,12.3152077421606
1747352096791408,132172364,1,1421,12,133036688,132062784,973904,12.321542985756295
1747352096885403,132267004,1,1422,12,133130683,132157424,973259,12.329708741455256
1747352096983759,132361644,1,1423,12,133229039,132252064,976975,12.282811740320888
1747352097077614,132456284,1,1424,12,133322894,132346704,976190,12.29268892326289
1747352097172330,132550924,1,1425,12,133417610,132441344,976266,12.29173196649274
1747352097265759,132645564,1,1426,12,133511039,132535984,975055,12.30699806677572
1747352097364241,132740204,1,1427,12,133609521,132630624,978897,12.258695245771516
1747352097458928,132834844,1,1428,12,133704208,132725264,978944,12.258106694560668
1747352097552420,132929484,1,1429,12,133797700,132819904,977796,12.27249855798142
1747352097650887,133024124,1,1430,12,133896167,132914544,981623,12.224652437850375
1747352097745406,133118764,1,1431,12,133990686,133009184,981502,12.22615949840143
1747352097839309,133213404,1,1432,12,134084589,133103824,980765,12.235346897574852
1747352097933826,133308044,1,1433,12,134179106,133198464,980642,12.236881553105006
1747352098032065,133402684,1,1434,12,134277345,133293104,984241,12.192135869162126
1747352098125710,133497324,1,1435,12,134370990,133387744,983246,12.204473753262157
1747352098220305,133591964,1,1436,12,134465585,133482384,983201,12.205032338250266
1747352098314858,133686604,1,1437,12,134560138,133577024,983114,12.20611241422663
1747352098412671,133781244,1,1438,12,134657951,133671664,986287,12.16684393082338
1747352098507417,133875884,1,1439,12,134752697,133766304,986393,12.165536454536884
1747352098600926,133970524,1,1440,12,134846206,133860944,985262,12.179501493003892
1747352098699575,134065172,1,1441,12,134944855,133955592,989263,12.130242412786084
1747352098793538,134159804,1,1442,12,135038818,134050224,988594,12.13845117409169
1747352098887982,134254444,1,1443,12,135133262,134144864,988398,12.140858237268793
1747352098982014,134349084,1,1444,12,135227294,134239504,987790,12.148331123011976
1747352099080116,134443724,1,1445,12,135325396,134334144,991252,12.10590243449698
1747352099174790,134538364,1,1446,12,135420070,134428784,991286,12.10548721559671
1747352099268560,134633004,1,1447,12,135513840,134523424,990416,12.11612090273178
1747352099367395,134727644,1,1448,12,135612675,134618064,994611,12.065018384071765
1747352099461401,134822284,1,1449,12,135706681,134712704,993977,12.07271395615794
1747352099555456,134916924,1,1450,12,135800736,134807344,993392,12.079823473512974
1747352099649863,135011564,1,1451,12,135895143,134901984,993159,12.082657459681682
1747352099748185,135106204,1,1452,12,135993465,134996624,996841,12.038028130865404
1747352099841946,135200844,1,1453,12,136087226,135091264,995962,12.04865245862794
1747352099936290,135295484,1,1454,12,136181570,135185904,995666,12.052234383819473
1747352100030967,135390124,1,1455,12,136276247,135280544,995703,12.051786526705252
1747352100129176,135484764,1,1456,12,136374456,135375184,999272,12.008742364441312
1747352100223604,135579404,1,1457,12,136468884,135469824,999060,12.011290613176389
1747352100317069,135674044,1,1458,12,136562349,135564464,997885,12.025433792471077
1747352100416057,135768684,1,1459,12,136661337,135659104,1002233,11.973263702153092
1747352100510086,135863332,1,1460,12,136755366,135753752,1001614,11.980663209579738
1747352100604304,135957964,1,1461,12,136849584,135848384,1001200,11.985617259288851
1747352100697815,136052604,1,1462,12,136943095,135943024,1000071,11.999148060487704
1747352100796799,136147244,1,1463,12,137042079,136037664,1004415,11.94725287854124
1747352100890599,136241884,1,1464,12,137135879,136132304,1003575,11.957252821164335
1747352100985197,136336524,1,1465,12,137230477,136226944,1003533,11.957753257740404
1747352101083722,136431164,1,1466,12,137329002,136321584,1007418,11.911639458496872
1747352101177934,136525804,1,1467,12,137423214,136416224,1006990,11.916702251263668
1747352101271930,136620444,1,1468,12,137517210,136510864,1006346,11.924328213159292
1747352101365598,136715084,1,1469,12,137610878,136605504,1005374,11.935856706061625
1747352101464141,136809724,1,1470,12,137709421,136700144,1009277,11.889699259965305
1747352101558653,136904364,1,1471,12,137803933,136794784,1009149,11.891207344009654
1747352101652950,136999004,1,1472,12,137898230,136889424,1008806,11.895250424759569
1747352101747304,137093644,1,1473,12,137992584,136984064,1008520,11.898623725855709
1747352101845527,137188284,1,1474,12,138090807,137078704,1012103,11.856500771166573
1747352101939791,137282924,1,1475,12,138185071,137173344,1011727,11.860907141946392
1747352102033359,137377564,1,1476,12,138278639,137267984,1010655,11.873487985514345
1747352102131608,137472204,1,1477,12,138376888,137362624,1014264,11.831239203994226
1747352102226282,137566844,1,1478,12,138471562,137457264,1014298,11.830842612328922
1747352102320135,137661484,1,1479,12,138565415,137551904,1013511,11.84002936327282
1747352102418608,137756124,1,1480,12,138663888,137646544,1017344,11.795420231504782
1747352102512390,137850764,1,1481,12,138757670,137741184,1016486,11.805376561998886
1747352102607529,137945404,1,1482,12,138852809,137835824,1016985,11.79958406466172
1747352102701507,138040044,1,1483,12,138946787,137930464,1016323,11.807269932885507
1747352102799757,138134684,1,1484,12,139045037,138025104,1019933,11.76547871281741
1747352102894238,138229324,1,1485,12,139139518,138119744,1019774,11.767313149776324
1747352102988287,138323964,1,1486,12,139233567,138214384,1019183,11.77413673501226
1747352103082762,138418604,1,1487,12,139328042,138309024,1019018,11.776043210227886
1747352103181269,138513244,1,1488,12,139426549,138403664,1022885,11.731524071620957
1747352103274793,138607884,1,1489,12,139520073,138498304,1021769,11.744337516601112
1747352103368966,138702524,1,1490,12,139614246,138592944,1021302,11.749707726020317
1747352103463530,138797164,1,1491,12,139708810,138687584,1021226,11.750582143423689
1747352103561259,138891804,1,1492,12,139806539,138782224,1024315,11.715146219668751
1747352103655236,138986444,1,1493,12,139900516,138876864,1023652,11.722733897848096
1747352103749809,139081084,1,1494,12,139995089,138971504,1023585,11.72350122364044
1747352103847739,139175724,1,1495,12,140093019,139066144,1026875,11.685940353012782
1747352103942170,139270364,1,1496,12,140187450,139160784,1026666,11.6883192781294
1747352104036465,139365004,1,1497,12,140281745,139255424,1026321,11.692248331662316
1747352104130770,139459644,1,1498,12,140376050,139350064,1025986,11.696066028191415
1747352104228538,139554284,1,1499,12,140473818,139444704,1029114,11.660515744611384
1747352104322932,139648924,1,1500,12,140568212,139539344,1028868,11.663303747419496
1747351654505185,109580,1,1,1,0,0,0,0.0
1747351654594431,197404,1,2,1,89246,87824,1422,703.2348804500702
1747351680708829,109580,1,1,1,26203644,0,26203644,0.0381626311210761
1747351680799226,200524,1,2,1,26294041,90944,26203097,0.0381634277810748
1747351680888812,292044,1,3,1,26383627,182464,26201163,0.0381662447579139
1747351680983215,383564,1,4,1,26478030,273984,26204046,0.0381620456627194
1747351681073754,475084,1,5,1,26568569,365504,26203065,0.0381634743874428
1747351681167930,566604,1,6,1,26662745,457024,26205721,0.0381596064462412
1747351681257372,658124,1,7,1,26752187,548544,26203643,0.0381626325774626
1747351681351721,749644,1,8,1,26846536,640064,26206472,0.0381585129047511
1747351681441819,841164,1,9,1,26936634,731584,26205050,0.0381605835516436
1747351681536383,932684,1,10,1,27031198,823104,26208094,0.0381561513019603
1747351681629969,1022124,1,11,1,27124784,912544,26212240,0.0381501161289534
1747351681724812,1115724,1,12,1,27219627,1006144,26213483,0.0381483071135567
1747351681818880,1209324,1,13,1,27313695,1099744,26213951,0.038147626048435
1747351681912730,1302924,1,14,1,27407545,1193344,26214201,0.0381472622415613
1747351682007079,1396524,1,15,1,27501894,1286944,26214950,0.0381461723177042
1747351682101336,1490124,1,16,1,27596151,1380544,26215607,0.0381452163209495
1747351682191746,1580604,1,17,1,27686561,1471024,26215537,0.0381453181752485
1747351682285587,1674204,1,18,1,27780402,1564624,26215778,0.0381449675077352
1747351682380559,1767804,1,19,1,27875374,1658224,26217150,0.0381429712993212
1747351682474444,1861404,1,20,1,27969259,1751824,26217435,0.0381425566612447
1747351682568972,1955004,1,21,1,28063787,1845424,26218363,0.0381412066039363
1747351682658522,2045484,1,22,1,28153337,1935904,26217433,0.0381425595709541
1747351682752760,2139084,1,23,1,28247575,2029504,26218071,0.0381416313961465
1747351682847012,2232684,1,24,1,28341827,2123104,26218723,0.0381406829005363
1747351682941123,2326284,1,25,1,28435938,2216704,26219234,0.0381399395573493
1747351683034927,2416764,1,26,1,28529742,2307184,26222558,0.0381351048970889
1747351683129997,2510364,1,27,1,28624812,2400784,26224028,0.0381329672161728
1747351683224426,2603964,1,28,1,28719241,2494384,26224857,0.0381317617861557
1747351683318309,2697564,1,29,1,28813124,2587984,26225140,0.0381313502997505
1747351683413621,2791164,1,30,1,28908436,2681584,26226852,0.038128861214453
1747351683506058,2884764,1,31,1,29000873,2775184,26225689,0.038130552070529
1747351683600356,2978364,1,32,1,29095171,2868784,26226387,0.0381295372481158
1747351683695121,3071964,1,33,1,29189936,2962384,26227552,0.0381278435745737
1747351683784701,3162444,1,34,1,29279516,3052864,26226652,0.0381291519786818
1747351683875028,3252924,1,35,1,29369843,3143344,26226499,0.0381293744163107
1747351683964912,3343404,1,36,1,29459727,3233824,26225903,0.0381302409301216
1747351684059616,3433884,1,37,1,29554431,3324304,26230127,0.0381241005809846
1747351684149751,3524364,1,38,1,29644566,3414784,26229782,0.0381246020268105
1747351684243773,3617964,1,39,1,29738588,3508384,26230204,0.0381239886658906
1747351684337751,3711564,1,40,1,29832566,3601984,26230582,0.0381234392740504
1747351684431985,3805164,1,41,1,29926800,3695584,26231216,0.0381225178428632
1747351684526170,3898764,1,42,1,30020985,3789184,26231801,0.0381216676658991
1747351684620525,3992364,1,43,1,30115340,3882784,26232556,0.038120570485011
1747351684714860,4085964,1,44,1,30209675,3976384,26233291,0.0381195024291843
1747351684808491,4179564,1,45,1,30303306,4069984,26233322,0.0381194573832471
1747351684902623,4273172,1,46,1,30397438,4163592,26233846,0.0381186959777075
1747351684997203,4366764,1,47,1,30492018,4257184,26234834,0.0381172604332087
1747351685091295,4460364,1,48,1,30586110,4350784,26235326,0.0381165456072472
1747351685185096,4553964,1,49,1,30679911,4444384,26235527,0.0381162535824037
1747351685279335,4647564,1,50,1,30774150,4537984,26236166,0.0381153252346398
1747351685373412,4741164,1,51,1,30868227,4631584,26236643,0.0381146322721241
1747351685467667,4834764,1,52,1,30962482,4725184,26237298,0.0381136807608771
1747351685562848,4928364,1,53,1,31057663,4818784,26238879,0.038111384255402
1747351685656547,5021964,1,54,1,31151362,4912384,26238978,0.0381112404606612
1747351685750657,5115564,1,55,1,31245472,5005984,26239488,0.0381104997170676
1747351685845275,5209164,1,56,1,31340090,5099584,26240506,0.038109021220856
1747351685939164,5302764,1,57,1,31433979,5193184,26240795,0.0381086015115014
1747351686033530,5396364,1,58,1,31528345,5286784,26241561,0.0381074891085938
1747351686127375,5489964,1,59,1,31622190,5380384,26241806,0.0381071333276375
1747351686222061,5583564,1,60,1,31716876,5473984,26242892,0.0381055563540786
1747351686315652,5677164,1,61,1,31810467,5567584,26242883,0.0381055694223839
1747351686409656,5770764,1,62,1,31904471,5661184,26243287,0.0381049828095085
1747351686504559,5864364,1,63,1,31999374,5754784,26244590,0.0381030909608418
1747351686597914,5957964,1,64,1,32092729,5848384,26244345,0.0381034466663199
1747351686697224,6051564,1,65,1,32192039,5941984,26250055,0.0380951582768112
1747351686791057,6145164,1,66,1,32285872,6035584,26250288,0.0380948201406399
1747351686885103,6238764,1,67,1,32379918,6129184,26250734,0.0380941729096032
1747351686979216,6332364,1,68,1,32474031,6222784,26251247,0.0380934284759882
1747351687072959,6425964,1,69,1,32567774,6316384,26251390,0.0380932209684896
1747351687167903,6519564,1,70,1,32662718,6409984,26252734,0.0380912707986909
1747351687261905,6613164,1,71,1,32756720,6503584,26253136,0.0380906875277681
1747351687356306,6706764,1,72,1,32851121,6597184,26253937,0.038089525391944
1747351687450407,6800364,1,73,1,32945222,6690784,26254438,0.03808879854903
1747351687544384,6893964,1,74,1,33039199,6784384,26254815,0.0380882516216549
1747351687638106,6987564,1,75,1,33132921,6877984,26254937,0.0380880746352581
1747351687733260,7081164,1,76,1,33228075,6971584,26256491,0.0380858203786637
1747351687827488,7174764,1,77,1,33322303,7065184,26257119,0.0380849094677904
1747351687921853,7268372,1,78,1,33416668,7158792,26257876,0.0380838115009759
1747351688012069,7358844,1,79,1,33506884,7249264,26257620,0.0380841828010307
1747351688105976,7452444,1,80,1,33600791,7342864,26257927,0.0380837375319079
1747351688200468,7546044,1,81,1,33695283,7436464,26258819,0.0380824438448659
1747351688293647,7639644,1,82,1,33788462,7530064,26258398,0.0380830544193899
1747351688388438,7733244,1,83,1,33883253,7623664,26259589,0.0380813271677633
1747351688482187,7826844,1,84,1,33977002,7717264,26259738,0.038081111091055
1747351688576367,7920444,1,85,1,34071182,7810864,26260318,0.0380802700104393
1747351688670493,8014044,1,86,1,34165308,7904464,26260844,0.038079507269454
1747351688765602,8107644,1,87,1,34260417,7998064,26262353,0.03807731927143
1747351688858889,8201252,1,88,1,34353704,8091672,26262032,0.0380777846893187
1747351688954035,8294844,1,89,1,34448850,8185264,26263586,0.0380755316505522
1747351689048118,8388444,1,90,1,34542933,8278864,26264069,0.0380748314360581
1747351689141664,8482044,1,91,1,34636479,8372464,26264015,0.0380749097196296
1747351689236240,8575644,1,92,1,34731055,8466064,26264991,0.038073494866227
1747351689330554,8669244,1,93,1,34825369,8559664,26265705,0.0380724598863803
1747351689425023,8762844,1,94,1,34919838,8653264,26266574,0.0380712003019503
1747351689518996,8853324,1,95,1,35013811,8743744,26270067,0.0380661381640176
1747351689612551,8946924,1,96,1,35107366,8837344,26270022,0.0380662033705186
1747351689706638,9040524,1,97,1,35201453,8930944,26270509,0.0380654977031469
1747351689800907,9134124,1,98,1,35295722,9024544,26271178,0.0380645283587968
1747351689895164,9227724,1,99,1,35389979,9118144,26271835,0.0380635764498368
1747351689989518,9321324,1,100,1,35484333,9211744,26272589,0.0380624840589558
1747351690083683,9415964,1,101,1,35578498,9306384,26272114,0.0380631722289268
1747351690182123,9510604,1,102,1,35676938,9401024,26275914,0.0380576675658171
1747351690276537,9605244,1,103,1,35771352,9495664,26275688,0.0380579949038822
1747351690371008,9699884,1,104,1,35865823,9590304,26275519,0.0380582396869116
1747351690464873,9794524,1,105,1,35959688,9684944,26274744,0.0380593622529681
1747351690562883,9889164,1,106,1,36057698,9779584,26278114,0.038054481383253
1747351690656877,9983804,1,107,1,36151692,9874224,26277468,0.0380554169069866
1747351690752006,10078444,1,108,1,36246821,9968864,26277957,0.0380547087431492
1747351690846124,10171004,1,109,1,36340939,10061424,26279515,0.0380524526422957
1747351690943906,10266684,1,110,1,36438721,10157104,26281617,0.0380494092125305
1747351691038289,10362364,1,111,1,36533104,10252784,26280320,0.038051287046733
1747351691136293,10458044,1,112,1,36631108,10348464,26282644,0.0380479224236343
1747351691230370,10550604,1,113,1,36725185,10441024,26284161,0.0380457264738258
1747351691325155,10646284,1,114,1,36819970,10536704,26283266,0.0380470220101261
1747351691418737,10738844,1,115,1,36913552,10629264,26284288,0.0380455426450965
1747351691513198,10834524,1,116,1,37008013,10724944,26283069,0.0380473071847127
1747351691611405,10930212,1,117,1,37106220,10820632,26285588,0.0380436610358497
1747351691706313,11025884,1,118,1,37201128,10916304,26284824,0.0380447668205805
1747351691804580,11121564,1,119,1,37299395,11011984,26287411,0.0380410227541997
1747351691902644,11217244,1,120,1,37397459,11107664,26289795,0.0380375731343663
1747351691997038,11312924,1,121,1,37491853,11203344,26288509,0.0380394338834507
1747351692093937,11408604,1,122,1,37588752,11299024,26289728,0.0380376700740304
1747351692188899,11504284,1,123,1,37683714,11394704,26289010,0.0380387089510027
1747351692287269,11599964,1,124,1,37782084,11490384,26291700,0.0380348170715472
1747351692381806,11695644,1,125,1,37876621,11586064,26290557,0.03803647066131
1747351692480110,11791324,1,126,1,37974925,11681744,26293181,0.0380326747075601
1747351692574493,11887004,1,127,1,38069308,11777424,26291884,0.0380345508903051
1747351692671951,11982684,1,128,1,38166766,11873104,26293662,0.0380319789613177
1747351692766489,12078364,1,129,1,38261304,11968784,26292520,0.0380336308577496
1747351692864710,12174044,1,130,1,38359525,12064464,26295061,0.0380299555114171
1747351692958760,12269724,1,131,1,38453575,12160144,26293431,0.038032313089912
1747351693057160,12365404,1,132,1,38551975,12255824,26296151,0.0380283791342695
1747351693151241,12461092,1,133,1,38646056,12351512,26294544,0.0380307032515947
1747351693249997,12556764,1,134,1,38744812,12447184,26297628,0.0380262432794318
1747351693348616,12652444,1,135,1,38843431,12542864,26300567,0.0380219939745025
1747351693442420,12748124,1,136,1,38937235,12638544,26298691,0.0380247062486874
1747351693541087,12843804,1,137,1,39035902,12734224,26301678,0.0380203879007263
1747351693635180,12939484,1,138,1,39129995,12829904,26300091,0.0380226821268413
1747351693733133,13035164,1,139,1,39227948,12925584,26302364,0.038019396279361
1747351693827753,13130844,1,140,1,39322568,13021264,26301304,0.0380209285440752
1747351693925886,13226524,1,141,1,39420701,13116944,26303757,0.0380173828400254
1747351694020215,13322204,1,142,1,39515030,13212624,26302406,0.0380193355695292
1747351694117904,13417884,1,143,1,39612719,13308304,26304415,0.0380164318423352
1747351694212877,13513564,1,144,1,39707692,13403984,26303708,0.0380174536609059
1747351694311115,13609244,1,145,1,39805930,13499664,26306266,0.0380137568745028
1747351694405350,13704924,1,146,1,39900165,13595344,26304821,0.0380158450802611
1747351694503406,13800604,1,147,1,39998221,13691024,26307197,0.0380124115845561
1747351694597798,13896284,1,148,1,40092613,13786704,26305909,0.0380142727628229
1747351694695898,13991972,1,149,1,40190713,13882392,26308321,0.0380107875375247
1747351694790160,14087644,1,150,1,40284975,13978064,26306911,0.0380128248428711
1747351694888610,14183324,1,151,1,40383425,14073744,26309681,0.038008822683939
1747351694986804,14279004,1,152,1,40481619,14169424,26312195,0.0380051911290563
1747351695080827,14374684,1,153,1,40575642,14265104,26310538,0.0380075846415607
1747351695174817,14467244,1,154,1,40669632,14357664,26311968,0.0380055190094484
1747351695268822,14559804,1,155,1,40763637,14450224,26313413,0.0380034319379245
1747351695358813,14652364,1,156,1,40853628,14542784,26310844,0.0380071426062957
1747351695453252,14744924,1,157,1,40948067,14635344,26312723,0.0380044285040358
1747351695547766,14837484,1,158,1,41042581,14727904,26314677,0.0380016064799123
1747351695641967,14930044,1,159,1,41136782,14820464,26316318,0.0379992368233276
1747351695736387,15025724,1,160,1,41231202,14916144,26315058,0.0380010562773602
1747351695834387,15121404,1,161,1,41329202,15011824,26317378,0.0379977063064565
1747351695928313,15217084,1,162,1,41423128,15107504,26315624,0.0380002389455024
1747351696027093,15312764,1,163,1,41521908,15203184,26318724,0.0379957630164745
1747351696121433,15408444,1,164,1,41616248,15298864,26317384,0.0379976976435043
1747351696219567,15504124,1,165,1,41714382,15394544,26319838,0.0379941548272447
1747351696313524,15599804,1,166,1,41808339,15490224,26318115,0.0379966422367255
1747351696412103,15695484,1,167,1,41906918,15585904,26321014,0.0379924572814709
1747351696506102,15791164,1,168,1,42000917,15681584,26319333,0.0379948838369118
1747351696604180,15886844,1,169,1,42098995,15777264,26321731,0.0379914223726395
1747351696702176,15982524,1,170,1,42196991,15872944,26324047,0.0379880798723691
1747351696796670,16078204,1,171,1,42291485,15968624,26322861,0.0379897914592186
1747351696894839,16173884,1,172,1,42389654,16064304,26325350,0.0379861996136803
1747351696989346,16269564,1,173,1,42484161,16159984,26324177,0.037987892271048
1747351697083268,16362124,1,174,1,42578083,16252544,26325539,0.037985926897831
1747351697177672,16457804,1,175,1,42672487,16348224,26324263,0.0379877681665769
1747351697271558,16550364,1,176,1,42766373,16440784,26325589,0.0379858547514359
1747351697365836,16642924,1,177,1,42860651,16533344,26327307,0.0379833759677736
1747351697459730,16735484,1,178,1,42954545,16625904,26328641,0.0379814514543306
1747351697550730,16828044,1,179,1,43045545,16718464,26327081,0.0379837020291007
1747351697644879,16920612,1,180,1,43139694,16811032,26328662,0.037981421159951
1747351697738947,17013164,1,181,1,43233762,16903584,26330178,0.0379792343219252
1747351697832924,17105724,1,182,1,43327739,16996144,26331595,0.037977190519602
1747351697927267,17198284,1,183,1,43422082,17088704,26333378,0.0379746191316586
1747351698017166,17290844,1,184,1,43511981,17181264,26330717,0.037978456872253
1747351698111421,17383404,1,185,1,43606236,17273824,26332412,0.0379760122240226
1747351698205484,17475964,1,186,1,43700299,17366384,26333915,0.0379738447549481
1747351698300285,17568524,1,187,1,43795100,17458944,26336156,0.0379706134790513
1747351698389799,17661084,1,188,1,43884614,17551504,26333110,0.037975005610807
1747351698483602,17753644,1,189,1,43978417,17644064,26334353,0.0379732131638092
1747351698578007,17846204,1,190,1,44072822,17736624,26336198,0.0379705529249134
1747351698672152,17938764,1,191,1,44166967,17829184,26337783,0.037968267868256
1747351698762987,18031324,1,192,1,44257802,17921744,26336058,0.0379707547727909
1747351698857408,18123884,1,193,1,44352223,18014304,26337919,0.0379680718131147
1747351698951253,18216444,1,194,1,44446068,18106864,26339204,0.0379662194802849
1747351699045678,18309004,1,195,1,44540493,18199424,26341069,0.0379635313965427
1747351699139149,18401564,1,196,1,44633964,18291984,26341980,0.0379622184816782
1747351699229388,18494124,1,197,1,44724203,18384544,26339659,0.0379655636392255
1747351699323462,18586684,1,198,1,44818277,18477104,26341173,0.0379633815092441
1747351699417873,18679244,1,199,1,44912688,18569664,26343024,0.0379607140015512
1747351699512484,18771804,1,200,1,45007299,18662224,26345075,0.0379577587082215
1747351699602310,18864364,1,201,1,45097125,18754784,26342341,0.0379616982408662
1747351699696740,18956924,1,202,1,45191555,18847344,26344211,0.0379590035928576
1747351699791004,19049492,1,203,1,45285819,18939912,26345907,0.0379565600075943
1747351699885002,19142044,1,204,1,45379817,19032464,26347353,0.0379544768690805
1747351699975096,19234604,1,205,1,45469911,19125024,26344887,0.0379580295789463
1747351700068906,19327164,1,206,1,45563721,19217584,26346137,0.0379562286493841
1747351700163884,19419724,1,207,1,45658699,19310144,26348555,0.0379527454162097
1747351700257793,19512284,1,208,1,45752608,19402704,26349904,0.0379508024014053
1747351700347830,19604844,1,209,1,45842645,19495264,26347381,0.0379544365339386
1747351700442090,19697404,1,210,1,45936905,19587824,26349081,0.0379519877752093
1747351700536611,19789964,1,211,1,46031426,19680384,26351042,0.0379491634524357
1747351700630533,19882524,1,212,1,46125348,19772944,26352404,0.0379472020844853
1747351700720923,19975084,1,213,1,46215738,19865504,26350234,0.0379503271204346
1747351700814833,20067644,1,214,1,46309648,19958064,26351584,0.0379483829131486
1747351700908579,20160204,1,215,1,46403394,20050624,26352770,0.0379466750554116
1747351701002854,20252764,1,216,1,46497669,20143184,26354485,0.0379442057016101
1747351701097264,20345324,1,217,1,46592079,20235744,26356335,0.0379415423274897
1747351701187817,20437884,1,218,1,46682632,20328304,26354328,0.0379444317457079
1747351701283920,20530444,1,219,1,46778735,20420864,26357871,0.0379393312912108
1747351701375433,20623004,1,220,1,46870248,20513424,26356824,0.0379408383953999
1747351701470344,20715564,1,221,1,46965159,20605984,26359175,0.0379374544157774
1747351701560473,20808124,1,222,1,47055288,20698544,26356744,0.0379409535563269
1747351701654581,20900684,1,223,1,47149396,20791104,26358292,0.0379387253164962
1747351701748363,20993244,1,224,1,47243178,20883664,26359514,0.0379369665161504
1747351701842325,21085804,1,225,1,47337140,20976224,26360916,0.0379349488462388
1747351701933320,21178364,1,226,1,47428135,21068784,26359351,0.0379372011093899
1747351702027473,21270924,1,227,1,47522288,21161344,26360944,0.037934908552592
1747351702121564,21363484,1,228,1,47616379,21253904,26362475,0.0379327054838364
1747351702214888,21456044,1,229,1,47709703,21346464,26363239,0.0379316062036231
1747351702309607,21548604,1,230,1,47804422,21439024,26365398,0.037928500074226
1747351702399426,21641164,1,231,1,47894241,21531584,26362657,0.0379324436076378
1747351702493402,21733724,1,232,1,47988217,21624144,26364073,0.0379304062767539
1747351702587564,21826284,1,233,1,48082379,21716704,26365675,0.0379281015942129
1747351702682596,21918844,1,234,1,48177411,21809264,26368147,0.0379245458545115
1747351702772314,22011404,1,235,1,48267129,21901824,26365305,0.0379286338618119
1747351702866395,22103964,1,236,1,48361210,21994384,26366826,0.0379264459059274
1747351702960499,22196524,1,237,1,48455314,22086944,26368370,0.0379242251227512
1747351703055164,22289084,1,238,1,48549979,22179504,26370475,0.0379211978547978
1747351703145135,22381644,1,239,1,48639950,22272064,26367886,0.0379249212470047
1747351703239384,22474204,1,240,1,48734199,22364624,26369575,0.0379224921144917
1747351703333492,22566764,1,241,1,48828307,22457184,26371123,0.0379202660425193
1747351703428062,22659324,1,242,1,48922877,22549744,26373133,0.037917375990179
1747351703517733,22751884,1,243,1,49012548,22642304,26370244,0.0379215300396917
1747351703612114,22844452,1,244,1,49106929,22734872,26372057,0.0379189230479821
1747351703706522,22937004,1,245,1,49201337,22827424,26373913,0.0379162545959714
1747351703800356,23029564,1,246,1,49295171,22919984,26375187,0.037914423128071
1747351703894244,23122124,1,247,1,49389059,23012544,26376515,0.0379125142195623
1747351703984834,23214684,1,248,1,49479649,23105104,26374545,0.0379153460277703
1747351704078532,23307244,1,249,1,49573347,23197664,26375683,0.0379137101397525
1747351704173087,23399804,1,250,1,49667902,23290224,26377678,0.0379108426450576
1747351704267321,23492364,1,251,1,49762136,23382784,26379352,0.0379084368713833
1747351704357018,23584924,1,252,1,49851833,23475344,26376489,0.0379125515909263
1747351704451299,23677484,1,253,1,49946114,23567904,26378210,0.0379100780530597
1747351704546073,23770044,1,254,1,50040888,23660464,26380424,0.0379068964168278
1747351704639989,23862604,1,255,1,50134804,23753024,26381780,0.0379049480361067
1747351704730586,23955164,1,256,1,50225401,23845584,26379817,0.0379077686551047
1747351704827867,24047724,1,257,1,50322682,23938144,26384538,0.0379009857970603
1747351704918191,24140284,1,258,1,50413006,24030704,26382302,0.0379041980491315
1747351705012896,24232844,1,259,1,50507711,24123264,26384447,0.0379011165176211
1747351705102535,24325404,1,260,1,50597350,24215824,26381526,0.0379053129830321
1747351705197216,24417964,1,261,1,50692031,24308384,26383647,0.0379022657481734
1747351705291552,24510524,1,262,1,50786367,24400944,26385423,0.0378997145507199
1747351705385172,24603084,1,263,1,50879987,24493504,26386483,0.0378981920402199
1747351705479285,24695644,1,264,1,50974100,24586064,26388036,0.0378959616395854
1747351705570264,24788204,1,265,1,51065079,24678624,26386455,0.0378982322559055
1747351705664048,24880764,1,266,1,51158863,24771184,26387679,0.037896474335617
1747351705758166,24973332,1,267,1,51252981,24863752,26389229,0.0378942484450758
1747351705851938,25065884,1,268,1,51346753,24956304,26390449,0.037892496637704
1747351705942418,25158444,1,269,1,51437233,25048864,26388369,0.0378954834230186
1747351706036865,25251004,1,270,1,51531680,25141424,26390256,0.0378927737571018
1747351706131349,25343564,1,271,1,51626164,25233984,26392180,0.0378900113594254
1747351706225113,25436124,1,272,1,51719928,25326544,26393384,0.0378882829121116
1747351706315276,25528684,1,273,1,51810091,25419104,26390987,0.0378917241708315
1747351706409043,25621244,1,274,1,51903858,25511664,26392194,0.0378899912602946
1747351706503393,25713804,1,275,1,51998208,25604224,26393984,0.0378874216185021
1747351706598161,25806364,1,276,1,52092976,25696784,26396192,0.0378842523951939
1747351706688358,25898924,1,277,1,52183173,25789344,26393829,0.0378876441155999
1747351706782161,25991484,1,278,1,52276976,25881904,26395072,0.0378858599059703
1747351706876178,26084044,1,279,1,52370993,25974464,26396529,0.0378837687333815
1747351706970757,26176604,1,280,1,52465572,26067024,26398548,0.0378808713267108
1747351707063729,26269164,1,281,1,52558544,26159584,26398960,0.0378802801322476
1747351707155054,26361724,1,282,1,52649869,26252144,26397725,0.0378820523359494
1747351707249008,26454284,1,283,1,52743823,26344704,26399119,0.0378800519820377
1747351707343323,26546844,1,284,1,52838138,26437264,26400874,0.0378775339028548
1747351707437381,26639404,1,285,1,52932196,26529824,26402372,0.0378753848328475
1747351707528066,26731964,1,286,1,53022881,26622384,26400497,0.0378780747953343
1747351707621168,26824524,1,287,1,53115983,26714944,26401039,0.0378772971775845
1747351707716175,26917084,1,288,1,53210990,26807504,26403486,0.0378737868173922
1747351707810424,27009644,1,289,1,53305239,26900064,26405175,0.0378713642306858
1747351707900497,27102204,1,290,1,53395312,26992624,26402688,0.0378749315221238
1747351707993872,27194764,1,291,1,53488687,27085184,26403503,0.0378737624322045
1747351708088973,27287324,1,292,1,53583788,27177744,26406044,0.0378701179169435
1747351708182255,27379884,1,293,1,53677070,27270304,26406766,0.0378690824919643
1747351708273268,27472444,1,294,1,53768083,27362864,26405219,0.0378713011242209
1747351708367287,27565004,1,295,1,53862102,27455424,26406678,0.0378692086903168
1747351708460905,27657564,1,296,1,53955720,27547984,26407736,0.0378676914976732
1747351708555903,27750124,1,297,1,54050718,27640544,26410174,0.0378641958208984
1747351708649740,27842684,1,298,1,54144555,27733104,26411451,0.0378623650779353
1747351708739824,27935244,1,299,1,54234639,27825664,26408975,0.0378659149020361
1747351708833830,28027804,1,300,1,54328645,27918224,26410421,0.0378638417009709
1747351708927801,28120364,1,301,1,54422616,28010784,26411832,0.0378618188999536
1747351709021968,28212924,1,302,1,54516783,28103344,26413439,0.037859515377759
1747351709113019,28305484,1,303,1,54607834,28195904,26411930,0.0378616784157765
1747351709206825,28398044,1,304,1,54701640,28288464,26413176,0.0378598923506964
1747351709300360,28490604,1,305,1,54795175,28381024,26414151,0.0378584948651198
1747351709395445,28583164,1,306,1,54890260,28473584,26416676,0.0378548762153118
1747351709484971,28675724,1,307,1,54979786,28566144,26413642,0.0378592244113856
1747351709579077,28768292,1,308,1,55073892,28658712,26415180,0.0378570200922348
1747351709673862,28860844,1,309,1,55168677,28751264,26417413,0.0378538201299271
1747351709767983,28953404,1,310,1,55262798,28843824,26418974,0.0378515834869287
1747351709858277,29045964,1,311,1,55353092,28936384,26416708,0.0378548303596345
1747351709952660,29138524,1,312,1,55447475,29028944,26418531,0.0378522182024428
1747351710046810,29231084,1,313,1,55541625,29121504,26420121,0.0378499402027719
1747351710139874,29323644,1,314,1,55634689,29214064,26420625,0.037849218177087
1747351710235118,29416204,1,315,1,55729933,29306624,26423309,0.0378453735677087
1747351710325051,29508764,1,316,1,55819866,29399184,26420682,0.0378491365211541
1747351710418547,29601324,1,317,1,55913362,29491744,26421618,0.0378477956951765
1747351710513175,29693884,1,318,1,56007990,29584304,26423686,0.0378448336087554
1747351710607496,29786444,1,319,1,56102311,29676864,26425447,0.0378423116172831
1747351710698022,29879004,1,320,1,56192837,29769424,26423413,0.0378452246119757
1747351710791393,29971564,1,321,1,56286208,29861984,26424224,0.0378440630839338
1747351710886220,30064124,1,322,1,56381035,29954544,26426491,0.0378408166260136
1747351710980694,30156684,1,323,1,56475509,30047104,26428405,0.0378380761154522
1747351711070948,30249244,1,324,1,56565763,30139664,26426099,0.037841377949882
1747351711164156,30341804,1,325,1,56658971,30232224,26426747,0.0378404500561495
1747351711258205,30434364,1,326,1,56753020,30324784,26428236,0.0378383180776802
1747351711352649,30526924,1,327,1,56847464,30417344,26430120,0.0378356208749714
1747351711443228,30619484,1,328,1,56938043,30509904,26428139,0.0378384569568065
1747351711537361,30712044,1,329,1,57032176,30602464,26429712,0.0378362049499442
1747351711631812,30804604,1,330,1,57126627,30695024,26431603,0.0378334980288558
1747351711725401,30897172,1,331,1,57220216,30787592,26432624,0.0378320366528877
1747351711819854,30989724,1,332,1,57314669,30880144,26434525,0.0378293160175944
1747351711910410,31082284,1,333,1,57405225,30972704,26432521,0.0378321840735509
1747351712004288,31174844,1,334,1,57499103,31065264,26433839,0.0378302977482763
1747351712098774,31267404,1,335,1,57593589,31157824,26435765,0.0378275415899634
1747351712192104,31359964,1,336,1,57686919,31250384,26436535,0.03782643981142
1747351712283145,31452524,1,337,1,57777960,31342944,26435016,0.0378286133815844
1747351712377017,31545084,1,338,1,57871832,31435504,26436328,0.0378267359975258
1747351712470879,31637644,1,339,1,57965694,31528064,26437630,0.0378248731070069
1747351712565033,31730204,1,340,1,58059848,31620624,26439224,0.0378225926751859
1747351712655537,31822764,1,341,1,58150352,31713184,26437168,0.0378255341116718
1747351712750025,31915324,1,342,1,58244840,31805744,26439096,0.0378227757862825
1747351712843949,32007884,1,343,1,58338764,31898304,26440460,0.0378208245998745
1747351712938140,32100444,1,344,1,58432955,31990864,26442091,0.0378184917372835
1747351713028273,32193004,1,345,1,58523088,32083424,26439664,0.0378219632443135
1747351713122494,32285564,1,346,1,58617309,32175984,26441325,0.0378195873315728
1747351713216950,32378124,1,347,1,58711765,32268544,26443221,0.0378168756370489
1747351713310884,32470684,1,348,1,58805699,32361104,26444595,0.0378149107596467
1747351713404845,32563244,1,349,1,58899660,32453664,26445996,0.0378129074813442
1747351713494963,32655804,1,350,1,58989778,32546224,26443554,0.0378163994143903
1747351713589948,32748364,1,351,1,59084763,32638784,26445979,0.0378129317882314
1747351713683122,32840924,1,352,1,59177937,32731344,26446593,0.0378120539004778
1747351713777421,32933484,1,353,1,59272236,32823904,26448332,0.0378095677262369
1747351713868035,33026044,1,354,1,59362850,32916464,26446386,0.0378123498613383
1747351713961565,33118604,1,355,1,59456380,33009024,26447356,0.0378109630316164
1747351714056298,33211164,1,356,1,59551113,33101584,26449529,0.0378078566162747
1747351714150121,33303724,1,357,1,59644936,33194144,26450792,0.0378060513273099
1747351714240774,33396284,1,358,1,59735589,33286704,26448885,0.0378087771941993
1747351714334204,33488844,1,359,1,59829019,33379264,26449755,0.037807533566946
1747351714428340,33581404,1,360,1,59923155,33471824,26451331,0.0378052809516466
1747351714522179,33673964,1,361,1,60016994,33564384,26452610,0.0378034530430078
1747351714617601,33766524,1,362,1,60112416,33656944,26455472,0.0377993633982413
1747351714707504,33859084,1,363,1,60202319,33749504,26452815,0.0378031600795605
1747351714801274,33951644,1,364,1,60296089,33842064,26454025,0.0378014309731694
1747351714895377,34044204,1,365,1,60390192,33934624,26455568,0.0377992262347192
1747351714989938,34136764,1,366,1,60484753,34027184,26457569,0.0377963674591569
1747351715079962,34229324,1,367,1,60574777,34119744,26455033,0.0377999906482823
1747351715174063,34321884,1,368,1,60668878,34212304,26456574,0.0377977889351811
1747351715268325,34414444,1,369,1,60763140,34304864,26458276,0.0377953574904124
1747351715362664,34507004,1,370,1,60857479,34397424,26460055,0.0377928163792554
1747351715453139,34599564,1,371,1,60947954,34489984,26457970,0.0377957946131165
1747351715547072,34692132,1,372,1,61041887,34582552,26459335,0.0377938447810574
1747351715641467,34784684,1,373,1,61136282,34675104,26461178,0.0377912124698303
1747351715735238,34877244,1,374,1,61230053,34767664,26462389,0.0377894830281574
1747351715825306,34969804,1,375,1,61320121,34860224,26459897,0.0377930420515242
1747351715919907,35062364,1,376,1,61414722,34952784,26461938,0.0377901270874415
1747351716013409,35154924,1,377,1,61508224,35045344,26462880,0.0377887818710586
1747351716107993,35247484,1,378,1,61602808,35137904,26464904,0.037785891836222
1747351716201901,35340044,1,379,1,61696716,35230464,26466252,0.0377839672954069
1747351716292704,35432604,1,380,1,61787519,35323024,26464495,0.0377864758046582
1747351716386504,35525164,1,381,1,61881319,35415584,26465735,0.0377847053935966
1747351716480209,35617724,1,382,1,61975024,35508144,26466880,0.0377830707661802
1747351716575209,35710284,1,383,1,62070024,35600704,26469320,0.0377795878398085
1747351716664863,35802844,1,384,1,62159678,35693264,26466414,0.0377837360210567
1747351716759152,35895404,1,385,1,62253967,35785824,26468143,0.0377812678433844
1747351716857659,35991084,1,386,1,62352474,35881504,26470970,0.0377772329461292
1747351716951795,36086764,1,387,1,62446610,35977184,26469426,0.0377794365469051
1747351717050458,36182444,1,388,1,62545273,36072864,26472409,0.0377751794330466
1747351717144257,36278124,1,389,1,62639072,36168544,26470528,0.0377778637434054
1747351717238333,36370684,1,390,1,62733148,36261104,26472044,0.0377757002821542
1747351717332363,36463244,1,391,1,62827178,36353664,26473514,0.0377736027034416
1747351717426650,36555812,1,392,1,62921465,36446232,26475233,0.0377711501160348
1747351717516996,36648364,1,393,1,63011811,36538784,26473027,0.0377742975897693
1747351717611441,36740924,1,394,1,63106256,36631344,26474912,0.0377716080793771
1747351717705542,36833484,1,395,1,63200357,36723904,26476453,0.037769409671303
1747351717799611,36926044,1,396,1,63294426,36816464,26477962,0.037767257162768
1747351717890071,37018604,1,397,1,63384886,36909024,26475862,0.0377702527683517
1747351717983672,37111164,1,398,1,63478487,37001584,26476903,0.0377687677444752
1747351718078545,37203724,1,399,1,63573360,37094144,26479216,0.0377654685848704
1747351718172252,37296284,1,400,1,63667067,37186704,26480363,0.0377638327692109
1747351718262667,37388844,1,401,1,63757482,37279264,26478218,0.0377668920166757
1747351718356577,37481404,1,402,1,63851392,37371824,26479568,0.0377649665583668
1747351718450723,37573964,1,403,1,63945538,37464384,26481154,0.0377627047522173
1747351718545299,37666524,1,404,1,64040114,37556944,26483170,0.0377598301109723
1747351718634691,37759084,1,405,1,64129506,37649504,26480002,0.03776434760088
1747351718728984,37851644,1,406,1,64223799,37742064,26481735,0.0377618762516881
1747351718823687,37944204,1,407,1,64318502,37834624,26483878,0.0377588206681816
1747351718917857,38036764,1,408,1,64412672,37927184,26485488,0.0377565253847692
1747351719011425,38129324,1,409,1,64506240,38019744,26486496,0.0377550884798049
1747351719101947,38221884,1,410,1,64596762,38112304,26484458,0.0377579937637387
1747351719196509,38314444,1,411,1,64691324,38204864,26486460,0.0377551397959561
1747351719290585,38407004,1,412,1,64785400,38297424,26487976,0.0377529789365559
1747351719384520,38499564,1,413,1,64879335,38389984,26489351,0.0377510192680824
1747351719474609,38592124,1,414,1,64969424,38482544,26486880,0.0377545411162054
1747351719569028,38684692,1,415,1,65063843,38575112,26488731,0.0377519028752264
1747351719663435,38777244,1,416,1,65158250,38667664,26490586,0.0377492593029085
1747351719757521,38869804,1,417,1,65252336,38760224,26492112,0.0377470848681298
1747351719847522,38962364,1,418,1,65342337,38852784,26489553,0.0377507313921076
1747351719941831,39054924,1,419,1,65436646,38945344,26491302,0.0377482390257753
1747351720035360,39147484,1,420,1,65530175,39037904,26492271,0.0377468583195453
1747351720129553,39240044,1,421,1,65624368,39130464,26493904,0.037744531723222
1747351720220522,39332604,1,422,1,65715337,39223024,26492313,0.037746798476977
1747351720314537,39425164,1,423,1,65809352,39315584,26493768,0.0377447254765724
1747351720408655,39517724,1,424,1,65903470,39408144,26495326,0.0377425059801113
1747351720502843,39610284,1,425,1,65997658,39500704,26496954,0.0377401870418765
1747351720596908,39702844,1,426,1,66091723,39593264,26498459,0.0377380435594386
1747351720686960,39795404,1,427,1,66181775,39685824,26495951,0.0377416156906389
1747351720781348,39887964,1,428,1,66276163,39778384,26497779,0.0377390120130445
1747351720875229,39980524,1,429,1,66370044,39870944,26499100,0.0377371306950047
1747351720969458,40073084,1,430,1,66464273,39963504,26500769,0.0377347540367602
1747351721059427,40165644,1,431,1,66554242,40056064,26498178,0.0377384437526232
1747351721153570,40258204,1,432,1,66648385,40148624,26499761,0.0377361893943119
1747351721248427,40350764,1,433,1,66743242,40241184,26502058,0.0377329187038983
1747351721342263,40443324,1,434,1,66837078,40333744,26503334,0.0377311020568204
1747351721432842,40535884,1,435,1,66927657,40426304,26501353,0.0377339224906743
1747351721527102,40628444,1,436,1,67021917,40518864,26503053,0.0377315021027954
1747351721621102,40721004,1,437,1,67115917,40611424,26504493,0.0377294521347757
1747351721714773,40813564,1,438,1,67209588,40703984,26505604,0.0377278706797249
1747351721805375,40906124,1,439,1,67300190,40796544,26503646,0.0377306578875978
1747351721899581,40998684,1,440,1,67394396,40889104,26505292,0.037728314783327
1747351721993812,41091244,1,441,1,67488627,40981664,26506963,0.037725936388865
1747351722087314,41183804,1,442,1,67582129,41074224,26507905,0.0377245957385164
1747351722181822,41276364,1,443,1,67676637,41166784,26509853,0.0377218236555291
1747351722272428,41368924,1,444,1,67767243,41259344,26507899,0.0377246042773891
1747351722365790,41461484,1,445,1,67860605,41351904,26508701,0.0377234629490143
1747351722460935,41554044,1,446,1,67955750,41444464,26511286,0.0377197846984865
1747351722554329,41646604,1,447,1,68049144,41537024,26512120,0.0377185981354942
1747351722645258,41739164,1,448,1,68140073,41629584,26510489,0.037720918689957
1747351722738786,41831724,1,449,1,68233601,41722144,26511457,0.0377195414043068
1747351722833299,41924284,1,450,1,68328114,41814704,26513410,0.0377167629512763
1747351722926976,42016844,1,451,1,68421791,41907264,26514527,0.0377151740251674
1747351723017393,42109404,1,452,1,68512208,41999824,26512384,0.0377182225483758
1747351723111915,42201964,1,453,1,68606730,42092384,26514346,0.0377154314875426
1747351723206275,42294524,1,454,1,68701090,42184944,26516146,0.0377128712445617
1747351723300511,42387084,1,455,1,68795326,42277504,26517822,0.0377104876863567
1747351723390647,42479652,1,456,1,68885462,42370072,26515390,0.0377139465042754
1747351723484265,42572204,1,457,1,68979080,42462624,26516456,0.0377124303489123
1747351723579054,42664764,1,458,1,69073869,42555184,26518685,0.0377092604704946
1747351723673222,42757324,1,459,1,69168037,42647744,26520293,0.0377069740519081
1747351723766749,42849884,1,460,1,69261564,42740304,26521260,0.0377055992060709
1747351723856435,42942444,1,461,1,69351250,42832864,26518386,0.0377096856497978
1747351723951491,43035004,1,462,1,69446306,42925424,26520882,0.0377061366209464
1747351724045804,43127564,1,463,1,69540619,43017984,26522635,0.0377036444531246
1747351724139389,43220124,1,464,1,69634204,43110544,26523660,0.0377021874055088
1747351724229610,43312684,1,465,1,69724425,43203104,26521321,0.0377055124818254
1747351724324216,43405244,1,466,1,69819031,43295664,26523367,0.0377026038964057
1747351724418569,43497804,1,467,1,69913384,43388224,26525160,0.0377000553436812
1747351724512512,43590364,1,468,1,70007327,43480784,26526543,0.0376980897963221
1747351724602709,43682924,1,469,1,70097524,43573344,26524180,0.0377014482634335
1747351724697047,43775484,1,470,1,70191862,43665904,26525958,0.037698921185052
1747351724790683,43868044,1,471,1,70285498,43758464,26527034,0.0376973920265642
1747351724884833,43960604,1,472,1,70379648,43851024,26528624,0.037695132623539
1747351724974990,44053164,1,473,1,70469805,43943584,26526221,0.0376985474108807
1747351725069917,44145724,1,474,1,70564732,44036144,26528588,0.0376951837768372
1747351725164014,44238284,1,475,1,70658829,44128704,26530125,0.0376929999387488
1747351725257930,44330844,1,476,1,70752745,44221264,26531481,0.0376910734836099
1747351725352223,44423404,1,477,1,70847038,44313824,26533214,0.0376886117151129
1747351725442698,44515964,1,478,1,70937513,44406384,26531129,0.0376915735474355
1747351725536329,44608532,1,479,1,71031144,44498952,26532192,0.0376900634519756
1747351725630254,44701084,1,480,1,71125069,44591504,26533565,0.0376881131502683
1747351725724708,44793644,1,481,1,71219523,44684064,26535459,0.0376854231162913
1747351725814636,44886204,1,482,1,71309451,44776624,26532827,0.0376891614301031
1747351725908964,44978764,1,483,1,71403779,44869184,26534595,0.0376866502013691
1747351726003592,45071324,1,484,1,71498407,44961744,26536663,0.0376837132837689
1747351726097618,45163884,1,485,1,71592433,45054304,26538129,0.0376816315875169
1747351726187314,45256444,1,486,1,71682129,45146864,26535265,0.037685698635382
1747351726282409,45349004,1,487,1,71777224,45239424,26537800,0.0376820987421715
1747351726375886,45441564,1,488,1,71870701,45331984,26538717,0.0376807967016642
1747351726470080,45534124,1,489,1,71964895,45424544,26540351,0.0376784768219531
1747351726560335,45626684,1,490,1,72055150,45517104,26538046,0.0376817494400303
1747351727039753,46101964,1,495,1,72534568,45992384,26542184,0.0376758747509247
1747351727133712,46194524,1,496,1,72628527,46084944,26543583,0.037673889014908
1747351727227445,46287084,1,497,1,72722260,46177504,26544756,0.037672224223873
1747351727322276,46379644,1,498,1,72817091,46270064,26547027,0.0376690015043869
1747351727411955,46472212,1,499,1,72906770,46362632,26544138,0.0376731013077162
1747351727506603,46564764,1,500,1,73001418,46455184,26546234,0.037670126768264
1747351727600967,46657324,1,501,1,73095782,46547744,26548038,0.037667566996853
1747351727694676,46749884,1,502,1,73189491,46640304,26549187,0.037665936813809
1747351727789346,46842444,1,503,1,73284161,46732864,26551297,0.0376629435465996
1747351727879227,46935004,1,504,1,73374042,46825424,26548618,0.0376667440843813
1747351727972853,47027564,1,505,1,73467668,46917984,26549684,0.0376652317217786
1747351728066958,47120124,1,506,1,73561773,47010544,26551229,0.0376630400046641
1747351728162084,47212684,1,507,1,73656899,47103104,26553795,0.0376594004736422
1747351728251768,47305244,1,508,1,73746583,47195664,26550919,0.0376634797462189
1747351728346244,47397804,1,509,1,73841059,47288224,26552835,0.0376607620240927
1747351728439841,47490364,1,510,1,73934656,47380784,26553872,0.0376592912702147
1747351728534087,47582924,1,511,1,74028902,47473344,26555558,0.0376569002993648
1747351728624222,47675484,1,512,1,74119037,47565904,26553133,0.0376603393656033
1747351728718552,47768044,1,513,1,74213367,47658464,26554903,0.0376578291398767
1747351728813244,47860604,1,514,1,74308059,47751024,26557035,0.0376548059676089
1747351728907115,47953164,1,515,1,74401930,47843584,26558346,0.0376529472129024
1747351728997603,48045724,1,516,1,74492418,47936144,26556274,0.037655885008567
1747351729091450,48138284,1,517,1,74586265,48028704,26557561,0.0376540601751794
1747351729185910,48230844,1,518,1,74680725,48121264,26559461,0.0376513664942221
1747351729279451,48323404,1,519,1,74774266,48213824,26560442,0.0376499758550704
1747351729373669,48415964,1,520,1,74868484,48306384,26562100,0.0376476257524819
1747351729463847,48508524,1,521,1,74958662,48398944,26559718,0.03765100216802
1747351729558253,48601084,1,522,1,75053068,48491504,26561564,0.0376483854640487
1747351729652737,48693644,1,523,1,75147552,48584064,26563488,0.0376456585821861
1747351729746940,48786204,1,524,1,75241755,48676624,26565131,0.0376433302738089
1747351729836666,48878764,1,525,1,75331481,48769184,26562297,0.0376473465378389
1747351729931090,48971324,1,526,1,75425905,48861744,26564161,0.0376447048337043
1747351730025331,49063884,1,527,1,75520146,48954304,26565842,0.03764232279933
1747351730118770,49156444,1,528,1,75613585,49046864,26566721,0.0376410773463537
1747351730209365,49249004,1,529,1,75704180,49139424,26564756,0.0376438616639279
1747351730304142,49341564,1,530,1,75798957,49231984,26566973,0.0376407203033631
1747351730397384,49434124,1,531,1,75892199,49324544,26567655,0.037639754054319
1747351730492321,49526684,1,532,1,75987136,49417104,26570032,0.0376363867382621
1747351730582570,49619244,1,533,1,76077385,49509664,26567721,0.0376396605489797
1747351730675816,49711804,1,534,1,76170631,49602224,26568407,0.0376386886876582
1747351730771088,49804364,1,535,1,76265903,49694784,26571119,0.0376348470683526
1747351730864401,49896924,1,536,1,76359216,49787344,26571872,0.0376337805631458
1747351730958400,49989484,1,537,1,76453215,49879904,26573311,0.0376317426157395
1747351731049466,50082044,1,538,1,76544281,49972464,26571817,0.0376338584598862
1747351731143109,50174604,1,539,1,76637924,50065024,26572900,0.0376323246615913
1747351731236920,50267172,1,540,1,76731735,50157592,26574143,0.0376305644174489
1747351731331506,50359724,1,541,1,76826321,50250144,26576177,0.0376276843731135
1747351731421564,50452284,1,542,1,76916379,50342704,26573675,0.0376312271449093
1747351731516478,50544844,1,543,1,77011293,50435264,26576029,0.0376278939189899
1747351731610296,50637404,1,544,1,77105111,50527824,26577287,0.03762611285343
1747351731704100,50729964,1,545,1,77198915,50620384,26578531,0.0376243517747463
1747351731794778,50822524,1,546,1,77289593,50712944,26576649,0.0376270161072601
1747351731888890,50915084,1,547,1,77383705,50805504,26578201,0.0376248189258558
1747351731983434,51007644,1,548,1,77478249,50898064,26580185,0.0376220105315294
1747351732077227,51100204,1,549,1,77572042,50990624,26581418,0.0376202654049531
1747351732167086,51192764,1,550,1,77661901,51083184,26578717,0.0376240884765054
1747351732261663,51285324,1,551,1,77756478,51175744,26580734,0.0376212334843725
1747351732356065,51377884,1,552,1,77850880,51268304,26582576,0.037618626577048
1747351732450209,51470444,1,553,1,77945024,51360864,26584160,0.0376163850954854
1747351732544362,51563004,1,554,1,78039177,51453424,26585753,0.0376141311476112
1747351732633829,51655564,1,555,1,78128644,51545984,26582660,0.0376185077038941
1747351732728806,51748124,1,556,1,78223621,51638544,26585077,0.0376150875921856
1747351732822019,51840684,1,557,1,78316834,51731104,26585730,0.0376141636885652
1747351732916355,51933244,1,558,1,78411170,51823664,26587506,0.0376116511266607
1747351733006432,52025804,1,559,1,78501247,51916224,26585023,0.0376151639966608
1747351733101515,52118364,1,560,1,78596330,52008784,26587546,0.0376115945412938
1747351733194903,52210924,1,561,1,78689718,52101344,26588374,0.0376104232624379
1747351733289388,52303484,1,562,1,78784203,52193904,26590299,0.0376077004624882
1747351733379477,52396052,1,563,1,78874292,52286472,26587820,0.0376112069361083
1747351733473477,52488604,1,564,1,78968292,52379024,26589268,0.0376091587026765
1747351733568467,52581164,1,565,1,79063282,52471584,26591698,0.0376057219061377
1747351733662378,52673724,1,566,1,79157193,52564144,26593049,0.0376038114320776
1747351733752015,52766284,1,567,1,79246830,52656704,26590126,0.0376079451447503
1747351733846407,52858844,1,568,1,79341222,52749264,26591958,0.0376053542202495
1747351733941127,52951404,1,569,1,79435942,52841824,26594118,0.0376022998769878
1747351734035287,53043964,1,570,1,79530102,52934384,26595718,0.0376000377203578
1747351734128627,53136524,1,571,1,79623442,53026944,26596498,0.0375989350176854
1747351734218890,53229084,1,572,1,79713705,53119504,26594201,0.0376021825209187
1747351734313621,53321644,1,573,1,79808436,53212064,26596372,0.0375991131421984
1747351734408058,53414204,1,574,1,79902873,53304624,26598249,0.0375964598271111
1747351734501363,53506764,1,575,1,79996178,53397184,26598994,0.0375954068037309
1747351734592364,53599324,1,576,1,80087179,53489744,26597435,0.0375976104462704
1747351734685737,53691884,1,577,1,80180552,53582304,26598248,0.037596461240605
1747351734796476,53784444,1,578,1,80291291,53674864,26616427,0.0375707828853211
1747351734874269,53877004,1,579,1,80369084,53767424,26601660,0.0375916390180161
1747351734965150,53969564,1,580,1,80459965,53859984,26599981,0.0375940118152716
1747351735059151,54062124,1,581,1,80553966,53952544,26601422,0.0375919753462803
1747351735153160,54154684,1,582,1,80647975,54045104,26602871,0.0375899277938836
1747351735246708,54247244,1,583,1,80741523,54137664,26603859,0.0375885317990897
1747351735337837,54339804,1,584,1,80832652,54230224,26602428,0.0375905537644909
1747351735431957,54432364,1,585,1,80926772,54322784,26603988,0.0375883495361672
1747351735526142,54524924,1,586,1,81020957,54415344,26605613,0.037586053739863
1747351735619837,54617484,1,587,1,81114652,54507904,26606748,0.0375844503807831
1747351735714341,54710044,1,588,1,81209156,54600464,26608692,0.0375817045046784
1747351735804301,54802604,1,589,1,81299116,54693024,26606092,0.037585377063268
1747351735898303,54895164,1,590,1,81393118,54785584,26607534,0.0375833401171262
1747351735992028,54987724,1,591,1,81486843,54878144,26608699,0.0375816946179894
1747351736087036,55080284,1,592,1,81581851,54970704,26611147,0.0375782374205816
1747351736176698,55172844,1,593,1,81671513,55063264,26608249,0.0375823302014349
1747351736270962,55265404,1,594,1,81765777,55155824,26609953,0.0375799235722062
1747351736364995,55357964,1,595,1,81859810,55248384,26611426,0.0375778434421364
1747351736459559,55450524,1,596,1,81954374,55340944,26613430,0.0375750138182113
1747351736549568,55543084,1,597,1,82044383,55433504,26610879,0.0375786158736056
1747351736643925,55635644,1,598,1,82138740,55526064,26612676,0.037576078407147
1747351736737565,55728204,1,599,1,82232380,55618624,26613756,0.037574553550427
1747351736832432,55820764,1,600,1,82327247,55711184,26616063,0.0375712967015444
1747351736922043,55913324,1,601,1,82416858,55803744,26613114,0.0375754599781145
1747351737016619,56005884,1,602,1,82511434,55896304,26615130,0.0375726137726924
1747351737110613,56098444,1,603,1,82605428,55988864,26616564,0.0375705895020859
1747351737205192,56191012,1,604,1,82700007,56081432,26618575,0.0375677510911083
1747351737299564,56283564,1,605,1,82794379,56173984,26620395,0.037565182635344
1747351737389201,56376124,1,606,1,82884016,56266544,26617472,0.0375693078591385
1747351737483776,56468684,1,607,1,82978591,56359104,26619487,0.0375664639968456
1747351737578121,56561244,1,608,1,83072936,56451664,26621272,0.0375639451037501
1747351737671722,56653804,1,609,1,83166537,56544224,26622313,0.0375624762581673
1747351737761891,56746364,1,610,1,83256706,56636784,26619922,0.0375658501178177
1747351737856270,56838924,1,611,1,83351085,56729344,26621741,0.0375632833329721
1747351737950535,56931484,1,612,1,83445350,56821904,26623446,0.0375608777316054
1747351738044575,57024044,1,613,1,83539390,56914464,26624926,0.0375587898347586
1747351738134733,57116604,1,614,1,83629548,57007024,26622524,0.0375621785522665
1747351738228989,57209164,1,615,1,83723804,57099584,26624220,0.0375597857890296
1747351738322559,57301724,1,616,1,83817374,57192144,26625230,0.037558360998196
1747351738417289,57394284,1,617,1,83912104,57284704,26627400,0.0375553001795143
1747351738511861,57486844,1,618,1,84006676,57377264,26629412,0.0375524626679702
1747351738601999,57579404,1,619,1,84096814,57469824,26626990,0.0375558784526527
1747351738695689,57671964,1,620,1,84190504,57562384,26628120,0.0375542847185606
1747351738789872,57764524,1,621,1,84284687,57654944,26629743,0.0375519959017253
1747351738884639,57857084,1,622,1,84379454,57747504,26631950,0.0375488839532967
1747351738974323,57949644,1,623,1,84469138,57840064,26629074,0.0375529393173791
1747351739068515,58042204,1,624,1,84563330,57932624,26630706,0.0375506379740739
1747351739162670,58134764,1,625,1,84657485,58025184,26632301,0.0375483890783601
1747351739257038,58227324,1,626,1,84751853,58117744,26634109,0.0375458401856056
1747351739347390,58319892,1,627,1,84842205,58210312,26631893,0.0375489643188338
1747351739441070,58412444,1,628,1,84935885,58302864,26633021,0.0375473739911067
1747351739535649,58505004,1,629,1,85030464,58395424,26635040,0.0375445278099826
1747351739629891,58597564,1,630,1,85124706,58487984,26636722,0.0375421570266791
1747351739719732,58690124,1,631,1,85214547,58580544,26634003,0.0375459896133525
1747351739813968,58782684,1,632,1,85308783,58673104,26635679,0.0375436271025792
1747351739908190,58875244,1,633,1,85403005,58765664,26637341,0.0375412846199626
1747351740002236,58967804,1,634,1,85497051,58858224,26638827,0.0375391904455853
1747351740096342,59060364,1,635,1,85591157,58950784,26640373,0.0375370119630081
1747351740186140,59152924,1,636,1,85680955,59043344,26637611,0.0375409040998458
1747351740281167,59245484,1,637,1,85775982,59135904,26640078,0.0375374276306548
1747351740375422,59338044,1,638,1,85870237,59228464,26641773,0.0375350394284944
1747351740469506,59430604,1,639,1,85964321,59321024,26643297,0.0375328924194329
1747351740559843,59523164,1,640,1,86054658,59413584,26641074,0.0375360242608837
1747351740653710,59615724,1,641,1,86148525,59506144,26642381,0.0375341828494983
1747351740747406,59708284,1,642,1,86242221,59598704,26643517,0.037532582504029
1747351740841539,59800844,1,643,1,86336354,59691264,26645090,0.037530366758003
1747351740932471,59893404,1,644,1,86427286,59783824,26643462,0.0375326599824001
1747351741026581,59985964,1,645,1,86521396,59876384,26645012,0.0375304766235421
1747351741119936,60078524,1,646,1,86614751,59968944,26645807,0.0375293568702948
1747351741214520,60171084,1,647,1,86709335,60061504,26647831,0.0375265063786992
1747351741304562,60263644,1,648,1,86799377,60154064,26645313,0.0375300526587921
1747351741399540,60356204,1,649,1,86894355,60246624,26647731,0.0375266472030958
1747351741492979,60448764,1,650,1,86987794,60339184,26648610,0.0375254093928351
1747351741587063,60541324,1,651,1,87081878,60431744,26650134,0.0375232634852792
1747351741681501,60633884,1,652,1,87176316,60524304,26652012,0.0375206194564222
1747351741771549,60726444,1,653,1,87266364,60616864,26649500,0.037524156175538
1747351741865635,60819004,1,654,1,87360450,60709424,26651026,0.0375220075955049
1747351741960299,60911564,1,655,1,87455114,60801984,26653130,0.0375190456055255
1747351742053988,61004124,1,656,1,87548803,60894544,26654259,0.0375174564034963
1747351742144606,61096684,1,657,1,87639421,60987104,26652317,0.0375201900832861
1747351742238411,61189244,1,658,1,87733226,61079664,26653562,0.0375184374981475
1747351742333254,61281804,1,659,1,87828069,61172224,26655845,0.0375152241468991
1747351742427064,61374364,1,660,1,87921879,61264784,26657095,0.0375134649893396
1747351742517477,61466924,1,661,1,88012292,61357344,26654948,0.0375164866200451
1747351742610751,61559484,1,662,1,88105566,61449904,26655662,0.0375154817014111
1747351742705736,61652044,1,663,1,88200551,61542464,26658087,0.0375120690393125
1747351742800604,61744604,1,664,1,88295419,61635024,26660395,0.0375088216059814
1747351742890670,61837164,1,665,1,88385485,61727584,26657901,0.0375123307720289
1747351742984661,61929724,1,666,1,88479476,61820144,26659332,0.0375103172127493
1747351743078056,62022284,1,667,1,88572871,61912704,26660167,0.0375091423845919
1747351743172498,62114852,1,668,1,88667313,62005272,26662041,0.0375065059722922
1747351743267170,62207404,1,669,1,88761985,62097824,26664161,0.0375035239248667
1747351743357002,62299964,1,670,1,88851817,62190384,26661433,0.0375073612884948
1747351743450949,62392524,1,671,1,88945764,62282944,26662820,0.0375054101554149
1747351743545353,62485084,1,672,1,89040168,62375504,26664664,0.0375028164615162
1747351743639318,62577644,1,673,1,89134133,62468064,26666069,0.0375008404875874
1747351743729062,62670204,1,674,1,89223877,62560624,26663253,0.0375048010833486
1747351743823678,62762764,1,675,1,89318493,62653184,26665309,0.037501909315958
1747351743917525,62855324,1,676,1,89412340,62745744,26666596,0.0375000993752633
1747351744012060,62947884,1,677,1,89506875,62838304,26668571,0.0374973222224767
1747351744102669,63040444,1,678,1,89597484,62930864,26666620,0.0375000656251148
1747351744195838,63133004,1,679,1,89690653,63023424,26667229,0.0374992092354252
1747351744290213,63225564,1,680,1,89785028,63115984,26669044,0.037496657173013
1747351744384312,63318124,1,681,1,89879127,63208544,26670583,0.0374944934649535
1747351744475236,63410684,1,682,1,89970051,63301104,26668947,0.037496793555441
1747351744569119,63503244,1,683,1,90063934,63393664,26670270,0.0374949334971112
1747351744663113,63595804,1,684,1,90157928,63486224,26671704,0.0374929175878676
1747351744757716,63688364,1,685,1,90252531,63578784,26673747,0.0374900459241815
1747351744851745,63780924,1,686,1,90346560,63671344,26675216,0.0374879813531781
1747351744942202,63873484,1,687,1,90437017,63763904,26673113,0.0374909370346085
1747351745036021,63966044,1,688,1,90530836,63856464,26674372,0.0374891675050494
1747351745130016,64058604,1,689,1,90624831,63949024,26675807,0.0374871508104703
1747351745224255,64151164,1,690,1,90719070,64041584,26677486,0.0374847914829755
1747351745314541,64243732,1,691,1,90809356,64134152,26675204,0.0374879982173707
1747351745408871,64336284,1,692,1,90903686,64226704,26676982,0.0374854996715895
1747351745502653,64428844,1,693,1,90997468,64319264,26678204,0.0374837826414401
1747351745596655,64521404,1,694,1,91091470,64411824,26679646,0.037481756691974
1747351745687773,64613964,1,695,1,91182588,64504384,26678204,0.0374837826414401
1747351745780842,64706524,1,696,1,91275657,64596944,26678713,0.0374830674927984
1747351745875857,64799084,1,697,1,91370672,64689504,26681168,0.0374796185834143
1747351745970151,64891644,1,698,1,91464966,64782064,26682902,0.0374771829540879
1747351746060273,64984204,1,699,1,91555088,64874624,26680464,0.037480607533662
1747351746154349,65076764,1,700,1,91649164,64967184,26681980,0.0374784779840176
1747351746248708,65169324,1,701,1,91743523,65059744,26683779,0.0374759512136568
1747351746342277,65261884,1,702,1,91837092,65152304,26684788,0.0374745341802977
1747351746436444,65354444,1,703,1,91931259,65244864,26686395,0.0374722775406719
1747351746526867,65447004,1,704,1,92021682,65337424,26684258,0.0374752784956583
1747351746621194,65539564,1,705,1,92116009,65429984,26686025,0.0374727970913614
1747351746715324,65632124,1,706,1,92210139,65522544,26687595,0.0374705926105368
1747351746809764,65724684,1,707,1,92304579,65615104,26689475,0.037467953191286
1747351746899359,65817244,1,708,1,92394174,65707664,26686510,0.0374721160616356
1747351746993459,65909804,1,709,1,92488274,65800224,26688050,0.037469953780812
1747351747087962,66002364,1,710,1,92582777,65892784,26689993,0.0374672260123859
1747351747181882,66094924,1,711,1,92676697,65985344,26691353,0.0374653169511489
1747351747272647,66187484,1,712,1,92767462,66077904,26689558,0.0374678366723045
1747351747366584,66280044,1,713,1,92861399,66170464,26690935,0.0374659036860267
1747351747460507,66372604,1,714,1,92955322,66263024,26692298,0.0374639905488841
1747351747554677,66465164,1,715,1,93049492,66355584,26693908,0.0374617309687288
1747351747644629,66557724,1,716,1,93139444,66448144,26691300,0.0374653913447452
1747351747739154,66650284,1,717,1,93233969,66540704,26693265,0.0374626333646333
1747351747833004,66742844,1,718,1,93327819,66633264,26694555,0.0374608230030431
1747351747927467,66835404,1,719,1,93422282,66725824,26696458,0.0374581526882704
1747351748021593,66927964,1,720,1,93516408,66818384,26698024,0.0374559555418783
1747351748111834,67020524,1,721,1,93606649,66910944,26695705,0.0374592092623139
1747351748206539,67113084,1,722,1,93701354,67003504,26697850,0.0374561996565266
1747351748300561,67205644,1,723,1,93795376,67096064,26699312,0.0374541486312456
1747351748394390,67298204,1,724,1,93889205,67188624,26700581,0.037452368545838
1747351748484642,67390764,1,725,1,93979457,67281184,26698273,0.0374556062109335
1747351748578633,67483324,1,726,1,94073448,67373744,26699704,0.0374535987365253
1747351748672732,67575884,1,727,1,94167547,67466304,26701243,0.0374514399947597
1747351748766896,67668444,1,728,1,94261711,67558864,26702847,0.0374491903428874
1747351748857583,67761004,1,729,1,94352398,67651424,26700974,0.0374518173007471
1747351748951447,67853564,1,730,1,94446262,67743984,26702278,0.0374499883493086
1747351749045648,67946124,1,731,1,94540463,67836544,26703919,0.0374476869855694
1747351749139808,68038692,1,732,1,94634623,67929112,26705511,0.0374454546104734
1747351749229947,68131244,1,733,1,94724762,68021664,26703098,0.03744883833329
1747351749324300,68223804,1,734,1,94819115,68114224,26704891,0.0374463239711407
1747351749418450,68316364,1,735,1,94913265,68206784,26706481,0.0374440945626644
1747351749512053,68408924,1,736,1,95006868,68299344,26707524,0.037442632270966
1747351749606123,68501484,1,737,1,95100938,68391904,26709034,0.0374405154450737
1747351749697385,68594044,1,738,1,95192200,68484464,26707736,0.0374423350597744
1747351749790878,68686604,1,739,1,95285693,68577024,26708669,0.0374410271062178
1747351749885615,68779164,1,740,1,95380430,68669584,26710846,0.0374379755699239
1747351749979768,68871724,1,741,1,95474583,68762144,26712439,0.0374357429510648
1747351750069316,68964284,1,742,1,95564131,68854704,26709427,0.0374399645488463
1747351750163590,69056844,1,743,1,95658405,68947264,26711141,0.0374375621018959
1747351750258111,69149404,1,744,1,95752926,69039824,26713102,0.0374348138228199
1747351750352495,69241964,1,745,1,95847310,69132384,26714926,0.0374322579070591
1747351750442468,69334524,1,746,1,95937283,69224944,26712339,0.0374358830950745
1747351750536822,69427084,1,747,1,96031637,69317504,26714133,0.0374333690709707
1747351750630734,69519644,1,748,1,96125549,69410064,26715485,0.0374314746672201
1747351750724982,69612204,1,749,1,96219797,69502624,26717173,0.0374291097340276
1747351750814864,69704764,1,750,1,96309679,69595184,26714495,0.037432861822767
1747351750909033,69797324,1,751,1,96403848,69687744,26716104,0.0374306073969468
1747351751003926,69889884,1,752,1,96498741,69780304,26718437,0.0374273390318453
1747351751097432,69982444,1,753,1,96592247,69872864,26719383,0.0374260139165638
1747351751191908,70075004,1,754,1,96686723,69965424,26721299,0.0374233303553094
1747351751281651,70167572,1,755,1,96776466,70057992,26718474,0.0374272872021059
1747351751376475,70260124,1,756,1,96871290,70150544,26720746,0.0374241048509648
1747351751490286,70352684,1,757,1,96985101,70243104,26741997,0.0373943651253868
1747351751564704,70445244,1,758,1,97059519,70335664,26723855,0.0374197510052348
1747351751655013,70537804,1,759,1,97149828,70428224,26721604,0.0374229032059602
1747351751748303,70630364,1,760,1,97243118,70520784,26722334,0.037421880888099
1747351751842558,70722924,1,761,1,97337373,70613344,26724029,0.03741950736545
1747351751937446,70815484,1,762,1,97432261,70705904,26726357,0.0374162479383179
1747351752027797,70908044,1,763,1,97522612,70798464,26724148,0.0374193407400677
1747351752121096,71000604,1,764,1,97615911,70891024,26724887,0.0374183060156624
1747351752215859,71093164,1,765,1,97710674,70983584,26727090,0.0374152217843394
1747351752309579,71185724,1,766,1,97804394,71076144,26728250,0.0374135979721829
1747351752404606,71278284,1,767,1,97899421,71168704,26730717,0.0374101450402546
1747351752493923,71370844,1,768,1,97988738,71261264,26727474,0.0374146842309153
1747351752588684,71463404,1,769,1,98083499,71353824,26729675,0.0374116033958512
1747351752682285,71555964,1,770,1,98177100,71446384,26730716,0.0374101464397736
1747351752776971,71648524,1,771,1,98271786,71538944,26732842,0.0374071712988839
1747351752867231,71741084,1,772,1,98362046,71631504,26730542,0.0374103899576746
1747351752961168,71833644,1,773,1,98455983,71724064,26731919,0.0374084628941154
1747351753054685,71926204,1,774,1,98549500,71816624,26732876,0.0374071237228646
1747351753149453,72018764,1,775,1,98644268,71909184,26735084,0.0374040343392973
1747351753239446,72111324,1,776,1,98734261,72001744,26732517,0.0374076260757638
1747351753333701,72203884,1,777,1,98828516,72094304,26734212,0.0374052543609663
1747351753428352,72296444,1,778,1,98923167,72186864,26736303,0.0374023289607392
1747351753522436,72389004,1,779,1,99017251,72279424,26737827,0.0374001971065187
1747351753611986,72481564,1,780,1,99106801,72371984,26734817,0.0374044078925245
1747351753706679,72574124,1,781,1,99201494,72464544,26736950,0.0374014238722068
1747351753800653,72666684,1,782,1,99295468,72557104,26738364,0.037399445979567
1747351753894963,72759244,1,783,1,99389778,72649664,26740114,0.0373969983822806
1747351753989301,72851804,1,784,1,99484116,72742224,26741892,0.0373945119515103
1747351754079493,72944364,1,785,1,99574308,72834784,26739524,0.0373978235364249
1747351754173560,73036924,1,786,1,99668375,72927344,26741031,0.0373957159692159
1747351754267360,73129484,1,787,1,99762175,73019904,26742271,0.0373939819845517
1747351754361789,73222044,1,788,1,99856604,73112464,26744140,0.0373913687260087
1747351754451989,73314604,1,789,1,99946804,73205024,26741780,0.037394668567313
1747351754546568,73407164,1,790,1,100041383,73297584,26743799,0.0373918454891169
1747351754640170,73499724,1,791,1,100134985,73390144,26744841,0.0373903886734641
1747351754734143,73592284,1,792,1,100228958,73482704,26746254,0.0373884133456595
1747351754824327,73684844,1,793,1,100319142,73575264,26743878,0.0373917350355845
1747351754918525,73777404,1,794,1,100413340,73667824,26745516,0.0373894450194941
1747351755012958,73869964,1,795,1,100507773,73760384,26747389,0.0373868268039172
1747351755106980,73962532,1,796,1,100601795,73852952,26748843,0.0373847945498053
1747351755197341,74055084,1,797,1,100692156,73945504,26746652,0.0373878569923443
1747351755291435,74147644,1,798,1,100786250,74038064,26748186,0.0373857128105808
1747351755385527,74240204,1,799,1,100880342,74130624,26749718,0.0373835716698022
1747351755480085,74332764,1,800,1,100974900,74223184,26751716,0.0373807796105491
1747351755574190,74425324,1,801,1,101069005,74315744,26753261,0.0373786208716761
1747351755664165,74517884,1,802,1,101158980,74408304,26750676,0.0373822328826381
1747351755758699,74610444,1,803,1,101253514,74500864,26752650,0.0373794745567261
1747351755852552,74703004,1,804,1,101347367,74593424,26753943,0.0373776680319607
1747351755947079,74795564,1,805,1,101441894,74685984,26755910,0.0373749201578268
1747351756037017,74888124,1,806,1,101531832,74778544,26753288,0.0373785831483591
1747351756130929,74980684,1,807,1,101625744,74871104,26754640,0.0373766942855519
1747351756225675,75073244,1,808,1,101720490,74963664,26756826,0.0373736406552855
1747351756319693,75165804,1,809,1,101814508,75056224,26758284,0.0373716042478658
1747351756410224,75258364,1,810,1,101905039,75148784,26756255,0.0373744382388342
1747351756503910,75350924,1,811,1,101998725,75241344,26757381,0.0373728654534612
1747351756597656,75443484,1,812,1,102092471,75333904,26758567,0.0373712090038304
1747351756692268,75536044,1,813,1,102187083,75426464,26760619,0.0373683433854799
1747351756782735,75628604,1,814,1,102277550,75519024,26758526,0.0373712662648159
1747351756876158,75721164,1,815,1,102370973,75611584,26759389,0.0373700610279255
1747351756970462,75813724,1,816,1,102465277,75704144,26761133,0.0373676256532187
1747351757065102,75906284,1,817,1,102559917,75796704,26763213,0.0373647214928939
1747351757159484,75998844,1,818,1,102654299,75889264,26765035,0.0373621779310208
1747351757249386,76091412,1,819,1,102744201,75981832,26762369,0.0373658998573706
1747351757343881,76183964,1,820,1,102838696,76074384,26764312,0.0373631872173661
1747351757438106,76276524,1,821,1,102932921,76166944,26765977,0.0373608630090356
1747351757532104,76369084,1,822,1,103026919,76259504,26767415,0.0373588559074531
1747351757622271,76461644,1,823,1,103117086,76352064,26765022,0.03736219607815
1747351757716349,76554204,1,824,1,103211164,76444624,26766540,0.0373600771709754
1747351757810509,76646764,1,825,1,103305324,76537184,26768140,0.0373578440638759
1747351757904392,76739324,1,826,1,103399207,76629744,26769463,0.0373559977650653
1747351757994510,76831884,1,827,1,103489325,76722304,26767021,0.0373594058150886
1747351758088600,76924444,1,828,1,103583415,76814864,26768551,0.0373572704775839
1747351758183409,77017004,1,829,1,103678224,76907424,26770800,0.0373541321140944
1747351758276852,77109564,1,830,1,103771667,76999984,26771683,0.0373529000772943
1747351758368032,77202124,1,831,1,103862847,77092544,26770303,0.0373548256065685
1747351758461799,77294684,1,832,1,103956614,77185104,26771510,0.0373531414552261
1747351758555759,77387244,1,833,1,104050574,77277664,26772910,0.0373511881973233
1747351758649606,77479804,1,834,1,104144421,77370224,26774197,0.0373493927754397
1747351758743881,77572364,1,835,1,104238696,77462784,26775912,0.037347000542876
1747351758834408,77664924,1,836,1,104329223,77555344,26773879,0.0373498363834392
1747351758928768,77757484,1,837,1,104423583,77647904,26775679,0.0373473255337427
1747351759022633,77850044,1,838,1,104517448,77740464,26776984,0.0373455053787984
1747351759117169,77942604,1,839,1,104611984,77833024,26778960,0.0373427496810929
1747351759206812,78035164,1,840,1,104701627,77925584,26776043,0.037346817825173
1747351759301435,78127724,1,841,1,104796250,78018144,26778106,0.0373439406058068
1747351759395452,78220284,1,842,1,104890267,78110704,26779563,0.0373419088280118
1747351759489474,78312844,1,843,1,104984289,78203264,26781025,0.0373398702999605
1747351759580078,78405404,1,844,1,105074893,78295824,26779069,0.0373425976832876
1747351759673859,78497964,1,845,1,105168674,78388384,26780290,0.0373408951135331
1747351759767879,78590524,1,846,1,105262694,78480944,26781750,0.037338859484537
1747351759861957,78683084,1,847,1,105356772,78573504,26783268,0.0373367432234184
1747351759952777,78775644,1,848,1,105447592,78666064,26781528,0.0373391689973775
1747351760046657,78868204,1,849,1,105541472,78758624,26782848,0.0373373287262056
1747351760140154,78960764,1,850,1,105634969,78851184,26783785,0.0373360225225822
1747351760235059,79053324,1,851,1,105729874,78943744,26786130,0.0373327539289923
1747351760329517,79145884,1,852,1,105824332,79036304,26788028,0.0373301088083079
1747351760419262,79238444,1,853,1,105914077,79128864,26785213,0.037334032027298
1747351760513726,79331004,1,854,1,106008541,79221424,26787117,0.0373313783637111
1747351760607489,79423564,1,855,1,106102304,79313984,26788320,0.0373297018999325
1747351760701505,79516124,1,856,1,106196320,79406544,26789776,0.0373276730645302
1747351760792544,79608684,1,857,1,106287359,79499104,26788255,0.0373297924780841
1747351760886402,79701244,1,858,1,106381217,79591664,26789553,0.037327983785321
1747351760980652,79793804,1,859,1,106475467,79684224,26791243,0.037325629124412
1747351761074468,79886372,1,860,1,106569283,79776792,26792491,0.0373238904885701
1747351761164903,79978924,1,861,1,106659718,79869344,26790374,0.0373268398567336
1747351761259277,80071484,1,862,1,106754092,79961904,26792188,0.0373243125944025
1747351761353059,80164044,1,863,1,106847874,80054464,26793410,0.0373226102985771
1747351761447220,80256604,1,864,1,106942035,80147024,26795011,0.0373203802752684
1747351761537279,80349164,1,865,1,107032094,80239584,26792510,0.0373238640202056
1747351761631378,80441724,1,866,1,107126193,80332144,26794049,0.037321720207349
1747351761726359,80534284,1,867,1,107221174,80424704,26796470,0.037318348274978
1747351761819965,80626844,1,868,1,107314780,80517264,26797516,0.0373168916104015
1747351761914211,80719404,1,869,1,107409026,80609824,26799202,0.037314543918136
1747351762004209,80811964,1,870,1,107499024,80702384,26796640,0.0373181115244299
1747351762098226,80904524,1,871,1,107593041,80794944,26798097,0.0373160825561606
1747351762192944,80997084,1,872,1,107687759,80887504,26800255,0.0373130778046701
1747351762286490,81089644,1,873,1,107781305,80980064,26801241,0.0373117050811191
1747351762376889,81182204,1,874,1,107871704,81072624,26799080,0.0373147137886823
1747351762472494,81274764,1,875,1,107967309,81165184,26802125,0.0373104744493207
1747351762565219,81367324,1,876,1,108060034,81257744,26802290,0.0373102447589366
1747351762659253,81459884,1,877,1,108154068,81350304,26803764,0.0373081929836421
1747351762749896,81552444,1,878,1,108244711,81442864,26801847,0.0373108614492128
1747351762843531,81645004,1,879,1,108338346,81535424,26802922,0.0373093650013233
1747351762938134,81737564,1,880,1,108432949,81627984,26804965,0.0373065213851239
1747351763032454,81830124,1,881,1,108527269,81720544,26806725,0.0373040720192414
1747351763122376,81922684,1,882,1,108617191,81813104,26804087,0.0373077434049516
1747351763217147,82015252,1,883,1,108711962,81905672,26806290,0.0373046773723629
1747351763310344,82107804,1,884,1,108805159,81998224,26806935,0.037303779786835
1747351763404845,82200364,1,885,1,108899660,82090784,26808876,0.0373010789411685
1747351763499098,82292924,1,886,1,108993913,82183344,26810569,0.0372987234996765
1747351763589240,82385484,1,887,1,109084055,82275904,26808151,0.0373020877120544
1747351763684138,82478044,1,888,1,109178953,82368464,26810489,0.0372988347955906
1747351763777323,82570604,1,889,1,109272138,82461024,26811114,0.0372979653139366
1747351763872084,82663164,1,890,1,109366899,82553584,26813315,0.0372949036700609
1747351763962326,82755724,1,891,1,109457141,82646144,26810997,0.0372981280778182
1747351764056338,82848284,1,892,1,109551153,82738704,26812449,0.0372961082368865
1747351764150611,82940844,1,893,1,109645426,82831264,26814162,0.0372937256066402
1747351764244616,83033404,1,894,1,109739431,82923824,26815607,0.0372917159771919
1747351764335271,83125964,1,895,1,109830086,83016384,26813702,0.0372943653957219
1747351764429010,83218524,1,896,1,109923825,83108944,26814881,0.0372927256324575
1747351764522931,83311084,1,897,1,110017746,83201504,26816242,0.0372908329213317
1747351764617591,83403644,1,898,1,110112406,83294064,26818342,0.0372879128769407
1747351764712068,83496204,1,899,1,110206883,83386624,26820259,0.0372852476927981
1747351764802057,83588764,1,900,1,110296872,83479184,26817688,0.0372888222131602
1747351764896468,83681324,1,901,1,110391283,83571744,26819539,0.0372862486562502
1747351764989856,83773884,1,902,1,110484671,83664304,26820367,0.0372850975529156
1747351765084065,83866444,1,903,1,110578880,83756864,26822016,0.0372828052895054
1747351765174960,83959004,1,904,1,110669775,83849424,26820351,0.0372851197957849
1747351765268957,84051564,1,905,1,110763772,83941984,26821788,0.0372831222139254
1747351765363049,84144124,1,906,1,110857864,84034544,26823320,0.0372809928077508
1747351765456814,84236684,1,907,1,110951629,84127104,26824525,0.0372793180867135
1747351765547293,84329244,1,908,1,111042108,84219664,26822444,0.0372822103757584
1747351765641639,84421804,1,909,1,111136454,84312224,26824230,0.0372797280667515
1747351765735395,84514364,1,910,1,111230210,84404784,26825426,0.0372780659662217
1747351765829882,84606924,1,911,1,111324697,84497344,26827353,0.0372753882949242
1747351765919670,84699484,1,912,1,111414485,84589904,26824581,0.0372792402610128
1747351766014685,84792044,1,913,1,111509500,84682464,26827036,0.0372758287572283
1747351766108785,84884604,1,914,1,111603600,84775024,26828576,0.0372736890694459
1747351766202181,84977164,1,915,1,111696996,84867584,26829412,0.0372725276275156
1747351766296223,85069724,1,916,1,111791038,84960144,26830894,0.0372704688856062
1747351766387318,85162284,1,917,1,111882133,85052704,26829429,0.0372725040104282
1747351766480752,85254844,1,918,1,111975567,85145264,26830303,0.0372712898546095
1747351766575369,85347404,1,919,1,112070184,85237824,26832360,0.0372684325940767
1747351766669428,85439964,1,920,1,112164243,85330384,26833859,0.0372663506952168
1747351766759513,85532524,1,921,1,112254328,85422944,26831384,0.0372697882449895
1747351766853659,85625084,1,922,1,112348474,85515504,26832970,0.0372675853623359
1747351766948283,85717644,1,923,1,112443098,85608064,26835034,0.037264718949117
1747351767042191,85810212,1,924,1,112537006,85700632,26836374,0.0372628582385981
1747351767132630,85902764,1,925,1,112627445,85793184,26834261,0.037265792413661
1747351767226191,85995324,1,926,1,112721006,85885744,26835262,0.0372644023374916
1747351767321005,86087884,1,927,1,112815820,85978304,26837516,0.0372612726155431
1747351767414796,86180444,1,928,1,112909611,86070864,26838747,0.0372595635705347
1747351767505322,86273004,1,929,1,113000137,86163424,26836713,0.0372623875360592
1747351767599103,86365564,1,930,1,113093918,86255984,26837934,0.0372606922723634
1747351767693100,86458124,1,931,1,113187915,86348544,26839371,0.037258697307027
1747351767787588,86550684,1,932,1,113282403,86441104,26841299,0.0372560210293846
1747351767882019,86643244,1,933,1,113376834,86533664,26843170,0.0372534242416227
1747351767972279,86735804,1,934,1,113467094,86626224,26840870,0.037256616495665
1747351768066440,86828364,1,935,1,113561255,86718784,26842471,0.0372543943513993
1747351768160549,86920924,1,936,1,113655364,86811344,26844020,0.0372522446340004
1747351768254335,87013484,1,937,1,113749150,86903904,26845246,0.0372505433550506
1747351768344663,87106044,1,938,1,113839478,86996464,26843014,0.0372536407424292
1747351768438636,87198604,1,939,1,113933451,87089024,26844427,0.0372516798365634
1747351768533466,87291164,1,940,1,114028281,87181584,26846697,0.0372485300519464
1747351768627385,87383724,1,941,1,114122200,87274144,26848056,0.0372466445987746
1747351768717168,87476284,1,942,1,114211983,87366704,26845279,0.0372504975642085
1747351768812067,87568844,1,943,1,114306882,87459264,26847618,0.0372472522515777
1747351768905451,87661404,1,944,1,114400266,87551824,26848442,0.0372461091038355
1747351769000182,87753964,1,945,1,114494997,87644384,26850613,0.0372430975784426
1747351769090475,87846524,1,946,1,114585290,87736944,26848346,0.0372462422824854
1747351769184760,87939092,1,947,1,114679575,87829512,26850063,0.0372438604706439
1747351769278278,88031644,1,948,1,114773093,87922064,26851029,0.0372425205752822
1747351769372575,88124204,1,949,1,114867390,88014624,26852766,0.0372401115028522
1747351769466787,88216764,1,950,1,114961602,88107184,26854418,0.037237820607395
1747351769556790,88309324,1,951,1,115051605,88199744,26851861,0.0372413666225964
1747351769650694,88401884,1,952,1,115145509,88292304,26853205,0.037239502696233
1747351769745051,88494444,1,953,1,115239866,88384864,26855002,0.0372370108183198
1747351769839779,88587004,1,954,1,115334594,88477424,26857170,0.0372340049230801
1747351769929493,88679564,1,955,1,115424308,88569984,26854324,0.0372379509534479
1747351770023697,88772124,1,956,1,115518512,88662544,26855968,0.0372356714157538
1747351770117822,88864684,1,957,1,115612637,88755104,26857533,0.0372335016771644
1747351770212547,88957244,1,958,1,115707362,88847664,26859698,0.0372305005067443
1747351770302260,89049804,1,959,1,115797075,88940224,26856851,0.0372344471807212
1747351770396717,89142364,1,960,1,115891532,89032784,26858748,0.0372318173579796
1747351770490311,89234924,1,961,1,115985126,89125344,26859782,0.0372303840738543
1747351770584962,89327484,1,962,1,116079777,89217904,26861873,0.0372274859612358
1747351770674824,89420044,1,963,1,116169639,89310464,26859175,0.037231225456478
1747351770769099,89512604,1,964,1,116263914,89403024,26860890,0.0372288483367453
1747351770863892,89605164,1,965,1,116358707,89495584,26863123,0.0372257536847074
1747351770957249,89697724,1,966,1,116452064,89588144,26863920,0.0372246492693545
1747351771051735,89790284,1,967,1,116546550,89680704,26865846,0.0372219806515677
1747351771141579,89882844,1,968,1,116636394,89773264,26863130,0.0372257439844128
1747351771235825,89975404,1,969,1,116730640,89865824,26864816,0.0372234077463996
1747351771330220,90067964,1,970,1,116825035,89958384,26866651,0.0372208653769314
1747351771424142,90160524,1,971,1,116918957,90050944,26868013,0.0372189785675628
1747351771514781,90253084,1,972,1,117009596,90143504,26866092,0.037221639827631
1747351771608860,90345644,1,973,1,117103675,90236064,26867611,0.0372195354473458
1747351771702893,90438204,1,974,1,117197708,90328624,26869084,0.0372174950214156
1747351771797006,90530764,1,975,1,117291821,90421184,26870637,0.0372153440203148
1747351771885615,90623324,1,976,1,117380430,90513744,26866686,0.0372208168882459
1747351771981756,90715884,1,977,1,117476571,90606304,26870267,0.0372158564706483
1747351772075659,90808444,1,978,1,117570474,90698864,26871610,0.0372139964817887
1747351772169731,90901004,1,979,1,117664546,90791424,26873122,0.0372119026587234
1747351772259796,90993564,1,980,1,117754611,90883984,26870627,0.0372153578701382
1747351772354941,91086124,1,981,1,117849756,90976544,26873212,0.0372117780338278
1747351772448777,91178684,1,982,1,117943592,91069104,26874488,0.0372100112195625
1747351772543011,91271244,1,983,1,118037826,91161664,26876162,0.0372076935687469
1747351772637196,91363804,1,984,1,118132011,91254224,26877787,0.0372054440345107
1747351772727424,91456364,1,985,1,118222239,91346784,26875455,0.0372086723741049
1747351772821544,91548924,1,986,1,118316359,91439344,26877015,0.0372065127023964
1747351772915737,91641484,1,987,1,118410552,91531904,26878648,0.0372042522376869
1747351773010311,91734052,1,988,1,118505126,91624472,26880654,0.0372014758271878
1747351773099727,91826604,1,989,1,118594542,91717024,26877518,0.0372058164001601
1747351773194524,91919164,1,990,1,118689339,91809584,26879755,0.0372027200396729
1747351773288636,92011724,1,991,1,118783451,91902144,26881307,0.0372005721299191
1747351773382102,92104284,1,992,1,118876917,91994704,26882213,0.0371993183745698
1747351773473255,92196844,1,993,1,118968070,92087264,26880806,0.0372012654680071
1747351773567560,92289404,1,994,1,119062375,92179824,26882551,0.0371988506596714
1747351773661267,92381964,1,995,1,119156082,92272384,26883698,0.0371972635609877
1747351773754861,92474524,1,996,1,119249676,92364944,26884732,0.0371958329359578
1747351773845621,92567084,1,997,1,119340436,92457504,26882932,0.0371983234566824
1747351773939297,92659644,1,998,1,119434112,92550064,26884048,0.0371967792945467
1747351774033533,92752204,1,999,1,119528348,92642624,26885724,0.0371944605248495
1747351774127563,92844764,1,1000,1,119622378,92735184,26887194,0.0371924269970306
1747351774221772,92938364,1,1001,1,119716587,92828784,26887803,0.0371915846006458
1747351774316461,93031964,1,1002,1,119811276,92922384,26888892,0.0371900783416438
1747351774410370,93125564,1,1003,1,119905185,93015984,26889201,0.0371896509680596
1747351774505010,93219164,1,1004,1,119999825,93109584,26890241,0.0371882126307458
1747351774598831,93312764,1,1005,1,120093646,93203184,26890462,0.0371879069983996
1747351774693463,93406364,1,1006,1,120188278,93296784,26891494,0.0371864798586497
1747351774787199,93499964,1,1007,1,120282014,93390384,26891630,0.0371862917941381
1747351774881114,93593564,1,1008,1,120375929,93483984,26891945,0.0371858562108467
1747351774975746,93687164,1,1009,1,120470561,93577584,26892977,0.0371844292284933
1747351775069649,93780764,1,1010,1,120564464,93671184,26893280,0.0371840102806351
1747351775164048,93874364,1,1011,1,120658863,93764784,26894079,0.0371829055756101
1747351775258257,93967964,1,1012,1,120753072,93858384,26894688,0.0371820636104795
1747351775351947,94061564,1,1013,1,120846762,93951984,26894778,0.0371819391853689
1747351775446630,94155164,1,1014,1,120941445,94045584,26895861,0.0371804420018381
1747351775540536,94248764,1,1015,1,121035351,94139184,26896167,0.0371800189967589
1747351775634737,94342364,1,1016,1,121129552,94232784,26896768,0.0371791882206813
1747351775728751,94435964,1,1017,1,121223566,94326384,26897182,0.0371786159605865
1747351775823405,94529572,1,1018,1,121318220,94419992,26898228,0.03717717018385
1747351775917329,94623164,1,1019,1,121412144,94513584,26898560,0.0371767113183754
1747351776011525,94716764,1,1020,1,121506340,94607184,26899156,0.0371758876003395
1747351776105889,94810364,1,1021,1,121600704,94700784,26899920,0.0371748317467115
1747351776204194,94903964,1,1022,1,121699009,94794384,26904625,0.0371683307238067
1747351776298210,94997564,1,1023,1,121793025,94887984,26905041,0.0371677560350121
1747351776392641,95091164,1,1024,1,121887456,94981584,26905872,0.0371666080920923
1747351776487087,95184764,1,1025,1,121981902,95075184,26906718,0.0371654395010197
1747351776581438,95278364,1,1026,1,122076253,95168784,26907469,0.0371644021962823
1747351776674839,95371964,1,1027,1,122169654,95262384,26907270,0.0371646770556804
1747351776769380,95465564,1,1028,1,122264195,95355984,26908211,0.037163377379492
1747351776863455,95559164,1,1029,1,122358270,95449584,26908686,0.0371627213606788
1747351776958032,95652764,1,1030,1,122452847,95543184,26909663,0.0371613721063693
1747351777051694,95746364,1,1031,1,122546509,95636784,26909725,0.0371612864865768
1747351777145793,95839964,1,1032,1,122640608,95730384,26910224,0.0371605973997094
1747351777240449,95933564,1,1033,1,122735264,95823984,26911280,0.0371591392159718
1747351777334978,96027164,1,1034,1,122829793,95917584,26912209,0.0371578564955407
1747351777428590,96120764,1,1035,1,122923405,96011184,26912221,0.0371578399270725
1747351777523386,96214364,1,1036,1,123018201,96104784,26913417,0.0371561886771939
1747351777617752,96307964,1,1037,1,123112567,96198384,26914183,0.0371551311812065
1747351777711100,96401564,1,1038,1,123205915,96291984,26913931,0.0371554790714147
1747351777805402,96495164,1,1039,1,123300217,96385584,26914633,0.0371545099648953
1747351777899665,96588764,1,1040,1,123394480,96479184,26915296,0.0371535947440444
1747351777994094,96682364,1,1041,1,123488909,96572784,26916125,0.037152450436309
1747351778112355,96775964,1,1042,1,123607170,96666384,26940786,0.0371184419044047
1747351778182307,96869564,1,1043,1,123677122,96759984,26917138,0.0371510522403979
1747351778276638,96963164,1,1044,1,123771453,96853584,26917869,0.037150043341098
1747351778371268,97056764,1,1045,1,123866083,96947184,26918899,0.0371486218659983
1747351778464866,97150364,1,1046,1,123959681,97040784,26918897,0.0371486246260387
1747351778559014,97243964,1,1047,1,124053829,97134384,26919445,0.0371478683903029
1747351778653666,97337564,1,1048,1,124148481,97227984,26920497,0.0371464167247729
1747351778747723,97431164,1,1049,1,124242538,97321584,26920954,0.0371457861411597
1747351778841845,97524772,1,1050,1,124336660,97415192,26921468,0.0371450769326546
1747351778936121,97618364,1,1051,1,124430936,97508784,26922152,0.0371441332030218
1747351779030669,97711964,1,1052,1,124525484,97602384,26923100,0.0371428253061497
1747351779124862,97805564,1,1053,1,124619677,97695984,26923693,0.0371420072276117
1747351779218631,97899164,1,1054,1,124713446,97789584,26923862,0.0371417740887247
1747351779312967,97992764,1,1055,1,124807782,97883184,26924598,0.0371407587961016
1747351779407262,98086364,1,1056,1,124902077,97976784,26925293,0.037139800112853
1747351779501552,98179964,1,1057,1,124996367,98070384,26925983,0.0371388483755634
1747351779595291,98273564,1,1058,1,125090106,98163984,26926122,0.037138656654679
1747351779690117,98367164,1,1059,1,125184932,98257584,26927348,0.037136965734613
1747351779784291,98460764,1,1060,1,125279106,98351184,26927922,0.037136174116963
1747351779878541,98554364,1,1061,1,125373356,98444784,26928572,0.0371352777265723
1747351779972536,98647964,1,1062,1,125467351,98538384,26928967,0.0371347330181659
1747351780066348,98741564,1,1063,1,125561163,98631984,26929179,0.0371344406749273
1747351780160858,98835164,1,1064,1,125655673,98725584,26930089,0.0371331858576479
1747351780254917,98928764,1,1065,1,125749732,98819184,26930548,0.0371325529655022
1747351780348743,99022364,1,1066,1,125843558,98912784,26930774,0.0371322413533305
1747351780443359,99115964,1,1067,1,125938174,99006384,26931790,0.0371308405419766
1747351780537068,99209564,1,1068,1,126031883,99099984,26931899,0.037130690264359
1747351780631229,99303164,1,1069,1,126126044,99193584,26932460,0.0371299168364122
1747351780729594,99396764,1,1070,1,126224409,99287184,26937225,0.0371233488230506
1747351780823813,99490364,1,1071,1,126318628,99380784,26937844,0.0371224957721189
1747351780917816,99583964,1,1072,1,126412631,99474384,26938247,0.0371219404143112
1747351781012569,99677564,1,1073,1,126507384,99567984,26939400,0.0371203516039704
1747351781106894,99771164,1,1074,1,126601709,99661584,26940125,0.0371193526384899
1747351781200395,99864764,1,1075,1,126695210,99755184,26940026,0.0371194890457789
1747351781295369,99958364,1,1076,1,126790184,99848784,26941400,0.0371175959675443
1747351781389115,100051964,1,1077,1,126883930,99942384,26941546,0.0371173948221085
1747351781483919,100146604,1,1078,1,126978734,100037024,26941710,0.0371171688805202
1747351781577503,100241244,1,1079,1,127072318,100131664,26940654,0.037118623772088
1747351781676123,100335884,1,1080,1,127170938,100226304,26944634,0.0371131409689959
1747351781770218,100430524,1,1081,1,127265033,100320944,26944089,0.0371138916591316
1747351781864596,100525164,1,1082,1,127359411,100415584,26943827,0.0371142525521708
1747351781963082,100619804,1,1083,1,127457897,100510224,26947673,0.0371089555673322
1747351782057412,100714444,1,1084,1,127552227,100604864,26947363,0.037109382465364
1747351782151667,100809084,1,1085,1,127646482,100699504,26946978,0.0371099126588517
1747351782245384,100903724,1,1086,1,127740199,100794144,26946055,0.0371111838077967
1747351782343556,100998364,1,1087,1,127838371,100888784,26949587,0.0371063200337726
1747351782437969,101093004,1,1088,1,127932784,100983424,26949360,0.0371066325879353
1747351782529054,101187644,1,1089,1,128023869,101078064,26945805,0.0371115281209821
1747351782630048,101282284,1,1090,1,128124863,101172704,26952159,0.037102779038963
1747351782724332,101376924,1,1091,1,128219147,101267344,26951803,0.0371032691208079
1747351782818822,101471564,1,1092,1,128313637,101361984,26951653,0.0371034756198441
1747351782913097,101566204,1,1093,1,128407912,101456624,26951288,0.0371039781104339
1747351783011218,101660844,1,1094,1,128506033,101551264,26954769,0.0370991864185517
1747351783105693,101755484,1,1095,1,128600508,101645904,26954604,0.0370994135176313
1747351783199336,101850132,1,1096,1,128694151,101740552,26953599,0.0371007968175233
1747351783293432,101944764,1,1097,1,128788247,101835184,26953063,0.037101534619646
1747351783391864,102039404,1,1098,1,128886679,101929824,26956855,0.0370963155753888
1747351783486510,102134044,1,1099,1,128981325,102024464,26956861,0.0370963073185709
1747351783580696,102228684,1,1100,1,129075511,102119104,26956407,0.0370969320948448
1747351783679126,102323324,1,1101,1,129173941,102213744,26960197,0.0370917170968743
1747351783773128,102417964,1,1102,1,129267943,102308384,26959559,0.0370925948751609
1747351783867568,102512604,1,1103,1,129362383,102403024,26959359,0.0370928700493212
1747351783961557,102607244,1,1104,1,129456372,102497664,26958708,0.0370937657694871
1747351784059742,102701884,1,1105,1,129554557,102592304,26962253,0.0370888886770701
1747351784153600,102796524,1,1106,1,129648415,102686944,26961471,0.037089964416259
1747351784248516,102891164,1,1107,1,129743331,102781584,26961747,0.0370895847364786
1747351784342410,102985804,1,1108,1,129837225,102876224,26961001,0.0370906109902966
1747351784440763,103080444,1,1109,1,129935578,102970864,26964714,0.0370855036697218
1747351784535515,103175084,1,1110,1,130030330,103065504,26964826,0.0370853496328884
1747351784629000,103269724,1,1111,1,130123815,103160144,26963671,0.0370869381991791
1747351784727139,103364364,1,1112,1,130221954,103254784,26967170,0.0370821261556181
1747351784821391,103459004,1,1113,1,130316206,103349424,26966782,0.0370826596959177
1747351784915678,103553644,1,1114,1,130410493,103444064,26966429,0.0370831451209205
1747351785010835,103648292,1,1115,1,130505650,103538712,26966938,0.0370824451778692
1747351785108556,103742924,1,1116,1,130603371,103633344,26970027,0.0370781979565685
1747351785202434,103837564,1,1117,1,130697249,103727984,26969265,0.0370792455782536
1747351785297161,103932204,1,1118,1,130791976,103822624,26969352,0.03707912596491
1747351785395272,104026844,1,1119,1,130890087,103917264,26972823,0.0370743544344616
1747351785489236,104121484,1,1120,1,130984051,104011904,26972147,0.0370752836249928
1747351785583352,104216124,1,1121,1,131078167,104106544,26971623,0.0370760039171539
1747351785677439,104310764,1,1122,1,131172254,104201184,26971070,0.0370767641031668
1747351785776042,104405404,1,1123,1,131270857,104295824,26975033,0.0370713170211877
1747351785870563,104500044,1,1124,1,131365378,104390464,26974914,0.037071480561532
1747351785963598,104594684,1,1125,1,131458413,104485104,26973309,0.037073686435728
1747351786058775,104689324,1,1126,1,131553590,104579744,26973846,0.0370729483663545
1747351786156859,104783964,1,1127,1,131651674,104674384,26977290,0.0370682155249841
1747351786251130,104878604,1,1128,1,131745945,104769024,26976921,0.0370687225573296
1747351786344708,104973244,1,1129,1,131839523,104863664,26975859,0.0370701818985634
1747351786443121,105067884,1,1130,1,131937936,104958304,26979632,0.0370649977731349
1747351786537818,105162524,1,1131,1,132032633,105052944,26979689,0.0370649194658989
1747351786631966,105257164,1,1132,1,132126781,105147584,26979197,0.0370655953918865
1747351786725866,105351804,1,1133,1,132220681,105242224,26978457,0.0370666120749604
1747351786824156,105446444,1,1134,1,132318971,105336864,26982107,0.0370615978952273
1747351786918159,105541084,1,1135,1,132412974,105431504,26981470,0.0370624728749026
1747351787013153,105635724,1,1136,1,132507968,105526144,26981824,0.0370619866173613
1747351787111207,105730364,1,1137,1,132606022,105620784,26985238,0.0370572977714704
1747351787205034,105825004,1,1138,1,132699849,105715424,26984425,0.0370584142519249
1747351787299667,105919644,1,1139,1,132794482,105810064,26984418,0.0370584238652099
1747351787393525,106014284,1,1140,1,132888340,105904704,26983636,0.0370594978378747
1747351787491855,106108924,1,1141,1,132986670,105999344,26987326,0.0370544306612667
1747351787586249,106203564,1,1142,1,133081064,106093984,26987080,0.0370547684299301
1747351787680503,106298204,1,1143,1,133175318,106188624,26986694,0.0370552984370742
1747351787774277,106392844,1,1144,1,133269092,106283264,26985828,0.0370564875756267
1747351787873239,106487484,1,1145,1,133368054,106377904,26990150,0.0370505536278975
1747351787966790,106582124,1,1146,1,133461605,106472544,26989061,0.0370520486059148
1747351788061142,106676764,1,1147,1,133555957,106567184,26988773,0.037052443992174
1747351788159623,106771404,1,1148,1,133654438,106661824,26992614,0.0370471714966175
1747351788253946,106866044,1,1149,1,133748761,106756464,26992297,0.0370476065819815
1747351788347564,106960684,1,1150,1,133842379,106851104,26991275,0.037049009355801
1747351788442700,107055324,1,1151,1,133937515,106945744,26991771,0.0370483285442811
1747351788540557,107149964,1,1152,1,134035372,107040384,26994988,0.0370439134849772
1747351788634831,107244604,1,1153,1,134129646,107135024,26994622,0.0370444157358454
1747351788728821,107339244,1,1154,1,134223636,107229664,26993972,0.0370453077450032
1747351788823223,107433884,1,1155,1,134318038,107324304,26993734,0.0370456343683315
1747351788921393,107528524,1,1156,1,134416208,107418944,26997264,0.037040790503808
1747351789015865,107623164,1,1157,1,134510680,107513584,26997096,0.0370410210046295
1747351789109515,107717804,1,1158,1,134604330,107608224,26996106,0.0370423793713063
1747351789207845,107812444,1,1159,1,134702660,107702864,26999796,0.0370373168745423
1747351789302305,107907092,1,1160,1,134797120,107797512,26999608,0.0370375747677521
1747351789396015,108001724,1,1161,1,134890830,107892144,26998686,0.0370388395938972
1747351789490465,108096364,1,1162,1,134985280,107986784,26998496,0.0370391002521029
1747351789589324,108191004,1,1163,1,135084139,108081424,27002715,0.037033313131661
1747351789683001,108285644,1,1164,1,135177816,108176064,27001752,0.0370346339007928
1747351789777262,108380284,1,1165,1,135272077,108270704,27001373,0.0370351537308862
1747351789875756,108474924,1,1166,1,135370571,108365344,27005227,0.0370298683288239
1747351789970074,108569564,1,1167,1,135464889,108459984,27004905,0.0370303098640783
1747351790064515,108664204,1,1168,1,135559330,108554624,27004706,0.0370305827436151
1747351790158182,108758844,1,1169,1,135652997,108649264,27003733,0.0370319170316192
1747351790256930,108853484,1,1170,1,135751745,108743904,27007841,0.0370262843297988
1747351790350282,108948124,1,1171,1,135845097,108838544,27006553,0.0370280501921144
1747351790445204,109042764,1,1172,1,135940019,108933184,27006835,0.0370276635525784
1747351790538749,109137404,1,1173,1,136033564,109027824,27005740,0.0370291649108671
1747351790637761,109232044,1,1174,1,136132576,109122464,27010112,0.0370231711738181
1747351790732201,109326684,1,1175,1,136227016,109217104,27009912,0.0370234453188888
1747351790825894,109421324,1,1176,1,136320709,109311744,27008965,0.0370247434509245
1747351790923687,109515964,1,1177,1,136418502,109406384,27012118,0.0370204217233169
1747351791018407,109610604,1,1178,1,136513222,109501024,27012198,0.0370203120827116
1747351791112993,109705252,1,1179,1,136607808,109595672,27012136,0.0370203970541241
1747351791207195,109799884,1,1180,1,136702010,109690304,27011706,0.0370209863827186
1747351791305064,109894524,1,1181,1,136799879,109784944,27014935,0.0370165613946507
1747351791399543,109989164,1,1182,1,136894358,109879584,27014774,0.0370167820023221
1747351791493729,110083804,1,1183,1,136988544,109974224,27014320,0.0370174041027129
1747351791591199,110178444,1,1184,1,137086014,110068864,27017150,0.0370135265932935
1747351791685522,110273084,1,1185,1,137180337,110163504,27016833,0.037013960888754
1747351791780058,110367724,1,1186,1,137274873,110258144,27016729,0.0370141033727658
1747351791873863,110462364,1,1187,1,137368678,110352784,27015894,0.0370152473947373
1747351791972105,110557004,1,1188,1,137466920,110447424,27019496,0.0370103128496549
1747351792066728,110651644,1,1189,1,137561543,110542064,27019479,0.0370103361356449
1747351792160818,110746284,1,1190,1,137655633,110636704,27018929,0.0370110895217201
1747351792255095,110840924,1,1191,1,137749910,110731344,27018566,0.037011586773332
1747351792352924,110935564,1,1192,1,137847739,110825984,27021755,0.0370072188131377
1747351792447831,111030204,1,1193,1,137942646,110920624,27022022,0.0370068531511076
1747351792541636,111124844,1,1194,1,138036451,111015264,27021187,0.0370079967249403
1747351792639030,111219484,1,1195,1,138133845,111109904,27023941,0.0370042252534521
1747351792734224,111314124,1,1196,1,138229039,111204544,27024495,0.0370034666697749
1747351792829076,111408764,1,1197,1,138323891,111299184,27024707,0.0370031763896644
1747351792923327,111503404,1,1198,1,138418142,111393824,27024318,0.0370037090297708
1747351793021608,111598044,1,1199,1,138516423,111488464,27027959,0.0369987241729943
1747351793115578,111692684,1,1200,1,138610393,111583104,27027289,0.0369996413624762
1747351793209706,111787324,1,1201,1,138704521,111677744,27026777,0.0370003422901665
1747351793307696,111881964,1,1202,1,138802511,111772384,27030127,0.036995756623711
1747351793401610,111976604,1,1203,1,138896425,111867024,27029401,0.0369967503164424
1747351793495500,112071244,1,1204,1,138990315,111961664,27028651,0.0369977769145785
1747351793590481,112165884,1,1205,1,139085296,112056304,27028992,0.036997310147563
1747351793688683,112260524,1,1206,1,139183498,112150944,27032554,0.0369924351210026
1747351793782663,112355164,1,1207,1,139277478,112245584,27031894,0.0369933383136231
1747351793877414,112449804,1,1208,1,139372229,112340224,27032005,0.036993186409961
1747351793971588,112544444,1,1209,1,139466403,112434864,27031539,0.0369938241400166
1747351794070052,112639084,1,1210,1,139564867,112529504,27035363,0.0369885915717129
1747351794163545,112733724,1,1211,1,139658360,112624144,27034216,0.0369901609131183
1747351794258122,112828364,1,1212,1,139752937,112718784,27034153,0.0369902471144555
1747351794356375,112923004,1,1213,1,139851190,112813424,27037766,0.0369853041852644
1747351794450790,113017644,1,1214,1,139945605,112908064,27037541,0.0369856119681889
1747351794545394,113112284,1,1215,1,140040209,113002704,27037505,0.0369856612139322
1747351794638643,113206924,1,1216,1,140133458,113097344,27036114,0.0369875641151683
1747351794736730,113301564,1,1217,1,140231545,113191984,27039561,0.0369828489449218
1747351794831746,113396204,1,1218,1,140326561,113286624,27039937,0.0369823346851732
1747351794925173,113490844,1,1219,1,140419988,113381264,27038724,0.0369839937713037
1747351795020277,113585484,1,1220,1,140515092,113475904,27039188,0.0369833591156657
1747351795118478,113680124,1,1221,1,140613293,113570544,27042749,0.0369784891321514
1747351795211987,113774764,1,1222,1,140706802,113665184,27041618,0.0369800357360273
1747351795306088,113869404,1,1223,1,140800903,113759824,27041079,0.0369807728456397
1747351795404655,113964052,1,1224,1,140899470,113854472,27044998,0.0369754140858135
1747351795499294,114058684,1,1225,1,140994109,113949104,27045005,0.0369754045155473
1747351795593413,114153324,1,1226,1,141088228,114043744,27044484,0.0369761168303303
1747351795687615,114247964,1,1227,1,141182430,114138384,27044046,0.0369767156881777
1747351795785747,114342604,1,1228,1,141280562,114233024,27047538,0.0369719417715579
1747351795880116,114437244,1,1229,1,141374931,114327664,27047267,0.0369723122118031
1747351795974355,114531884,1,1230,1,141469170,114422304,27046866,0.03697286036763
1747351796072664,114626524,1,1231,1,141567479,114516944,27050535,0.0369678455527774
1747351796166199,114721164,1,1232,1,141661014,114611584,27049430,0.0369693557313407
1747351796260823,114815804,1,1233,1,141755638,114706224,27049414,0.0369693775990858
1747351796355529,114910444,1,1234,1,141850344,114800864,27049480,0.0369692873948038
1747351796453656,115005084,1,1235,1,141948471,114895504,27052967,0.0369645222278207
1747351796547428,115099724,1,1236,1,142042243,114990144,27052099,0.0369657082801597
1747351796641459,115194364,1,1237,1,142136274,115084784,27051490,0.0369665404752196
1747351796736354,115289004,1,1238,1,142231169,115179424,27051745,0.0369661920146001
1747351796834223,115383644,1,1239,1,142329038,115274064,27054974,0.0369617801148136
1747351796928126,115478284,1,1240,1,142422941,115368704,27054237,0.0369627870118828
1747351797022744,115572924,1,1241,1,142517559,115463344,27054215,0.0369628170693549
1747351797120342,115667564,1,1242,1,142615157,115557984,27057173,0.03695877614413
1747351797214992,115762212,1,1243,1,142709807,115652632,27057175,0.0369587734122279
1747351797308993,115856844,1,1244,1,142803808,115747264,27056544,0.0369596353473673
1747351797403430,115951484,1,1245,1,142898245,115841904,27056341,0.0369599126504208
1747351797502144,116046124,1,1246,1,142996959,115936544,27060415,0.0369543482611039
1747351797595844,116140764,1,1247,1,143090659,116031184,27059475,0.036955631992121
1747351797689928,116235404,1,1248,1,143184743,116125824,27058919,0.0369563913473409
1747351797788865,116330044,1,1249,1,143283680,116220464,27063216,0.036950523544578
1747351797883044,116424684,1,1250,1,143377859,116315104,27062755,0.0369511529775885
1747351797976958,116519324,1,1251,1,143471773,116409744,27062029,0.0369521442756565
1747351798071747,116613964,1,1252,1,143566562,116504384,27062178,0.0369519408230926
1747351798169530,116708604,1,1253,1,143664345,116599024,27065321,0.0369476497249007
1747351798263573,116803244,1,1254,1,143758388,116693664,27064724,0.0369484647247834
1747351798357719,116897884,1,1255,1,143852534,116788304,27064230,0.0369491391404817
1747351798451725,116992524,1,1256,1,143946540,116882944,27063596,0.0369500047222106
1747351798550151,117087164,1,1257,1,144044966,116977584,27067382,0.0369448364086338
1747351798644867,117181804,1,1258,1,144139682,117072224,27067458,0.0369447326749338
1747351798738967,117276444,1,1259,1,144233782,117166864,27066918,0.0369454697428055
1747351798836969,117371084,1,1260,1,144331784,117261504,27070280,0.0369408812912167
1747351798931230,117465724,1,1261,1,144426045,117356144,27069901,0.0369413984927392
1747351799025918,117560364,1,1262,1,144520733,117450784,27069949,0.036941332988843
1747351799119516,117655004,1,1263,1,144614331,117545424,27068907,0.0369427550214716
1747351799217695,117749644,1,1264,1,144712510,117640064,27072446,0.0369379257419148
1747351799312030,117844284,1,1265,1,144806845,117734704,27072141,0.0369383418917624
1747351799406656,117938924,1,1266,1,144901471,117829344,27072127,0.0369383609939477
1747351799500157,118033564,1,1267,1,144994972,117923984,27070988,0.036939915159358
1747351799598515,118128204,1,1268,1,145093330,118018624,27074706,0.0369348424318993
1747351799693313,118222844,1,1269,1,145188128,118113264,27074864,0.0369346268923086
1747351799787387,118317484,1,1270,1,145282202,118207904,27074298,0.0369353990267817
1747351799886082,118412124,1,1271,1,145380897,118302544,27078353,0.0369298679280826
1747351799980091,118506764,1,1272,1,145474906,118397184,27077722,0.0369307285154932
1747351800074250,118601404,1,1273,1,145569065,118491824,27077241,0.0369313845528058
1747351800168023,118696044,1,1274,1,145662838,118586464,27076374,0.0369325671155229
1747351800266770,118790684,1,1275,1,145761585,118681104,27080481,0.0369269659575101
1747351800360479,118885324,1,1276,1,145855294,118775744,27079550,0.0369282355135148
1747351800454539,118979964,1,1277,1,145949354,118870384,27078970,0.0369290264733112
1747351800553313,119074604,1,1278,1,146048128,118965024,27083104,0.0369233895789788
1747351800647021,119169244,1,1279,1,146141836,119059664,27082172,0.0369246602525085
1747351800741772,119263884,1,1280,1,146236587,119154304,27082283,0.0369245089123394
1747351800836044,119358524,1,1281,1,146330859,119248944,27081915,0.0369250106574812
1747351800934088,119453164,1,1282,1,146428903,119343584,27085319,0.036920370035147
1747351801028366,119547804,1,1283,1,146523181,119438224,27084957,0.0369208634889101
1747351801122025,119642444,1,1284,1,146616840,119532864,27083976,0.0369222007876539
1747351801216115,119737084,1,1285,1,146710930,119627504,27083426,0.0369229505897813
1747351801315049,119831724,1,1286,1,146809864,119722144,27087720,0.0369170974891943
1747351801409150,119926364,1,1287,1,146903965,119816784,27087181,0.0369178320918666
1747351801503757,120021012,1,1288,1,146998572,119911432,27087140,0.0369178879719305
1747351801601222,120115644,1,1289,1,147096037,120006064,27089973,0.0369140271937517
1747351801695138,120210284,1,1290,1,147189953,120100704,27089249,0.0369150137753911
1747351801789745,120304924,1,1291,1,147284560,120195344,27089216,0.0369150587451478
1747351801884374,120399564,1,1292,1,147379189,120289984,27089205,0.0369150737350911
1747351801982773,120494204,1,1293,1,147477588,120384624,27092964,0.0369099519712941
1747351802080414,120591964,1,1294,1,147575229,120482384,27092845,0.0369101140910081
1747351802175086,120686612,1,1295,1,147669901,120577032,27092869,0.0369100813944805
1747351802272805,120784364,1,1296,1,147767620,120674784,27092836,0.0369101263522209
1747351802371596,120882124,1,1297,1,147866411,120772544,27093867,0.036908721815162
1747351802470503,120979884,1,1298,1,147965318,120870304,27095014,0.0369071593762601
1747351802564654,121074524,1,1299,1,148059469,120964944,27094525,0.0369078254739656
1747351802662845,121169164,1,1300,1,148157660,121059584,27098076,0.0369029889797342
1747351802756697,121263804,1,1301,1,148251512,121154224,27097288,0.0369040621334504
1747351802851316,121358444,1,1302,1,148346131,121248864,27097267,0.0369040907335784
1747351802949066,121453084,1,1303,1,148443881,121343504,27100377,0.0368998556735945
1747351803043790,121547724,1,1304,1,148538605,121438144,27100461,0.0368997412996037
1747351803138387,121642364,1,1305,1,148633202,121532784,27100418,0.0368997998481056
1747351803231523,121737004,1,1306,1,148726338,121627424,27098914,0.0369018478009856
1747351803330181,121831644,1,1307,1,148824996,121722064,27102932,0.0368963771152139
1747351803424582,121926284,1,1308,1,148919397,121816704,27102693,0.036896702478975
1747351803518547,122020924,1,1309,1,149013362,121911344,27102018,0.0368976214243529
1747351803613163,122115564,1,1310,1,149107978,122005984,27101994,0.0368976540988091
1747351803710525,122210204,1,1311,1,149205340,122100624,27104716,0.0368939486397865
1747351803804783,122304844,1,1312,1,149299598,122195264,27104334,0.0368944686115512
1747351803898969,122399484,1,1313,1,149393784,122289904,27103880,0.0368950866075263
1747351803997774,122494124,1,1314,1,149492589,122384544,27108045,0.0368894178831413
1747351804091712,122588764,1,1315,1,149586527,122479184,27107343,0.0368903732099453
1747351804186371,122683412,1,1316,1,149681186,122573832,27107354,0.0368903582400554
1747351804280527,122778044,1,1317,1,149775342,122668464,27106878,0.0368910060391314
1747351804378554,122872684,1,1318,1,149873369,122763104,27110265,0.0368863970898108
1747351804472570,122967324,1,1319,1,149967385,122857744,27109641,0.0368872461276783
1747351804566940,123061964,1,1320,1,150061755,122952384,27109371,0.0368876135119475
1747351804664893,123156604,1,1321,1,150159708,123047024,27112684,0.0368831060768458
1747351804760145,123251244,1,1322,1,150254960,123141664,27113296,0.0368822735531674
1747351804853651,123345884,1,1323,1,150348466,123236304,27112162,0.036883816200272
1747351804947445,123440524,1,1324,1,150442260,123330944,27111316,0.0368849671480351
1747351805046020,123535164,1,1325,1,150540835,123425584,27115251,0.0368796143542982
1747351805140172,123629804,1,1326,1,150634987,123520224,27114763,0.0368802780979498
1747351805234923,123724444,1,1327,1,150729738,123614864,27114874,0.0368801271213725
1747351805328488,123819084,1,1328,1,150823303,123709504,27113799,0.0368815893339033
1747351805427144,123913724,1,1329,1,150921959,123804144,27117815,0.0368761273723565
1747351805521746,124008364,1,1330,1,151016561,123898784,27117777,0.0368761790466821
1747351805615704,124103004,1,1331,1,151110519,123993424,27117095,0.0368771064894672
1747351805713912,124197644,1,1332,1,151208727,124088064,27120663,0.0368722549297559
1747351805807637,124292284,1,1333,1,151302452,124182704,27119748,0.0368734989720405
1747351805902545,124386924,1,1334,1,151397360,124277344,27120016,0.0368731345881211
1747351805996604,124481572,1,1335,1,151491419,124371992,27119427,0.036873935426438
1747351806095047,124576204,1,1336,1,151589862,124466624,27123238,0.0368687543869209
1747351806188506,124670844,1,1337,1,151683321,124561264,27122057,0.0368703597960877
1747351806282864,124765484,1,1338,1,151777679,124655904,27121775,0.0368707431574814
1747351806377113,124860124,1,1339,1,151871928,124750544,27121384,0.0368712747107596
1747351806475719,124954764,1,1340,1,151970534,124845184,27125350,0.0368658837581819
1747351806569897,125049404,1,1341,1,152064712,124939824,27124888,0.0368665116700205
1747351806664094,125144044,1,1342,1,152158909,125034464,27124445,0.0368671137787335
1747351806762061,125238684,1,1343,1,152256876,125129104,27127772,0.0368625923278918
1747351806855971,125333324,1,1344,1,152350786,125223744,27127042,0.0368635843156065
1747351806950665,125427964,1,1345,1,152445480,125318384,27127096,0.0368635109338647
1747351807045269,125522604,1,1346,1,152540084,125413024,27127060,0.0368635598549935
1747351807143098,125617244,1,1347,1,152637913,125507664,27130249,0.0368592267619806
1747351807237037,125711884,1,1348,1,152731852,125602304,27129548,0.03686017916701
1747351807331193,125806524,1,1349,1,152826008,125696944,27129064,0.0368608367763812
1747351807429763,125901164,1,1350,1,152924578,125791584,27132994,0.0368554977751441
1747351807523700,125995804,1,1351,1,153018515,125886224,27132291,0.0368564527042703
1747351807617925,126090444,1,1352,1,153112740,125980864,27131876,0.036857016448107
1747351807712123,126185084,1,1353,1,153206938,126075504,27131434,0.036857616888219
1747351807810667,126279724,1,1354,1,153305482,126170144,27135338,0.0368523141300101
1747351807904670,126374364,1,1355,1,153399485,126264784,27134701,0.0368531792555959
1747351807998870,126469004,1,1356,1,153493685,126359424,27134261,0.0368537768542876
1747351808093691,126563644,1,1357,1,153588506,126454064,27134442,0.0368535310215702
1747351808191896,126658284,1,1358,1,153686711,126548704,27138007,0.0368486897361328
1747351808285634,126752924,1,1359,1,153780449,126643344,27137105,0.0368499145358357
1747351808380053,126847564,1,1360,1,153874868,126737984,27136884,0.0368502146377601
1747351808477786,126942204,1,1361,1,153972601,126832624,27139977,0.0368460150132035
1747351808572976,127036844,1,1362,1,154067791,126927264,27140527,0.036845268332483
1747351808666836,127131484,1,1363,1,154161651,127021904,27139747,0.0368463272704789
1747351808760799,127226124,1,1364,1,154255614,127116544,27139070,0.0368472464236983
1747351808859460,127320764,1,1365,1,154354275,127211184,27143091,0.03684178784207
1747351808953020,127415404,1,1366,1,154447835,127305824,27142011,0.0368432538031172
1747351809048033,127510044,1,1367,1,154542848,127400464,27142384,0.0368427474904194
1747351809145750,127604684,1,1368,1,154640565,127495104,27145461,0.0368385712808487
1747351809240001,127699324,1,1369,1,154734816,127589744,27145072,0.0368390991926637
1747351809334099,127793964,1,1370,1,154828914,127684384,27144530,0.0368398347659731
1747351809428268,127888604,1,1371,1,154923083,127779024,27144059,0.0368404740057483
1747351809526277,127983244,1,1372,1,155021092,127873664,27147428,0.0368359020972447
1747351809620930,128077884,1,1373,1,155115745,127968304,27147441,0.0368358844577652
1747351809715216,128172524,1,1374,1,155210031,128062944,27147087,0.0368363648003927
1747351809809692,128267164,1,1375,1,155304507,128157584,27146923,0.0368365873362517
1747351809907695,128361804,1,1376,1,155402510,128252224,27150286,0.0368320245318962
1747351810001760,128456444,1,1377,1,155496575,128346864,27149711,0.0368328045922846
1747351810095983,128551084,1,1378,1,155590798,128441504,27149294,0.0368333703263149
1747351810194637,128645724,1,1379,1,155689452,128536144,27153308,0.0368279253489114
1747351810289040,128740372,1,1380,1,155783855,128630792,27153063,0.0368282576444506
1747351810382595,128835004,1,1381,1,155877410,128725424,27151986,0.0368297184596368
1747351810477509,128929644,1,1382,1,155972324,128820064,27152260,0.0368293468020709
1747351810575701,129024284,1,1383,1,156070516,128914704,27155812,0.036824529496669
1747351810669206,129118924,1,1384,1,156164021,129009344,27154677,0.0368260686731792
1747351810764168,129213564,1,1385,1,156258983,129103984,27154999,0.0368256319950518
1747351810857834,129308204,1,1386,1,156352649,129198624,27154025,0.0368269529102959
1747351810955971,129402844,1,1387,1,156450786,129293264,27157522,0.0368222108040637
1747351811050347,129497484,1,1388,1,156545162,129387904,27157258,0.0368225687585985
1747351811144538,129592124,1,1389,1,156639353,129482544,27156809,0.0368231775684691
1747351811242591,129686764,1,1390,1,156737406,129577184,27160222,0.0368185503049275
1747351811337618,129781404,1,1391,1,156832433,129671824,27160609,0.0368180256930174
1747351811430907,129876044,1,1392,1,156925722,129766464,27159258,0.0368198571551549
1747351811525555,129970684,1,1393,1,157020370,129861104,27159266,0.0368198463095431
1747351811624005,130065324,1,1394,1,157118820,129955744,27163076,0.0368146818129139
1747351811717829,130159964,1,1395,1,157212644,130050384,27162260,0.0368157877879086
1747351811812359,130254604,1,1396,1,157307174,130145024,27162150,0.0368159368827578
1747351811910279,130349244,1,1397,1,157405094,130239664,27165430,0.0368114916642217
1747351812004513,130443884,1,1398,1,157499328,130334304,27165024,0.0368120418373272
1747351812099338,130538532,1,1399,1,157594153,130428952,27165201,0.036811801981513
1747351812193287,130633164,1,1400,1,157688102,130523584,27164518,0.0368127275440705
1747351812290989,130727804,1,1401,1,157785804,130618224,27167580,0.0368085784600615
1747351812385257,130822444,1,1402,1,157880072,130712864,27167208,0.0368090824791417
1747351812479726,130917084,1,1403,1,157974541,130807504,27167037,0.0368093141699626
1747351812573804,131011724,1,1404,1,158068619,130902144,27166475,0.0368100756539079
1747351812671820,131106364,1,1405,1,158166635,130996784,27169851,0.0368055018041872
1747351812766453,131201004,1,1406,1,158261268,131091424,27169844,0.0368055112867044
1747351812861240,131295644,1,1407,1,158356055,131186064,27169991,0.0368053121548696
1747351812958662,131390284,1,1408,1,158453477,131280704,27172773,0.0368015439572545
1747351813053137,131484924,1,1409,1,158547952,131375344,27172608,0.0368017674269617
1747351813147155,131579564,1,1410,1,158641970,131469984,27171986,0.036802609864439
1747351813241782,131674204,1,1411,1,158736597,131564624,27171973,0.0368026274720646
1747351813339983,131768844,1,1412,1,158834798,131659264,27175534,0.0367978049667763
1747351813434597,131863484,1,1413,1,158929412,131753904,27175508,0.0367978401728497
1747351813528294,131958124,1,1414,1,159023109,131848544,27174565,0.0367991171155821
1747351813626310,132052764,1,1415,1,159121125,131943184,27177941,0.0367945459886015
1747351813720806,132147404,1,1416,1,159215621,132037824,27177797,0.0367947409423949
1747351813814720,132242044,1,1417,1,159309535,132132464,27177071,0.0367957238659015
1747351813909259,132336684,1,1418,1,159404074,132227104,27176970,0.0367958606128644
1747351814007430,132431324,1,1419,1,159502245,132321744,27180501,0.0367910804881779
1747351814101508,132525964,1,1420,1,159596323,132416384,27179939,0.0367918412178923
1747351814195380,132620604,1,1421,1,159690195,132511024,27179171,0.0367928808424657
1747351814290284,132715244,1,1422,1,159785099,132605664,27179435,0.0367925234648917
1747351814388704,132809884,1,1423,1,159883519,132700304,27183215,0.0367874072290566
1747351814483142,132904524,1,1424,1,159977957,132794944,27183013,0.0367876806003808
1747351814576566,132999164,1,1425,1,160071381,132889584,27181797,0.0367893263274683
1747351814675306,133093804,1,1426,1,160170121,132984224,27185897,0.0367837780007773
1747351814769379,133188444,1,1427,1,160264194,133078864,27185330,0.0367845451940439
1747351814863913,133283084,1,1428,1,160358728,133173504,27185224,0.0367846886234963
1747351814954028,133377724,1,1429,1,160448843,133268144,27180699,0.0367908124805767
1747351815056112,133472364,1,1430,1,160550927,133362784,27188143,0.0367807393097792
1747351815149956,133567004,1,1431,1,160644771,133457424,27187347,0.0367818161882437
1747351815243910,133661644,1,1432,1,160738725,133552064,27186661,0.0367827443024356
1747351815343277,133756284,1,1433,1,160838092,133646704,27191388,0.0367763499237332
1747351815437040,133850924,1,1434,1,160931855,133741344,27190511,0.0367775361044152
1747351815531385,133945564,1,1435,1,161026200,133835984,27190216,0.0367779351219571
1747351815625567,134040204,1,1436,1,161120382,133930624,27189758,0.0367785546307547
1747351815723151,134134844,1,1437,1,161217966,134025264,27192702,0.0367745728247233
1747351815817429,134229484,1,1438,1,161312244,134119904,27192340,0.0367750623888933
1747351815911949,134324124,1,1439,1,161406764,134214544,27192220,0.0367752246782351
1747351816006446,134418764,1,1440,1,161501261,134309184,27192077,0.0367754180749046
1747351816104555,134513404,1,1441,1,161599370,134403824,27195546,0.0367707270889137
1747351816198468,134608044,1,1442,1,161693283,134498464,27194819,0.0367717100819829
1747351816292914,134702684,1,1443,1,161787729,134593104,27194625,0.0367719724026347
1747351816390967,134797332,1,1444,1,161885782,134687752,27198030,0.0367673688131088
1747351816485659,134891964,1,1445,1,161980474,134782384,27198090,0.0367672877029232
1747351816579175,134986604,1,1446,1,162073990,134877024,27196966,0.0367688072265119
1747351816673894,135081244,1,1447,1,162168709,134971664,27197045,0.0367687004231525
1747351816771974,135175884,1,1448,1,162266789,135066304,27200485,0.0367640503468963
1747351816866763,135270524,1,1449,1,162361578,135160944,27200634,0.0367638489602852
1747351816960200,135365164,1,1450,1,162455015,135255584,27199431,0.0367654749836494
1747351817055256,135459804,1,1451,1,162550071,135350224,27199847,0.0367649126849867
1747351817153035,135554444,1,1452,1,162647850,135444864,27202986,0.0367606703175894
1747351817247320,135649084,1,1453,1,162742135,135539504,27202631,0.0367611500519931
1747351817341933,135743724,1,1454,1,162836748,135634144,27202604,0.0367611865393474
1747351817439706,135838364,1,1455,1,162934521,135728784,27205737,0.0367569531382296
1747351817533878,135933004,1,1456,1,163028693,135823424,27205269,0.0367575854515535
1747351817628389,136027644,1,1457,1,163123204,135918064,27205140,0.0367577597468713
1747351817722548,136122284,1,1458,1,163217363,136012704,27204659,0.0367584096532876
1747351817820935,136216924,1,1459,1,163315750,136107344,27208406,0.0367533474765114
1747351817914632,136311564,1,1460,1,163409447,136201984,27207463,0.0367546213331246
1747351818009397,136406204,1,1461,1,163504212,136296624,27207588,0.0367544524711268
1747351818107403,136500844,1,1462,1,163602218,136391264,27210954,0.0367499059386157
1747351818201476,136595492,1,1463,1,163696291,136485912,27210379,0.0367506825244881
1747351818295879,136690124,1,1464,1,163790694,136580544,27210150,0.0367509918173916
1747351818389774,136784764,1,1465,1,163884589,136675184,27209405,0.0367519980683149
1747351818488523,136879404,1,1466,1,163983338,136769824,27213514,0.0367464488415571
1747351818582598,136974044,1,1467,1,164077413,136864464,27212949,0.0367472117777459
1747351818676432,137068684,1,1468,1,164171247,136959104,27212143,0.0367483001981872
1747351818770343,137163324,1,1469,1,164265158,137053744,27211414,0.036749284693548
1747351818869321,137257964,1,1470,1,164364136,137148384,27215752,0.036743427115297
1747351818962877,137352604,1,1471,1,164457692,137243024,27214668,0.0367448906596986
1747351819057200,137447244,1,1472,1,164552015,137337664,27214351,0.0367453186739599
1747351819155545,137541884,1,1473,1,164650360,137432304,27218056,0.0367403167955859
1747351819249533,137636524,1,1474,1,164744348,137526944,27217404,0.0367411969194416
1747351819343945,137731164,1,1475,1,164838760,137621584,27217176,0.0367415047027656
1747351819438836,137825804,1,1476,1,164933651,137716224,27217427,0.0367411658714102
1747351819536454,137920444,1,1477,1,165031269,137810864,27220405,0.0367371462694989
1747351819630536,138015084,1,1478,1,165125351,137905504,27219847,0.0367378993717341
1747351819725219,138109724,1,1479,1,165220034,138000144,27219890,0.036737841335876
1747351819823492,138204364,1,1480,1,165318307,138094784,27223523,0.0367329386428053
1747351819917738,138299004,1,1481,1,165412553,138189424,27223129,0.0367334702781594
1747351820011515,138393644,1,1482,1,165506330,138284064,27222266,0.0367346348022607
1747351820106372,138488284,1,1483,1,165601187,138378704,27222483,0.0367343419775484
1747351820204213,138582924,1,1484,1,165699028,138473344,27225684,0.0367300230179708
1747351820298951,138677564,1,1485,1,165793766,138567984,27225782,0.0367298908071768
1747351820392515,138772204,1,1486,1,165887330,138662624,27224706,0.0367313424798783
1747351820486620,138866844,1,1487,1,165981435,138757264,27224171,0.0367320643115266
1747351820585063,138961484,1,1488,1,166079878,138851904,27227974,0.0367269338511929
1747351820681320,139056124,1,1489,1,166176135,138946544,27229591,0.0367247528616937
1747351820773313,139150764,1,1490,1,166268128,139041184,27226944,0.0367283232374518
1747351820871726,139245404,1,1491,1,166366541,139135824,27230717,0.0367232342798759
1747351820966114,139340044,1,1492,1,166460929,139230464,27230465,0.0367235741291968
1747351821060291,139434684,1,1493,1,166555106,139325104,27230002,0.0367241985512891
1747351821154798,139529324,1,1494,1,166649613,139419744,27229869,0.0367243779248442
1747351821253038,139623964,1,1495,1,166747853,139514384,27233469,0.0367195233188985
1747351821346619,139718604,1,1496,1,166841434,139609024,27232410,0.0367209512488979
1747351821441768,139813244,1,1497,1,166936583,139703664,27232919,0.0367202649117415
1747351821535283,139907884,1,1498,1,167030098,139798304,27231794,0.0367217818994958
1747351821634065,140002524,1,1499,1,167128880,139892944,27235936,0.0367161973063822
1747351821728048,140097164,1,1500,1,167222863,139987584,27235279,0.0367170830157458
1747352159869185,109580,1,1,25,0,0,0,0.0
1747352159959450,197404,1,2,25,90265,87824,2441,10241.704219582138
1747352160049394,285804,1,3,25,180209,176224,3985,6273.525721455459
1747352160135529,374204,1,4,25,266344,264624,1720,14534.883720930233
1747352160224771,462604,1,5,25,355586,353024,2562,9758.001561280247
1747352160315031,551004,1,6,25,445846,441424,4422,5653.550429669833
1747352160405537,639404,1,7,25,536352,529824,6528,3829.656862745098
1747352160491708,727804,1,8,25,622523,618224,4299,5815.305885089556
1747352160582034,816204,1,9,25,712849,706624,6225,4016.064257028113
1747352160671262,904604,1,10,25,802077,795024,7053,3544.590954203885
1747352160761497,994044,1,11,25,892312,884464,7848,3185.5249745158
1747352160852230,1083484,1,12,25,983045,973904,9141,2734.930532764468
1747352160946432,1173964,1,13,25,1077247,1064384,12863,1943.559045323797
1747352161036094,1264444,1,14,25,1166909,1154864,12045,2075.5500207555
1747352161125869,1354924,1,15,25,1256684,1245344,11340,2204.5855379188715
1747352161220810,1445404,1,16,25,1351625,1335824,15801,1582.1783431428391
1747352161310573,1535884,1,17,25,1441388,1426304,15084,1657.3853089366216
1747352161400703,1626364,1,18,25,1531518,1516784,14734,1696.755802904846
1747352161494525,1716844,1,19,25,1625340,1607264,18076,1383.0493472007083
1747352161580411,1807324,1,20,25,1711226,1697744,13482,1854.3242842308264
1747352161674747,1897804,1,21,25,1805562,1788224,17338,1441.9194832160572
1747352161765618,1988284,1,22,25,1896433,1878704,17729,1410.1190140447852
1747352161855245,2078764,1,23,25,1986060,1969184,16876,1481.3936951884334
1747352161945253,2169244,1,24,25,2076068,2059664,16404,1524.01853206535
1747352162039564,2259724,1,25,25,2170379,2150144,20235,1235.4830738818878
1747352162129624,2350204,1,26,25,2260439,2240624,19815,1261.6704516780217
1747352162219985,2440684,1,27,25,2350800,2331104,19696,1269.293257514216
1747352162310461,2531164,1,28,25,2441276,2421584,19692,1269.5510867357302
1747352162404117,2621644,1,29,25,2534932,2512064,22868,1093.2307154101802
1747352162494883,2712124,1,30,25,2625698,2602544,23154,1079.7270450030232
1747352162588018,2802604,1,31,25,2718833,2693024,25809,968.6543453833934
1747352162674957,2893084,1,32,25,2805772,2783504,22268,1122.6872642356743
1747352162769006,2983564,1,33,25,2899821,2873984,25837,967.60459805705
1747352162859143,3074044,1,34,25,2989958,2964464,25494,980.622891660783
1747352162949590,3164524,1,35,25,3080405,3054944,25461,981.8938769097836
1747352163039130,3255004,1,36,25,3169945,3145424,24521,1019.534276742384
1747352163133158,3345484,1,37,25,3263973,3235904,28069,890.6622964836653
1747352163223496,3435964,1,38,25,3354311,3326384,27927,895.1910337666058
1747352163313093,3526444,1,39,25,3443908,3416864,27044,924.419464576246
1747352163403929,3616924,1,40,25,3534744,3507344,27400,912.4087591240876
1747352163498283,3707404,1,41,25,3629098,3597824,31274,799.3860714970901
1747352163588157,3797884,1,42,25,3718972,3688304,30668,815.1819486109299
1747352163678469,3888364,1,43,25,3809284,3778784,30500,819.672131147541
1747352163768757,3978844,1,44,25,3899572,3869264,30308,824.8647221855615
1747352163864068,4069324,1,45,25,3994883,3959744,35139,711.4602009163608
1747352163952506,4159804,1,46,25,4083321,4050224,33097,755.3554702843157
1747352164046231,4250284,1,47,25,4177046,4140704,36342,687.909306037092
1747352164132393,4340772,1,48,25,4263208,4231192,32016,780.8595702148925
1747352164227135,4431244,1,49,25,4357950,4321664,36286,688.9709529846222
1747352164317068,4521724,1,50,25,4447883,4412144,35739,699.5159349729987
1747352164407083,4612204,1,51,25,4537898,4502624,35274,708.7373136020865
1747352164497144,4702684,1,52,25,4627959,4593104,34855,717.2572084349448
1747352164591685,4793164,1,53,25,4722500,4683584,38916,642.4092918079967
1747352164681016,4883644,1,54,25,4811831,4774064,37767,661.9535573384171
1747352164771300,4974124,1,55,25,4902115,4864544,37571,665.4068297357004
1747352164866026,5064604,1,56,25,4996841,4955024,41817,597.8429825190711
1747352164956001,5155084,1,57,25,5086816,5045504,41312,605.151045701007
1747352165045919,5245564,1,58,25,5176734,5135984,40750,613.4969325153374
1747352165136084,5336044,1,59,25,5266899,5226464,40435,618.2762458266353
1747352165226271,5426524,1,60,25,5357086,5316944,40142,622.7890986996164
1747352165320737,5517004,1,61,25,5451552,5407424,44128,566.5337200870196
1747352165410137,5607484,1,62,25,5540952,5497904,43048,580.7470730347519
1747352165500174,5697964,1,63,25,5630989,5588384,42605,586.7855885459453
1747352165590521,5788444,1,64,25,5721336,5678864,42472,588.6230928611791
1747352165684638,5878924,1,65,25,5815453,5769344,46109,542.1934980155718
1747352165774785,5969404,1,66,25,5905600,5859824,45776,546.1377140859839
1747352165865196,6059884,1,67,25,5996011,5950304,45707,546.9621720961778
1747352165955448,6150364,1,68,25,6086263,6040784,45479,549.7042591085996
1747352166049522,6240844,1,69,25,6180337,6131264,49073,509.44511238359183
1747352166139237,6331324,1,70,25,6270052,6221744,48308,517.5126273081064
1747352166229326,6421804,1,71,25,6360141,6312224,47917,521.735500970428
1747352166319307,6512284,1,72,25,6450122,6402704,47418,527.2259479522544
1747352166414211,6602772,1,73,25,6545026,6493192,51834,482.30890921017095
1747352166503840,6693244,1,74,25,6634655,6583664,50991,490.2825988900002
1747352166594329,6783724,1,75,25,6725144,6674144,51000,490.1960784313726
1747352166687746,6874204,1,76,25,6818561,6764624,53937,463.5037172998128
1747352166778110,6964684,1,77,25,6908925,6855104,53821,464.5027034057338
1747352166868732,7055164,1,78,25,6999547,6945584,53963,463.2803958267703
1747352166962581,7145644,1,79,25,7093396,7036064,57332,436.0566524802902
1747352167052784,7236124,1,80,25,7183599,7126544,57055,438.1736920515292
1747352167142670,7326604,1,81,25,7273485,7217024,56461,442.7835142841962
1747352167232547,7417084,1,82,25,7363362,7307504,55858,447.563464499266
1747352167327048,7507564,1,83,25,7457863,7397984,59879,417.5086424288983
1747352167417548,7598044,1,84,25,7548363,7488464,59899,417.3692382176664
1747352167507311,7688524,1,85,25,7638126,7578944,59182,422.4257375553378
1747352167601007,7779004,1,86,25,7731822,7669424,62398,400.65386711112535
1747352167687725,7869484,1,87,25,7818540,7759904,58636,426.3592332355549
1747352167782218,7959964,1,88,25,7913033,7850384,62649,399.0486679755463
1747352167876122,8050444,1,89,25,8006937,7940864,66073,378.36937932287015
1747352167966403,8140924,1,90,25,8097218,8031344,65874,379.51240246531256
1747352168055805,8231404,1,91,25,8186620,8121824,64796,385.8262855731835
1747352168146035,8321884,1,92,25,8276850,8212304,64546,387.3206705295448
1747352168236035,8412364,1,93,25,8366850,8302784,64066,390.2225829613212
1747352168326224,8502844,1,94,25,8457039,8393264,63775,392.0031360250882
1747352168416638,8593324,1,95,25,8547453,8483744,63709,392.40923574377246
1747352168511084,8683804,1,96,25,8641899,8574224,67675,369.4126339120798
1747352168600999,8774284,1,97,25,8731814,8664704,67110,372.52272388615705
1747352168695138,8864764,1,98,25,8825953,8755184,70769,353.26202150659185
1747352168784813,8955244,1,99,25,8915628,8845664,69964,357.3266251214911
1747352168875339,9045724,1,100,25,9006154,8936144,70010,357.09184402228254
1747352168969632,9137244,1,101,25,9100447,9027664,72783,343.4868032370196
1747352169059668,9228764,1,102,25,9190483,9119184,71299,350.63605380159606
1747352169150124,9320284,1,103,25,9280939,9210704,70235,355.9478892290168
1747352169244021,9411804,1,104,25,9374836,9302224,72612,344.29570869828683
1747352169333979,9503324,1,105,25,9464794,9393744,71050,351.8648838845883
1747352169428187,9594844,1,106,25,9559002,9485264,73738,339.0382163877512
1747352169518600,9686364,1,107,25,9649415,9576784,72631,344.20564221888725
1747352169612645,9777884,1,108,25,9743460,9668304,75156,332.6414391399223
1747352169703085,9869404,1,109,25,9833900,9759824,74076,337.49122522814406
1747352169797061,9960924,1,110,25,9927876,9851344,76532,326.6607432185229
1747352169891190,10052444,1,111,25,10022005,9942864,79141,315.8918891598539
1747352169981037,10145004,1,112,25,10111852,10035424,76428,327.10524938504216
1747352170075531,10237564,1,113,25,10206346,10127984,78362,319.0321839667185
1747352170169654,10330132,1,114,25,10300469,10220552,79917,312.82455547630667
1747352170263315,10422684,1,115,25,10394130,10313104,81026,308.54293683509
1747352170358148,10515244,1,116,25,10488963,10405664,83299,300.123650944189
1747352170447992,10607804,1,117,25,10578807,10498224,80583,310.2391323231947
1747352170542305,10700364,1,118,25,10673120,10590784,82336,303.6338904003109
1747352170636314,10792924,1,119,25,10767129,10683344,83785,298.38276541146985
1747352170730397,10885484,1,120,25,10861212,10775904,85308,293.0557509260562
1747352170820505,10978044,1,121,25,10951320,10868464,82856,301.7282997006855
1747352170915547,11070604,1,122,25,11046362,10961024,85338,292.9527291476247
1747352171009263,11163164,1,123,25,11140078,11053584,86494,289.03738987675445
1747352171103755,11255724,1,124,25,11234570,11146144,88426,282.72227625359056
1747352171197652,11348284,1,125,25,11328467,11238704,89763,278.5111905796375
1747352171287716,11440844,1,126,25,11418531,11331264,87267,286.4771333952124
1747352171386434,11533404,1,127,25,11517249,11423824,93425,267.5943270002676
1747352171480358,11625964,1,128,25,11611173,11516384,94789,263.743683338784
1747352171566576,11718524,1,129,25,11697391,11608944,88447,282.655149411512
1747352171663923,11811084,1,130,25,11794738,11701504,93234,268.1425231138855
1747352171754243,11903644,1,131,25,11885058,11794064,90994,274.7433896740444
1747352171848945,11996204,1,132,25,11979760,11886624,93136,268.4246693008074
1747352171942721,12088764,1,133,25,12073536,11979184,94352,264.9652365609632
1747352172033114,12181324,1,134,25,12163929,12071744,92185,271.1937950859684
1747352172127712,12273884,1,135,25,12258527,12164304,94223,265.3279984717107
1747352172221931,12366444,1,136,25,12352746,12256864,95882,260.7371560876911
1747352172315984,12459004,1,137,25,12446799,12349424,97375,256.73940949935815
1747352172405990,12551564,1,138,25,12536805,12441984,94821,263.654675652018
1747352172500707,12644124,1,139,25,12631522,12534544,96978,257.79042669471426
1747352172594065,12736684,1,140,25,12724880,12627104,97776,255.6864670266732
1747352172688518,12829244,1,141,25,12819333,12719664,99669,250.83024812128147
1747352172778681,12921804,1,142,25,12909496,12812224,97272,257.0112673739617
1747352172873207,13014364,1,143,25,13004022,12904784,99238,251.91962756202255
1747352172967299,13106924,1,144,25,13098114,12997344,100770,248.0897092388608
1747352173060942,13199484,1,145,25,13191757,13089904,101853,245.45177854358727
1747352173155401,13292044,1,146,25,13286216,13182464,103752,240.9592104248593
1747352173245306,13384604,1,147,25,13376121,13275024,101097,247.28725877127903
1747352173339320,13477164,1,148,25,13470135,13367584,102551,243.78114304102348
1747352173434309,13569724,1,149,25,13565124,13460144,104980,238.14059820918268
1747352173527765,13662284,1,150,25,13658580,13552704,105876,236.1252786278288
1747352173618266,13754844,1,151,25,13749081,13645264,103817,240.80834545402004
1747352173712270,13847404,1,152,25,13843085,13737824,105261,237.50486884981143
1747352173806429,13939964,1,153,25,13937244,13830384,106860,233.9509638779712
1747352173901205,14032524,1,154,25,14032020,13922944,109076,229.19799039202024
1747352173991348,14125092,1,155,25,14122163,14015512,106651,234.40942888486748
1747352174085618,14217644,1,156,25,14216433,14108064,108369,230.6932794433833
1747352174179118,14310204,1,157,25,14309933,14200624,109309,228.7094383811031
1747352174273587,14402764,1,158,25,14404402,14293184,111218,224.78375802478016
1747352174363630,14495324,1,159,25,14494445,14385744,108701,229.9886845567198
1747352174457420,14587884,1,160,25,14588235,14478304,109931,227.41537873757176
1747352174552075,14680444,1,161,25,14682890,14570864,112026,223.16248013853928
1747352174645967,14773004,1,162,25,14776782,14663424,113358,220.5402353605392
1747352174740561,14865564,1,163,25,14871376,14755984,115392,216.65280088740988
1747352174830645,14958124,1,164,25,14961460,14848544,112916,221.4035212016012
1747352174924559,15050684,1,165,25,15055374,14941104,114270,218.78008226131087
1747352175018564,15143244,1,166,25,15149379,15033664,115715,216.04804908611675
1747352175113070,15235804,1,167,25,15243885,15126224,117661,212.47482173362457
1747352175203240,15328364,1,168,25,15334055,15218784,115271,216.88022139133
1747352175297623,15420924,1,169,25,15428438,15311344,117094,213.50368080345703
1747352175391624,15513484,1,170,25,15522439,15403904,118535,210.9081705825284
1747352175485636,15606044,1,171,25,15616451,15496464,119987,208.35590522306583
1747352175580101,15698604,1,172,25,15710916,15589024,121892,205.09959636399435
1747352175670269,15791164,1,173,25,15801084,15681584,119500,209.2050209205021
1747352175764679,15883724,1,174,25,15895494,15774144,121350,206.01565718994644
1747352175858140,15976284,1,175,25,15988955,15866704,122251,204.4973047255237
1747352175948149,16068844,1,176,25,16078964,15959264,119700,208.85547201336675
1747352176042485,16161404,1,177,25,16173300,16051824,121476,205.8019691132405
1747352176137384,16253972,1,178,25,16268199,16144392,123807,201.9271931312446
1747352176231492,16346524,1,179,25,16362307,16236944,125363,199.4208817593708
1747352176324927,16439084,1,180,25,16455742,16329504,126238,198.03862545350847
1747352176419508,16531644,1,181,25,16550323,16422064,128259,194.91809541630604
1747352176509666,16624204,1,182,25,16640481,16514624,125857,198.63813693318608
1747352176603752,16716764,1,183,25,16734567,16607184,127383,196.25852743301695
1747352176698156,16809324,1,184,25,16828971,16699744,129227,193.4580234780657
1747352176792715,16901884,1,185,25,16923530,16792304,131226,190.5110267782299
1747352176882114,16994444,1,186,25,17012929,16884864,128065,195.2133682114551
1747352176976683,17087004,1,187,25,17107498,16977424,130074,192.1982871288651
1747352177070482,17179564,1,188,25,17201297,17069984,131313,190.38480576942115
1747352177160759,17272124,1,189,25,17291574,17162544,129030,193.75339068433695
1747352177255529,17364684,1,190,25,17386344,17255104,131240,190.4907040536422
1747352177349077,17457244,1,191,25,17479892,17347664,132228,189.06736848473847
1747352177443686,17549804,1,192,25,17574501,17440224,134277,186.18229480849288
1747352177533552,17642364,1,193,25,17664367,17532784,131583,189.99414818023604
1747352177627339,17734924,1,194,25,17758154,17625344,132810,188.23883743694
1747352177722457,17827484,1,195,25,17853272,17717904,135368,184.6817563973761
1747352177816020,17920044,1,196,25,17946835,17810464,136371,183.32343386790447
1747352177910190,18012604,1,197,25,18041005,17903024,137981,181.18436596342977
1747352178000754,18105164,1,198,25,18131569,17995584,135985,183.8438063021657
1747352178094075,18197724,1,199,25,18224890,18088144,136746,182.82070407909555
1747352178189100,18290284,1,200,25,18319915,18180704,139211,179.58350992378476
1747352178282750,18382844,1,201,25,18413565,18273264,140301,178.1883236755262
1747352178372870,18475404,1,202,25,18503685,18365824,137861,181.34207643931205
1747352178467446,18567964,1,203,25,18598261,18458384,139877,178.72845428483595
1747352178561822,18660524,1,204,25,18692637,18550944,141693,176.43779156345053
1747352178655838,18753084,1,205,25,18786653,18643504,143149,174.6432039343621
1747352178745840,18845644,1,206,25,18876655,18736064,140591,177.82077088860598
1747352178840012,18938204,1,207,25,18970827,18828624,142203,175.8050111460377
1747352178934781,19030764,1,208,25,19065596,18921184,144412,173.11580755061905
1747352179029021,19123324,1,209,25,19159836,19013744,146092,171.12504449251156
1747352179119158,19215884,1,210,25,19249973,19106304,143669,174.01109494741385
1747352179216621,19308444,1,211,25,19347436,19198864,148572,168.26858358237084
1747352179307241,19401004,1,212,25,19438056,19291424,146632,170.49484423591028
1747352179401363,19493564,1,213,25,19532178,19383984,148194,168.6977880346033
1747352179495808,19586124,1,214,25,19626623,19476544,150079,166.57893509418375
1747352179585709,19678684,1,215,25,19716524,19569104,147420,169.58350291683627
1747352179679816,19771244,1,216,25,19810631,19661664,148967,167.82240361959362
1747352179773636,19863804,1,217,25,19904451,19754224,150227,166.41482556397983
1747352179868077,19956364,1,218,25,19998892,19846784,152108,164.35690430483604
1747352179958876,20048932,1,219,25,20089691,19939352,150339,166.2908493471421
1747352180052694,20141484,1,220,25,20183509,20031904,151605,164.9022129876983
1747352180146740,20234044,1,221,25,20277555,20124464,153091,163.30156573541225
1747352180240352,20326604,1,222,25,20371167,20217024,154143,162.18706006759956
1747352180331659,20419164,1,223,25,20462474,20309584,152890,163.51625351559946
1747352180425508,20511724,1,224,25,20556323,20402144,154179,162.149190226944
1747352180519627,20604284,1,225,25,20650442,20494704,155738,160.52601163492534
1747352180613502,20696844,1,226,25,20744317,20587264,157053,159.18193221396598
1747352180703598,20789404,1,227,25,20834413,20679824,154589,161.71913913667854
1747352180797623,20881964,1,228,25,20928438,20772384,156054,160.20095607930588
1747352180892332,20974524,1,229,25,21023147,20864944,158203,158.02481621713872
1747352180986683,21067084,1,230,25,21117498,20957504,159994,156.2558595947348
1747352181080341,21159644,1,231,25,21211156,21050064,161092,155.1908226355126
1747352181171161,21252204,1,232,25,21301976,21142624,159352,156.8853858125408
1747352181265234,21344764,1,233,25,21396049,21235184,160865,155.40981568395858
1747352181358638,21437324,1,234,25,21489453,21327744,161709,154.59869271345443
1747352181453643,21529884,1,235,25,21584458,21420304,164154,152.29601471788686
1747352181543836,21622444,1,236,25,21674651,21512864,161787,154.52415830690973
1747352181637555,21715004,1,237,25,21768370,21605424,162946,153.4250610631743
1747352181732176,21807564,1,238,25,21862991,21697984,165007,151.5087238723206
1747352181825532,21900124,1,239,25,21956347,21790544,165803,150.78134895026025
1747352181916464,21992684,1,240,25,22047279,21883104,164175,152.27653418608193
1747352182013928,22085244,1,241,25,22144743,21975664,169079,147.85987615256772
1747352182104479,22177812,1,242,25,22235294,22068232,167062,149.64504196046977
1747352182198921,22270364,1,243,25,22329736,22160784,168952,147.9710213551778
1747352182292360,22362924,1,244,25,22423175,22253344,169831,147.205162779469
1747352182382672,22455484,1,245,25,22513487,22345904,167583,149.1798094078755
1747352182477537,22548044,1,246,25,22608352,22438464,169888,147.15577321529477
1747352182571846,22640604,1,247,25,22702661,22531024,171637,145.6562396219929
1747352182665367,22733164,1,248,25,22796182,22623584,172598,144.84524733774435
1747352182756162,22825724,1,249,25,22886977,22716144,170833,146.34174895951014
1747352182849388,22918284,1,250,25,22980203,22808704,171499,145.77344474311803
1747352182943914,23010844,1,251,25,23074729,22901264,173465,144.12129247975096
1747352183037895,23103404,1,252,25,23168710,22993824,174886,142.9502647438903
1747352183128585,23195964,1,253,25,23259400,23086384,173016,144.49530679243537
1747352183222600,23288524,1,254,25,23353415,23178944,174471,143.29028893053862
1747352183316439,23381084,1,255,25,23447254,23271504,175750,142.2475106685633
1747352183410639,23473644,1,256,25,23541454,23364064,177390,140.9324088167315
1747352183501059,23566204,1,257,25,23631874,23456624,175250,142.65335235378032
1747352183595726,23658764,1,258,25,23726541,23549184,177357,140.9586314608389
1747352183689873,23751324,1,259,25,23820688,23641744,178944,139.7085121602289
1747352183783604,23843884,1,260,25,23914419,23734304,180115,138.8002109763207
1747352183877604,23936444,1,261,25,24008419,23826864,181555,137.69931976536037
1747352183967924,24029004,1,262,25,24098739,23919424,179315,139.41945737947188
1747352184061919,24121564,1,263,25,24192734,24011984,180750,138.31258644536652
1747352184156455,24214124,1,264,25,24287270,24104544,182726,136.8168733513567
1747352184250541,24306684,1,265,25,24381356,24197104,184252,135.6837374899594
1747352184340735,24399244,1,266,25,24471550,24289664,181886,137.44873162310458
1747352184435116,24491804,1,267,25,24565931,24382224,183707,136.08626780688817
1747352184529188,24584364,1,268,25,24660003,24474784,185219,134.9753535004508
1747352184622838,24676924,1,269,25,24753653,24567344,186309,134.18568077763285
1747352184713424,24769484,1,270,25,24844239,24659904,184335,135.6226435565682
1747352184807578,24862044,1,271,25,24938393,24752464,185929,134.45992825218227
1747352184902017,24954604,1,272,25,25032832,24845024,187808,133.1146703015846
1747352184996336,25047164,1,273,25,25127151,24937584,189567,131.879493793751
1747352185085393,25139724,1,274,25,25216208,25030144,186064,134.3623699372259
1747352185180146,25232284,1,275,25,25310961,25122704,188257,132.79718682439432
1747352185274402,25324844,1,276,25,25405217,25215264,189953,131.61150389833273
1747352185368983,25417404,1,277,25,25499798,25307824,191974,130.22596809984685
1747352185462882,25509964,1,278,25,25593697,25400384,193313,129.3239461391629
1747352185553053,25602524,1,279,25,25683868,25492944,190924,130.94215499361002
1747352185646844,25695084,1,280,25,25777659,25585504,192155,130.10330202180532
1747352185741267,25787644,1,281,25,25872082,25678064,194018,128.8540238534569
1747352185835916,25880204,1,282,25,25966731,25770624,196107,127.48142595623816
1747352185925428,25972772,1,283,25,26056243,25863192,193051,129.49945869226266
1747352186019991,26065324,1,284,25,26150806,25955744,195062,128.16437850529573
1747352186114303,26157884,1,285,25,26245118,26048304,196814,127.02348410174072
1747352186208253,26250444,1,286,25,26339068,26140864,198204,126.13267138907388
1747352186298174,26343004,1,287,25,26428989,26233424,195565,127.8347352542633
1747352186393071,26435564,1,288,25,26523886,26325984,197902,126.3251508322301
1747352186486457,26528124,1,289,25,26617272,26418544,198728,125.80008856326236
1747352186581508,26620684,1,290,25,26712323,26511104,201219,124.24274049667278
1747352186670721,26713244,1,291,25,26801536,26603664,197872,126.34430338804884
1747352186765760,26805804,1,292,25,26896575,26696224,200351,124.78100932862826
1747352186859738,26898364,1,293,25,26990553,26788784,201769,123.90406851399372
1747352186953801,26990924,1,294,25,27084616,26881344,203272,122.9879176669684
1747352187048186,27083484,1,295,25,27179001,26973904,205097,121.89354305523727
1747352187137754,27176044,1,296,25,27268569,27066464,202105,123.69807773187205
1747352187232374,27268604,1,297,25,27363189,27159024,204165,122.44997918350352
1747352187325776,27361164,1,298,25,27456591,27251584,205007,121.94705546639872
1747352187420040,27453724,1,299,25,27550855,27344144,206711,120.94179796914533
1747352187510899,27546284,1,300,25,27641714,27436704,205010,121.94527096239209
1747352187604758,27638844,1,301,25,27735573,27529264,206309,121.17745711529793
1747352187699549,27731404,1,302,25,27830364,27621824,208540,119.88107797065312
1747352187793107,27823964,1,303,25,27923922,27714384,209538,119.31010127041397
1747352187883094,27916524,1,304,25,28013909,27806944,206965,120.7933708598072
1747352187977209,28009084,1,305,25,28108024,27899504,208520,119.89257625167848
1747352188072059,28101652,1,306,25,28202874,27992072,210802,118.59470024003568
1747352188165590,28194204,1,307,25,28296405,28084624,211781,118.0464725353077
1747352188255792,28286764,1,308,25,28386607,28177184,209423,119.37561776882195
1747352188350791,28379324,1,309,25,28481606,28269744,211862,118.00134049522804
1747352188444802,28471884,1,310,25,28575617,28362304,213313,117.19867049828188
1747352188539109,28564444,1,311,25,28669924,28454864,215060,116.24662884776342
1747352188633160,28657004,1,312,25,28763975,28547424,216551,115.4462459189752
1747352188723191,28749564,1,313,25,28854006,28639984,214022,116.81042135855192
1747352188817636,28842124,1,314,25,28948451,28732544,215907,115.79059502470972
1747352188911862,28934684,1,315,25,29042677,28825104,217573,114.90396326750104
1747352189005910,29027244,1,316,25,29136725,28917664,219061,114.12346332756628
1747352189096173,29119804,1,317,25,29226988,29010224,216764,115.33280434020408
1747352189189684,29212364,1,318,25,29320499,29102784,217715,114.82901958983076
1747352189284012,29304924,1,319,25,29414827,29195344,219483,113.90403812595964
1747352189378633,29397484,1,320,25,29509448,29287904,221544,112.84440111219442
1747352189468047,29490044,1,321,25,29598862,29380464,218398,114.46991272813852
1747352189566783,29582604,1,322,25,29697598,29473024,224574,111.32188053826356
1747352189657169,29675164,1,323,25,29787984,29565584,222400,112.41007194244604
1747352189751068,29767724,1,324,25,29881883,29658144,223739,111.7373368076196
1747352189841456,29860284,1,325,25,29972271,29750704,221567,112.83268717814477
1747352189935702,29952844,1,326,25,30066517,29843264,223253,111.98057808853632
1747352190029785,30045404,1,327,25,30160600,29935824,224776,111.22183863045876
1747352190123466,30137964,1,328,25,30254281,30028384,225897,110.669907081546
1747352190217838,30230524,1,329,25,30348653,30120944,227709,109.78924855846716
1747352190307984,30323084,1,330,25,30438799,30213504,225295,110.96562285004106
1747352190401952,30415644,1,331,25,30532767,30306064,226703,110.27644098225431
1747352190496160,30508204,1,332,25,30626975,30398624,228351,109.48058033466025
1747352190590383,30600764,1,333,25,30721198,30491184,230014,108.68903631952838
1747352190681372,30693324,1,334,25,30812187,30583744,228443,109.4364896276095
1747352190774469,30785884,1,335,25,30905284,30676304,228980,109.17984103415148
1747352190869161,30878444,1,336,25,30999976,30768864,231112,108.17266087438124
1747352190963059,30971004,1,337,25,31093874,30861424,232450,107.55001075500108
1747352191053226,31063564,1,338,25,31184041,30953984,230057,108.66872122995603
1747352191147469,31156124,1,339,25,31278284,31046544,231740,107.87952015189435
1747352191241986,31248684,1,340,25,31372801,31139104,233697,106.9761272074524
1747352191335972,31341244,1,341,25,31466787,31231664,235123,106.3273265482322
1747352191429795,31433804,1,342,25,31560610,31324224,236386,105.75922431954514
1747352191520640,31526364,1,343,25,31651455,31416784,234671,106.53212369657948
1747352191614292,31618924,1,344,25,31745107,31509344,235763,106.0386913977172
1747352191708565,31711484,1,345,25,31839380,31601904,237476,105.27379608886793
1747352191803456,31804044,1,346,25,31934271,31694464,239807,104.25050144491196
1747352191893626,31896612,1,347,25,32024441,31787032,237409,105.3035057643139
1747352191987138,31989164,1,348,25,32117953,31879584,238369,104.87940965477894
1747352192081454,32081724,1,349,25,32212269,31972144,240125,104.1124414367517
1747352192175465,32174284,1,350,25,32306280,32064704,241576,103.48710136768553
1747352192266013,32266844,1,351,25,32396828,32157264,239564,104.35624718238132
1747352192360477,32359404,1,352,25,32491292,32249824,241468,103.53338744678383
1747352192454660,32451964,1,353,25,32585475,32342384,243091,102.842145533977
1747352192549109,32544524,1,354,25,32679924,32434944,244980,102.04914686913216
1747352192638558,32637084,1,355,25,32769373,32527504,241869,103.36173713869904
1747352192733410,32729644,1,356,25,32864225,32620064,244161,102.39145481874664
1747352192827700,32822204,1,357,25,32958515,32712624,245891,101.67106563477311
1747352192921892,32914764,1,358,25,33052707,32805184,247523,101.0007150850628
1747352193015778,33007324,1,359,25,33146593,32897744,248849,100.4625294857524
1747352193106017,33099884,1,360,25,33236832,32990304,246528,101.40835929387332
1747352193199886,33192444,1,361,25,33330701,33082864,247837,100.87275104201552
1747352193294381,33285004,1,362,25,33425196,33175424,249772,100.0912832503243
1747352193388554,33377564,1,363,25,33519369,33267984,251385,99.44905225053203
1747352193478737,33470124,1,364,25,33609552,33360544,249008,100.39838077491486
1747352193572780,33562684,1,365,25,33703595,33453104,250491,99.80398497351202
1747352193667374,33655244,1,366,25,33798189,33545664,252525,99.000099000099
1747352193760889,33747804,1,367,25,33891704,33638224,253480,98.62711062016729
1747352193850673,33840364,1,368,25,33981488,33730784,250704,99.71919075882316
1747352193945456,33932924,1,369,25,34076271,33823344,252927,98.842749093612
1747352194038923,34025492,1,370,25,34169738,33915912,253826,98.49266820577876
1747352194133711,34118044,1,371,25,34264526,34008464,256062,97.63260460357256
1747352194224112,34210604,1,372,25,34354927,34101024,253903,98.46279878536292
1747352194318080,34303164,1,373,25,34448895,34193584,255311,97.91979194002607
1747352194412282,34395724,1,374,25,34543097,34286144,256953,97.29405766813386
1747352194506496,34488284,1,375,25,34637311,34378704,258607,96.67178382642388
1747352194600446,34580844,1,376,25,34731261,34471264,259997,96.15495563410347
1747352194690862,34673404,1,377,25,34821677,34563824,257853,96.95446630444478
1747352194784253,34765964,1,378,25,34915068,34656384,258684,96.64300845819608
1747352194878826,34858524,1,379,25,35009641,34748944,260697,95.8967690460573
1747352194973577,34951084,1,380,25,35104392,34841504,262888,95.0975320288488
1747352195063773,35043644,1,381,25,35194588,34934064,260524,95.96044894136432
1747352195157321,35136204,1,382,25,35288136,35026624,261512,95.59790755299947
1747352195251417,35228764,1,383,25,35382232,35119184,263048,95.03968857394848
1747352195345841,35321324,1,384,25,35476656,35211744,264912,94.37096092287253
1747352195436365,35413884,1,385,25,35567180,35304304,262876,95.1018731264931
1747352195530373,35506444,1,386,25,35661188,35396864,264324,94.58089314629017
1747352195624085,35599004,1,387,25,35754900,35489424,265476,94.17047115370129
1747352195718244,35691564,1,388,25,35849059,35581984,267075,93.60666479453336
1747352195808234,35784124,1,389,25,35939049,35674544,264505,94.51617171698078
1747352195902696,35876684,1,390,25,36033511,35767104,266407,93.84137804186828
1747352195997505,35969244,1,391,25,36128320,35859664,268656,93.05580370436545
1747352196091574,36061804,1,392,25,36222389,35952224,270165,92.5360427886662
1747352196185817,36154364,1,393,25,36316632,36044784,271848,91.96315588122776
1747352196275503,36246924,1,394,25,36406318,36137344,268974,92.94578658160268
1747352196369700,36339484,1,395,25,36500515,36229904,270611,92.38353208110536
1747352196464298,36432044,1,396,25,36595113,36322464,272649,91.69298255265927
1747352196557538,36524604,1,397,25,36688353,36415024,273329,91.46486468687918
1747352196647922,36617164,1,398,25,36778737,36507584,271153,92.19886927306725
1747352196742690,36709724,1,399,25,36873505,36600144,273361,91.45415768891684
1747352196836725,36802284,1,400,25,36967540,36692704,274836,90.96333813619758
1747352196930439,36894844,1,401,25,37061254,36785264,275990,90.58299213739627
1747352197021347,36987404,1,402,25,37152162,36877824,274338,91.12846197027024
1747352197115630,37079964,1,403,25,37246445,36970384,276061,90.55969513984228
1747352197209842,37172524,1,404,25,37340657,37062944,277713,90.02099289554324
1747352197303988,37265084,1,405,25,37434803,37155504,279299,89.50980848481376
1747352197393617,37357644,1,406,25,37524432,37248064,276368,90.45909801424187
1747352197488424,37450204,1,407,25,37619239,37340624,278615,89.72955512086571
1747352197582548,37542764,1,408,25,37713363,37433184,280179,89.22867167061057
1747352197676347,37635324,1,409,25,37807162,37525744,281418,88.83582428984641
1747352197770154,37727884,1,410,25,37900969,37618304,282665,88.44391771177897
1747352197860259,37820452,1,411,25,37991074,37710872,280202,89.22134745647783
1747352197954863,37913004,1,412,25,38085678,37803424,282254,88.57270401836644
1747352198049194,38005564,1,413,25,38180009,37895984,284025,88.02042073761112
1747352198142925,38098124,1,414,25,38273740,37988544,285196,87.65901345039902
1747352198232988,38190684,1,415,25,38363803,38081104,282699,88.43328062709809
1747352198327463,38283244,1,416,25,38458278,38173664,284614,87.83826515912781
1747352198421647,38375804,1,417,25,38552462,38266224,286238,87.33990595238927
1747352198516256,38468364,1,418,25,38647071,38358784,288287,86.71913752614581
1747352198605736,38560924,1,419,25,38736551,38451344,285207,87.65563257563805
1747352198700107,38653484,1,420,25,38830922,38543904,287018,87.10255105951543
1747352198794010,38746044,1,421,25,38924825,38636464,288361,86.69688342043482
1747352198888660,38838604,1,422,25,39019475,38729024,290451,86.07303813724174
1747352198982073,38931164,1,423,25,39112888,38821584,291304,85.82099799522149
1747352199072518,39023724,1,424,25,39203333,38914144,289189,86.44865468603578
1747352199167209,39116284,1,425,25,39298024,39006704,291320,85.81628449814636
1747352199261817,39208844,1,426,25,39392632,39099264,293368,85.21720160344687
1747352199355250,39301404,1,427,25,39486065,39191824,294241,84.9643659449227
1747352199445811,39393964,1,428,25,39576626,39284384,292242,85.54554102421966
1747352199539752,39486524,1,429,25,39670567,39376944,293623,85.14319382337214
1747352199633843,39579084,1,430,25,39764658,39469504,295154,84.70154563380471
1747352199727841,39671644,1,431,25,39858656,39562064,296592,84.29087770405135
1747352199818314,39764204,1,432,25,39949129,39654624,294505,84.888202237653
1747352199912397,39856764,1,433,25,40043212,39747184,296028,84.45147080681556
1747352200006885,39949332,1,434,25,40137700,39839752,297948,83.9072589847893
1747352200100556,40041884,1,435,25,40231371,39932304,299067,83.59330852283935
1747352200191010,40134444,1,436,25,40321825,40024864,296961,84.186138920599
1747352200285225,40227004,1,437,25,40416040,40117424,298616,83.71955956814102
1747352200379634,40319564,1,438,25,40510449,40209984,300465,83.20436656515734
1747352200473831,40412124,1,439,25,40604646,40302544,302102,82.75350709363063
1747352200567747,40504684,1,440,25,40698562,40395104,303458,82.38372361249333
1747352200658096,40597244,1,441,25,40788911,40487664,301247,82.98837830750182
1747352200752651,40689804,1,442,25,40883466,40580224,303242,82.44240573535328
1747352200846027,40782364,1,443,25,40976842,40672784,304058,82.22115517434173
1747352200940306,40874924,1,444,25,41071121,40765344,305777,81.75892889262435
1747352201031096,40967484,1,445,25,41161911,40857904,304007,82.23494853736919
1747352201124760,41060044,1,446,25,41255575,40950464,305111,81.93739327654525
1747352201219169,41152604,1,447,25,41349984,41043024,306960,81.44383633046651
1747352201313367,41245164,1,448,25,41444182,41135584,308598,81.0115425245789
1747352201403861,41337724,1,449,25,41534676,41228144,306532,81.55755353437813
1747352201498021,41430284,1,450,25,41628836,41320704,308132,81.13405942907585
1747352201592000,41522844,1,451,25,41722815,41413264,309551,80.76213612619568
1747352201685573,41615404,1,452,25,41816388,41505824,310564,80.49870558081426
1747352201776047,41707964,1,453,25,41906862,41598384,308478,81.0430565550866
1747352201870262,41800524,1,454,25,42001077,41690944,310133,80.61057675255455
1747352201964920,41893084,1,455,25,42095735,41783504,312231,80.06892332920178
1747352202058870,41985644,1,456,25,42189685,41876064,313621,79.71404976069843
1747352202153358,42078204,1,457,25,42284173,41968624,315549,79.2269980256632
1747352202242843,42170764,1,458,25,42373658,42061184,312474,80.00665655382528
1747352202337589,42263324,1,459,25,42468404,42153744,314660,79.45083582279285
1747352202431285,42355884,1,460,25,42562100,42246304,315796,79.16503058936782
1747352202525117,42448444,1,461,25,42655932,42338864,317068,78.84743966593916
1747352202615962,42541004,1,462,25,42746777,42431424,315353,79.27623964255929
1747352202710049,42633564,1,463,25,42840864,42523984,316880,78.89421863165867
1747352202804271,42726124,1,464,25,42935086,42616544,318542,78.48258628375537
1747352202898350,42818684,1,465,25,43029165,42709104,320061,78.11011026023165
1747352202988949,42911244,1,466,25,43119764,42801664,318100,78.59163784973279
1747352203079918,43003804,1,467,25,43210733,42894224,316509,78.98669548101319
1747352203177166,43096364,1,468,25,43307981,42986784,321197,77.83385274457731
1747352203271134,43188924,1,469,25,43401949,43079344,322605,77.49414919173603
1747352203360788,43281484,1,470,25,43491603,43171904,319699,78.1985555162825
1747352203459792,43374044,1,471,25,43590607,43264464,326143,76.65349248642467
1747352203549739,43466604,1,472,25,43680554,43357024,323530,77.27258677711495
1747352203643262,43559164,1,473,25,43774077,43449584,324493,77.0432644155652
1747352203738303,43651724,1,474,25,43869118,43542144,326974,76.45867867169866
1747352203827951,43744292,1,475,25,43958766,43634712,324054,77.14763588784585
1747352203922698,43836844,1,476,25,44053513,43727264,326249,76.62858736731759
1747352204016503,43929404,1,477,25,44147318,43819824,327494,76.3372764081174
1747352204110285,44021964,1,478,25,44241100,43912384,328716,76.05349298482581
1747352204200269,44114524,1,479,25,44331084,44004944,326140,76.6541975838597
1747352204295265,44207084,1,480,25,44426080,44097504,328576,76.08589793533308
1747352204389282,44299644,1,481,25,44520097,44190064,330033,75.7500007575
1747352204483574,44392204,1,482,25,44614389,44282624,331765,75.35454312540503
1747352204573292,44484764,1,483,25,44704107,44375184,328923,76.00563049710722
1747352204668076,44577324,1,484,25,44798891,44467744,331147,75.49517283864868
1747352204761634,44669884,1,485,25,44892449,44560304,332145,75.2683316021617
1747352204856491,44762444,1,486,25,44987306,44652864,334442,74.75137692036287
1747352204946262,44855004,1,487,25,45077077,44745424,331653,75.3799905322732
1747352205040072,44947564,1,488,25,45170887,44837984,332903,75.09695016266
1747352205134593,45040124,1,489,25,45265408,44930544,334864,74.65717425581728
1747352205228218,45132684,1,490,25,45359033,45023104,335929,74.42048766257156
1747352205322716,45225244,1,491,25,45453531,45115664,337867,73.99361287133695
1747352205413114,45317804,1,492,25,45543929,45208224,335705,74.47014491890202
1747352205507663,45410364,1,493,25,45638478,45300784,337694,74.03151965981036
1747352205601144,45502924,1,494,25,45731959,45393344,338615,73.83016109741152
1747352205695812,45595484,1,495,25,45826627,45485904,340723,73.37338541865387
1747352205785668,45688044,1,496,25,45916483,45578464,338019,73.96033950754247
1747352205880256,45780604,1,497,25,46011071,45671024,340047,73.51924880972336
1747352205974393,45873172,1,498,25,46105208,45763592,341616,73.18158400074938
1747352206067886,45965724,1,499,25,46198701,45856144,342557,72.98055506090957
1747352206158666,46058284,1,500,25,46289481,45948704,340777,73.36175856938702
1747352206253024,46150844,1,501,25,46383839,46041264,342575,72.97672042618404
1747352206346723,46243404,1,502,25,46477538,46133824,343714,72.73489005394019
1747352206440920,46335964,1,503,25,46571735,46226384,345351,72.39011903831174
1747352206530729,46428524,1,504,25,46661544,46318944,342600,72.97139521307648
1747352206624960,46521084,1,505,25,46755775,46411504,344271,72.61721144098689
1747352206719660,46613644,1,506,25,46850475,46504064,346411,72.16860896449593
1747352206813994,46706204,1,507,25,46944809,46596624,348185,71.80091043554432
1747352206908000,46798764,1,508,25,47038815,46689184,349631,71.50395702898197
1747352206998469,46891324,1,509,25,47129284,46781744,347540,71.93416585141279
1747352207092117,46983884,1,510,25,47222932,46874304,348628,71.70967334809596
1747352207186012,47076444,1,511,25,47316827,46966864,349963,71.43612324731471
1747352207281085,47169004,1,512,25,47411900,47059424,352476,70.92681487533903
1747352207371105,47261564,1,513,25,47501920,47151984,349936,71.44163504183622
1747352207464943,47354124,1,514,25,47595758,47244544,351214,71.1816727123634
1747352207559610,47446684,1,515,25,47690425,47337104,353321,70.75718680746404
1747352207653448,47539244,1,516,25,47784263,47429664,354599,70.50217287696807
1747352207744139,47631804,1,517,25,47874954,47522224,352730,70.8757406514898
1747352207837916,47724364,1,518,25,47968731,47614784,353947,70.63204378056601
1747352207932222,47816924,1,519,25,48063037,47707344,355693,70.28533032699548
1747352208026458,47909484,1,520,25,48157273,47799904,357369,69.95570404819668
1747352208120279,48002044,1,521,25,48251094,47892464,358630,69.70972868973594
1747352208210429,48094604,1,522,25,48341244,47985024,356220,70.18134860479479
1747352208304324,48187164,1,523,25,48435139,48077584,357555,69.91931311266798
1747352208399209,48279724,1,524,25,48530024,48170144,359880,69.46760031121485
1747352208493189,48372284,1,525,25,48624004,48262704,361300,69.1945751453086
1747352208583590,48464844,1,526,25,48714405,48355264,359141,69.61054293439068
1747352208676885,48557404,1,527,25,48807700,48447824,359876,69.4683724393958
1747352208771560,48649964,1,528,25,48902375,48540384,361991,69.06249050390755
1747352208866056,48742524,1,529,25,48996871,48632944,363927,68.69509544496562
1747352208955789,48835084,1,530,25,49086604,48725504,361100,69.23289947382997
1747352209050490,48927644,1,531,25,49181305,48818064,363241,68.82482979619591
1747352209144344,49020204,1,532,25,49275159,48910624,364535,68.58052038898872
1747352209238438,49112764,1,533,25,49369253,49003184,366069,68.29313599348757
1747352209328802,49205324,1,534,25,49459617,49095744,363873,68.70529003251134
1747352209422474,49297884,1,535,25,49553289,49188304,364985,68.49596558762688
1747352209516757,49390444,1,536,25,49647572,49280864,366708,68.17413309772353
1747352209611432,49483004,1,537,25,49742247,49373424,368823,67.78319139533055
1747352209704798,49575564,1,538,25,49835613,49465984,369629,67.6353857516591
1747352209795783,49668132,1,539,25,49926598,49558552,368046,67.92629182221788
1747352209889436,49760684,1,540,25,50020251,49651104,369147,67.72369814735052
1747352209983929,49853244,1,541,25,50114744,49743664,371080,67.37091732241026
1747352210077622,49945804,1,542,25,50208437,49836224,372213,67.16584321342887
1747352210168611,50038364,1,543,25,50299426,49928784,370642,67.45053177999255
1747352210262347,50130924,1,544,25,50393162,50021344,371818,67.23719669300571
1747352210356567,50223484,1,545,25,50487382,50113904,373478,66.93834710478262
1747352210451060,50316044,1,546,25,50581875,50206464,375411,66.5936799933939
1747352210541203,50408604,1,547,25,50672018,50299024,372994,67.02520683978831
1747352210635433,50501164,1,548,25,50766248,50391584,374664,66.72645356906455
1747352210728888,50593724,1,549,25,50859703,50484144,375559,66.56743680753225
1747352210823198,50686284,1,550,25,50954013,50576704,377309,66.25868982717083
1747352210913347,50778844,1,551,25,51044162,50669264,374898,66.6848049336086
1747352211007854,50871404,1,552,25,51138669,50761824,376845,66.34027252583954
1747352211102179,50963964,1,553,25,51232994,50854384,378610,66.03100816143261
1747352211196455,51056524,1,554,25,51327270,50946944,380326,65.73308161945279
1747352211290168,51149084,1,555,25,51420983,51039504,381479,65.53440687429715
1747352211380747,51241644,1,556,25,51511562,51132064,379498,65.87650000790518
1747352211474858,51334204,1,557,25,51605673,51224624,381049,65.60836007967478
1747352211569214,51426764,1,558,25,51700029,51317184,382845,65.30057856312607
1747352211662907,51519324,1,559,25,51793722,51409744,383978,65.10789680658787
1747352211752974,51611884,1,560,25,51883789,51502304,381485,65.53337614847241
1747352211847695,51704444,1,561,25,51978510,51594864,383646,65.16423995037091
1747352211942046,51797012,1,562,25,52072861,51687432,385429,64.86278925560867
1747352212035052,51889564,1,563,25,52165867,51779984,385883,64.7864767299933
1747352212126126,51982124,1,564,25,52256941,51872544,384397,65.03692796770007
1747352212220081,52074684,1,565,25,52350896,51965104,385792,64.80175846051758
1747352212313827,52167244,1,566,25,52444642,52057664,386978,64.60315573495134
1747352212408178,52259804,1,567,25,52538993,52150224,388769,64.30553876466489
1747352212499094,52352364,1,568,25,52629909,52242784,387125,64.57862447529868
1747352212593319,52444924,1,569,25,52724134,52335344,388790,64.30206538234007
1747352212687400,52537484,1,570,25,52818215,52427904,390311,64.05148714742859
1747352212781230,52630044,1,571,25,52912045,52520464,391581,63.84375135667971
1747352212875475,52722604,1,572,25,53006290,52613024,393266,63.57020439092116
1747352212965485,52815164,1,573,25,53096300,52705584,390716,63.98509403249419
1747352213059401,52907724,1,574,25,53190216,52798144,392072,63.763798485992375
1747352213154392,53000284,1,575,25,53285207,52890704,394503,63.370874239232656
1747352213248398,53092844,1,576,25,53379213,52983264,395949,63.139444726467296
1747352213338118,53185404,1,577,25,53468933,53075824,393109,63.59559307978195
1747352213432130,53277964,1,578,25,53562945,53168384,394561,63.36155879572487
1747352213526668,53370524,1,579,25,53657483,53260944,396539,63.04550119912544
1747352213620628,53463084,1,580,25,53751443,53353504,397939,62.82369910966254
1747352213711160,53555644,1,581,25,53841975,53446064,395911,63.14550492408648
1747352213805151,53648204,1,582,25,53935966,53538624,397342,62.91809071278647
1747352213899501,53740764,1,583,25,54030316,53631184,399132,62.63591994628344
1747352213993776,53833324,1,584,25,54124591,53723744,400847,62.36793589574077
1747352214084166,53925884,1,585,25,54214981,53816304,398677,62.707404741181456
1747352214178321,54018444,1,586,25,54309136,53908864,400272,62.45752888036135
1747352214272173,54111004,1,587,25,54402988,54001424,401564,62.256576784771546
1747352214366438,54203564,1,588,25,54497253,54093984,403269,61.993359271354855
1747352214460488,54296124,1,589,25,54591303,54186544,404759,61.76514913812911
1747352214550731,54388684,1,590,25,54681546,54279104,402442,62.12075280413078
1747352214644729,54481244,1,591,25,54775544,54371664,403880,61.89957413092998
1747352214738955,54573804,1,592,25,54869770,54464224,405546,61.64528808076026
1747352214833108,54666364,1,593,25,54963923,54556784,407139,61.404090494892415
1747352214923863,54758924,1,594,25,55054678,54649344,405334,61.67753013564122
1747352215017697,54851484,1,595,25,55148512,54741904,406608,61.48427969936646
1747352215111648,54944044,1,596,25,55242463,54834464,407999,61.27465998691173
1747352215205808,55036604,1,597,25,55336623,54927024,409599,61.035305261975736
1747352215296191,55129164,1,598,25,55427006,55019584,407422,61.36143850847524
1747352215390617,55221724,1,599,25,55521432,55112144,409288,61.08168331346143
1747352215484172,55314284,1,600,25,55614987,55204704,410283,60.93355074424239
1747352215578301,55406844,1,601,25,55709116,55297264,411852,60.701417013878775
1747352215668244,55499404,1,602,25,55799059,55389824,409235,61.089593998558286
1747352215762795,55591972,1,603,25,55893610,55482392,411218,60.79500410974228
1747352215857463,55684524,1,604,25,55988278,55574944,413334,60.48377341326869
1747352215951249,55777084,1,605,25,56082064,55667504,414560,60.30490158240062
1747352216045919,55869644,1,606,25,56176734,55760064,416670,59.99952000383997
1747352216136089,55962204,1,607,25,56266904,55852624,414280,60.34565994013711
1747352216230256,56054764,1,608,25,56361071,55945184,415887,60.11248247721136
1747352216324138,56147324,1,609,25,56454953,56037744,417209,59.92200551761827
1747352216418639,56239884,1,610,25,56549454,56130304,419150,59.64451866873434
1747352216508762,56332444,1,611,25,56639577,56222864,416713,59.993328741843904
1747352216602574,56425004,1,612,25,56733389,56315424,417965,59.81362075771895
1747352216696589,56517564,1,613,25,56827404,56407984,419420,59.60612274092794
1747352216790590,56610124,1,614,25,56921405,56500544,420861,59.40203535133928
1747352216881587,56702684,1,615,25,57012402,56593104,419298,59.6234658882227
1747352216974954,56795244,1,616,25,57105769,56685664,420105,59.50893229073684
1747352217069317,56887804,1,617,25,57200132,56778224,421908,59.254624230874974
1747352217162952,56980364,1,618,25,57293767,56870784,422983,59.1040301856103
1747352217253656,57072924,1,619,25,57384471,56963344,421127,59.3645147425836
1747352217347669,57165484,1,620,25,57478484,57055904,422580,59.1603956647262
1747352217441605,57258044,1,621,25,57572420,57148464,423956,58.96838351149648
1747352217536167,57350604,1,622,25,57666982,57241024,425958,58.69123246892886
1747352217630344,57443164,1,623,25,57761159,57333584,427575,58.46927439630475
1747352217720662,57535724,1,624,25,57851477,57426144,425333,58.77747553093693
1747352217814556,57628284,1,625,25,57945371,57518704,426667,58.593704223668574
1747352217909378,57720852,1,626,25,58040193,57611272,428921,58.2857915560208
1747352218002946,57813404,1,627,25,58133761,57703824,429937,58.14805424980869
1747352218093479,57905964,1,628,25,58224294,57796384,427910,58.4235002687481
1747352218187439,57998524,1,629,25,58318254,57888944,429310,58.232978500384334
1747352218281633,58091084,1,630,25,58412448,57981504,430944,58.01217791638821
1747352218375695,58183644,1,631,25,58506510,58074064,432446,57.8106861897208
1747352218466323,58276204,1,632,25,58597138,58166624,430514,58.070120832307424
1747352218560349,58368764,1,633,25,58691164,58259184,431980,57.87304967822585
1747352218654440,58461324,1,634,25,58785255,58351744,433511,57.66866354025619
1747352218748968,58553884,1,635,25,58879783,58444304,435479,57.408049527072485
1747352218842587,58646444,1,636,25,58973402,58536864,436538,57.26878301545341
1747352218932742,58739004,1,637,25,59063557,58629424,434133,57.586039301320106
1747352219026756,58831564,1,638,25,59157571,58721984,435587,57.39381570157053
1747352219121343,58924124,1,639,25,59252158,58814544,437614,57.127971225783455
1747352219214964,59016684,1,640,25,59345779,58907104,438675,56.989798826010144
1747352219305899,59109244,1,641,25,59436714,58999664,437050,57.20169317011784
1747352219399423,59201804,1,642,25,59530238,59092224,438014,57.07580123009767
1747352219494211,59294364,1,643,25,59625026,59184784,440242,56.78694899623389
1747352219588112,59386924,1,644,25,59718927,59277344,441583,56.61449829363902
1747352219678588,59479484,1,645,25,59809403,59369904,439499,56.88295081445009
1747352219772794,59572044,1,646,25,59903609,59462464,441145,56.67070917725464
1747352219866884,59664604,1,647,25,59997699,59555024,442675,56.474840458575706
1747352219961263,59757164,1,648,25,60092078,59647584,444494,56.2437288242361
1747352220051374,59849724,1,649,25,60182189,59740144,442045,56.55532807745818
1747352220145343,59942284,1,650,25,60276158,59832704,443454,56.37563309835969
1747352220239763,60034844,1,651,25,60370578,59925264,445314,56.14016177349017
1747352220333218,60127404,1,652,25,60464033,60017824,446209,56.02755659343491
1747352220427741,60219964,1,653,25,60558556,60110384,448172,55.782155065465936
1747352220518084,60312524,1,654,25,60648899,60202944,445955,56.05946788353085
1747352220612770,60405084,1,655,25,60743585,60295504,448081,55.79348376744383
1747352220706580,60497644,1,656,25,60837395,60388064,449331,55.63827111861857
1747352220800657,60590204,1,657,25,60931472,60480624,450848,55.45106111150543
1747352220891195,60682764,1,658,25,61022010,60573184,448826,55.70087294408078
1747352220985431,60775324,1,659,25,61116246,60665744,450502,55.49364930677333
1747352221078848,60867884,1,660,25,61209663,60758304,451359,55.38828294107351
1747352221172835,60960444,1,661,25,61303650,60850864,452786,55.213721272300816
1747352221262970,61053004,1,662,25,61393785,60943424,450361,55.5110233790226
1747352221357863,61145564,1,663,25,61488678,61035984,452694,55.224942234710426
1747352221451664,61238124,1,664,25,61582479,61128544,453935,55.0739643341007
1747352221546456,61330684,1,665,25,61677271,61221104,456167,54.80449046073039
1747352221635730,61423244,1,666,25,61766545,61313664,452881,55.20213919329802
1747352221730407,61515812,1,667,25,61861222,61406232,454990,54.94626255522099
1747352221824906,61608364,1,668,25,61955721,61498784,456937,54.71213755944474
1747352221918995,61700924,1,669,25,62049810,61591344,458466,54.52967068441281
1747352222012917,61793484,1,670,25,62143732,61683904,459828,54.368155049279295
1747352222103424,61886044,1,671,25,62234239,61776464,457775,54.61198186882202
1747352222196983,61978604,1,672,25,62327798,61869024,458774,54.49306194335337
1747352222291714,62071164,1,673,25,62422529,61961584,460945,54.2364056449251
1747352222385657,62163724,1,674,25,62516472,62054144,462328,54.07416379713104
1747352222476554,62256284,1,675,25,62607369,62146704,460665,54.26937145213984
1747352222569982,62348844,1,676,25,62700797,62239264,461533,54.167307646473816
1747352222664419,62441404,1,677,25,62795234,62331824,463410,53.94790790013163
1747352222759025,62533964,1,678,25,62889840,62424384,465456,53.71076965384484
1747352222848761,62626524,1,679,25,62979576,62516944,462632,54.03863113662696
1747352222942409,62719084,1,680,25,63073224,62609504,463720,53.91184335374795
1747352223037483,62811644,1,681,25,63168298,62702064,466234,53.62114303118177
1747352223130907,62904204,1,682,25,63261722,62794624,467098,53.52195898933415
1747352223221170,62996764,1,683,25,63351985,62887184,464801,53.78645915133573
1747352223315771,63089324,1,684,25,63446586,62979744,466842,53.55130857977646
1747352223409657,63181884,1,685,25,63540472,63072304,468168,53.39963431930418
1747352223504146,63274444,1,686,25,63634961,63164864,470097,53.18051380885222
1747352223598363,63367004,1,687,25,63729178,63257424,471754,52.99372130389991
1747352223688712,63459564,1,688,25,63819527,63349984,469543,53.24325993572474
1747352223786412,63552124,1,689,25,63917227,63442544,474683,52.66672705784703
1747352223876408,63644692,1,690,25,64007223,63535112,472111,52.95364861229668
1747352223970306,63737244,1,691,25,64101121,63627664,473457,52.80310566746294
1747352224060935,63829804,1,692,25,64191750,63720224,471526,53.0193456988586
1747352224155186,63922364,1,693,25,64286001,63812784,473217,52.829885654995486
1747352224249224,64014924,1,694,25,64380039,63905344,474695,52.66539567511771
1747352224343195,64107484,1,695,25,64474010,63997904,476106,52.50931515250806
1747352224433388,64200044,1,696,25,64564203,64090464,473739,52.77167385416865
1747352224527761,64292604,1,697,25,64658576,64183024,475552,52.570486508310346
1747352224621461,64385164,1,698,25,64752276,64275584,476692,52.44476517331946
1747352224716464,64477724,1,699,25,64847279,64368144,479135,52.177361286485024
1747352224806572,64570284,1,700,25,64937387,64460704,476683,52.44575535523608
1747352224899962,64662844,1,701,25,65030777,64553264,477513,52.354595581690965
1747352224994958,64755404,1,702,25,65125773,64645824,479949,52.08886777553448
1747352225088299,64847964,1,703,25,65219114,64738384,480730,52.00424354627338
1747352225183485,64940524,1,704,25,65314300,64830944,483356,51.72171236107548
1747352225273528,65033084,1,705,25,65404343,64923504,480839,51.99245485495145
1747352225367283,65125644,1,706,25,65498098,65016064,482034,51.863561491513046
1747352225461287,65218204,1,707,25,65592102,65108624,483478,51.70866099388183
1747352225555287,65310764,1,708,25,65686102,65201184,484918,51.55510828634944
1747352225645857,65403324,1,709,25,65776672,65293744,482928,51.76755127058278
1747352225739755,65495884,1,710,25,65870570,65386304,484266,51.62452040820541
1747352225834740,65588444,1,711,25,65965555,65478864,486691,51.36729464896619
1747352225928167,65681004,1,712,25,66058982,65571424,487558,51.27595075867897
1747352226018423,65773564,1,713,25,66149238,65663984,485254,51.5194104530823
1747352226112781,65866124,1,714,25,66243596,65756544,487052,51.329221520494734
1747352226206824,65958684,1,715,25,66337639,65849104,488535,51.17340620426377
1747352226301569,66051244,1,716,25,66432384,65941664,490720,50.94554939680469
1747352226395632,66143804,1,717,25,66526447,66034224,492223,50.78998746503109
1747352226485101,66236364,1,718,25,66615916,66126784,489132,51.11094755607893
1747352226579875,66328924,1,719,25,66710690,66219344,491346,50.8806421544085
1747352226674244,66421484,1,720,25,66805059,66311904,493155,50.694000871936815
1747352226768557,66514044,1,721,25,66899372,66404464,494908,50.51443904725727
1747352226858086,66606604,1,722,25,66988901,66497024,491877,50.82571455872098
1747352226952203,66699164,1,723,25,67083018,66589584,493434,50.665337208218325
1747352227046486,66791724,1,724,25,67177301,66682144,495157,50.48903681054696
1747352227140953,66884284,1,725,25,67271768,66774704,497064,50.29533420243671
1747352227230648,66976844,1,726,25,67361463,66867264,494199,50.5869093219533
1747352227325594,67069404,1,727,25,67456409,66959824,496585,50.3438484851536
1747352227418919,67161964,1,728,25,67549734,67052384,497350,50.26641198351262
1747352227513282,67254524,1,729,25,67644097,67144944,499153,50.08484372527061
1747352227603957,67347084,1,730,25,67734772,67237504,497268,50.274700966078655
1747352227698066,67439652,1,731,25,67828881,67330072,498809,50.119384373577866
1747352227791962,67532204,1,732,25,67922777,67422624,500153,49.98470468036781
1747352227886301,67624764,1,733,25,68017116,67515184,501932,49.80754365133125
1747352227980693,67717324,1,734,25,68111508,67607744,503764,49.626412367695984
1747352228070766,67809884,1,735,25,68201581,67700304,501277,49.87262531494563
1747352228164888,67902444,1,736,25,68295703,67792864,502839,49.71770288303015
1747352228259028,67995004,1,737,25,68389843,67885424,504419,49.56197129767119
1747352228353329,68087564,1,738,25,68484144,67977984,506160,49.39149675991781
1747352228443778,68180124,1,739,25,68574593,68070544,504049,49.598352541122
1747352228537816,68272684,1,740,25,68668631,68163104,505527,49.4533427492498
1747352228631905,68365244,1,741,25,68762720,68255664,507056,49.30421886339971
1747352228725440,68457804,1,742,25,68856255,68348224,508031,49.20959547744133
1747352228815916,68550364,1,743,25,68946731,68440784,505947,49.41229022012187
1747352228910531,68642924,1,744,25,69041346,68533344,508002,49.21240467557215
1747352229004140,68735484,1,745,25,69134955,68625904,509051,49.11099280818621
1747352229098227,68828044,1,746,25,69229042,68718464,510578,48.964115179267424
1747352229188376,68920604,1,747,25,69319191,68811024,508167,49.19642558450273
1747352229282692,69013164,1,748,25,69413507,68903584,509923,49.02700996032734
1747352229376682,69105724,1,749,25,69507497,68996144,511353,48.88990579892951
1747352229471310,69198284,1,750,25,69602125,69088704,513421,48.692982951612805
1747352229565791,69290844,1,751,25,69696606,69181264,515342,48.51147393381483
1747352229655199,69383404,1,752,25,69786014,69273824,512190,48.8100119096429
1747352229749395,69475964,1,753,25,69880210,69366384,513826,48.65460292005465
1747352229843456,69568532,1,754,25,69974271,69458952,515319,48.51363912450346
1747352229937676,69661084,1,755,25,70068491,69551504,516987,48.35711536266869
1747352230028662,69753644,1,756,25,70159477,69644064,515413,48.50479130328494
1747352230122749,69846204,1,757,25,70253564,69736624,516940,48.36151197431037
1747352230216085,69938764,1,758,25,70346900,69829184,517716,48.28902332552983
1747352230310967,70031324,1,759,25,70441782,69921744,520038,48.073410020037
1747352230400656,70123884,1,760,25,70531471,70014304,517167,48.34028466626834
1747352230494654,70216444,1,761,25,70625469,70106864,518605,48.20624560118009
1747352230589014,70309004,1,762,25,70719829,70199424,520405,48.03950769112518
1747352230683159,70401564,1,763,25,70813974,70291984,521990,47.89363780915344
1747352230774251,70494124,1,764,25,70905066,70384544,520522,48.02870964147529
1747352230867530,70586684,1,765,25,70998345,70477104,521241,47.9624588242291
1747352230961917,70679244,1,766,25,71092732,70569664,523068,47.794932972386
1747352231056289,70771804,1,767,25,71187104,70662224,524880,47.62993446121018
1747352231150523,70864364,1,768,25,71281338,70754784,526554,47.4785112258192
1747352231240219,70956924,1,769,25,71371034,70847344,523690,47.73816570872081
1747352231334692,71049484,1,770,25,71465507,70939904,525603,47.56441648925139
1747352231428525,71142044,1,771,25,71559340,71032464,526876,47.44949475777982
1747352231523089,71234604,1,772,25,71653904,71125024,528880,47.26970201179852
1747352231613182,71327164,1,773,25,71743997,71217584,526413,47.491228370120034
1747352231707354,71419724,1,774,25,71838169,71310144,528025,47.34624307561195
1747352231801958,71512284,1,775,25,71932773,71402704,530069,47.163671144700025
1747352231896050,71604844,1,776,25,72026865,71495264,531601,47.02775201702028
1747352231986186,71697404,1,777,25,72117001,71587824,529177,47.24317194435888
1747352232080206,71789964,1,778,25,72211021,71680384,530637,47.113186604024975
1747352232174324,71882524,1,779,25,72305139,71772944,532195,46.97526282659552
1747352232268254,71975084,1,780,25,72399069,71865504,533565,46.85464751248677
1747352232358961,72067644,1,781,25,72489776,71958064,531712,47.01793452094367
1747352232453349,72160204,1,782,25,72584164,72050624,533540,46.856842973347824
1747352232546757,72252764,1,783,25,72677572,72143184,534388,46.78248763071027
1747352232641682,72345324,1,784,25,72772497,72235744,536753,46.57635821318185
1747352232735491,72437884,1,785,25,72866306,72328304,538002,46.46822874264408
1747352232825999,72530444,1,786,25,72956814,72420864,535950,46.64614236402649
1747352232920167,72623004,1,787,25,73050982,72513424,537558,46.50660951934489
1747352233014151,72715564,1,788,25,73144966,72605984,538982,46.383738232445616
1747352233108327,72808124,1,789,25,73239142,72698544,540598,46.24508414755511
1747352233198609,72900684,1,790,25,73329424,72791104,538320,46.44077871897756
1747352233292824,72993244,1,791,25,73423639,72883664,539975,46.29843974258068
1747352233386597,73085804,1,792,25,73517412,72976224,541188,46.19466802663769
1747352233480619,73178364,1,793,25,73611434,73068784,542650,46.07021100156639
1747352233571303,73270924,1,794,25,73702118,73161344,540774,46.23003324863991
1747352233665527,73363492,1,795,25,73796342,73253912,542430,46.0888962631123
1747352233759253,73456044,1,796,25,73890068,73346464,543604,45.98935990169315
1747352233853180,73548604,1,797,25,73983995,73439024,544971,45.87400063489617
1747352233943958,73641164,1,798,25,74074773,73531584,543189,46.02449607779244
1747352234037478,73733724,1,799,25,74168293,73624144,544149,45.9432986185769
1747352234131634,73826284,1,800,25,74262449,73716704,545745,45.80894007274459
1747352234226300,73918844,1,801,25,74357115,73809264,547851,45.63284542695003
1747352234320906,74011404,1,802,25,74451721,73901824,549897,45.46305944567801
1747352234411098,74103964,1,803,25,74541913,73994384,547529,45.659681952919385
1747352234505315,74196524,1,804,25,74636130,74086944,549186,45.52191789302714
1747352234598897,74289084,1,805,25,74729712,74179504,550208,45.43736187041991
1747352234693091,74381644,1,806,25,74823906,74272064,551842,45.30282218461081
1747352234783466,74474204,1,807,25,74914281,74364624,549657,45.48291025130218
1747352234877398,74566764,1,808,25,75008213,74457184,551029,45.36966293970009
1747352234972057,74659324,1,809,25,75102872,74549744,553128,45.19749497403856
1747352235066143,74751884,1,810,25,75196958,74642304,554654,45.07314469921789
1747352235156320,74844444,1,811,25,75287135,74734864,552271,45.26763128971104
1747352235250596,74937004,1,812,25,75381411,74827424,553987,45.12741273712199
1747352235344841,75029564,1,813,25,75475656,74919984,555672,44.99056997653292
1747352235439035,75122124,1,814,25,75569850,75012544,557306,44.85865933616362
1747352235532558,75214684,1,815,25,75663373,75105104,558269,44.78127927576133
1747352235622698,75307244,1,816,25,75753513,75197664,555849,44.97624354815786
1747352235716754,75399804,1,817,25,75847569,75290224,557345,44.8555203688918
1747352235811020,75492372,1,818,25,75941835,75382792,559043,44.7192791967702
1747352235905409,75584924,1,819,25,76036224,75475344,560880,44.57281414919412
1747352235995740,75677484,1,820,25,76126555,75567904,558651,44.75065828218333
1747352236090086,75770044,1,821,25,76220901,75660464,560437,44.608046934802665
1747352236184383,75862604,1,822,25,76315198,75753024,562174,44.47021740599886
1747352236278425,75955164,1,823,25,76409240,75845584,563656,44.353293498162
1747352236368489,76047724,1,824,25,76499304,75938144,561160,44.55057381139069
1747352236463021,76140284,1,825,25,76593836,76030704,563132,44.39456468465653
1747352236556813,76232844,1,826,25,76687628,76123264,564364,44.29765187006967
1747352236650524,76325404,1,827,25,76781339,76215824,565515,44.2074922857926
1747352236740725,76417964,1,828,25,76871540,76308384,563156,44.39267272301103
1747352236835380,76510524,1,829,25,76966195,76400944,565251,44.22813935755974
1747352236929179,76603084,1,830,25,77059994,76493504,566490,44.13140567353351
1747352237023642,76695644,1,831,25,77154457,76586064,568393,43.98365215616659
1747352237117501,76788204,1,832,25,77248316,76678624,569692,43.88336153570702
1747352237207707,76880764,1,833,25,77338522,76771184,567338,44.06544246992093
1747352237302548,76973324,1,834,25,77433363,76863744,569619,43.88898544465687
1747352237396321,77065884,1,835,25,77527136,76956304,570832,43.795722734534856
1747352237490887,77158444,1,836,25,77621702,77048864,572838,43.64235612860879
1747352237580542,77251004,1,837,25,77711357,77141424,569933,43.86480516130843
1747352237674819,77343564,1,838,25,77805634,77233984,571650,43.733053441791306
1747352237769636,77436124,1,839,25,77900451,77326544,573907,43.56106477181844
1747352237863501,77528684,1,840,25,77994316,77419104,575212,43.462236531922144
1747352237953709,77621244,1,841,25,78084524,77511664,572860,43.64068009635862
1747352238047130,77713804,1,842,25,78177945,77604224,573721,43.57518724257958
1747352238141762,77806364,1,843,25,78272577,77696784,575793,43.41838125854257
1747352238235788,77898924,1,844,25,78366603,77789344,577259,43.30811646072214
1747352238325826,77991484,1,845,25,78456641,77881904,574737,43.498156548125486
1747352238420492,78084044,1,846,25,78551307,77974464,576843,43.33934883495162
1747352238514752,78176604,1,847,25,78645567,78067024,578543,43.21199979949632
1747352238609068,78269164,1,848,25,78739883,78159584,580299,43.08123915429804
1747352238703153,78361724,1,849,25,78833968,78252144,581824,42.968320316796834
1747352238792672,78454284,1,850,25,78923487,78344704,578783,43.19408137419378
1747352238887320,78546844,1,851,25,79018135,78437264,580871,43.0388158472363
1747352238981576,78639404,1,852,25,79112391,78529824,582567,42.91351896005095
1747352239076107,78731964,1,853,25,79206922,78622384,584538,42.768819135796136
1747352239165465,78824524,1,854,25,79296280,78714944,581336,43.00438988811978
1747352239260392,78917084,1,855,25,79391207,78807504,583703,42.83000087373202
1747352239354484,79009644,1,856,25,79485299,78900064,585235,42.71788255999727
1747352239447605,79102204,1,857,25,79578420,78992624,585796,42.67697287110189
1747352239538379,79194764,1,858,25,79669194,79085184,584010,42.80748617318197
1747352239632377,79287332,1,859,25,79763192,79177752,585440,42.70292429625581
1747352239727285,79379884,1,860,25,79858100,79270304,587796,42.5317627203996
1747352239821210,79472444,1,861,25,79952025,79362864,589161,42.43322283722106
1747352239911216,79565004,1,862,25,80042031,79455424,586607,42.61797080498528
1747352240005477,79657564,1,863,25,80136292,79547984,588308,42.49474764919056
1747352240100039,79750124,1,864,25,80230854,79640544,590310,42.35062933035185
1747352240193590,79842684,1,865,25,80324405,79733104,591301,42.2796511421425
1747352240287548,79935244,1,866,25,80418363,79825664,592699,42.17992606702559
1747352240378291,80027804,1,867,25,80509106,79918224,590882,42.30963204159206
1747352240472061,80120364,1,868,25,80602876,80010784,592092,42.2231680211859
1747352240566470,80212924,1,869,25,80697285,80103344,593941,42.09172291523905
1747352240660906,80305484,1,870,25,80791721,80195904,595817,41.95919216806502
1747352240751262,80398044,1,871,25,80882077,80288464,593613,42.11498063553191
1747352240845157,80490604,1,872,25,80975972,80381024,594948,42.02047910069451
1747352240939442,80583164,1,873,25,81070257,80473584,596673,41.89899660282936
1747352241033508,80675724,1,874,25,81164323,80566144,598179,41.793509969423866
1747352241123386,80768284,1,875,25,81254201,80658704,595497,41.98173962253378
1747352241217855,80860844,1,876,25,81348670,80751264,597406,41.84758773765245
1747352241311306,80953404,1,877,25,81442121,80843824,598297,41.78526718335542
1747352241406008,81045964,1,878,25,81536823,80936384,600439,41.63620284491847
1747352241496739,81138524,1,879,25,81627554,81028944,598610,41.76341858639181
1747352241590273,81231084,1,880,25,81721088,81121504,599584,41.69557559908203
1747352241688592,81323644,1,881,25,81819407,81214064,605343,41.2988999625006
1747352241778592,81416212,1,882,25,81909407,81306632,602775,41.474845506200495
1747352241873370,81508764,1,883,25,82004185,81399184,605001,41.322245748354135
1747352241966868,81601324,1,884,25,82097683,81491744,605939,41.25827847357572
1747352242057085,81693884,1,885,25,82187900,81584304,603596,41.41843219636976
1747352242151726,81786444,1,886,25,82282541,81676864,605677,41.27612572377687
1747352242245230,81879004,1,887,25,82376045,81769424,606621,41.21189342274666
1747352242335968,81971564,1,888,25,82466783,81861984,604799,41.3360471826177
1747352242429627,82064124,1,889,25,82560442,81954544,605898,41.26107034517361
1747352242524321,82156684,1,890,25,82655136,82047104,608032,41.1162570391032
1747352242617782,82249244,1,891,25,82748597,82139664,608933,41.055419890201385
1747352242708535,82341804,1,892,25,82839350,82232224,607126,41.1776138725734
1747352242802521,82434364,1,893,25,82933336,82324784,608552,41.0811237166257
1747352242896883,82526924,1,894,25,83027698,82417344,610354,40.95983642279727
1747352242991338,82619484,1,895,25,83122153,82509904,612249,40.83305975183299
1747352243085414,82712044,1,896,25,83216229,82602464,613765,40.732202064308
1747352243174967,82804604,1,897,25,83305782,82695024,610758,40.932742591992245
1747352243269594,82897164,1,898,25,83400409,82787584,612825,40.79468037367928
1747352243363737,82989724,1,899,25,83494552,82880144,614408,40.68957435450059
1747352243457805,83082284,1,900,25,83588620,82972704,615916,40.58995057767618
1747352243548163,83174844,1,901,25,83678978,83065264,613714,40.73558693463079
1747352243642565,83267404,1,902,25,83773380,83157824,615556,40.61368908758911
1747352243736928,83359964,1,903,25,83867743,83250384,617359,40.495076608585926
1747352243830730,83452524,1,904,25,83961545,83342944,618601,40.41377236700232
1747352243920867,83545084,1,905,25,84051682,83435504,616178,40.57269165728085
1747352244014865,83637644,1,906,25,84145680,83528064,617616,40.47822595269552
1747352244109139,83730204,1,907,25,84239954,83620624,619330,40.36620218623351
1747352244203414,83822764,1,908,25,84334229,83713184,621045,40.25473194373999
1747352244293439,83915324,1,909,25,84424254,83805744,618510,40.4197183554025
1747352244387350,84007884,1,910,25,84518165,83898304,619861,40.331622734774406
1747352244481802,84100444,1,911,25,84612617,83990864,621753,40.20889324217173
1747352244576259,84193004,1,912,25,84707074,84083424,623650,40.08658702798044
1747352244670413,84285564,1,913,25,84801228,84175984,625244,39.98439009410726
1747352244760692,84378124,1,914,25,84891507,84268544,622963,40.1307942847328
1747352244854830,84470684,1,915,25,84985645,84361104,624541,40.02939758958979
1747352244949109,84563244,1,916,25,85079924,84453664,626260,39.91952224315779
1747352245043212,84655804,1,917,25,85174027,84546224,627803,39.82140894516274
1747352245133200,84748364,1,918,25,85264015,84638784,625231,39.98522146214759
1747352245227381,84840924,1,919,25,85358196,84731344,626852,39.88182218450288
1747352245321476,84933484,1,920,25,85452291,84823904,628387,39.78440037747439
1747352245416173,85026044,1,921,25,85546988,84916464,630524,39.64956131725359
1747352245506083,85118604,1,922,25,85636898,85009024,627874,39.81690593972676
1747352245600442,85211172,1,923,25,85731257,85101592,629665,39.70365194190561
1747352245694651,85303724,1,924,25,85825466,85194144,631322,39.5994437070148
1747352245788810,85396284,1,925,25,85919625,85286704,632921,39.49940039910194
1747352245878914,85488844,1,926,25,86009729,85379264,630465,39.65327179145551
1747352245973102,85581404,1,927,25,86103917,85471824,632093,39.551141999674094
1747352246066877,85673964,1,928,25,86197692,85564384,633308,39.47526322105516
1747352246160956,85766524,1,929,25,86291771,85656944,634827,39.38080768461329
1747352246255175,85859084,1,930,25,86385990,85749504,636486,39.278161656344366
1747352246345597,85951644,1,931,25,86476412,85842064,634348,39.41054436996727
1747352246439638,86044204,1,932,25,86570453,85934624,635829,39.31874765070483
1747352246533538,86136764,1,933,25,86664353,86027184,637169,39.236058251421525
1747352246628236,86229324,1,934,25,86759051,86119744,639307,39.104843213041626
1747352246718389,86321884,1,935,25,86849204,86212304,636900,39.25262992620505
1747352246812370,86414444,1,936,25,86943185,86304864,638321,39.16524757919605
1747352246906233,86507004,1,937,25,87037048,86397424,639624,39.08546270934174
1747352247000298,86599564,1,938,25,87131113,86489984,641129,38.99371265377171
1747352247090957,86692124,1,939,25,87221772,86582544,639228,39.109676046731366
1747352247185371,86784684,1,940,25,87316186,86675104,641082,38.99657142144063
1747352247279170,86877244,1,941,25,87409985,86767664,642321,38.92134929420025
1747352247373285,86969804,1,942,25,87504100,86860224,643876,38.82735185035628
1747352247463598,87062364,1,943,25,87594413,86952784,641629,38.96332615888621
1747352247557463,87154924,1,944,25,87688278,87045344,642934,38.884240061965926
1747352247651821,87247484,1,945,25,87782636,87137904,644732,38.77580141826371
1747352247745771,87340052,1,946,25,87876586,87230472,646114,38.69286225031496
1747352247840306,87432604,1,947,25,87971121,87323024,648097,38.57447264838442
1747352247930345,87525164,1,948,25,88061160,87415584,645576,38.72510750089842
1747352248024321,87617724,1,949,25,88155136,87508144,646992,38.64035413111754
1747352248118694,87710284,1,950,25,88249509,87600704,648805,38.53237875787024
1747352248213057,87802844,1,951,25,88343872,87693264,650608,38.425595750436514
1747352248303176,87895404,1,952,25,88433991,87785824,648167,38.57030672650721
1747352248397650,87987964,1,953,25,88528465,87878384,650081,38.45674615932476
1747352248491582,88080524,1,954,25,88622397,87970944,651453,38.37575389168521
1747352248585636,88173084,1,955,25,88716451,88063504,652947,38.28794680119519
1747352248676306,88265644,1,956,25,88807121,88156064,651057,38.39909562449985
1747352248770127,88358204,1,957,25,88900942,88248624,652318,38.32486609291787
1747352248864563,88450764,1,958,25,88995378,88341184,654194,38.21496375692837
1747352248958446,88543324,1,959,25,89089261,88433744,655517,38.13783624223323
1747352249048840,88635884,1,960,25,89179655,88526304,653351,38.264271425313495
1747352249146511,88728444,1,961,25,89277326,88618864,658462,37.96726310705857
1747352249236684,88821004,1,962,25,89367499,88711424,656075,38.10539953511413
1747352249331584,88913564,1,963,25,89462399,88803984,658415,37.96997334507872
1747352249425474,89006124,1,964,25,89556289,88896544,659745,37.89342852162578
1747352249515315,89098684,1,965,25,89646130,88989104,657026,38.050244586972205
1747352249609447,89191244,1,966,25,89740262,89081664,658598,37.95942289530184
1747352249703582,89283804,1,967,25,89834397,89174224,660173,37.86886164687135
1747352249798607,89376364,1,968,25,89929422,89266784,662638,37.72799024505085
1747352249888565,89468924,1,969,25,90019380,89359344,660036,37.87672187577648
1747352249982774,89561484,1,970,25,90113589,89451904,661685,37.78232844933768
1747352250077124,89654044,1,971,25,90207939,89544464,663475,37.68039489053845
1747352250170696,89746604,1,972,25,90301511,89637024,664487,37.62300842604896
1747352250265402,89839164,1,973,25,90396217,89729584,666633,37.5018938456392
1747352250355183,89931724,1,974,25,90485998,89822144,663854,37.658882826645616
1747352250449724,90024284,1,975,25,90580539,89914704,665835,37.54683968250393
1747352250543723,90116844,1,976,25,90674538,90007264,667274,37.46586859371113
1747352250634374,90209404,1,977,25,90765189,90099824,665365,37.57336198928408
1747352250728030,90301964,1,978,25,90858845,90192384,666461,37.51157232006074
1747352250822235,90394524,1,979,25,90953050,90284944,668106,37.41921192146157
1747352250916249,90487084,1,980,25,91047064,90377504,669560,37.33795328275285
1747352251010628,90579644,1,981,25,91141443,90470064,671379,37.23679173760276
1747352251100390,90672204,1,982,25,91231205,90562624,668581,37.39262707136458
1747352251194770,90764764,1,983,25,91325585,90655184,670401,37.2911138259042
1747352251289078,90857324,1,984,25,91419893,90747744,672149,37.194134038732486
1747352251382818,90949884,1,985,25,91513633,90840304,673329,37.128951819986966
1747352251473339,91042444,1,986,25,91604154,90932864,671290,37.241728612075256
1747352251567953,91135012,1,987,25,91698768,91025432,673336,37.12856582746207
1747352251661282,91227564,1,988,25,91792097,91117984,674113,37.08577048655048
1747352251755679,91320124,1,989,25,91886494,91210544,675950,36.984984096456834
1747352251845963,91412684,1,990,25,91976778,91303104,673674,37.10993744748944
1747352251940210,91505244,1,991,25,92071025,91395664,675361,37.01723966885858
1747352252034254,91597804,1,992,25,92165069,91488224,676845,36.9360784226817
1747352252128778,91690364,1,993,25,92259593,91580784,678809,36.82921116249195
1747352252223160,91782924,1,994,25,92353975,91673344,680631,36.73062202573788
1747352252312554,91875484,1,995,25,92443369,91765904,677465,36.902275394300815
1747352252406936,91968044,1,996,25,92537751,91858464,679287,36.803295219840805
1747352252501753,92060604,1,997,25,92632568,91951024,681544,36.68141748735224
1747352252595882,92153164,1,998,25,92726697,92043584,683113,36.59716620822616
1747352252685715,92245724,1,999,25,92816530,92136144,680386,36.74384834491009
1747352252780249,92338284,1,1000,25,92911064,92228704,682360,36.63755202532388
1747352252874509,92431884,1,1001,25,93005324,92322304,683020,36.602149278205616
1747352252968565,92525484,1,1002,25,93099380,92415904,683476,36.57772913752641
1747352253063049,92619084,1,1003,25,93193864,92509504,684360,36.53048103337425
1747352253160547,92712684,1,1004,25,93291362,92603104,688258,36.32358795684176
1747352253255026,92806284,1,1005,25,93385841,92696704,689137,36.27725691698458
1747352253345862,92899884,1,1006,25,93476677,92790304,686373,36.42334415835121
1747352253443958,92993484,1,1007,25,93574773,92883904,690869,36.18631028458362
1747352253537651,93087084,1,1008,25,93668466,92977504,690962,36.18143978974242
1747352253632495,93180684,1,1009,25,93763310,93071104,692206,36.116416211359045
1747352253726392,93274284,1,1010,25,93857207,93164704,692503,36.10092663858496
1747352253820575,93367884,1,1011,25,93951390,93258304,693086,36.07055978623144
1747352253914568,93461484,1,1012,25,94045383,93351904,693479,36.05011831648832
1747352254008239,93555084,1,1013,25,94139054,93445504,693550,36.04642779900512
1747352254102763,93648684,1,1014,25,94233578,93539104,694474,35.99846790520595
1747352254201440,93742284,1,1015,25,94332255,93632704,699551,35.737208580932624
1747352254290444,93835884,1,1016,25,94421259,93726304,694955,35.97355224438993
1747352254385443,93929492,1,1017,25,94516258,93819912,696346,35.901692549393545
1747352254479351,94023084,1,1018,25,94610166,93913504,696662,35.88540784483724
1747352254574200,94116684,1,1019,25,94705015,94007104,697911,35.821186369035594
1747352254668439,94210284,1,1020,25,94799254,94100704,698550,35.78841886765443
1747352254762582,94303884,1,1021,25,94893397,94194304,699093,35.76062126212106
1747352254856690,94397484,1,1022,25,94987505,94287904,699601,35.73465446733209
1747352254950910,94491084,1,1023,25,95081725,94381504,700221,35.703013762797745
1747352255045112,94584684,1,1024,25,95175927,94475104,700823,35.67234522839576
1747352255139266,94678284,1,1025,25,95270081,94568704,701377,35.64416854273807
1747352255233443,94771884,1,1026,25,95364258,94662304,701954,35.61486935041328
1747352255327664,94865484,1,1027,25,95458479,94755904,702575,35.58338967370032
1747352255421305,94959084,1,1028,25,95552120,94849504,702616,35.581313263574984
1747352255515477,95052684,1,1029,25,95646292,94943104,703188,35.55237006319789
1747352255610001,95146284,1,1030,25,95740816,95036704,704112,35.505714999886386
1747352255703990,95239884,1,1031,25,95834805,95130304,704501,35.4861100268133
1747352255798074,95333484,1,1032,25,95928889,95223904,704985,35.46174741306553
1747352255892991,95427084,1,1033,25,96023806,95317504,706302,35.39562396821756
1747352255991311,95520684,1,1034,25,96122126,95411104,711022,35.16065606971373
1747352256080988,95614284,1,1035,25,96211803,95504704,707099,35.35572812293611
1747352256174969,95707884,1,1036,25,96305784,95598304,707480,35.33668796291061
1747352256273733,95801484,1,1037,25,96404548,95691904,712644,35.080629318425466
1747352256363825,95895084,1,1038,25,96494640,95785504,709136,35.25416845287787
1747352256457998,95988684,1,1039,25,96588813,95879104,709709,35.225705183392066
1747352256552183,96082284,1,1040,25,96682998,95972704,710294,35.19669320028045
1747352256650374,96175884,1,1041,25,96781189,96066304,714885,34.97065961658169
1747352256740316,96269484,1,1042,25,96871131,96159904,711227,35.15052156343896
1747352256834586,96363084,1,1043,25,96965401,96253504,711897,35.117439741985145
1747352256933275,96456684,1,1044,25,97064090,96347104,716986,34.86818431601175
1747352257022734,96550284,1,1045,25,97153549,96440704,712845,35.07073767789632
1747352257117655,96643884,1,1046,25,97248470,96534304,714166,35.005866983306404
1747352257210863,96737484,1,1047,25,97341678,96627904,713774,35.02509197589153
1747352257309610,96831084,1,1048,25,97440425,96721504,718921,34.77433542767564
1747352257399572,96924692,1,1049,25,97530387,96815112,715275,34.95159204501765
1747352257498053,97018284,1,1050,25,97628868,96908704,720164,34.71431507267789
1747352257588717,97111884,1,1051,25,97719532,97002304,717228,34.85641943705488
1747352257682073,97205484,1,1052,25,97812888,97095904,716984,34.868281579505265
1747352257776957,97299084,1,1053,25,97907772,97189504,718268,34.805949868294284
1747352257874681,97392684,1,1054,25,98005496,97283104,722392,34.60724924971483
1747352257969537,97486284,1,1055,25,98100352,97376704,723648,34.5471831608738
1747352258063222,97579884,1,1056,25,98194037,97470304,723733,34.543125710724816
1747352258157340,97673484,1,1057,25,98288155,97563904,724251,34.51841971913052
1747352258251325,97767084,1,1058,25,98382140,97657504,724636,34.50008004018569
1747352258346366,97860684,1,1059,25,98477181,97751104,726077,34.43160987057847
1747352258439875,97954284,1,1060,25,98570690,97844704,725986,34.435925761653806
1747352258534357,98047884,1,1061,25,98665172,97938304,726868,34.39414033909871
1747352258628614,98141484,1,1062,25,98759429,98031904,727525,34.363080306518675
1747352258722456,98235084,1,1063,25,98853271,98125504,727767,34.351653757315184
1747352258817266,98328684,1,1064,25,98948081,98219104,728977,34.29463481015176
1747352258911273,98422284,1,1065,25,99042088,98312704,729384,34.27549822864225
1747352259005676,98515884,1,1066,25,99136491,98406304,730187,34.23780483629536
1747352259099842,98609484,1,1067,25,99230657,98499904,730753,34.21128616646117
1747352259193968,98703084,1,1068,25,99324783,98593504,731279,34.18667840865114
1747352259288056,98796684,1,1069,25,99418871,98687104,731767,34.16388003285199
1747352259382248,98890284,1,1070,25,99513063,98780704,732359,34.13626377227562
1747352259476175,98983884,1,1071,25,99606990,98874304,732686,34.12102865347502
1747352259570592,99077484,1,1072,25,99701407,98967904,733503,34.08302351864955
1747352259664703,99171084,1,1073,25,99795518,99061504,734014,34.059295871740865
1747352259758451,99264684,1,1074,25,99889266,99155104,734162,34.05242984518404
1747352259852671,99358284,1,1075,25,99983486,99248704,734782,34.02369682436423
1747352259946651,99451884,1,1076,25,100077466,99342304,735162,34.00611021788395
1747352260041797,99545484,1,1077,25,100172612,99435904,736708,33.93474755262601
1747352260135403,99639084,1,1078,25,100266218,99529504,736714,33.93447117877494
1747352260230063,99732684,1,1079,25,100360878,99623104,737774,33.88571567986944
1747352260323779,99826284,1,1080,25,100454594,99716704,737890,33.880388675818885
1747352260417939,99919892,1,1081,25,100548754,99810312,738442,33.85506241519307
1747352260512544,100013484,1,1082,25,100643359,99903904,739455,33.80868342225017
1747352260610291,100108124,1,1083,25,100741106,99998544,742562,33.667222400284416
1747352260704517,100202764,1,1084,25,100835332,100093184,742148,33.686003330872005
1747352260799413,100297404,1,1085,25,100930228,100187824,742404,33.6743875302396
1747352260893543,100392044,1,1086,25,101024358,100282464,741894,33.69753630572561
1747352260991216,100486684,1,1087,25,101122031,100377104,744927,33.560335442264815
1747352261089696,100581324,1,1088,25,101220511,100471744,748767,33.38822357288716
1747352261180111,100675964,1,1089,25,101310926,100566384,744542,33.577689371452514
1747352261277952,100770604,1,1090,25,101408767,100661024,747743,33.43394722518298
1747352261372531,100865244,1,1091,25,101503346,100755664,747682,33.43667495004561
1747352261466892,100959884,1,1092,25,101597707,100850304,747403,33.44915661296516
1747352261561221,101054524,1,1093,25,101692036,100944944,747092,33.46308085215743
1747352261658689,101149164,1,1094,25,101789504,101039584,749920,33.33688926818861
1747352261753910,101243804,1,1095,25,101884725,101134224,750501,33.31108153087072
1747352261847418,101338444,1,1096,25,101978233,101228864,749369,33.36140139237145
1747352261945856,101433084,1,1097,25,102076671,101323504,753167,33.19316964232368
1747352262040109,101527724,1,1098,25,102170924,101418144,752780,33.21023406572969
1747352262134394,101622364,1,1099,25,102265209,101512784,752425,33.22590291391168
1747352262228595,101717012,1,1100,25,102359410,101607432,751978,33.24565346326621
1747352262327288,101811644,1,1101,25,102458103,101702064,756039,33.06707722749752
1747352262420854,101906284,1,1102,25,102551669,101796704,754965,33.11411787301398
1747352262515208,102000924,1,1103,25,102646023,101891344,754679,33.12666709952178
1747352262610092,102095564,1,1104,25,102740907,101985984,754923,33.11596017077238
1747352262707663,102190204,1,1105,25,102838478,102080624,757854,32.98788420988739
1747352262802152,102284844,1,1106,25,102932967,102175264,757703,32.9944582507922
1747352262896426,102379484,1,1107,25,103027241,102269904,757337,33.01040355878558
1747352262994858,102474124,1,1108,25,103125673,102364544,761129,32.84594332892322
1747352263088299,102568764,1,1109,25,103219114,102459184,759930,32.897766899582855
1747352263183466,102663404,1,1110,25,103314281,102553824,760457,32.874968604404984
1747352263277544,102758044,1,1111,25,103408359,102648464,759895,32.899282137663754
1747352263375109,102852684,1,1112,25,103505924,102743104,762820,32.773131276054634
1747352263469910,102947324,1,1113,25,103600725,102837744,762981,32.76621567247415
1747352263564042,103041964,1,1114,25,103694857,102932384,762473,32.7880462652448
1747352263658141,103136604,1,1115,25,103788956,103027024,761932,32.81132699505992
1747352263756419,103231244,1,1116,25,103887234,103121664,765570,32.65540708230469
1747352263850947,103325884,1,1117,25,103981762,103216304,765458,32.66018514405754
1747352263944944,103420524,1,1118,25,104075759,103310944,764815,32.68764341703549
1747352264042724,103515172,1,1119,25,104173539,103405592,767947,32.5543299212055
1747352264136784,103609804,1,1120,25,104267599,103500224,767375,32.57859586251833
1747352264231123,103704444,1,1121,25,104361938,103594864,767074,32.59137971043211
1747352264325366,103799084,1,1122,25,104456181,103689504,766677,32.60825614959103
1747352264424145,103893724,1,1123,25,104554960,103784144,770816,32.43316174028562
1747352264522288,103988364,1,1124,25,104653103,103878784,774319,32.28643491894168
1747352264616474,104083004,1,1125,25,104747289,103973424,773865,32.30537626071731
1747352264710939,104177644,1,1126,25,104841754,104068064,773690,32.31268337447815
1747352264804363,104272284,1,1127,25,104935178,104162704,772474,32.36354880552614
1747352264899576,104366924,1,1128,25,105030391,104257344,773047,32.33956020785282
1747352264993005,104461564,1,1129,25,105123820,104351984,771836,32.39030053016444
1747352265091688,104556204,1,1130,25,105222503,104446624,775879,32.221519077072585
1747352265185675,104650844,1,1131,25,105316490,104541264,775226,32.24866039064737
1747352265284447,104745484,1,1132,25,105415262,104635904,779358,32.07768445310114
1747352265374599,104840124,1,1133,25,105505414,104730544,774870,32.26347645411489
1747352265472824,104934764,1,1134,25,105603639,104825184,778455,32.11489424565325
1747352265570636,105029404,1,1135,25,105701451,104919824,781627,31.98456552805878
1747352265661035,105124044,1,1136,25,105791850,105014464,777386,32.15905611883929
1747352265759068,105218684,1,1137,25,105889883,105109104,780779,32.01930379787366
1747352265853010,105313324,1,1138,25,105983825,105203744,780081,32.04795399452108
1747352265947526,105407964,1,1139,25,106078341,105298384,779957,32.053049078346625
1747352266041441,105502604,1,1140,25,106172256,105393024,779232,32.082871339986035
1747352266140117,105597244,1,1141,25,106270932,105487664,783268,31.91755567698413
1747352266234092,105691884,1,1142,25,106364907,105582304,782603,31.944676930704325
1747352266332909,105786524,1,1143,25,106463724,105676944,786780,31.775083250718115
1747352266427052,105881164,1,1144,25,106557867,105771584,786283,31.7951678975636
1747352266520685,105975804,1,1145,25,106651500,105866224,785276,31.83594048461942
1747352266614875,106070444,1,1146,25,106745690,105960864,784826,31.854194432906148
1747352266709825,106165084,1,1147,25,106840640,106055504,785136,31.841617248476695
1747352266807826,106259724,1,1148,25,106938641,106150144,788497,31.705891081386486
1747352266902068,106354364,1,1149,25,107032883,106244784,788099,31.72190295889222
1747352266996149,106449004,1,1150,25,107126964,106339424,787540,31.744419331081595
1747352267090181,106543644,1,1151,25,107220996,106434064,786932,31.768945728474637
1747352267188057,106638284,1,1152,25,107318872,106528704,790168,31.638841360318317
1747352267282529,106732924,1,1153,25,107413344,106623344,790000,31.645569620253163
1747352267377017,106827564,1,1154,25,107507832,106717984,789848,31.65165955981404
1747352267475111,106922204,1,1155,25,107605926,106812624,793302,31.513849706669088
1747352267569482,107016844,1,1156,25,107700297,106907264,793033,31.524539331906745
1747352267664166,107111484,1,1157,25,107794981,107001904,793077,31.52279034696505
1747352267758180,107206124,1,1158,25,107888995,107096544,792451,31.547691907764644
1747352267856159,107300764,1,1159,25,107986974,107191184,795790,31.4153231380138
1747352267950462,107395404,1,1160,25,108081277,107285824,795453,31.428632489914552
1747352268044055,107490044,1,1161,25,108174870,107380464,794406,31.470054355077885
1747352268142597,107584684,1,1162,25,108273412,107475104,798308,31.31623383456009
1747352268236671,107679324,1,1163,25,108367486,107569744,797742,31.338452782979964
1747352268330960,107773972,1,1164,25,108461775,107664392,797383,31.35256206866713
1747352268425522,107868604,1,1165,25,108556337,107759024,797313,31.35531466312477
1747352268523444,107963244,1,1166,25,108654259,107853664,800595,31.226775086029768
1747352268617964,108057884,1,1167,25,108748779,107948304,800475,31.23145632280833
1747352268712454,108152524,1,1168,25,108843269,108042944,800325,31.23730984287633
1747352268806449,108247164,1,1169,25,108937264,108137584,799680,31.262505002000804
1747352268904709,108341804,1,1170,25,109035524,108232224,803300,31.12162330387153
1747352268998750,108436444,1,1171,25,109129565,108326864,802701,31.14484720960856
1747352269093159,108531084,1,1172,25,109223974,108421504,802470,31.153812603586427
1747352269191558,108625724,1,1173,25,109322373,108516144,806229,31.008559602792754
1747352269285496,108720364,1,1174,25,109416311,108610784,805527,31.035582916525456
1747352269380158,108815004,1,1175,25,109510973,108705424,805549,31.034735317156372
1747352269473680,108909644,1,1176,25,109604495,108800064,804431,31.07786746159708
1747352269571722,109004284,1,1177,25,109702537,108894704,807833,30.94699028140717
1747352269666149,109098924,1,1178,25,109796964,108989344,807620,30.95515217552809
1747352269760803,109193564,1,1179,25,109891618,109083984,807634,30.954615580820025
1747352269859276,109288204,1,1180,25,109990091,109178624,811467,30.80840009513634
1747352269952634,109382844,1,1181,25,110083449,109273264,810185,30.85714991020569
1747352270047308,109477484,1,1182,25,110178123,109367904,810219,30.85585502191383
1747352270141457,109572132,1,1183,25,110272272,109462552,809720,30.874870325544634
1747352270239827,109666764,1,1184,25,110370642,109557184,813458,30.73299420498661
1747352270333807,109761404,1,1185,25,110464622,109651824,812798,30.75794969967938
1747352270428205,109856044,1,1186,25,110559020,109746464,812556,30.767110205327388
1747352270522768,109950684,1,1187,25,110653583,109841104,812479,30.770026056058065
1747352270620418,110045324,1,1188,25,110751233,109935744,815489,30.6564527541144
1747352270714412,110139964,1,1189,25,110845227,110030384,814843,30.680756906545188
1747352270809413,110234604,1,1190,25,110940228,110125024,815204,30.667170426052863
1747352270907704,110329244,1,1191,25,111038519,110219664,818855,30.530435791440485
1747352271001448,110423884,1,1192,25,111132263,110314304,817959,30.56387911863553
1747352271096405,110518524,1,1193,25,111227220,110408944,818276,30.5520386764368
1747352271194489,110613164,1,1194,25,111325304,110503584,821720,30.423988706615397
1747352271287997,110707804,1,1195,25,111418812,110598224,820588,30.465958556547257
1747352271382682,110802444,1,1196,25,111513497,110692864,820633,30.464287933826693
1747352271476361,110897084,1,1197,25,111607176,110787504,819672,30.500004880000784
1747352271574773,110991724,1,1198,25,111705588,110882144,823444,30.360291653105737
1747352271669332,111086364,1,1199,25,111800147,110976784,823363,30.363278408186915
1747352271763945,111181004,1,1200,25,111894760,111071424,823336,30.364274123808507
1747352271857210,111275644,1,1201,25,111988025,111166064,821961,30.41506835482462
1747352271956406,111370284,1,1202,25,112087221,111260704,826517,30.247411728978356
1747352272050503,111464924,1,1203,25,112181318,111355344,825974,30.26729654928605
1747352272143883,111559564,1,1204,25,112274698,111449984,824714,30.31353899654911
1747352272238861,111654204,1,1205,25,112369676,111544624,825052,30.30112041422844
1747352272336955,111748844,1,1206,25,112467770,111639264,828506,30.174796561521585
1747352272430891,111843484,1,1207,25,112561706,111733904,827802,30.20045856376283
1747352272525026,111938124,1,1208,25,112655841,111828544,827297,30.218893577518116
1747352272623108,112032764,1,1209,25,112753923,111923184,830739,30.093687668449416
1747352272717829,112127404,1,1210,25,112848644,112017824,830820,30.090753713199007
1747352272811564,112222044,1,1211,25,112942379,112112464,829915,30.1235668713061
1747352272906486,112316684,1,1212,25,113037301,112207104,830197,30.11333454589694
1747352273004396,112411324,1,1213,25,113135211,112301744,833467,29.99518877172102
1747352273098234,112505964,1,1214,25,113229049,112396384,832665,30.02407931160791
1747352273193036,112600604,1,1215,25,113323851,112491024,832827,30.018239082066263
1747352273287223,112695244,1,1216,25,113418038,112585664,832374,30.03457580366518
1747352273384946,112789884,1,1217,25,113515761,112680304,835457,29.9237423350334
1747352273479539,112884524,1,1218,25,113610354,112774944,835410,29.925425838809687
1747352273573289,112979164,1,1219,25,113704104,112869584,834520,29.957340746776588
1747352273671737,113073804,1,1220,25,113802552,112964224,838328,29.82126327642641
1747352273766073,113168444,1,1221,25,113896888,113058864,838024,29.83208118144588
1747352273860848,113263084,1,1222,25,113991663,113153504,838159,29.827276208929334
1747352273954473,113357724,1,1223,25,114085288,113248144,837144,29.86344045946695
1747352274053368,113452364,1,1224,25,114184183,113342784,841399,29.712419434774706
1747352274147082,113547004,1,1225,25,114277897,113437424,840473,29.74515540653893
1747352274241235,113641644,1,1226,25,114372050,113532064,839986,29.76240080191813
1747352274339642,113736284,1,1227,25,114470457,113626704,843753,29.629524280209967
1747352274433385,113830932,1,1228,25,114564200,113721352,842848,29.661338699267244
1747352274528025,113925564,1,1229,25,114658840,113815984,842856,29.66105716753514
1747352274622262,114020204,1,1230,25,114753077,113910624,842453,29.675245978113917
1747352274720191,114114844,1,1231,25,114851006,114005264,845742,29.559842126795168
1747352274815253,114209484,1,1232,25,114946068,114099904,846164,29.545100004254493
1747352274909066,114304124,1,1233,25,115039881,114194544,845337,29.57400421370412
1747352275003534,114398764,1,1234,25,115134349,114289184,845165,29.580022835777623
1747352275101263,114493404,1,1235,25,115232078,114383824,848254,29.47230428621616
1747352275196061,114588044,1,1236,25,115326876,114478464,848412,29.466815650886595
1747352275290053,114682684,1,1237,25,115420868,114573104,847764,29.4893390141596
1747352275388385,114777324,1,1238,25,115519200,114667744,851456,29.36147023451593
1747352275482065,114871964,1,1239,25,115612880,114762384,850496,29.394612085183237
1747352275576641,114966604,1,1240,25,115707456,114857024,850432,29.396824202287775
1747352275670807,115061244,1,1241,25,115801622,114951664,849958,29.413218064892614
1747352275769221,115155884,1,1242,25,115900036,115046304,853732,29.283194257682737
1747352275863349,115250524,1,1243,25,115994164,115140944,853220,29.30076650805185
1747352275957528,115345164,1,1244,25,116088343,115235584,852759,29.316606450357018
1747352276052134,115439804,1,1245,25,116182949,115330224,852725,29.317775367205137
1747352276149802,115534444,1,1246,25,116280617,115424864,855753,29.21403722803192
1747352276244377,115629092,1,1247,25,116375192,115519512,855680,29.216529543754675
1747352276338826,115723724,1,1248,25,116469641,115614144,855497,29.222779273334684
1747352276436771,115818364,1,1249,25,116567586,115708784,858802,29.110318792923167
1747352276531134,115913004,1,1250,25,116661949,115803424,858525,29.119711132465568
1747352276625548,116007644,1,1251,25,116756363,115898064,858299,29.127378687380503
1747352276719294,116102284,1,1252,25,116850109,115992704,857405,29.157749255019507
1747352276817130,116196924,1,1253,25,116947945,116087344,860601,29.049466593694408
1747352276911608,116291564,1,1254,25,117042423,116181984,860439,29.05493591062237
1747352277006400,116386204,1,1255,25,117137215,116276624,860591,29.049804146220445
1747352277104368,116480844,1,1256,25,117235183,116371264,863919,28.93789811313329
1747352277198389,116575484,1,1257,25,117329204,116465904,863300,28.95864705200973
1747352277292782,116670124,1,1258,25,117423597,116560544,863053,28.96693482323797
1747352277387138,116764764,1,1259,25,117517953,116655184,862769,28.97646994734396
1747352277484468,116859404,1,1260,25,117615283,116749824,865459,28.88640594181816
1747352277578892,116954044,1,1261,25,117709707,116844464,865243,28.893617168818476
1747352277673390,117048684,1,1262,25,117804205,116939104,865101,28.898359844688656
1747352277768048,117143324,1,1263,25,117898863,117033744,865119,28.89775857425395
1747352277866280,117237964,1,1264,25,117997095,117128384,868711,28.77827033386247
1747352277960170,117332604,1,1265,25,118090985,117223024,867961,28.80313746815813
1747352278054846,117427244,1,1266,25,118185661,117317664,867997,28.801942863857825
1747352278152357,117521884,1,1267,25,118283172,117412304,870868,28.70699118580543
1747352278246716,117616524,1,1268,25,118377531,117506944,870587,28.7162569622565
1747352278340699,117711164,1,1269,25,118471514,117601584,869930,28.737944432310645
1747352278435367,117805804,1,1270,25,118566182,117696224,869958,28.737019488297136
1747352278533818,117900444,1,1271,25,118664633,117790864,873769,28.61168111938052
1747352278627649,117995084,1,1272,25,118758464,117885504,872960,28.63819648093842
1747352278722008,118089724,1,1273,25,118852823,117980144,872679,28.647417893635577
1747352278820634,118184364,1,1274,25,118951449,118074784,876665,28.517164481301293
1747352278914734,118279004,1,1275,25,119045549,118169424,876125,28.534741047224998
1747352279008447,118373644,1,1276,25,119139262,118264064,875198,28.564964727981558
1747352279103258,118468284,1,1277,25,119234073,118358704,875369,28.559384670921634
1747352279201403,118562924,1,1278,25,119332218,118453344,878874,28.44548820422495
1747352279295320,118657564,1,1279,25,119426135,118547984,878151,28.46890796685308
1747352279389329,118752204,1,1280,25,119520144,118642624,877520,28.48937915944936
1747352279483416,118846844,1,1281,25,119614231,118737264,876967,28.507344061977246
1747352279581838,118941484,1,1282,25,119712653,118831904,880749,28.384931461744493
1747352279675866,119036124,1,1283,25,119806681,118926544,880137,28.404668818604375
1747352279770938,119130764,1,1284,25,119901753,119021184,880569,28.390733718765933
1747352279869061,119225404,1,1285,25,119999876,119115824,884052,28.278879522923997
1747352279963416,119320044,1,1286,25,120094231,119210464,883767,28.28799898615812
1747352280057323,119414684,1,1287,25,120188138,119305104,883034,28.311480645139373
1747352280151127,119509324,1,1288,25,120281942,119399744,882198,28.33830954048864
1747352280249307,119603964,1,1289,25,120380122,119494384,885738,28.225050748641245
1747352280343515,119698604,1,1290,25,120474330,119589024,885306,28.2388236383804
1747352280438044,119793244,1,1291,25,120568859,119683664,885195,28.24236467670965
1747352280536291,119887892,1,1292,25,120667106,119778312,888794,28.128002664284413
1747352280630440,119982524,1,1293,25,120761255,119872944,888311,28.14329666074157
1747352280724368,120077164,1,1294,25,120855183,119967584,887599,28.165872201298107
1747352280818926,120171804,1,1295,25,120949741,120062224,887517,28.16847451936132
1747352280917718,120266444,1,1296,25,121048533,120156864,891669,28.03730980890891
1747352281011320,120361084,1,1297,25,121142135,120251504,890631,28.06998633553065
1747352281105798,120455724,1,1298,25,121236613,120346144,890469,28.075093012783157
1747352281200119,120550364,1,1299,25,121330934,120440784,890150,28.08515418749649
1747352281298245,120645004,1,1300,25,121429060,120535424,893636,27.975596327811324
1747352281392282,120739644,1,1301,25,121523097,120630064,893033,27.994486205996868
1747352281486449,120834284,1,1302,25,121617264,120724704,892560,28.00932150219593
1747352281584773,120928924,1,1303,25,121715588,120819344,896244,27.8941895287444
1747352281679294,121023564,1,1304,25,121810109,120913984,896125,27.89789370902497
1747352281773035,121118204,1,1305,25,121903850,121008624,895226,27.92590921175212
1747352281867595,121212844,1,1306,25,121998410,121103264,895146,27.928404975277772
1747352281966136,121307484,1,1307,25,122096951,121197904,899047,27.807222536752803
1747352282059761,121402124,1,1308,25,122190576,121292544,898032,27.8386516293406
1747352282154237,121496764,1,1309,25,122285052,121387184,897868,27.8437364957878
1747352282252355,121591404,1,1310,25,122383170,121481824,901346,27.736296605299188
1747352282347289,121686052,1,1311,25,122478104,121576472,901632,27.727498580352076
1747352282445187,121780684,1,1312,25,122576002,121671104,904898,27.627423201288984
1747352282535646,121875324,1,1313,25,122666461,121765744,900717,27.755665764052416
1747352282633823,121969964,1,1314,25,122764638,121860384,904254,27.64709915576818
1747352282727985,122064604,1,1315,25,122858800,121955024,903776,27.661721488510427
1747352282822569,122159244,1,1316,25,122953384,122049664,903720,27.66343557739123
1747352282916171,122253884,1,1317,25,123046986,122144304,902682,27.69524594486209
1747352283013944,122348524,1,1318,25,123144759,122238944,905815,27.59945463477641
1747352283108651,122443164,1,1319,25,123239466,122333584,905882,27.597413349641567
1747352283203266,122537804,1,1320,25,123334081,122428224,905857,27.5981749878844
1747352283300842,122632444,1,1321,25,123431657,122522864,908793,27.50901470411854
1747352283395475,122727084,1,1322,25,123526290,122617504,908786,27.50922659459983
1747352283489388,122821724,1,1323,25,123620203,122712144,908059,27.531250722695333
1747352283584573,122916364,1,1324,25,123715388,122806784,908604,27.51473689307993
1747352283682518,123011004,1,1325,25,123813333,122901424,911909,27.415016191308563
1747352283776406,123105644,1,1326,25,123907221,122996064,911157,27.43764246995853
1747352283870463,123200284,1,1327,25,124001278,123090704,910574,27.455209571105694
1747352283964968,123294924,1,1328,25,124095783,123185344,910439,27.459280632749696
1747352284062593,123389564,1,1329,25,124193408,123279984,913424,27.36954579691359
1747352284156709,123484204,1,1330,25,124287524,123374624,912900,27.38525577828897
1747352284251314,123578844,1,1331,25,124382129,123469264,912865,27.386305751671934
1747352284349334,123673484,1,1332,25,124480149,123563904,916245,27.28527850083766
1747352284444684,123768124,1,1333,25,124575499,123658544,916955,27.26415145781418
1747352284538298,123862764,1,1334,25,124669113,123753184,915929,27.294692055825287
1747352284632507,123957404,1,1335,25,124763322,123847824,915498,27.30754190615381
1747352284730430,124052044,1,1336,25,124861245,123942464,918781,27.209966248757866
1747352284824801,124146684,1,1337,25,124955616,124037104,918512,27.21793509502325
1747352284923134,124241324,1,1338,25,125053949,124131744,922205,27.108939986228656
1747352285017104,124335964,1,1339,25,125147919,124226384,921535,27.128649481571507
1747352285111007,124430604,1,1340,25,125241822,124321024,920798,27.15036305465477
1747352285205902,124525244,1,1341,25,125336717,124415664,921053,27.14284628571863
1747352285299672,124619884,1,1342,25,125430487,124510304,920183,27.16850887269163
1747352285397827,124714524,1,1343,25,125528642,124604944,923698,27.06512301639713
1747352285492453,124809164,1,1344,25,125623268,124699584,923684,27.06553323430957
1747352285586521,124903804,1,1345,25,125717336,124794224,923112,27.082304205773514
1747352285684784,124998444,1,1346,25,125815599,124888864,926735,26.97642799721603
1747352285778792,125093084,1,1347,25,125909607,124983504,926103,26.994837507275108
1747352285873118,125187724,1,1348,25,126003933,125078144,925789,27.00399335053668
1747352285971199,125282364,1,1349,25,126102014,125172784,929230,26.90399578145346
1747352286065688,125377004,1,1350,25,126196503,125267424,929079,26.90836839493735
1747352286159519,125471644,1,1351,25,126290334,125362064,928270,26.93181940599179
1747352286254186,125566284,1,1352,25,126385001,125456704,928297,26.93103608004765
1747352286450243,125758684,1,1354,25,126581058,125649104,931954,26.825358333136617
1747352286544980,125853324,1,1355,25,126675795,125743744,932051,26.822566576292505
1747352286639311,125947964,1,1356,25,126770126,125838384,931742,26.83146192830204
1747352286733139,126042604,1,1357,25,126863954,125933024,930930,26.854865564542983
1747352286831926,126137244,1,1358,25,126962741,126027664,935077,26.735766145461817
1747352286925930,126231884,1,1359,25,127056745,126122304,934441,26.753963064548756
1747352287020063,126326524,1,1360,25,127150878,126216944,933934,26.76848685239
1747352287114529,126421164,1,1361,25,127245344,126311584,933760,26.773474982864972
1747352287212749,126515804,1,1362,25,127343564,126406224,937340,26.671218554633324
1747352287305467,126610452,1,1363,25,127436282,126500872,935410,26.72624838306197
1747352287405140,126705084,1,1364,25,127535955,126595504,940451,26.582990501365835
1747352287495156,126799724,1,1365,25,127625971,126690144,935827,26.714339295617677
1747352287593204,126894364,1,1366,25,127724019,126784784,939235,26.617406719298152
1747352287691271,126989004,1,1367,25,127822086,126879424,942662,26.520640484075948
1747352287781748,127083644,1,1368,25,127912563,126974064,938499,26.63828091452415
1747352287879644,127178284,1,1369,25,128010459,127068704,941755,26.54618239350999
1747352287974036,127272924,1,1370,25,128104851,127163344,941507,26.553174856904945
1747352288068043,127367564,1,1371,25,128198858,127257984,940874,26.571039267744677
1747352288162893,127462204,1,1372,25,128293708,127352624,941084,26.565110022059667
1747352288261071,127556844,1,1373,25,128391886,127447264,944622,26.465612700106497
1747352288355005,127651484,1,1374,25,128485820,127541904,943916,26.4854075998288
1747352288449097,127746124,1,1375,25,128579912,127636544,943368,26.50079290372368
1747352288547886,127840764,1,1376,25,128678701,127731184,947517,26.384750880459137
1747352288641966,127935404,1,1377,25,128772781,127825824,946957,26.400353975946107
1747352288736190,128030044,1,1378,25,128867005,127920464,946541,26.411956798490504
1747352288830186,128124684,1,1379,25,128961001,128015104,945897,26.42993898912884
1747352288928048,128219324,1,1380,25,129058863,128109744,949119,26.340216558724457
1747352289022273,128313964,1,1381,25,129153088,128204384,948704,26.35173879313253
1747352289121423,128408612,1,1382,25,129252238,128299032,953206,26.227279307935536
1747352289210998,128503244,1,1383,25,129341813,128393664,948149,26.367163810751265
1747352289309452,128597884,1,1384,25,129440267,128488304,951963,26.261524870189284
1747352289403705,128692524,1,1385,25,129534520,128582944,951576,26.272205267892424
1747352289497938,128787164,1,1386,25,129628753,128677584,951169,26.28344700048046
1747352289595738,128881804,1,1387,25,129726553,128772224,954329,26.19641653978869
1747352289689931,128976444,1,1388,25,129820746,128866864,953882,26.208692479782613
1747352289784064,129071084,1,1389,25,129914879,128961504,953375,26.22263012980202
1747352289879140,129165724,1,1390,25,130009955,129056144,953811,26.210643408390133
1747352289977092,129260364,1,1391,25,130107907,129150784,957123,26.11994487646833
1747352290070877,129355004,1,1392,25,130201692,129245424,956268,26.14329874052044
1747352290165150,129449644,1,1393,25,130295965,129340064,955901,26.153335962615376
1747352290263571,129544284,1,1394,25,130394386,129434704,959682,26.050295827159413
1747352290358072,129638924,1,1395,25,130488887,129529344,959543,26.054069489329816
1747352290455780,129733564,1,1396,25,130586595,129623984,962611,25.97103087332266
1747352290546049,129828204,1,1397,25,130676864,129718624,958240,26.089497411921855
1747352290644968,129922844,1,1398,25,130775783,129813264,962519,25.97351325012805
1747352290738676,130017484,1,1399,25,130869491,129907904,961587,25.998687586250647
1747352290836861,130112124,1,1400,25,130967676,130002544,965132,25.903192516671297
1747352290931498,130206764,1,1401,25,131062313,130097184,965129,25.90327303396748
1747352291025950,130301404,1,1402,25,131156765,130191824,964941,25.908319783282085
1747352291120072,130396044,1,1403,25,131250887,130286464,964423,25.9222353676758
1747352291218143,130490684,1,1404,25,131348958,130381104,967854,25.830342179708925
1747352291311940,130585324,1,1405,25,131442755,130475744,967011,25.8528599984902
1747352291406930,130679964,1,1406,25,131537745,130570384,967361,25.843506198823395
1747352291500120,130774604,1,1407,25,131630935,130665024,965911,25.88230178556824
1747352291595343,130869244,1,1408,25,131726158,130759664,966494,25.866689291397567
1747352291692849,130963884,1,1409,25,131823664,130854304,969360,25.7902120987043
1747352291787409,131058524,1,1410,25,131918224,130948944,969280,25.7923407065038
1747352291885594,131153164,1,1411,25,132016409,131043584,972825,25.698352735589648
1747352291980119,131247804,1,1412,25,132110934,131138224,972710,25.70139095927872
1747352292074269,131342444,1,1413,25,132205084,131232864,972220,25.714344489930262
1747352292172822,131437084,1,1414,25,132303637,131327504,976133,25.611264038814383
1747352292262298,131531724,1,1415,25,132393113,131422144,970969,25.747474945132133
1747352292360519,131626364,1,1416,25,132491334,131516784,974550,25.65286542506798
1747352292459003,131721004,1,1417,25,132589818,131611424,978394,25.55207820162429
1747352292557429,131815644,1,1418,25,132688244,131706064,982180,25.45358284632145
1747352292647848,131910284,1,1419,25,132778663,131800704,977959,25.56344386625615
1747352292745886,132004924,1,1420,25,132876701,131895344,981357,25.474929103272306
1747352292835967,132099564,1,1421,25,132966782,131989984,976798,25.59382799719082
1747352292930096,132194204,1,1422,25,133060911,132084624,976287,25.607224105206768
1747352293028648,132288844,1,1423,25,133159463,132179264,980199,25.505025000025505
1747352293122649,132383484,1,1424,25,133253464,132273904,979560,25.521662787373923
1747352293221170,132478124,1,1425,25,133351985,132368544,983441,25.42094543546588
1747352293315493,132572764,1,1426,25,133446308,132463184,983124,25.429142203831866
1747352293409405,132667412,1,1427,25,133540220,132557832,982388,25.44819358542653
1747352293503646,132762044,1,1428,25,133634461,132652464,981997,25.458326247432527
1747352293597439,132856684,1,1429,25,133728254,132747104,981150,25.48030372522041
1747352293691617,132951324,1,1430,25,133822432,132841744,980688,25.49230744130651
1747352293790470,133045964,1,1431,25,133921285,132936384,984901,25.38326187099008
1747352293888650,133140604,1,1432,25,134019465,133031024,988441,25.292354323626803
1747352293982489,133235244,1,1433,25,134113304,133125664,987640,25.31286703657203
1747352294080511,133329884,1,1434,25,134211326,133220304,991022,25.226483367674987
1747352294171249,133424524,1,1435,25,134302064,133314944,987120,25.326201474997973
1747352294264907,133519164,1,1436,25,134395722,133409584,986138,25.35142140349525
1747352294359641,133613804,1,1437,25,134490456,133504224,986232,25.349005102247748
1747352294457406,133708444,1,1438,25,134588221,133598864,989357,25.2689372996805
1747352294551667,133803084,1,1439,25,134682482,133693504,988978,25.278620960223584
1747352294650696,133897724,1,1440,25,134781511,133788144,993367,25.1669322616918
1747352294744527,133992364,1,1441,25,134875342,133882784,992558,25.18744496543275
1747352294838959,134087004,1,1442,25,134969774,133977424,992350,25.19272434121026
1747352294937262,134181644,1,1443,25,135068077,134072064,996013,25.100073995018136
1747352295030928,134276284,1,1444,25,135161743,134166704,995039,25.124643355687567
1747352295125053,134370924,1,1445,25,135255868,134261344,994524,25.137653792165903
1747352295220034,134465572,1,1446,25,135350849,134355992,994857,25.129239679672555
1747352295317902,134560204,1,1447,25,135448717,134450624,998093,25.047766089933504
1747352295412390,134654844,1,1448,25,135543205,134545264,997941,25.051581205702544
1747352295518569,134752604,1,1449,25,135649384,134643024,1006360,24.84200484915935
1747352295604934,134847244,1,1450,25,135735749,134737664,998085,25.047966856530252
1747352295703135,134941884,1,1451,25,135833950,134832304,1001646,24.958917621594853
1747352295797120,135036524,1,1452,25,135927935,134926944,1000991,24.97524952771803
1747352295890518,135131172,1,1453,25,136021333,135021592,999741,25.006476677459464
1747352295989743,135225804,1,1454,25,136120558,135116224,1004334,24.89211756248419
1747352296083344,135320444,1,1455,25,136214159,135210864,1003295,24.91789553421476
1747352296177578,135415084,1,1456,25,136308393,135305504,1002889,24.92798305694848
1747352296276445,135509724,1,1457,25,136407260,135400144,1007116,24.82335699164744
1747352296366102,135604364,1,1458,25,136496917,135494784,1002133,24.946788500129227
1747352296464214,135699004,1,1459,25,136595029,135589424,1005605,24.860656022991133
1747352296558641,135793644,1,1460,25,136689456,135684064,1005392,24.86592294348871
1747352296652680,135888284,1,1461,25,136783495,135778704,1004791,24.88079610585684
1747352296747364,135982924,1,1462,25,136878179,135873344,1004835,24.87970661849956
1747352296841512,136077564,1,1463,25,136972327,135967984,1004343,24.891894502177045
1747352296943747,136172204,1,1464,25,137074562,136062624,1011938,24.705070864025267
1747352297038444,136266844,1,1465,25,137169259,136157264,1011995,24.70367936600477
1747352297132550,136361484,1,1466,25,137263365,136251904,1011461,24.71672165313344
1747352297226145,136456124,1,1467,25,137356960,136346544,1010416,24.742284366043293
1747352297320138,136550764,1,1468,25,137450953,136441184,1009769,24.75813775229781
1747352297414789,136645404,1,1469,25,137545604,136535824,1009780,24.75786805046644
1747352297513021,136740044,1,1470,25,137643836,136630464,1013372,24.67011127206988
1747352297607257,136834684,1,1471,25,137738072,136725104,1012968,24.679950403171667
1747352297704735,136929324,1,1472,25,137835550,136819744,1015806,24.610998556811044
1747352297799800,137023964,1,1473,25,137930615,136914384,1016231,24.600705941857704
1747352297890509,137118604,1,1474,25,138021324,137009024,1012300,24.696236293588857
1747352297987925,137213244,1,1475,25,138118740,137103664,1015076,24.628697752680587
1747352298082731,137307884,1,1476,25,138213546,137198304,1015242,24.62467076815183
1747352298176515,137402524,1,1477,25,138307330,137292944,1014386,24.645450548410565
1747352298275002,137497164,1,1478,25,138405817,137387584,1018233,24.55233723519077
1747352298368837,137591804,1,1479,25,138499652,137482224,1017428,24.57176330904988
1747352298467082,137686444,1,1480,25,138597897,137576864,1021033,24.48500685090492
1747352298558034,137781084,1,1481,25,138688849,137671504,1017345,24.573767994141612
1747352298655383,137875724,1,1482,25,138786198,137766144,1020054,24.508506412405616
1747352298749489,137970364,1,1483,25,138880304,137860784,1019520,24.52134337727558
1747352298844439,138065004,1,1484,25,138975254,137955424,1019830,24.513889569830265
1747352298937932,138159644,1,1485,25,139068747,138050064,1018683,24.5414913177112
1747352299037217,138254284,1,1486,25,139168032,138144704,1023328,24.43009474967948
1747352299130579,138348924,1,1487,25,139261394,138239344,1022050,24.460642825693466
1747352299228754,138443564,1,1488,25,139359569,138333984,1025585,24.376331557111307
1747352299322953,138538204,1,1489,25,139453768,138428624,1025144,24.386817851931045
1747352299417359,138632844,1,1490,25,139548174,138523264,1024910,24.392385672888352
1747352299516197,138727484,1,1491,25,139647012,138617904,1029108,24.292882768378053
1747352299606212,138822124,1,1492,25,139737027,138712544,1024483,24.40255231175139
1747352299704584,138916764,1,1493,25,139835399,138807184,1028215,24.313981025369205
1747352299798457,139011404,1,1494,25,139929272,138901824,1027448,24.332131650458223
1747352299896991,139106044,1,1495,25,140027806,138996464,1031342,24.24026171725771
1747352400409688,109580,1,1,50,0,0,0,0.0
1747352400589891,288924,1,3,50,180203,179344,859,58207.217694994186
1747352400671489,377324,1,4,50,261801,267744,-5943,0.0
1747352400761928,465724,1,5,50,352240,356144,-3904,0.0
1747352400851490,554124,1,6,50,441802,444544,-2742,0.0
1747352400941624,642524,1,7,50,531936,532944,-1008,0.0
1747352401031542,730924,1,8,50,621854,621344,510,98039.2156862745
1747352401118375,819324,1,9,50,708687,709744,-1057,0.0
1747352401228589,907724,1,10,50,818901,798144,20757,2408.8259382377028
1747352401679229,1370524,1,15,50,1269541,1260944,8597,5815.982319413749
1747352401769466,1461004,1,16,50,1359778,1351424,8354,5985.156811108451
1747352401858946,1551484,1,17,50,1449258,1441904,7354,6799.020940984498
1747352401949840,1641964,1,18,50,1540152,1532384,7768,6436.663233779609
1747352402039263,1732444,1,19,50,1629575,1622864,6711,7450.454477723141
1747352402133515,1822924,1,20,50,1723827,1713344,10483,4769.627015167414
1747352402223528,1913404,1,21,50,1813840,1803824,10016,4992.012779552715
1747352402314275,2003884,1,22,50,1904587,1894304,10283,4862.3942429252165
1747352402408072,2094364,1,23,50,1998384,1984784,13600,3676.470588235294
1747352402498343,2184844,1,24,50,2088655,2075264,13391,3733.8510940183705
1747352402588859,2275324,1,25,50,2179171,2165744,13427,3723.840023832576
1747352402682801,2365804,1,26,50,2273113,2256224,16889,2960.506838770797
1747352402773017,2456284,1,27,50,2363329,2346704,16625,3007.518796992481
1747352402863271,2546764,1,28,50,2453583,2437184,16399,3048.966400390268
1747352402952976,2637244,1,29,50,2543288,2527664,15624,3200.2048131080387
1747352403047217,2727724,1,30,50,2637529,2618144,19385,2579.3139025019345
1747352403133159,2818204,1,31,50,2723471,2708624,14847,3367.6837071462246
1747352403227071,2908684,1,32,50,2817383,2799104,18279,2735.379397122381
1747352403317969,2999164,1,33,50,2908281,2889584,18697,2674.225811627534
1747352403416206,3089644,1,34,50,3006518,2980064,26454,1890.073334845392
1747352403497172,3180124,1,35,50,3087484,3070544,16940,2951.59386068477
1747352403592018,3270604,1,36,50,3182330,3161024,21306,2346.7567821271005
1747352403689833,3361084,1,37,50,3280145,3251504,28641,1745.7491009392131
1747352403776575,3451564,1,38,50,3366887,3341984,24903,2007.7902260771796
1747352403866253,3542052,1,39,50,3456565,3432472,24093,2075.291578466775
1747352403960169,3632524,1,40,50,3550481,3522944,27537,1815.7388241275376
1747352404046427,3723004,1,41,50,3636739,3613424,23315,2144.542140253056
1747352404140062,3813484,1,42,50,3730374,3703904,26470,1888.930865130336
1747352404230718,3903964,1,43,50,3821030,3794384,26646,1876.4542520453351
1747352404320899,3994444,1,44,50,3911211,3884864,26347,1897.7492693665315
1747352404419107,4084924,1,45,50,4009419,3975344,34075,1467.3514306676448
1747352404505256,4175404,1,46,50,4095568,4065824,29744,1681.0112963959118
1747352404591437,4265884,1,47,50,4181749,4156304,25445,1965.0225977598743
1747352404685190,4356364,1,48,50,4275502,4246784,28718,1741.068319520858
1747352404783807,4446844,1,49,50,4374119,4337264,36855,1356.66802333469
1747352404869843,4537324,1,50,50,4460155,4427744,32411,1542.686125080991
1747352404955100,4627804,1,51,50,4545412,4518224,27188,1839.0466382227453
1747352405057607,4718284,1,52,50,4647919,4608704,39215,1275.0223128904756
1747352405156019,4808764,1,53,50,4746331,4699184,47147,1060.5128640210403
1747352405238803,4899244,1,54,50,4829115,4789664,39451,1267.3949963245543
1747352405328587,4989724,1,55,50,4918899,4880144,38755,1290.1561088891756
1747352405426573,5080204,1,56,50,5016885,4970624,46261,1080.8240202330255
1747352405521068,5170684,1,57,50,5111380,5061104,50276,994.5103031267404
1747352405615067,5261164,1,58,50,5205379,5151584,53795,929.4544102611768
1747352405693060,5351644,1,59,50,5283372,5242064,41308,1210.4192892417934
1747352405782871,5442124,1,60,50,5373183,5332544,40639,1230.3452348729054
1747352405869050,5532604,1,61,50,5459362,5423024,36338,1375.9700588915184
1747352405959083,5623084,1,62,50,5549395,5513504,35891,1393.106907024045
1747352406052819,5713564,1,63,50,5643131,5603984,39147,1277.2370807469283
1747352406143843,5804052,1,64,50,5734155,5694472,39683,1259.9853841695435
1747352406237643,5894524,1,65,50,5827955,5784944,43011,1162.493315663435
1747352406331685,5985004,1,66,50,5921997,5875424,46573,1073.583406694866
1747352406418179,6075484,1,67,50,6008491,5965904,42587,1174.0672036067344
1747352406516221,6165964,1,68,50,6106533,6056384,50149,997.0288540150352
1747352406601720,6256444,1,69,50,6192032,6146864,45168,1106.9783917817924
1747352406704854,6346924,1,70,50,6295166,6237344,57822,864.7227698799765
1747352406786050,6437404,1,71,50,6376362,6327824,48538,1030.1207301495735
1747352406880828,6527884,1,72,50,6471140,6418304,52836,946.3244757362404
1747352407159473,6805564,1,75,50,6749785,6695984,53801,929.3507555621644
1747352407253131,6896044,1,76,50,6843443,6786464,56979,877.5162779269555
1747352407360163,6986524,1,77,50,6950475,6876944,73531,679.9853123172539
1747352407445534,7077004,1,78,50,7035846,6967424,68422,730.7591125661337
1747352407531941,7167484,1,79,50,7122253,7057904,64349,777.0128517925687
1747352407609456,7257964,1,80,50,7199768,7148384,51384,973.065545695158
1747352407699899,7348444,1,81,50,7290211,7238864,51347,973.7667244434924
1747352407793598,7438924,1,82,50,7383910,7329344,54566,916.3215188945496
1747352407884199,7529404,1,83,50,7474511,7419824,54687,914.2940735458152
1747352407973757,7619884,1,84,50,7564069,7510304,53765,929.9730307821072
1747352408064193,7710364,1,85,50,7654505,7600784,53721,930.7347219895386
1747352408157870,7800852,1,86,50,7748182,7691272,56910,878.5802143735723
1747352408265419,7891324,1,87,50,7855731,7781744,73987,675.7943963128658
1747352408338791,7981804,1,88,50,7929103,7872224,56879,879.0590551873275
1747352408429237,8072284,1,89,50,8019549,7962704,56845,879.5848359574281
1747352408522886,8162764,1,90,50,8113198,8053184,60014,833.1389342486754
1747352408613389,8253244,1,91,50,8203701,8143664,60037,832.8197611472925
1747352408703360,8343724,1,92,50,8293672,8234144,59528,839.9408681628813
1747352408813208,8434204,1,93,50,8403520,8324624,78896,633.7456905293044
1747352408891286,8524684,1,94,50,8481598,8415104,66494,751.9475441393208
1747352408977187,8615164,1,95,50,8567499,8505584,61915,807.5587498990552
1747352409067623,8705644,1,96,50,8657935,8596064,61871,808.1330510255208
1747352409161854,8796124,1,97,50,8752166,8686544,65622,761.9395934290329
1747352409248005,8886604,1,98,50,8838317,8777024,61293,815.7538381218084
1747352409354317,8977084,1,99,50,8944629,8867504,77125,648.2982171799027
1747352409432384,9067564,1,100,50,9022696,8957984,64712,772.6542217826677
1747352409530371,9159084,1,101,50,9120683,9049504,71179,702.4543755883054
1747352409620815,9250604,1,102,50,9211127,9141024,70103,713.2362381067858
1747352409714547,9342124,1,103,50,9304859,9232544,72315,691.4194842010647
1747352409813564,9433644,1,104,50,9403876,9324064,79812,626.472209692778
1747352409895066,9525164,1,105,50,9485378,9415584,69794,716.3939593661347
1747352409992911,9616684,1,106,50,9583223,9507104,76119,656.8662226251001
1747352410091860,9708204,1,107,50,9682172,9598624,83548,598.4583712356969
1747352410178057,9799724,1,108,50,9768369,9690144,78225,639.1818472355385
1747352410271861,9891244,1,109,50,9862173,9781664,80509,621.048578419804
1747352410362158,9982764,1,110,50,9952470,9873184,79286,630.6283580960069
1747352410464475,10074284,1,111,50,10054787,9964704,90083,555.0436819377685
1747352410558257,10166844,1,112,50,10148569,10057264,91305,547.6151360823613
1747352410636500,10259404,1,113,50,10226812,10149824,76988,649.451862627942
1747352410746731,10351964,1,114,50,10337043,10242384,94659,528.2117918000401
1747352410836968,10444524,1,115,50,10427280,10334944,92336,541.5006064806793
1747352410914495,10537084,1,116,50,10504807,10427504,77303,646.8054279911518
1747352411021801,10629644,1,117,50,10612113,10520064,92049,543.1889537094373
1747352411123289,10722204,1,118,50,10713601,10612624,100977,495.1622646741337
1747352411201800,10814764,1,119,50,10792112,10705184,86928,575.188661881097
1747352411287549,10907324,1,120,50,10877861,10797744,80117,624.0872723641675
1747352411385850,10999884,1,121,50,10976162,10890304,85858,582.3569149060075
1747352411479655,11092444,1,122,50,11069967,10982864,87103,574.0330413418596
1747352411570146,11185004,1,123,50,11160458,11075424,85034,588.0000940800151
1747352411660264,11277564,1,124,50,11250576,11167984,82592,605.3855094924448
1747352411766446,11370124,1,125,50,11356758,11260544,96214,519.6748913879477
1747352411857264,11462692,1,126,50,11447576,11353112,94464,529.3021680216801
1747352411942572,11555244,1,127,50,11532884,11445664,87220,573.2630130703967
1747352412040513,11647804,1,128,50,11630825,11538224,92601,539.9509724517013
1747352412127161,11740364,1,129,50,11717473,11630784,86689,576.7744465849185
1747352412221844,11832924,1,130,50,11812156,11723344,88812,562.9869837409359
1747352412339957,11925484,1,131,50,11930269,11815904,114365,437.1966947929874
1747352412409634,12018044,1,132,50,11999946,11908464,91482,546.5556065674122
1747352412500066,12110604,1,133,50,12090378,12001024,89354,559.57203930434
1747352412594223,12203164,1,134,50,12184535,12093584,90951,549.7465668326901
1747352412700121,12295724,1,135,50,12290433,12186144,104289,479.43694924680455
1747352412782829,12388284,1,136,50,12373141,12278704,94437,529.453498099262
1747352412892891,12480844,1,137,50,12483203,12371264,111939,446.6718480601042
1747352412970931,12573404,1,138,50,12561243,12463824,97419,513.2469025549431
1747352413057270,12665964,1,139,50,12647582,12556384,91198,548.2576372288866
1747352413159259,12758524,1,140,50,12749571,12648944,100627,496.8845339719956
1747352413269995,12851084,1,141,50,12860307,12741504,118803,420.8647929766083
1747352413343402,12943644,1,142,50,12933714,12834064,99650,501.7561465127948
1747352413528067,13131884,1,144,50,13118379,13022304,96075,520.4267499349467
1747352413630709,13224444,1,145,50,13221021,13114864,106157,471.0004992605292
1747352413729066,13317004,1,146,50,13319378,13207424,111954,446.6120013577005
1747352413811030,13409564,1,147,50,13401342,13299984,101358,493.3009727895183
1747352413909257,13502124,1,148,50,13499569,13392544,107025,467.1805652884841
1747352414007468,13594684,1,149,50,13597780,13485104,112676,443.7502218751109
1747352414100939,13687244,1,150,50,13691251,13577664,113587,440.1912190655621
1747352414183688,13779804,1,151,50,13774000,13670224,103776,481.8069688559976
1747352414281951,13872364,1,152,50,13872263,13762784,109479,456.70859251545954
1747352414372175,13964924,1,153,50,13962487,13855344,107143,466.66604444527405
1747352414465624,14057492,1,154,50,14055936,13947912,108024,462.8601051618159
1747352414568536,14150044,1,155,50,14158848,14040464,118384,422.3543722124612
1747352414761119,14338284,1,157,50,14351431,14228704,122727,407.4083127592135
1747352414850330,14430844,1,158,50,14440642,14321264,119378,418.8376417765418
1747352415047826,14619084,1,160,50,14638138,14509504,128634,388.6997216909993
1747352415232001,14807324,1,162,50,14822313,14697744,124569,401.3839719352327
1747352415318219,14899884,1,163,50,14908531,14790304,118227,422.915239327734
1747352415600474,15183804,1,166,50,15190786,15074224,116562,428.9562636193614
1747352415887834,15467724,1,169,50,15478146,15358144,120002,416.65972233796106
1747352416173604,15751644,1,172,50,15763916,15642064,121852,410.3338476184224
1747352416288248,15844204,1,173,50,15878560,15734624,143936,347.3766118274789
1747352416550920,16128124,1,176,50,16141232,16018544,122688,407.5378195096505
1747352416849558,16412044,1,179,50,16439870,16302464,137406,363.88512874255855
1747352426753414,26263964,1,282,50,26343726,26154384,189342,264.07241922024696
1747352426847250,26356524,1,283,50,26437562,26246944,190618,262.3047141403225
1747352426941602,26449084,1,284,50,26531914,26339504,192410,259.8617535471129
1747352427035687,26541644,1,285,50,26625999,26432064,193935,257.81834119679274
1747352427125423,26634204,1,286,50,26715735,26524624,191111,261.62805908608084
1747352427219906,26726764,1,287,50,26810218,26617184,193034,259.0217267424391
1747352427314478,26819324,1,288,50,26904790,26709744,195046,256.3497841534817
1747352427408053,26911884,1,289,50,26998365,26802304,196061,255.0226715154977
1747352427498234,27004444,1,290,50,27088546,26894864,193682,258.155120248655
1747352427592314,27097004,1,291,50,27182626,26987424,195202,256.1449165479862
1747352427686738,27189564,1,292,50,27277050,27079984,197066,253.72210325474717
1747352427780742,27282124,1,293,50,27371054,27172544,198510,251.87647977431868
1747352427874627,27374684,1,294,50,27464939,27265104,199835,250.2064202967448
1747352427964888,27467244,1,295,50,27555200,27357664,197536,253.1184189211081
1747352428059486,27559804,1,296,50,27649798,27450224,199574,250.5336366460561
1747352428153165,27652364,1,297,50,27743477,27542784,200693,249.1367411917705
1747352428247274,27744924,1,298,50,27837586,27635344,202242,247.22856775546128
1747352428338179,27837484,1,299,50,27928491,27727904,200587,249.26839725405932
1747352428432564,27930044,1,300,50,28022876,27820464,202412,247.02092761298732
1747352428526293,28022604,1,301,50,28116605,27913024,203581,245.602487461993
1747352428620914,28115164,1,302,50,28211226,28005584,205642,243.1409925987882
1747352428710252,28207724,1,303,50,28300564,28098144,202420,247.0111649046537
1747352428804365,28300284,1,304,50,28394677,28190704,203973,245.13048295607757
1747352428899119,28392844,1,305,50,28489431,28283264,206167,242.52183909161025
1747352428993147,28485404,1,306,50,28583459,28375824,207635,240.8071856864209
1747352429083014,28577964,1,307,50,28673326,28468384,204942,243.97146509744215
1747352429177546,28670524,1,308,50,28767858,28560944,206914,241.6462878297264
1747352429271661,28763084,1,309,50,28861973,28653504,208469,239.84381370851304
1747352435243575,34692132,1,371,50,34833887,34582552,251335,198.93767282710328
1747352435337091,34784684,1,372,50,34927403,34675104,252299,198.17755916591028
1747352435431371,34877244,1,373,50,35021683,34767664,254019,196.83566977273355
1747352435526086,34969804,1,374,50,35116398,34860224,256174,195.17983870338128
1747352435906871,35349404,1,378,50,35497183,35239824,257359,194.28114035258145
1747352436001287,35441964,1,379,50,35591599,35332384,259215,192.8900719479969
1747352436090990,35534524,1,380,50,35681302,35424944,256358,195.0397491008668
1747352436185089,35627084,1,381,50,35775401,35517504,257897,193.87584966091117
1747352436280014,35719644,1,382,50,35870326,35610064,260262,192.11410040651344
1747352436372984,35812204,1,383,50,35963296,35702624,260672,191.81193223668055
1747352436463858,35904764,1,384,50,36054170,35795184,258986,193.06062875985572
1747352436557675,35997324,1,385,50,36147987,35887744,260243,192.1281264049369
1747352436652116,36089892,1,386,50,36242428,35980312,262116,190.75523813883927
1747352436746424,36182444,1,387,50,36336736,36072864,263872,189.4858113024497
1747352436840995,36275004,1,388,50,36431307,36165424,265883,188.0526396949034
1747352436931000,36367564,1,389,50,36521312,36257984,263328,189.87726333697896
1747352437024551,36460124,1,390,50,36614863,36350544,264319,189.16536457840712
1747352437119853,36552684,1,391,50,36710165,36443104,267061,187.22314377614103
1747352437212776,36645244,1,392,50,36803088,36535664,267424,186.96900801723103
1747352437303214,36737804,1,393,50,36893526,36628224,265302,188.4644669094089
1747352437397603,36830364,1,394,50,36987915,36720784,267131,187.1740831277538
1747352437492312,36922924,1,395,50,37082624,36813344,269280,185.68033273915623
1747352437586546,37015484,1,396,50,37176858,36905904,270954,184.5331679916148
1747352437676445,37108044,1,397,50,37266757,36998464,268293,186.3634161159628
1747352437770421,37200604,1,398,50,37360733,37091024,269709,185.38498900667017
1747352437863971,37293164,1,399,50,37454283,37183584,270699,184.70699928703092
1747352437958579,37385724,1,400,50,37548891,37276144,272747,183.3200731813732
1747352438048662,37478284,1,401,50,37638974,37368704,270270,185.00018500018496
1747352438142929,37570844,1,402,50,37733241,37461264,271977,183.83907462763395
1747352438236989,37663404,1,403,50,37827301,37553824,273477,182.8307316520219
1747352438332218,37755964,1,404,50,37922530,37646384,276146,181.06364024827445
1747352438425500,37848524,1,405,50,38015812,37738944,276868,180.5914731930017
1747352438515676,37941084,1,406,50,38105988,37831504,274484,182.15998018099413
1747352438610328,38033644,1,407,50,38200640,37924064,276576,180.7821358324656
1747352438704086,38126204,1,408,50,38294398,38016624,277774,180.00244803329323
1747352438799036,38218772,1,409,50,38389348,38109192,280156,178.4719941746741
1747352438888162,38311324,1,410,50,38478474,38201744,276730,180.6815307339284
1747352438982768,38403884,1,411,50,38573080,38294304,278776,179.35546818951414
1747352439076891,38496444,1,412,50,38667203,38386864,280339,178.35549103050235
1747352439171264,38589004,1,413,50,38761576,38479424,282152,177.20944739005924
1747352439260845,38681564,1,414,50,38851157,38571984,279173,179.100414438359
1747352439355131,38774124,1,415,50,38945443,38664544,280899,177.99992168003445
1747352439449692,38866684,1,416,50,39040004,38757104,282900,176.74089784376105
1747352439543431,38959244,1,417,50,39133743,38849664,284079,176.00737822929537
1747352439638152,39051804,1,418,50,39228464,38942224,286240,174.678591391839
1747352439728145,39144364,1,419,50,39318457,39034784,283673,176.2592844578088
1747352439822159,39236924,1,420,50,39412471,39127344,285127,175.36045341198832
1747352439917021,39329484,1,421,50,39507333,39219904,287429,173.95600304770915
1747352440010883,39422044,1,422,50,39601195,39312464,288731,173.1715679992796
1747352440100813,39514604,1,423,50,39691125,39405024,286101,174.76345766005713
1747352440195049,39607164,1,424,50,39785361,39497584,287777,173.74564332799355
1747352440288863,39699724,1,425,50,39879175,39590144,289031,172.99182440637856
1747352440383803,39792284,1,426,50,39974115,39682704,291411,171.57897265374336
1747352440473554,39884844,1,427,50,40063866,39775264,288602,173.24897263359227
1747352440567925,39977404,1,428,50,40158237,39867824,290413,172.1686012678496
1747352440661639,40069964,1,429,50,40251951,39960384,291567,171.48717104473414
1747352440756127,40162524,1,430,50,40346439,40052944,293495,170.36065350346684
1747352440846524,40255084,1,431,50,40436836,40145504,291332,171.62549943020335
1747352440939951,40347644,1,432,50,40530263,40238064,292199,171.1162598092396
1747352441035221,40440204,1,433,50,40625533,40330624,294909,169.54382538342338
1747352441129172,40532764,1,434,50,40719484,40423184,296300,168.74789065136684
1747352441223465,40625324,1,435,50,40813777,40515744,298033,167.76665671251172
1747352441312790,40717884,1,436,50,40903102,40608304,294798,169.60766355266995
1747352441407670,40810444,1,437,50,40997982,40700864,297118,168.28330831521484
1747352441501416,40903004,1,438,50,41091728,40793424,298304,167.61424586998498
1747352441595841,40995564,1,439,50,41186153,40885984,300169,166.57283063874016
1747352441685504,41088124,1,440,50,41275816,40978544,297272,168.19613014343767
1747352441779930,41180684,1,441,50,41370242,41071104,299138,167.146935528084
1747352441874352,41273244,1,442,50,41464664,41163664,301000,166.11295681063123
1747352441968423,41365804,1,443,50,41558735,41256224,302511,165.28324589849626
1747352442059063,41458364,1,444,50,41649375,41348784,300591,166.33897887827646
1747352442152490,41550924,1,445,50,41742802,41441344,301458,165.86058422732188
1747352442246637,41643484,1,446,50,41836949,41533904,303045,164.99199788810242
1747352442341102,41736044,1,447,50,41931414,41626464,304950,163.96130513198884
1747352442431106,41828604,1,448,50,42021418,41719024,302394,165.34719604224952
1747352442525917,41921164,1,449,50,42116229,41811584,304645,164.12545749971278
1747352442620026,42013732,1,450,50,42210338,41904152,306186,163.29943237117308
1747352442713393,42106284,1,451,50,42303705,41996704,307001,162.86591900352116
1747352442808169,42198844,1,452,50,42398481,42089264,309217,161.69874230718233
1747352442898643,42291404,1,453,50,42488955,42181824,307131,162.79698239513434
1747352442992790,42383964,1,454,50,42583102,42274384,308718,161.96010598669335
1747352443086517,42476524,1,455,50,42676829,42366944,309885,161.350178291947
1747352443180816,42569084,1,456,50,42771128,42459504,311624,160.4497728031217
1747352443271336,42661644,1,457,50,42861648,42552064,309584,161.50705462814614
1747352443365494,42754204,1,458,50,42955806,42644624,311182,160.677674158531
1747352443458908,42846764,1,459,50,43049220,42737184,312036,160.237921265495
1747352443552961,42939324,1,460,50,43143273,42829744,313529,159.47488111147612
1747352443643175,43031884,1,461,50,43233487,42922304,311183,160.67715781389086
1747352443738301,43124444,1,462,50,43328613,43014864,313749,159.3630577308613
1747352443831832,43217004,1,463,50,43422144,43107424,314720,158.8713777325877
1747352443925913,43309564,1,464,50,43516225,43199984,316241,158.10726629374432
1747352444016101,43402124,1,465,50,43606413,43292544,313869,159.30212923225932
1747352444110705,43494684,1,466,50,43701017,43385104,315913,158.27142282843695
1747352444204702,43587244,1,467,50,43795014,43477664,317350,157.5547502757208
1747352444299234,43679804,1,468,50,43889546,43570224,319322,156.5817575989127
1747352444393125,43772364,1,469,50,43983437,43662784,320653,155.9318016672228
1747352444483717,43864924,1,470,50,44074029,43755344,318685,156.89473931939062
1747352444577782,43957484,1,471,50,44168094,43847904,320190,156.15728161404166
1747352444671976,44050044,1,472,50,44262288,43940464,321824,155.36442279009646
1747352444765510,44142612,1,473,50,44355822,44033032,322790,154.89947024381175
1747352444856336,44235164,1,474,50,44446648,44125584,321064,155.73219046669823
1747352444949635,44327724,1,475,50,44539947,44218144,321803,155.3745614553003
1747352445043987,44420284,1,476,50,44634299,44310704,323595,154.5141303172175
1747352445138483,44512844,1,477,50,44728795,44403264,325531,153.59520291462258
1747352445228344,44605404,1,478,50,44818656,44495824,322832,154.87931803538683
1747352445322905,44697964,1,479,50,44913217,44588384,324833,153.92524774268625
1747352445417520,44790524,1,480,50,45007832,44680944,326888,152.95758792002152
1747352445511509,44883084,1,481,50,45101821,44773504,328317,152.29183989863455
1747352445601217,44975644,1,482,50,45191529,44866064,325465,153.62634999155054
1747352445695258,45068204,1,483,50,45285570,44958624,326946,152.9304533470359
1747352445789423,45160764,1,484,50,45379735,45051184,328551,152.18337487939468
1747352445883969,45253324,1,485,50,45474281,45143744,330537,151.26899560412298
1747352445978154,45345884,1,486,50,45568466,45236304,332162,150.52895876108644
1747352446067714,45438444,1,487,50,45658026,45328864,329162,151.90088770878776
1747352446162942,45531004,1,488,50,45753254,45421424,331830,150.6795648374167
1747352446257035,45623564,1,489,50,45847347,45513984,333363,149.98665118804425
1747352446350513,45716124,1,490,50,45940825,45606544,334281,149.57475896027594
1747352446441364,45808684,1,491,50,46031676,45699104,332572,150.34338428971773
1747352446535346,45901244,1,492,50,46125658,45791664,333994,149.70328808301946
1747352446629348,45993804,1,493,50,46219660,45884224,335436,149.05973121549266
1747352446723438,46086364,1,494,50,46313750,45976784,336966,148.38292290616857
1747352446813922,46178924,1,495,50,46404234,46069344,334890,149.30275612887812
1747352446907390,46271484,1,496,50,46497702,46161904,335798,148.89904049458306
1747352447002052,46364044,1,497,50,46592364,46254464,337900,147.9727730097662
1747352447096617,46456604,1,498,50,46686929,46347024,339905,147.09992497903826
1747352447186415,46549164,1,499,50,46776727,46439584,337143,148.3050219046517
1747352447280971,46641724,1,500,50,46871283,46532144,339139,147.43217382843022
1747352447375151,46734284,1,501,50,46965463,46624704,340759,146.7312675527279
1747352447469427,46826844,1,502,50,47059739,46717264,342475,145.99605810643115
1747352447563654,46919404,1,503,50,47153966,46809824,344142,145.28886331804895
1747352447653751,47011964,1,504,50,47244063,46902384,341679,146.33618103541627
1747352447747518,47104524,1,505,50,47337830,46994944,342886,145.8210600607782
1747352447841676,47197084,1,506,50,47431988,47087504,344484,145.1446221014619
1747352447935473,47289644,1,507,50,47525785,47180064,345721,144.62529033527034
1747352448026210,47382204,1,508,50,47616522,47272624,343898,145.39194761237346
1747352448120154,47474764,1,509,50,47710466,47365184,345282,144.80917047514785
1747352448214516,47567324,1,510,50,47804828,47457744,347084,144.05734634843438
1747352448308224,47659884,1,511,50,47898536,47550304,348232,143.58243929334466
1747352448399034,47752444,1,512,50,47989346,47642864,346482,144.30764080096512
1747352448492747,47845004,1,513,50,48083059,47735424,347635,143.8290160657011
1747352448587349,47937572,1,514,50,48177661,47827992,349669,142.99237278683557
1747352448681750,48030124,1,515,50,48272062,47920544,351518,142.24022667402522
1747352448771494,48122684,1,516,50,48361806,48013104,348702,143.38891087518854
1747352448865530,48215244,1,517,50,48455842,48105664,350178,142.7845267264077
1747352448959845,48307804,1,518,50,48550157,48198224,351933,142.07249675364346
1747352449054383,48400364,1,519,50,48644695,48290784,353911,141.2784570132039
1747352449148655,48492924,1,520,50,48738967,48383344,355623,140.5983302542299
1747352449238647,48585484,1,521,50,48828959,48475904,353055,141.62099389613516
1747352449332177,48678044,1,522,50,48922489,48568464,354025,141.2329637737448
1747352449426534,48770604,1,523,50,49016846,48661024,355822,140.51969805127283
1747352449520788,48863164,1,524,50,49111100,48753584,357516,139.85388066548072
1747352449610899,48955724,1,525,50,49201211,48846144,355067,140.81849341110268
1747352449705179,49048284,1,526,50,49295491,48938704,356787,140.13963513244596
1747352449799901,49140844,1,527,50,49390213,49031264,358949,139.29555452167298
1747352449893229,49233404,1,528,50,49483541,49123824,359717,138.9981568844397
1747352449983425,49325964,1,529,50,49573737,49216384,357353,139.91767244153542
1747352450078366,49418524,1,530,50,49668678,49308944,359734,138.99158822908038
1747352450172022,49511084,1,531,50,49762334,49401504,360830,138.56940941717707
1747352450266698,49603644,1,532,50,49857010,49494064,362946,137.76154028422962
1747352450360719,49696204,1,533,50,49951031,49586624,364407,137.20921936186738
1747352450450941,49788764,1,534,50,50041253,49679184,362069,138.09522494331193
1747352450545127,49881324,1,535,50,50135439,49771744,363695,137.47783169963844
1747352450639126,49973884,1,536,50,50229438,49864304,365134,136.93602896470884
1747352450733530,50066452,1,537,50,50323842,49956872,366970,136.2509196937079
1747352450823339,50159004,1,538,50,50413651,50049424,364227,137.27702778761596
1747352450917665,50251564,1,539,50,50507977,50141984,365993,136.61463470612824
1747352451011924,50344124,1,540,50,50602236,50234544,367692,135.9833773919476
1747352451105877,50436684,1,541,50,50696189,50327104,369085,135.4701491526342
1747352451195920,50529244,1,542,50,50786232,50419664,366568,136.40034045524976
1747352451289946,50621804,1,543,50,50880258,50512224,368034,135.85701321073597
1747352451384227,50714364,1,544,50,50974539,50604784,369755,135.22467579883977
1747352451478778,50806924,1,545,50,51069090,50697344,371746,134.50043847142942
1747352451569175,50899484,1,546,50,51159487,50789904,369583,135.28760792568923
1747352451663249,50992044,1,547,50,51253561,50882464,371097,134.73566210451713
1747352451757558,51084604,1,548,50,51347870,50975024,372846,134.10362455276442
1747352451851324,51177164,1,549,50,51441636,51067584,374052,133.671254264113
1747352451945787,51269724,1,550,50,51536099,51160144,375955,132.99464031599527
1747352452035846,51362284,1,551,50,51626158,51252704,373454,133.88529778767935
1747352452129532,51454844,1,552,50,51719844,51345264,374580,133.48283410753376
1747352452224094,51547404,1,553,50,51814406,51437824,376582,132.77320742892653
1747352452317824,51639964,1,554,50,51908136,51530384,377752,132.3619729346238
1747352452408501,51732524,1,555,50,51998813,51622944,375869,133.02506990467424
1747352452502912,51825084,1,556,50,52093224,51715504,377720,132.37318648734512
1747352452596862,51917644,1,557,50,52187174,51808064,379110,131.8878425786711
1747352452691074,52010204,1,558,50,52281386,51900624,380762,131.31562498358556
1747352452781104,52102764,1,559,50,52371416,51993184,378232,132.193997334969
1747352452874943,52195324,1,560,50,52465255,52085744,379511,131.7484868686283
1747352452969083,52287884,1,561,50,52559395,52178304,381091,131.20225877808713
1747352453064102,52380444,1,562,50,52654414,52270864,383550,130.3611002476861
1747352453153939,52473004,1,563,50,52744251,52363424,380827,131.29321187835944
1747352453248465,52565564,1,564,50,52838777,52455984,382793,130.61889846470547
1747352453341904,52658124,1,565,50,52932216,52548544,383672,130.3196480326946
1747352453435980,52750684,1,566,50,53026292,52641104,385188,129.80674371994974
1747352453530049,52843244,1,567,50,53120361,52733664,386697,129.30020144971385
1747352453621058,52935804,1,568,50,53211370,52826224,385146,129.82089908761873
1747352453714979,53028364,1,569,50,53305291,52918784,386507,129.36376314012423
1747352453808791,53120924,1,570,50,53399103,53011344,387759,128.9460721736955
1747352453903316,53213484,1,571,50,53493628,53103904,389724,128.29592224240744
1747352453993495,53306044,1,572,50,53583807,53196464,387343,129.08455813064907
1747352454088129,53398604,1,573,50,53678441,53289024,389417,128.3970653566742
1747352454181929,53491164,1,574,50,53772241,53381584,390657,127.9895150989231
1747352454275948,53583724,1,575,50,53866260,53474144,392116,127.51328688449335
1747352454366598,53676284,1,576,50,53956910,53566704,390206,128.13744534937956
1747352454459969,53768844,1,577,50,54050281,53659264,391017,127.8716782134792
1747352454554512,53861412,1,578,50,54144824,53751832,392992,127.22905300871264
1747352454648284,53953964,1,579,50,54238596,53844384,394212,126.83530689070857
1747352454739263,54046524,1,580,50,54329575,53936944,392631,127.34603227967226
1747352454833697,54139084,1,581,50,54424009,54029504,394505,126.74110594289046
1747352454927374,54231644,1,582,50,54517686,54122064,395622,126.3832648336038
1747352455021120,54324204,1,583,50,54611432,54214624,396808,126.00552408217575
1747352455115357,54416764,1,584,50,54705669,54307184,398485,125.4752374618869
1747352455205801,54509324,1,585,50,54796113,54399744,396369,126.14508198168878
1747352455299732,54601884,1,586,50,54890044,54492304,397740,125.71026298587016
1747352455393998,54694444,1,587,50,54984310,54584864,399446,125.17336511067828
1747352455488314,54787004,1,588,50,55078626,54677424,401202,124.625500371384
1747352455578169,54879564,1,589,50,55168481,54769984,398497,125.47145900721964
1747352455673066,54972124,1,590,50,55263378,54862544,400834,124.73991727248686
1747352455766754,55064684,1,591,50,55357066,54955104,401962,124.38986769893673
1747352455860859,55157244,1,592,50,55451171,55047664,403507,123.91358762053694
1747352455951530,55249804,1,593,50,55541842,55140224,401618,124.4964120134058
1747352456045583,55342364,1,594,50,55635895,55232784,403111,124.03531533498216
1747352456139777,55434924,1,595,50,55730089,55325344,404745,123.53457114973624
1747352456233759,55527484,1,596,50,55824071,55417904,406167,123.10207377753486
1747352456323663,55620044,1,597,50,55913975,55510464,403511,123.91235926653796
1747352456418134,55712604,1,598,50,56008446,55603024,405422,123.32828509553008
1747352456512619,55805164,1,599,50,56102931,55695584,407347,122.7454725332456
1747352456606650,55897724,1,600,50,56196962,55788144,408818,122.30381245444184
1747352456700974,55990292,1,601,50,56291286,55880712,410574,121.780726495102
1747352456790491,56082844,1,602,50,56380803,55973264,407539,122.6876446180611
1747352456885317,56175404,1,603,50,56475629,56065824,409805,122.00924830102124
1747352456979338,56267964,1,604,50,56569650,56158384,411266,121.5758171110668
1747352457073482,56360524,1,605,50,56663794,56250944,412850,121.10936175366356
1747352457163571,56453084,1,606,50,56753883,56343504,410379,121.83859310539768
1747352457257861,56545644,1,607,50,56848173,56436064,412109,121.32712461994278
1747352457352079,56638204,1,608,50,56942391,56528624,413767,120.8409563836652
1747352457446086,56730764,1,609,50,57036398,56621184,415214,120.4198317012432
1747352457535970,56823324,1,610,50,57126282,56713744,412538,121.20095603314118
1747352457629881,56915884,1,611,50,57220193,56806304,413889,120.80533669655392
1747352457724717,57008444,1,612,50,57315029,56898864,416165,120.14465416361298
1747352457818698,57101004,1,613,50,57409010,56991424,417586,119.73581489800902
1747352457909419,57193564,1,614,50,57499731,57083984,415747,120.26544990102154
1747352458002628,57286124,1,615,50,57592940,57176544,416396,120.0780026705348
1747352458097037,57378684,1,616,50,57687349,57269104,418245,119.54715537543784
1747352458191709,57471244,1,617,50,57782021,57361664,420357,118.94651451028533
1747352458285642,57563804,1,618,50,57875954,57454224,421730,118.5592677779622
1747352458375781,57656364,1,619,50,57966093,57546784,419309,119.24380349575137
1747352458470424,57748924,1,620,50,58060736,57639344,421392,118.6543645821468
1747352458564203,57841484,1,621,50,58154515,57731904,422611,118.3121120841625
1747352458658525,57934044,1,622,50,58248837,57824464,424373,117.82087927365784
1747352458748888,58026604,1,623,50,58339200,57917024,422176,118.43401803986964
1747352458843099,58119164,1,624,50,58433411,58009584,423827,117.97266337444287
1747352458936786,58211724,1,625,50,58527098,58102144,424954,117.65979376591348
1747352459031356,58304284,1,626,50,58621668,58194704,426964,117.10589183162983
1747352459121322,58396844,1,627,50,58711634,58287264,424370,117.82171218512148
1747352459215500,58489404,1,628,50,58805812,58379824,425988,117.37419833422538
1747352459309790,58581964,1,629,50,58900102,58472384,427718,116.89945244296476
1747352459403636,58674524,1,630,50,58993948,58564944,429004,116.54902984587557
1747352459493659,58767084,1,631,50,59083971,58657504,426467,117.24236576335332
1747352459588047,58859644,1,632,50,59178359,58750064,428295,116.74196523424276
1747352459682628,58952204,1,633,50,59272940,58842624,430316,116.1936809228567
1747352459776845,59044764,1,634,50,59367157,58935184,431973,115.74797498917756
1747352459870732,59137324,1,635,50,59461044,59027744,433300,115.39349180706208
1747352459960829,59229884,1,636,50,59551141,59120304,430837,116.05317092078906
1747352460054755,59322444,1,637,50,59645067,59212864,432203,115.68637885438092
1747352460148774,59415004,1,638,50,59739086,59305424,433662,115.2971669180145
1747352460243655,59507564,1,639,50,59833967,59397984,435983,114.68337068188438
1747352460333779,59600124,1,640,50,59924091,59490544,433547,115.32774993253328
1747352460427681,59692684,1,641,50,60017993,59583104,434889,114.97186638429577
1747352460522061,59785252,1,642,50,60112373,59675672,436701,114.49481452984996
1747352460616216,59877804,1,643,50,60206528,59768224,438304,114.07607505293127
1747352460706089,59970364,1,644,50,60296401,59860784,435617,114.779726227397
1747352460800986,60062924,1,645,50,60391298,59953344,437954,114.16724130844791
1747352460894468,60155484,1,646,50,60484780,60045904,438876,113.9273963488548
1747352460988631,60248044,1,647,50,60578943,60138464,440479,113.5127894859914
1747352461083303,60340604,1,648,50,60673615,60231024,442591,112.9711178040222
1747352461172859,60433164,1,649,50,60763171,60323584,439587,113.7431270715467
1747352461267654,60525724,1,650,50,60857966,60416144,441822,113.16774628696623
1747352461361665,60618284,1,651,50,60951977,60508704,443273,112.79730549796628
1747352461455538,60710844,1,652,50,61045850,60601264,444586,112.46418015861948
1747352461546528,60803404,1,653,50,61136840,60693824,443016,112.86274084908896
1747352461640140,60895964,1,654,50,61230452,60786384,444068,112.59536827693056
1747352461734129,60988524,1,655,50,61324441,60878944,445497,112.2342013526466
1747352461828808,61081084,1,656,50,61419120,60971504,447616,111.70288818987704
1747352461918962,61173644,1,657,50,61509274,61064064,445210,112.3065519642416
1747352462012938,61266204,1,658,50,61603250,61156624,446626,111.95049101485358
1747352462106912,61358764,1,659,50,61697224,61249184,448040,111.59717882331935
1747352462201124,61451324,1,660,50,61791436,61341744,449692,111.18721258105548
1747352462291825,61543884,1,661,50,61882137,61434304,447833,111.648761926879
1747352462386005,61636444,1,662,50,61976317,61526864,449453,111.24633721434722
1747352462480332,61729004,1,663,50,62070644,61619424,451220,110.81069101546916
1747352462574211,61821564,1,664,50,62164523,61711984,452539,110.4877148709835
1747352462668654,61914132,1,665,50,62258966,61804552,454414,110.03182120269182
1747352462758848,62006684,1,666,50,62349160,61897104,452056,110.60576565735218
1747352462852602,62099244,1,667,50,62442914,61989664,453250,110.31439602868174
1747352462947241,62191804,1,668,50,62537553,62082224,455329,109.81070830103069
1747352463041083,62284364,1,669,50,62631395,62174784,456611,109.50239919756642
1747352463131581,62376924,1,670,50,62721893,62267344,454549,109.99914200669237
1747352463225062,62469484,1,671,50,62815374,62359904,455470,109.77671416339166
1747352463319108,62562044,1,672,50,62909420,62452464,456956,109.41972531272158
1747352463413328,62654604,1,673,50,63003640,62545024,458616,109.02367121949516
1747352463504045,62747164,1,674,50,63094357,62637584,456773,109.46356286382952
1747352463598376,62839724,1,675,50,63188688,62730144,458544,109.04078997871524
1747352463692652,62932284,1,676,50,63282964,62822704,460260,108.63425020640508
1747352463786560,63024844,1,677,50,63376872,62915264,461608,108.31701356995544
1747352463876069,63117404,1,678,50,63466381,63007824,458557,109.03769869394644
1747352463970354,63209964,1,679,50,63560666,63100384,460282,108.62905783845557
1747352464063890,63302524,1,680,50,63654202,63192944,461258,108.39920391624644
1747352464159305,63395084,1,681,50,63749617,63285504,464113,107.73238413920748
1747352464252818,63487644,1,682,50,63843130,63378064,465066,107.5116220063389
1747352464342832,63580204,1,683,50,63933144,63470624,462520,108.10343336504368
1747352464437396,63672764,1,684,50,64027708,63563184,464524,107.63706503862018
1747352464531615,63765324,1,685,50,64121927,63655744,466183,107.25401827179456
1747352464625610,63857884,1,686,50,64215922,63748304,467618,106.92488313110276
1747352464716083,63950444,1,687,50,64306395,63840864,465531,107.40423301563162
1747352464810734,64043004,1,688,50,64401046,63933424,467622,106.92396850447584
1747352464904728,64135564,1,689,50,64495040,64025984,469056,106.59708009278212
1747352464998902,64228124,1,690,50,64589214,64118544,470670,106.23154226953068
1747352465089069,64320684,1,691,50,64679381,64211104,468277,106.7744091638069
1747352465182385,64413244,1,692,50,64772697,64303664,469033,106.60230730033922
1747352465277415,64505804,1,693,50,64867727,64396224,471503,106.0438639838983
1747352465371399,64598364,1,694,50,64961711,64488784,472927,105.7245621417259
1747352465461104,64690924,1,695,50,65051416,64581344,470072,106.36668425262512
1747352465555812,64783484,1,696,50,65146124,64673904,472220,105.88285121341748
1747352465649994,64876044,1,697,50,65240306,64766464,473842,105.52040553602257
1747352465743667,64968604,1,698,50,65333979,64859024,474955,105.27313113873946
1747352465838211,65061164,1,699,50,65428523,64951584,476939,104.8352095341333
1747352465928213,65153724,1,700,50,65518525,65044144,474381,105.40051140328131
1747352466022754,65246284,1,701,50,65613066,65136704,476362,104.96219261821892
1747352466116574,65338844,1,702,50,65706886,65229264,477622,104.68529506597268
1747352466210252,65431404,1,703,50,65800564,65321824,478740,104.44082382921836
1747352466300747,65523964,1,704,50,65891059,65414384,476675,104.89327109665916
1747352466395118,65616524,1,705,50,65985430,65506944,478486,104.49626530347804
1747352466489128,65709092,1,706,50,66079440,65599512,479928,104.18229401076827
1747352466583245,65801644,1,707,50,66173557,65692064,481493,103.84366958605835
1747352466673978,65894204,1,708,50,66264290,65784624,479666,104.23919977651116
1747352466768202,65986764,1,709,50,66358514,65877184,481330,103.8788357260092
1747352466861883,66079324,1,710,50,66452195,65969744,482451,103.6374678464756
1747352466956254,66171884,1,711,50,66546566,66062304,484262,103.24989365260952
1747352467046833,66264444,1,712,50,66637145,66154864,482281,103.67399918304888
1747352467140829,66357004,1,713,50,66731141,66247424,483717,103.3662244659584
1747352467235345,66449564,1,714,50,66825657,66339984,485673,102.94992721440146
1747352467328803,66542124,1,715,50,66919115,66432544,486571,102.75992609506116
1747352467423534,66634684,1,716,50,67013846,66525104,488742,102.30346481374632
1747352467513281,66727244,1,717,50,67103593,66617664,485929,102.89569052268952
1747352467607803,66819804,1,718,50,67198115,66710224,487891,102.48190681935104
1747352467701808,66912364,1,719,50,67292120,66802784,489336,102.17927967695
1747352467795703,67004924,1,720,50,67386015,66895344,490671,101.90127396972716
1747352467885614,67097484,1,721,50,67475926,66987904,488022,102.45439754765154
1747352467980270,67190044,1,722,50,67570582,67080464,490118,102.01624914816432
1747352468074889,67282604,1,723,50,67665201,67173024,492177,101.58946882930329
1747352468168270,67375164,1,724,50,67758582,67265584,492998,101.42028973748371
1747352468258967,67467724,1,725,50,67849279,67358144,491135,101.80500269783258
1747352468353418,67560284,1,726,50,67943730,67450704,493026,101.41452986252246
1747352468447226,67652844,1,727,50,68037538,67543264,494274,101.158466761351
1747352468541686,67745404,1,728,50,68131998,67635824,496174,100.77110046072546
1747352468631707,67837972,1,729,50,68222019,67728392,493627,101.291055797191
1747352468726194,67930524,1,730,50,68316506,67820944,495562,100.89554889196508
1747352468819805,68023084,1,731,50,68410117,67913504,496613,100.68202000350372
1747352468914422,68115644,1,732,50,68504734,68006064,498670,100.26670944712936
1747352469008006,68208204,1,733,50,68598318,68098624,499694,100.06123747733612
1747352469098029,68300764,1,734,50,68688341,68191184,497157,100.57185154790136
1747352469192481,68393324,1,735,50,68782793,68283744,499049,100.19056244977948
1747352469286511,68485884,1,736,50,68876823,68376304,500519,99.89630763267728
1747352469380907,68578444,1,737,50,68971219,68468864,502355,99.53120801027164
1747352469471526,68671004,1,738,50,69061838,68561424,500414,99.9172685016806
1747352469565162,68763564,1,739,50,69155474,68653984,501490,99.70288540150352
1747352469659463,68856124,1,740,50,69249775,68746544,503231,99.35794893398857
1747352470257381,69430204,1,746,50,69847693,69320624,527069,94.86423978644162
1747352470335067,69525884,1,747,50,69925379,69416304,509075,98.21735500662966
1747352470425321,69618444,1,748,50,70015633,69508864,506769,98.66428293759088
1747352470519646,69711004,1,749,50,70109958,69601424,508534,98.32184278730624
1747352470613896,69803564,1,750,50,70204208,69693984,510224,97.99617422935808
1747352470707968,69896124,1,751,50,70298280,69786544,511736,97.706629981084
1747352470798242,69988684,1,752,50,70388554,69879104,509450,98.14505839630976
1747352470892795,70081244,1,753,50,70483107,69971664,511443,97.76260502147844
1747352470987015,70173804,1,754,50,70577327,70064224,513103,97.44632169369504
1747352471080796,70266364,1,755,50,70671108,70156784,514324,97.21498510666429
1747352471174804,70358924,1,756,50,70765116,70249344,515772,96.94205966977655
1747352471264792,70451484,1,757,50,70855104,70341904,513200,97.42790335151987
1747352471358692,70544044,1,758,50,70949004,70434464,514540,97.17417499125432
1747352471555674,70732284,1,760,50,71145986,70622704,523282,95.550773770166
1747352471646283,70827964,1,761,50,71236595,70718384,518211,96.485794396491
1747352471740596,70923644,1,762,50,71330908,70814064,516844,96.74098954423386
1747352471834381,71016204,1,763,50,71424693,70906624,518069,96.51224064748132
1747352471928408,71108764,1,764,50,71518720,70999184,519536,96.23972159773336
1747352472023125,71201324,1,765,50,71613437,71091744,521693,95.84180734646624
1747352472113309,71293884,1,766,50,71703621,71184304,519317,96.28030663352057
1747352472207016,71386444,1,767,50,71797328,71276864,520464,96.06812382796888
1747352472301480,71479004,1,768,50,71891792,71369424,522368,95.717961283999
1747352472395268,71571564,1,769,50,71985580,71461984,523596,95.49347206624957
1747352472489267,71664124,1,770,50,72079579,71554544,525035,95.23174645499824
1747352472579631,71756684,1,771,50,72169943,71647104,522839,95.631733669447
1747352472673429,71849244,1,772,50,72263741,71739664,524077,95.40582776958348
1747352472767647,71941804,1,773,50,72357959,71832224,525735,95.1049483104606
1747352472862743,72034364,1,774,50,72453055,71924784,528271,94.64839069341303
1747352472952652,72126924,1,775,50,72542964,72017344,525620,95.1257562497622
1747352473047100,72219484,1,776,50,72637412,72109904,527508,94.78529235575574
1747352473140902,72312044,1,777,50,72731214,72202464,528750,94.5626477541371
1747352473234842,72404604,1,778,50,72825154,72295024,530130,94.31648840850356
1747352473325026,72497172,1,779,50,72915338,72387592,527746,94.74254660385868
1747352473419026,72589724,1,780,50,73009338,72480144,529194,94.48330857870648
1747352473513204,72682284,1,781,50,73103516,72572704,530812,94.1953083200832
1747352473607222,72774844,1,782,50,73197534,72665264,532270,93.9372874668871
1747352473698179,72867404,1,783,50,73288491,72757824,530667,94.22104634356386
1747352473792079,72959964,1,784,50,73382391,72850384,532007,93.98372577804427
1747352473886547,73052524,1,785,50,73476859,72942944,533915,93.64786529691057
1747352473980271,73145084,1,786,50,73570583,73035504,535079,93.44414563083208
1747352474074670,73237644,1,787,50,73664982,73128064,536918,93.12408971202306
1747352474165100,73330204,1,788,50,73755412,73220624,534788,93.4949924082066
1747352474259037,73422764,1,789,50,73849349,73313184,536165,93.25487489858531
1747352474353300,73515324,1,790,50,73943612,73405744,537868,92.9596109082526
1747352474447221,73607884,1,791,50,74037533,73498304,539229,92.72498326314052
1747352474537752,73700444,1,792,50,74128064,73590864,537200,93.07520476545048
1747352474631863,73793004,1,793,50,74222175,73683424,538751,92.80725232992609
1747352474725489,73885564,1,794,50,74315801,73775984,539817,92.62398183087971
1747352474819651,73978124,1,795,50,74409963,73868544,541419,92.34991753152364
1747352474909683,74070684,1,796,50,74499995,73961104,538891,92.78314167429036
1747352475004362,74163244,1,797,50,74594674,74053664,541010,92.4197334614887
1747352475098798,74255804,1,798,50,74689110,74146224,542886,92.10036729626478
1747352475192423,74348364,1,799,50,74782735,74238784,543951,91.92004426869332
1747352475287042,74440924,1,800,50,74877354,74331344,546010,91.57341440632956
1747352475377068,74533484,1,801,50,74967380,74423904,543476,92.00038272159212
1747352475471126,74626044,1,802,50,75061438,74516464,544974,91.74749621082842
1747352475565438,74718604,1,803,50,75155750,74609024,546726,91.45348858477554
1747352475660146,74811164,1,804,50,75250458,74701584,548874,91.09558842284386
1747352475750179,74903724,1,805,50,75340491,74794144,546347,91.51692971682832
1747352475844363,74996284,1,806,50,75434675,74886704,547971,91.24570460845555
1747352475937988,75088844,1,807,50,75528300,74979264,549036,91.06870951995862
1747352476032705,75181404,1,808,50,75623017,75071824,551193,90.71232762389944
1747352476122711,75273964,1,809,50,75713023,75164384,548639,91.13460763817372
1747352476216889,75366524,1,810,50,75807201,75256944,550257,90.86663141041367
1747352476311100,75459084,1,811,50,75901412,75349504,551908,90.5948092798075
1747352476404847,75551644,1,812,50,75995159,75442064,553095,90.40038329762518
1747352476495625,75644204,1,813,50,76085937,75534624,551313,90.6925829791788
1747352476589365,75736764,1,814,50,76179677,75627184,552493,90.49888414875844
1747352476683713,75829324,1,815,50,76274025,75719744,554281,90.20695279109331
1747352476777549,75921884,1,816,50,76367861,75812304,555557,89.9997660006084
1747352476872258,76014444,1,817,50,76462570,75904864,557706,89.65297127877412
1747352476961597,76107004,1,818,50,76551909,75997424,554485,90.17376484485604
1747352477056602,76199564,1,819,50,76646914,76089984,556930,89.7778895013736
1747352477150953,76292132,1,820,50,76741265,76182552,558713,89.49138466439835
1747352477244302,76384684,1,821,50,76834614,76275104,559510,89.36390770495613
1747352477334467,76477244,1,822,50,76924779,76367664,557115,89.7480771474471
1747352477428540,76569804,1,823,50,77018852,76460224,558628,89.50500153948603
1747352477523058,76662364,1,824,50,77113370,76552784,560586,89.19238083005997
1747352477617733,76754924,1,825,50,77208045,76645344,562701,88.85713727183709
1747352477707656,76847484,1,826,50,77297968,76737904,560064,89.27551137012912
1747352477801396,76940044,1,827,50,77391708,76830464,561244,89.08781207460571
1747352477896719,77032604,1,828,50,77487031,76923024,564007,88.65138198639379
1747352477989957,77125164,1,829,50,77580269,77015584,564685,88.54494098479684
1747352478080094,77217724,1,830,50,77670406,77108144,562262,88.92651468532463
1747352478174854,77310284,1,831,50,77765166,77200704,564462,88.57992212053247
1747352478269042,77402844,1,832,50,77859354,77293264,566090,88.32517797523363
1747352478363012,77495404,1,833,50,77953324,77385824,567500,88.10572687224669
1747352478457202,77587964,1,834,50,78047514,77478384,569130,87.85339026233022
1747352478547113,77680524,1,835,50,78137425,77570944,566481,88.26421362764152
1747352478641716,77773084,1,836,50,78232028,77663504,568524,87.94703477777543
1747352478735097,77865644,1,837,50,78325409,77756064,569345,87.82021445696371
1747352478829417,77958204,1,838,50,78419729,77848624,571105,87.54957494681364
1747352478919856,78050764,1,839,50,78510168,77941184,568984,87.87593324241102
1747352479013911,78143324,1,840,50,78604223,78033744,570479,87.6456451508294
1747352479108564,78235884,1,841,50,78698876,78126304,572572,87.32526215043698
1747352479202601,78328444,1,842,50,78792913,78218864,574049,87.10057852204254
1747352479293001,78421012,1,843,50,78883313,78311432,571881,87.43077668256159
1747352479386721,78513564,1,844,50,78977033,78403984,573049,87.25257351465581
1747352479480663,78606124,1,845,50,79070975,78496544,574431,87.04265612406016
1747352479575159,78698684,1,846,50,79165471,78589104,576367,86.75028237216912
1747352479664853,78791244,1,847,50,79255165,78681664,573501,87.18380613111398
1747352479759844,78883804,1,848,50,79350156,78774224,575932,86.81580464360376
1747352479853948,78976364,1,849,50,79444260,78866784,577476,86.58368486309388
1747352479947532,79068924,1,850,50,79537844,78959344,578500,86.4304235090752
1747352480042032,79161484,1,851,50,79632344,79051904,580440,86.14154779133072
1747352480132587,79254044,1,852,50,79722899,79144464,578435,86.4401358838936
1747352480226266,79346604,1,853,50,79816578,79237024,579554,86.27323769657357
1747352480320943,79439164,1,854,50,79911255,79329584,581671,85.95924500275929
1747352480415058,79531724,1,855,50,80005370,79422144,583226,85.73006004533406
1747352480505121,79624284,1,856,50,80095433,79514704,580729,86.09867941845508
1747352480598755,79716844,1,857,50,80189067,79607264,581803,85.93974249015561
1747352480693240,79809404,1,858,50,80283552,79699824,583728,85.65633308664309
1747352480788141,79901964,1,859,50,80378453,79792384,586069,85.31418655482547
1747352480877823,79994524,1,860,50,80468135,79884944,583191,85.73520510433117
1747352480971438,80087084,1,861,50,80561750,79977504,584246,85.58038908268092
1747352481065774,80179644,1,862,50,80656086,80070064,586022,85.32102890335175
1747352481159871,80272204,1,863,50,80750183,80162624,587559,85.09783698317955
1747352481250735,80364764,1,864,50,80841047,80255184,585863,85.34418456191976
1747352481344695,80457324,1,865,50,80935007,80347744,587263,85.14072911114782
1747352481438419,80549884,1,866,50,81028731,80440304,588427,84.97230752497761
1747352481532887,80642444,1,867,50,81123199,80532864,590335,84.69767166100603
1747352481627072,80735004,1,868,50,81217384,80625424,591960,84.46516656530846
1747352481717293,80827564,1,869,50,81307605,80717984,589621,84.80023608385727
1747352481811225,80920124,1,870,50,81401537,80810544,590993,84.6033709367116
1747352481905329,81012684,1,871,50,81495641,80903104,592537,84.38291617232342
1747352481999318,81105244,1,872,50,81589630,80995664,593966,84.1799025533448
1747352482089310,81197804,1,873,50,81679622,81088224,591398,84.54543302479887
1747352482184178,81290364,1,874,50,81774490,81180784,593706,84.21676722148673
1747352482278851,81382924,1,875,50,81869163,81273344,595819,83.91810264526643
1747352482372540,81475484,1,876,50,81962852,81365904,596948,83.75938942755482
1747352482462786,81568044,1,877,50,82053098,81458464,594634,84.08533652633385
1747352482557099,81660604,1,878,50,82147411,81551024,596387,83.83817890061319
1747352482651187,81753164,1,879,50,82241499,81643584,597915,83.62392647784384
1747352482745215,81845724,1,880,50,82335527,81736144,599383,83.41911599094402
1747352482835179,81938284,1,881,50,82425491,81828704,596787,83.78198586765463
1747352482929347,82030844,1,882,50,82519659,81921264,598395,83.55684790146977
1747352483023631,82123404,1,883,50,82613943,82013824,600119,83.31680883291482
1747352483117629,82215972,1,884,50,82707941,82106392,601549,83.11874843113362
1747352483212089,82308524,1,885,50,82802401,82198944,603457,82.85594499690947
1747352483302369,82401084,1,886,50,82892681,82291504,601177,83.17018116128861
1747352483396568,82493644,1,887,50,82986880,82384064,602816,82.94404926212974
1747352483490610,82586204,1,888,50,83080922,82476624,604298,82.74063458757104
1747352483585240,82678764,1,889,50,83175552,82569184,606368,82.45817721251781
1747352483675328,82771324,1,890,50,83265640,82661744,603896,82.79571316915495
1747352483768978,82863884,1,891,50,83359290,82754304,604986,82.64654058110435
1747352483863165,82956444,1,892,50,83453477,82846864,606613,82.42487384873058
1747352483957828,83049004,1,893,50,83548140,82939424,608716,82.14011131627885
1747352484047587,83141564,1,894,50,83637899,83031984,605915,82.51982538804948
1747352484142236,83234124,1,895,50,83732548,83124544,608004,82.2363010769666
1747352484236240,83326684,1,896,50,83826552,83217104,609448,82.04145390582954
1747352484330726,83419244,1,897,50,83921038,83309664,611374,81.78300025843429
1747352484424751,83511804,1,898,50,84015063,83402224,612839,81.58749687927825
1747352484515006,83604364,1,899,50,84105318,83494784,610534,81.8955209701671
1747352484609291,83696924,1,900,50,84199603,83587344,612259,81.6647856544371
1747352484703361,83789484,1,901,50,84293673,83679904,613769,81.46387321614483
1747352484797543,83882044,1,902,50,84387855,83772464,615391,81.24915703999571
1747352484886940,83974604,1,903,50,84477252,83865024,612228,81.66892072887879
1747352484981594,84067164,1,904,50,84571906,83957584,614322,81.39054111687355
1747352485075963,84159724,1,905,50,84666275,84050144,616131,81.1515732855513
1747352485170089,84252284,1,906,50,84760401,84142704,617697,80.94583590336362
1747352485260473,84344852,1,907,50,84850785,84235272,615513,81.23305275436913
1747352485354585,84437404,1,908,50,84944897,84327824,617073,81.0276904029183
1747352485448645,84529964,1,909,50,85038957,84420384,618573,80.83120343112292
1747352485542775,84622524,1,910,50,85133087,84512944,620143,80.62656516319623
1747352485632682,84715084,1,911,50,85222994,84605504,617490,80.97297122220603
1747352485726576,84807644,1,912,50,85316888,84698064,618824,80.79841764378885
1747352485821497,84900204,1,913,50,85411809,84790624,621185,80.49131901124464
1747352485915740,84992764,1,914,50,85506052,84883184,622868,80.27383008920029
1747352486009410,85085324,1,915,50,85599722,84975744,623978,80.13103026068227
1747352486099998,85177884,1,916,50,85690310,85068304,622006,80.38507667128614
1747352486194225,85270444,1,917,50,85784537,85160864,623673,80.17021740559555
1747352486288388,85363004,1,918,50,85878700,85253424,625276,79.9646875939585
1747352486381982,85455564,1,919,50,85972294,85345984,626310,79.83267072216634
1747352486472334,85548124,1,920,50,86062646,85438544,624102,80.11510938917036
1747352486566808,85640684,1,921,50,86157120,85531104,626016,79.8701630629249
1747352486660479,85733244,1,922,50,86250791,85623664,627127,79.72866739910737
1747352486754444,85825804,1,923,50,86344756,85716224,628532,79.55044452788403
1747352486845654,85918364,1,924,50,86435966,85808784,627182,79.72167568584557
1747352486939639,86010924,1,925,50,86529951,85901344,628607,79.54095325060014
1747352487033249,86103484,1,926,50,86623561,85993904,629657,79.40831277981503
1747352487127438,86196044,1,927,50,86717750,86086464,631286,79.20340384548366
1747352487217559,86288604,1,928,50,86807871,86179024,628847,79.51059637717918
1747352487311553,86381164,1,929,50,86901865,86271584,630281,79.32969580234848
1747352487406201,86473724,1,930,50,86996513,86364144,632369,79.06775948852648
1747352487500160,86566284,1,931,50,87090472,86456704,633768,78.89322275659232
1747352487594827,86658844,1,932,50,87185139,86549264,635875,78.63180656575585
1747352487684545,86751404,1,933,50,87274857,86641824,633033,78.98482385594433
1747352487778518,86843964,1,934,50,87368830,86734384,634446,78.8089136033642
1747352487872721,86936524,1,935,50,87463033,86826944,636089,78.60535239565532
1747352487966860,87029084,1,936,50,87557172,86919504,637668,78.41070902099526
1747352488057298,87121644,1,937,50,87647610,87012064,635546,78.67251150978842
1747352488151336,87214204,1,938,50,87741648,87104624,637024,78.48997839955794
1747352488246122,87306764,1,939,50,87836434,87197184,639250,78.21666014861165
1747352488340384,87399324,1,940,50,87930696,87289744,640952,78.0089616695166
1747352488429957,87491884,1,941,50,88020269,87382304,637965,78.37420548149193
1747352488524696,87584444,1,942,50,88115008,87474864,640144,78.10742582918843
1747352488618289,87677004,1,943,50,88208601,87567424,641177,77.98158698768047
1747352488712646,87769564,1,944,50,88302958,87659984,642974,77.76364207572934
1747352488802503,87862124,1,945,50,88392815,87752544,640271,78.0919329471427
1747352488896579,87954684,1,946,50,88486891,87845104,641787,77.90746774241298
1747352488991396,88047244,1,947,50,88581708,87937664,644044,77.63444733589631
1747352489085473,88139812,1,948,50,88675785,88030232,645553,77.4529744265769
1747352489179433,88232364,1,949,50,88769745,88122784,646961,77.28441127054026
1747352489270130,88324924,1,950,50,88860442,88215344,645098,77.50760349590296
1747352489364275,88417484,1,951,50,88954587,88307904,646683,77.31763476077151
1747352489457828,88510044,1,952,50,89048140,88400464,647676,77.19909337384742
1747352489552003,88602604,1,953,50,89142315,88493024,649291,77.00707386980568
1747352489642607,88695164,1,954,50,89232919,88585584,647335,77.23975993882611
1747352489736889,88787724,1,955,50,89327201,88678144,649057,77.0348366938497
1747352489831132,88880284,1,956,50,89421444,88770704,650740,76.83560254479515
1747352489924815,88972844,1,957,50,89515127,88863264,651863,76.70323365492443
1747352490014952,89065404,1,958,50,89605264,88955824,649440,76.98940625769895
1747352490108950,89157964,1,959,50,89699262,89048384,650878,76.81931176042208
1747352490203768,89250524,1,960,50,89794080,89140944,653136,76.5537345973886
1747352490297337,89343084,1,961,50,89887649,89233504,654145,76.43565264582011
1747352490388021,89435644,1,962,50,89978333,89326064,652269,76.65549029618148
1747352490772970,89815244,1,966,50,90363282,89705664,657618,76.03198209294757
1747352490866638,89907804,1,967,50,90456950,89798224,658726,75.90409365957925
1747352490956940,90000364,1,968,50,90547252,89890784,656468,76.16517484477536
1747352491051286,90092924,1,969,50,90641598,89983344,658254,75.95852057108654
1747352491145489,90185484,1,970,50,90735801,90075904,659897,75.76940037611931
1747352491239858,90278044,1,971,50,90830170,90168464,661706,75.56225876748888
1747352491330247,90370604,1,972,50,90920559,90261024,659535,75.81098804460719
1747352491424445,90463164,1,973,50,91014757,90353584,661173,75.6231727550883
1747352491518100,90555724,1,974,50,91108412,90446144,662268,75.4981367059861
1747352491612472,90648284,1,975,50,91202784,90538704,664080,75.29213347789423
1747352491702769,90740844,1,976,50,91293081,90631264,661817,75.54958545942459
1747352491797028,90833404,1,977,50,91387340,90723824,663516,75.35613308495952
1747352491894754,90925964,1,978,50,91485066,90816384,668682,74.77395832398659
1747352491985616,91018524,1,979,50,91575928,90908944,666984,74.96431698511508
1747352492083622,91114204,1,980,50,91673934,91004624,669310,74.70379943523928
1747352492177722,91206764,1,981,50,91768034,91097184,670850,74.53230975627935
1747352492267853,91299324,1,982,50,91858165,91189744,668421,74.80315549631145
1747352492362199,91391884,1,983,50,91952511,91282304,670207,74.60381643283344
1747352492460647,91487564,1,984,50,92050959,91377984,672975,74.29696496898102
1747352493418067,92444364,1,994,50,93008379,92334784,673595,74.22857948767434
1747352493513120,92536924,1,995,50,93103432,92427344,676088,73.95486978026528
1747352493607331,92629484,1,996,50,93197643,92519904,677739,73.77471268438146
1747352493700799,92722044,1,997,50,93291111,92612464,678647,73.67600534593095
1747352493794973,92814604,1,998,50,93385285,92705024,680261,73.50120027460048
1747352493886127,92907164,1,999,50,93476439,92797584,678855,73.6534311450899
1747352493979684,92999724,1,1000,50,93569996,92890144,679852,73.54541870877779
1747352494074530,93093324,1,1001,50,93664842,92983744,681098,73.41087479334838
1747352494168408,93186924,1,1002,50,93758720,93077344,681376,73.38092330812944
1747352494262120,93280524,1,1003,50,93852432,93170944,681488,73.36886342826286
1747352494356438,93374124,1,1004,50,93946750,93264544,682206,73.29164504563138
1747352494451227,93467724,1,1005,50,94041539,93358144,683395,73.16412909078937
1747352494545183,93561324,1,1006,50,94135495,93451744,683751,73.12603564747985
1747352494638873,93654924,1,1007,50,94229185,93545344,683841,73.11641156350672
1747352494737006,93748524,1,1008,50,94327318,93638944,688374,72.63493391673711
1747352494831503,93842124,1,1009,50,94421815,93732544,689271,72.54040863462993
1747352494924921,93935724,1,1010,50,94515233,93826144,689089,72.55956777716668
1747352495019765,94029324,1,1011,50,94610077,93919744,690333,72.42881334080799
1747352495113969,94122924,1,1012,50,94704281,94013344,690937,72.36549786738877
1747352495208693,94216524,1,1013,50,94799005,94106944,692061,72.24796658098057
1747352495302686,94310124,1,1014,50,94892998,94200544,692454,72.20696248415057
1747352495397323,94403724,1,1015,50,94987635,94294144,693491,72.09898902797585
1747352495491501,94497324,1,1016,50,95081813,94387744,694069,72.0389471363798
1747352495585551,94590924,1,1017,50,95175863,94481344,694519,71.99227090979512
1747352495679885,94684524,1,1018,50,95270197,94574944,695253,71.91626645264385
1747352495774036,94778124,1,1019,50,95364348,94668544,695804,71.85931670412933
1747352495867399,94871724,1,1020,50,95457711,94762144,695567,71.88380127291835
1747352495962148,94965324,1,1021,50,95552460,94855744,696716,71.76525298686983
1747352496056634,95058924,1,1022,50,95646946,94949344,697602,71.67410643891502
1747352496150665,95152524,1,1023,50,95740977,95042944,698033,71.62985131075465
1747352496244333,95246124,1,1024,50,95834645,95136544,698101,71.62287405404089
1747352496338449,95339724,1,1025,50,95928761,95230144,698617,71.56997324714399
1747352496432716,95433324,1,1026,50,96023028,95323744,699284,71.50170746077416
1747352496527800,95526932,1,1027,50,96118112,95417352,700760,71.35110451509789
1747352496621225,95620524,1,1028,50,96211537,95510944,700593,71.36811244188851
1747352496715288,95714124,1,1029,50,96305600,95604544,701056,71.32097863794047
1747352496809790,95807724,1,1030,50,96400102,95698144,701958,71.22933280908545
1747352496904445,95901324,1,1031,50,96494757,95791744,703013,71.12244012557377
1747352496997945,95994924,1,1032,50,96588257,95885344,702913,71.13255836782076
1747352497092960,96088524,1,1033,50,96683272,95978944,704328,70.98965254824458
1747352497187093,96182124,1,1034,50,96777405,96072544,704861,70.93597177315812
1747352497281127,96275724,1,1035,50,96871439,96166144,705295,70.8923216526418
1747352497375040,96369324,1,1036,50,96965352,96259744,705608,70.86087459325857
1747352497468963,96462924,1,1037,50,97059275,96353344,705931,70.82845207251134
1747352497563337,96556524,1,1038,50,97153649,96446944,706705,70.75087907967256
1747352497657228,96650124,1,1039,50,97247540,96540544,706996,70.721757973171
1747352497751898,96743724,1,1040,50,97342210,96634144,708066,70.61488618292645
1747352505099140,104037244,1,1115,50,104689452,103927664,761788,65.63505857272627
1747352505197651,104131884,1,1116,50,104787963,104022304,765659,65.30322245281516
1747352505783287,104715324,1,1122,50,105373599,104605744,767855,65.11646079012314
1747352508936995,107840532,1,1154,50,108527307,107730952,796355,62.78606902700429
1747352509036171,107935164,1,1155,50,108626483,107825584,800899,62.4298444622855
1747352509122125,108029804,1,1156,50,108712437,107920224,792213,63.11433919918002
1747352509219480,108124444,1,1157,50,108809792,108014864,794928,62.8987782541312
1747352509314604,108219084,1,1158,50,108904916,108109504,795412,62.86050499615293
1747352509412086,108313724,1,1159,50,109002398,108204144,798254,62.636704607806536
1747352509507097,108408364,1,1160,50,109097409,108298784,798625,62.60760682422914
1747352509600668,108503004,1,1161,50,109190980,108393424,797556,62.691522601547724
1747352509694705,108597644,1,1162,50,109285017,108488064,796953,62.7389570024832
1747352509793337,108692284,1,1163,50,109383649,108582704,800945,62.42625898157801
1747352509883575,108786924,1,1164,50,109473887,108677344,796543,62.77125026520853
1747352509981476,108881564,1,1165,50,109571788,108771984,799804,62.51531625248186
1747352510080711,108976204,1,1166,50,109671023,108866624,804399,62.158207556200345
1747352510174058,109070844,1,1167,50,109764370,108961264,803106,62.25828221928363
1747352510268102,109165484,1,1168,50,109858414,109055904,802510,62.3045195698496
1747352510367389,109260124,1,1169,50,109957701,109150544,807157,61.945817232583
1747352510460924,109354764,1,1170,50,110051236,109245184,806052,62.03073747103165
1747352510554693,109449404,1,1171,50,110145005,109339824,805181,62.09783887101161
1747352510649093,109544044,1,1172,50,110239405,109434464,804941,62.11635386941403
1747352510743576,109638692,1,1173,50,110333888,109529112,804776,62.12908933666014
1747352510837907,109733324,1,1174,50,110428219,109623744,804475,62.15233537400167
1747352510935624,109827964,1,1175,50,110525936,109718384,807552,61.91551751466159
1747352511034759,109922604,1,1176,50,110625071,109813024,812047,61.572790737481945
1747352511124347,110017244,1,1177,50,110714659,109907664,806995,61.95825252944566
1747352511222740,110111884,1,1178,50,110813052,110002304,810748,61.67144414787332
1747352511317313,110206524,1,1179,50,110907625,110096944,810681,61.67654108089372
1747352511419102,110301164,1,1180,50,111009414,110191584,817830,61.13740019319419
1747352511722771,110591324,1,1183,50,111313083,110481744,831339,60.14393646875703
1747352511808544,110685964,1,1184,50,111398856,110576384,822472,60.79234308280404
1747352511923107,110780604,1,1185,50,111513419,110671024,842395,59.35457831539836
1747352512008952,110875244,1,1186,50,111599264,110765664,833600,59.98080614203455
1747352512107753,110969892,1,1187,50,111698065,110860312,837753,59.68346278676412
1747352512193099,111064524,1,1188,50,111783411,110954944,828467,60.352434074018646
1747352512377857,111256924,1,1190,50,111968169,111147344,820825,60.91432400328937
1747352512574756,111449324,1,1192,50,112165068,111339744,825324,60.58226829705667
1747352512672450,111543964,1,1193,50,112262762,111434384,828378,60.35891827161031
1747352512766952,111638604,1,1194,50,112357264,111529024,828240,60.36897517627741
1747352512865209,111733244,1,1195,50,112455521,111623664,831857,60.10648464820276
1747352512971521,111827884,1,1196,50,112561833,111718304,843529,59.274784862168346
1747352513045276,111922524,1,1197,50,112635588,111812944,822644,60.77963250203004
1747352513344077,112212684,1,1200,50,112934389,112103104,831285,60.14784339907492
1747352513438248,112307324,1,1201,50,113028560,112197744,830816,60.1817971728999
1747352513548714,112401964,1,1202,50,113139026,112292384,846642,59.05683866380359
1747352513622646,112496604,1,1203,50,113212958,112387024,825934,60.53752479011641
1747352513721440,112591244,1,1204,50,113311752,112481664,830088,60.23457753876697
1747352513810902,112685884,1,1205,50,113401214,112576304,824910,60.61267289764944
1747352513925464,112780524,1,1206,50,113515776,112670944,844832,59.18336426650505
1747352514004043,112875164,1,1207,50,113594355,112765584,828771,60.33029630621728
1747352514101939,112969804,1,1208,50,113692251,112860224,832027,60.09420367367886
1747352514208612,113064444,1,1209,50,113798924,112954864,844060,59.237494964812925
1747352514296247,113159084,1,1210,50,113886559,113049504,837055,59.73323138861843
1747352514389068,113253724,1,1211,50,113979380,113144144,835236,59.86332006762161
1747352514482981,113348364,1,1212,50,114073293,113238784,834509,59.91547125315605
1747352514581633,113443004,1,1213,50,114171945,113333424,838521,59.62879880169966
1747352514675623,113537644,1,1214,50,114265935,113428064,837871,59.67505737756767
1747352514769802,113632292,1,1215,50,114360114,113522712,837402,59.70847932056528
1747352514863360,113726924,1,1216,50,114453672,113617344,836328,59.78515606317139
1747352514957897,113821564,1,1217,50,114548209,113711984,836225,59.792519955753534
1747352515052445,113916204,1,1218,50,114642757,113806624,836133,59.799098947177065
1747352515150889,114010844,1,1219,50,114741201,113901264,839937,59.52827414437035
1747352515249161,114105484,1,1220,50,114839473,113995904,843569,59.27197419535332
1747352515343208,114200124,1,1221,50,114933520,114090544,842976,59.31366966556581
1747352515437543,114294764,1,1222,50,115027855,114185184,842671,59.335137912661054
1747352515531691,114389404,1,1223,50,115122003,114279824,842179,59.36980143176213
1747352515629707,114484044,1,1224,50,115220019,114374464,845555,59.13275895713467
1747352515719701,114578684,1,1225,50,115310013,114469104,840909,59.45946588750982
1747352515817813,114673324,1,1226,50,115408125,114563744,844381,59.214975230375856
1747352515912309,114767964,1,1227,50,115502621,114658384,844237,59.22507542313355
1747352516010922,114862604,1,1228,50,115601234,114753024,848210,58.94766626189269
1747352516109251,114957244,1,1229,50,115699563,114847664,851899,58.69240367696171
1747352516198916,115051884,1,1230,50,115789228,114942304,846924,59.03717452805682
1747352516309100,115146524,1,1231,50,115899412,115036944,862468,57.97316538120835
1747352516387513,115241164,1,1232,50,115977825,115131584,846241,59.08482335410362
1747352516498169,115335804,1,1233,50,116088481,115226224,862257,57.98735179882564
1747352516583892,115430444,1,1234,50,116174204,115320864,853340,58.59329223990438
1747352516678622,115525084,1,1235,50,116268934,115415504,853430,58.587113178585234
1747352516768191,115619724,1,1236,50,116358503,115510144,848359,58.93731309504585
1747352516866455,115714364,1,1237,50,116456767,115604784,851983,58.68661698648916
1747352516973618,115809004,1,1238,50,116563930,115699424,864506,57.83649853210967
1747352517062858,115903644,1,1239,50,116653170,115794064,859106,58.20003585122208
1747352517152933,115998284,1,1240,50,116743245,115888704,854541,58.510943301725725
1747352517243058,116092924,1,1241,50,116833370,115983344,850026,58.8217301588422
1747352517349560,116187564,1,1242,50,116939872,116077984,861888,58.01217791638821
1747352517562344,116379964,1,1244,50,117152656,116270384,882272,56.67186536578289
1747352517632226,116474604,1,1245,50,117222538,116365024,857514,58.308085932124726
1747352517735000,116569244,1,1246,50,117325312,116459664,865648,57.7601981405837
1747352517923650,116761644,1,1248,50,117513962,116652064,861898,58.01150484164019
1747352518017712,116856284,1,1249,50,117608024,116746704,861320,58.05043421724795
1747352518127828,116950924,1,1250,50,117718140,116841344,876796,57.02580759948722
1747352518218449,117045564,1,1251,50,117808761,116935984,872777,57.28840242123704
1747352518300457,117140204,1,1252,50,117890769,117030624,860145,58.12973394020775
1747352518402731,117234844,1,1253,50,117993043,117125264,867779,57.618356747512905
1747352518590889,117427244,1,1255,50,118181201,117317664,863537,57.90139855038058
1747352518705560,117521884,1,1256,50,118295872,117412304,883568,56.5887401988302
1747352518787265,117616524,1,1257,50,118377577,117506944,870633,57.42947947068397
1747352518872979,117711164,1,1258,50,118463291,117601584,861707,58.02436326964966
1747352518971362,117805804,1,1259,50,118561674,117696224,865450,57.77341267548674
1747352519073884,117900444,1,1260,50,118664196,117790864,873332,57.25199580457375
1747352519160172,117995084,1,1261,50,118750484,117885504,864980,57.80480473536961
1747352519258432,118089724,1,1262,50,118848744,117980144,868600,57.56389592447616
1747352519352155,118184364,1,1263,50,118942467,118074784,867683,57.62473161281252
1747352519451043,118279004,1,1264,50,119041355,118169424,871931,57.34398708154659
1747352519540590,118373644,1,1265,50,119130902,118264064,866838,57.68090462116336
1747352519639600,118468284,1,1266,50,119229912,118358704,871208,57.391575834932645
1747352519733779,118562924,1,1267,50,119324091,118453344,870747,57.42196068433196
1747352519831668,118657564,1,1268,50,119421980,118547984,873996,57.20849981006778
1747352519929927,118752204,1,1269,50,119520239,118642624,877615,56.97259048671684
1747352520023880,118846844,1,1270,50,119614192,118737264,876928,57.01722376295431
1747352520118250,118941484,1,1271,50,119708562,118831904,876658,57.03478437429419
1747352520212241,119036124,1,1272,50,119802553,118926544,876009,57.07703916283965
1747352520315029,119130764,1,1273,50,119905341,119021184,884157,56.55104240536466
1747352520405616,119225404,1,1274,50,119995928,119115824,880104,56.81146773563125
1747352520495748,119320044,1,1275,50,120086060,119210464,875596,57.10396118757966
1747352520593558,119414684,1,1276,50,120183870,119305104,878766,56.89796828734839
1747352520687575,119509324,1,1277,50,120277887,119399744,878143,56.938334644812976
1747352520786476,119603964,1,1278,50,120376788,119494384,882404,56.66338774529581
1747352520884237,119698604,1,1279,50,120474549,119589024,885525,56.46367973800852
1747352520974501,119793244,1,1280,50,120564813,119683664,881149,56.74409208885217
1747352521072634,119887892,1,1281,50,120662946,119778312,884634,56.520549741475
1747352521162675,119982524,1,1282,50,120752987,119872944,880043,56.81540561086219
1747352521273600,120077164,1,1283,50,120863912,119967584,896328,55.78315081086388
1747352521355620,120171804,1,1284,50,120945932,120062224,883708,56.579775219869006
1747352521453539,120266444,1,1285,50,121043851,120156864,886987,56.37061197063768
1747352521547689,120361084,1,1286,50,121138001,120251504,886497,56.40177011315323
1747352521642282,120455724,1,1287,50,121232594,120346144,886450,56.40476056179142
1747352521740072,120550364,1,1288,50,121330384,120440784,889600,56.20503597122303
1747352521834501,120645004,1,1289,50,121424813,120535424,889389,56.218370139500266
1747352521925107,120739644,1,1290,50,121515419,120630064,885355,56.47452151961642
1747352522023300,120834284,1,1291,50,121613612,120724704,888908,56.248790651001
1747352522121109,120928924,1,1292,50,121711421,120819344,892077,56.04897335095513
1747352522211811,121023564,1,1293,50,121802123,120913984,888139,56.29749397335327
1747352522318836,121118204,1,1294,50,121909148,121008624,900524,55.52322869795808
1747352522403586,121212844,1,1295,50,121993898,121103264,890634,56.13978356990638
1747352522498358,121307484,1,1296,50,122088670,121197904,890766,56.13146438009534
1747352522596691,121402124,1,1297,50,122187003,121292544,894459,55.89971144568952
1747352522690769,121496764,1,1298,50,122281081,121387184,893897,55.93485602927407
1747352522793248,121591404,1,1299,50,122383560,121481824,901736,55.44860136447918
1747352522887390,121686052,1,1300,50,122477702,121576472,901230,55.47973325344252
1747352522977884,121780684,1,1301,50,122568196,121671104,897092,55.73564361291818
1747352523071490,121875324,1,1302,50,122661802,121765744,896058,55.79995937762957
1747352523166578,121969964,1,1303,50,122756890,121860384,896506,55.77207514506316
1747352523268629,122064604,1,1304,50,122858941,121955024,903917,55.31481319634435
1747352523354960,122159244,1,1305,50,122945272,122049664,895608,55.82799617689882
1747352523452695,122253884,1,1306,50,123043007,122144304,898703,55.63573282830924
1747352523550755,122348524,1,1307,50,123141067,122238944,902123,55.424814576282834
1747352523645107,122443164,1,1308,50,123235419,122333584,901835,55.44251442891438
1747352523739036,122537804,1,1309,50,123329348,122428224,901124,55.48625938272646
1747352523845794,122632444,1,1310,50,123436106,122522864,913242,54.75000054750001
1747352523931851,122727084,1,1311,50,123522163,122617504,904659,55.26944406676992
1747352524025628,122821724,1,1312,50,123615940,122712144,903796,55.322218730775525
1747352524120303,122916364,1,1313,50,123710615,122806784,903831,55.32007643021759
1747352524214247,123011004,1,1314,50,123804559,122901424,903135,55.36270878661552
1747352524317152,123105644,1,1315,50,123907464,122996064,911400,54.86065393899495
1747352524406531,123200284,1,1316,50,123996843,123090704,906139,55.17917229034398
1747352524501392,123294924,1,1317,50,124091704,123185344,906360,55.16571781632023
1747352524598834,123389564,1,1318,50,124189146,123279984,909162,54.9956993363119
1747352524688913,123484204,1,1319,50,124279225,123374624,904601,55.27298775924413
1747352524787645,123578844,1,1320,50,124377957,123469264,908693,55.024084041585006
1747352524886043,123673484,1,1321,50,124476355,123563904,912451,54.79746309664848
1747352524980232,123768124,1,1322,50,124570544,123658544,912000,54.82456140350877
1747352525078867,123862764,1,1323,50,124669179,123753184,915995,54.58545079394538
1747352525192708,123957404,1,1324,50,124783020,123847824,935196,53.46472824947925
1747352525271210,124052044,1,1325,50,124861522,123942464,919058,54.403530571519966
1747352525357060,124146684,1,1326,50,124947372,124037104,910268,54.92887808865082
1747352525455319,124241324,1,1327,50,125045631,124131744,913887,54.71135928183681
1747352525549874,124335964,1,1328,50,125140186,124226384,913802,54.716448420992734
1747352525664449,124430604,1,1329,50,125254761,124321024,933737,53.54826894510981
1747352525746479,124525244,1,1330,50,125336791,124415664,921127,54.28133145592302
1747352525844518,124619884,1,1331,50,125434830,124510304,924526,54.08176730562472
1747352525938213,124714524,1,1332,50,125528525,124604944,923581,54.13710329684132
1747352526024869,124809164,1,1333,50,125615181,124699584,915597,54.60917849228427
1747352526127368,124903804,1,1334,50,125717680,124794224,923456,54.14443135352415
1747352526225165,124998444,1,1335,50,125815477,124888864,926613,53.95995955161432
1747352526315073,125093084,1,1336,50,125905385,124983504,921881,54.2369351358798
1747352526421349,125187724,1,1337,50,126011661,125078144,933517,53.56088855371675
1747352526503505,125282364,1,1338,50,126093817,125172784,921033,54.28687137160124
1747352526597842,125377004,1,1339,50,126188154,125267424,920730,54.30473645911396
1747352526692121,125471644,1,1340,50,126282433,125362064,920369,54.32603662226781
1747352526786014,125566284,1,1341,50,126376326,125456704,919622,54.37016513306554
1747352526896880,125660924,1,1342,50,126487192,125551344,935848,53.42747967618673
1747352526983148,125755564,1,1343,50,126573460,125645984,927476,53.90975076444027
1747352527094060,125850204,1,1344,50,126684372,125740624,943748,52.98024472634644
1747352527188061,125944852,1,1345,50,126778373,125835272,943101,53.016591011991295
1747352527269908,126039484,1,1346,50,126860220,125929904,930316,53.74517905743855
1747352527363588,126134124,1,1347,50,126953900,126024544,929356,53.80069639621416
1747352527462381,126228764,1,1348,50,127052693,126119184,933509,53.56134756065555
1747352527573075,126323404,1,1349,50,127163387,126213824,949563,52.65580061565162
1747352527670615,126418044,1,1350,50,127260927,126308464,952463,52.49547751461212
1747352527753274,126512684,1,1351,50,127343586,126403104,940482,53.16422855514512
1747352527838487,126607324,1,1352,50,127428799,126497744,931055,53.70252025927577
1747352527953685,126701964,1,1353,50,127543997,126592384,951613,52.54236753806432
1747352528035289,126796604,1,1354,50,127625601,126687024,938577,53.27213430544324
1747352528130123,126891244,1,1355,50,127720435,126781664,938771,53.26112545018966
1747352528220350,126985884,1,1356,50,127810662,126876304,934358,53.51267929423197
1747352528322452,127080524,1,1357,50,127912764,126970944,941820,53.08870060096409
1747352528429092,127175164,1,1358,50,128019404,127065584,953820,52.42079218301147
1747352528527328,127269804,1,1359,50,128117640,127160224,957416,52.22390267135707
1747352528605104,127364444,1,1360,50,128195416,127254864,940552,53.16027184036608
1747352528703142,127459084,1,1361,50,128293454,127349504,943950,52.968907251443405
1747352528801041,127553724,1,1362,50,128391353,127444144,947209,52.78666059971981
1747352529091741,127843884,1,1365,50,128682053,127734304,947749,52.75658428550175
1747352529178102,127938524,1,1366,50,128768414,127828944,939470,53.22149722715999
1747352529281062,128033164,1,1367,50,128871374,127923584,947790,52.75430211333734
1747352529370722,128127804,1,1368,50,128961034,128018224,942810,53.03295467803693
1747352529567310,128320204,1,1370,50,129157622,128210624,946998,52.79842196076444
1747352529665739,128414844,1,1371,50,129256051,128305264,950787,52.58801392951312
1747352529762971,128509484,1,1372,50,129353283,128399904,953379,52.44504022010135
1747352529948498,128701884,1,1374,50,129538810,128592304,946506,52.82586692530212
1747352530042921,128796524,1,1375,50,129633233,128686944,946289,52.83798078599666
1747352530153287,128891164,1,1376,50,129743599,128781584,962015,51.97424156587995
1747352530247728,128985804,1,1377,50,129838040,128876224,961816,51.98499505102847
1747352530350062,129080444,1,1378,50,129940374,128970864,969510,51.57244381182247
1747352530530145,129272852,1,1380,50,130120457,129163272,957185,52.23650600458637
1747352530619609,129367484,1,1381,50,130209921,129257904,952017,52.52007054495876
1747352530717937,129462124,1,1382,50,130308249,129352544,955705,52.317399197451095
1747352530808443,129556764,1,1383,50,130398755,129447184,951571,52.54468662874342
1747352622474565,7109244,1,76,75,0,0,0,0.0
1747352622564533,7199724,1,77,75,89968,90480,-512,0.0
1747352622654819,7290204,1,78,75,180254,180960,-706,0.0
1747352622744008,7380684,1,79,75,269443,271440,-1997,0.0
1747352622838899,7471164,1,80,75,364334,361920,2414,31068.76553438277
1747352622929089,7561644,1,81,75,454524,452400,2124,35310.73446327684
1747352623019322,7652124,1,82,75,544757,542880,1877,39957.37879595099
1747352623108635,7742604,1,83,75,634070,633360,710,105633.8028169014
1747352623202924,7833084,1,84,75,728359,723840,4519,16596.5921664085
1747352623293711,7923564,1,85,75,819146,814320,4826,15540.82055532532
1747352623383685,8014044,1,86,75,909120,904800,4320,17361.11111111111
1747352623474052,8104524,1,87,75,999487,995280,4207,17827.430473021155
1747352623567871,8195004,1,88,75,1093306,1085760,7546,9939.04055128545
1747352623657581,8285484,1,89,75,1183016,1176240,6776,11068.476977567889
1747352623748386,8375964,1,90,75,1273821,1266720,7101,10561.892691170258
1747352623838130,8466452,1,91,75,1363565,1357208,6357,11798.01793298726
1747352623932641,8556924,1,92,75,1458076,1447680,10396,7214.313197383609
1747352624022195,8647404,1,93,75,1547630,1538160,9470,7919.746568109821
1747352624112752,8737884,1,94,75,1638187,1628640,9547,7855.870954226459
1747352624202746,8828364,1,95,75,1728181,1719120,9061,8277.232093587905
1747352624296545,8918844,1,96,75,1821980,1809600,12380,6058.158319870759
1747352624386378,9009324,1,97,75,1911813,1900080,11733,6392.227051904883
1747352624477397,9099804,1,98,75,2002832,1990560,12272,6111.4732724902215
1747352624567188,9190284,1,99,75,2092623,2081040,11583,6475.006475006475
1747352624661274,9280764,1,100,75,2186709,2171520,15189,4937.783922575548
1747352624751356,9372284,1,101,75,2276791,2263040,13751,5454.148789178969
1747352624845934,9463804,1,102,75,2371369,2354560,16809,4461.895413171515
1747352624940178,9555324,1,103,75,2465613,2446080,19533,3839.6559668253726
1747352625030022,9646844,1,104,75,2555457,2537600,17857,4200.033600268802
1747352625124215,9738364,1,105,75,2649650,2629120,20530,3653.190452995616
1747352625214198,9829884,1,106,75,2739633,2720640,18993,3948.8232506713
1747352625308791,9921404,1,107,75,2834226,2812160,22066,3398.894226411674
1747352625398999,10012924,1,108,75,2924434,2903680,20754,3613.761202659728
1747352625492705,10105484,1,109,75,3018140,2996240,21900,3424.657534246576
1747352625586607,10198052,1,110,75,3112042,3088808,23234,3228.027890160971
1747352625681135,10290604,1,111,75,3206570,3181360,25210,2975.0099166997225
1747352625771599,10383164,1,112,75,3297034,3273920,23114,3244.786709353639
1747352625865564,10475724,1,113,75,3390999,3366480,24519,3058.8523186100574
1747352625959104,10568284,1,114,75,3484539,3459040,25499,2941.291815365308
1747352626054147,10660844,1,115,75,3579582,3551600,27982,2680.294475019656
1747352626144384,10753404,1,116,75,3669819,3644160,25659,2922.9510113410497
1747352626238400,10845964,1,117,75,3763835,3736720,27115,2765.996680803983
1747352626332801,10938524,1,118,75,3858236,3829280,28956,2590.136759220887
1747352626426705,11031084,1,119,75,3952140,3921840,30300,2475.247524752476
1747352626520137,11123644,1,120,75,4045572,4014400,31172,2406.0053894520724
1747352626611212,11216204,1,121,75,4136647,4106960,29687,2526.3583386667565
1747352626705356,11308764,1,122,75,4230791,4199520,31271,2398.3882830737743
1747352626798886,11401324,1,123,75,4324321,4292080,32241,2326.2305759746905
1747352626893647,11493884,1,124,75,4419082,4384640,34442,2177.5738923407466
1747352626983965,11586444,1,125,75,4509400,4477200,32200,2329.192546583851
1747352627078064,11679004,1,126,75,4603499,4569760,33739,2222.946738196153
1747352627171732,11771564,1,127,75,4697167,4662320,34847,2152.26561827417
1747352627265922,11864124,1,128,75,4791357,4754880,36477,2056.090138991693
1747352627355906,11956684,1,129,75,4881341,4847440,33901,2212.3241202324416
1747352627450380,12049244,1,130,75,4975815,4940000,35815,2094.094653078319
1747352627545192,12141804,1,131,75,5070627,5032560,38067,1970.2104184726927
1747352627639308,12234364,1,132,75,5164743,5125120,39623,1892.8400171617493
1747352627728946,12326932,1,133,75,5254381,5217688,36693,2043.98659144796
1747352627822942,12419484,1,134,75,5348377,5310240,38137,1966.5941211946408
1747352627917757,12512044,1,135,75,5443192,5402800,40392,1856.8033273915628
1747352628011773,12604604,1,136,75,5537208,5495360,41848,1792.200344102466
1747352628105275,12697164,1,137,75,5630710,5587920,42790,1752.745968684272
1747352628196395,12789724,1,138,75,5721830,5680480,41350,1813.7847642079807
1747352628289834,12882284,1,139,75,5815269,5773040,42229,1776.0306898103197
1747352628383942,12974844,1,140,75,5909377,5865600,43777,1713.2284076113026
1747352628478677,13067404,1,141,75,6004112,5958160,45952,1632.1378830083563
1747352628568861,13159964,1,142,75,6094296,6050720,43576,1721.1308977418764
1747352628663074,13252524,1,143,75,6188509,6143280,45229,1658.228127970992
1747352628756796,13345084,1,144,75,6282231,6235840,46391,1616.6928930180422
1747352628851273,13437644,1,145,75,6376708,6328400,48308,1552.537881924319
1747352628941767,13530204,1,146,75,6467202,6420960,46242,1621.902166861295
1747352629035133,13622764,1,147,75,6560568,6513520,47048,1594.1166468287706
1747352629129834,13715324,1,148,75,6655269,6606080,49189,1524.7311390758098
1747352629224052,13807884,1,149,75,6749487,6698640,50847,1475.013275119476
1747352629314364,13900444,1,150,75,6839799,6791200,48599,1543.2416304862238
1747352629407874,13993004,1,151,75,6933309,6883760,49549,1513.653151425861
1747352629502131,14085564,1,152,75,7027566,6976320,51246,1463.5288607891348
1747352629596362,14178124,1,153,75,7121797,7068880,52917,1417.3139066840524
1747352629691020,14270684,1,154,75,7216455,7161440,55015,1363.264564209761
1747352629784595,14363244,1,155,75,7310030,7254000,56030,1338.5686239514546
1747352629875218,14455804,1,156,75,7400653,7346560,54093,1386.5010260107592
1747352629969361,14548364,1,157,75,7494796,7439120,55676,1347.0795315755445
1747352630063130,14640924,1,158,75,7588565,7531680,56885,1318.4495033840203
1747352630153275,14733484,1,159,75,7678710,7624240,54470,1376.9047181935011
1747352630247512,14826044,1,160,75,7772947,7716800,56147,1335.7792936399094
1747352630342236,14918604,1,161,75,7867671,7809360,58311,1286.2067191439007
1747352630436523,15011164,1,162,75,7961958,7901920,60038,1249.2088344048768
1747352630526893,15103724,1,163,75,8052328,7994480,57848,1296.5011754943991
1747352630620400,15196284,1,164,75,8145835,8087040,58795,1275.618675057403
1747352630715102,15288844,1,165,75,8240537,8179600,60937,1230.7793294714213
1747352630809531,15381404,1,166,75,8334966,8272160,62806,1194.1534248320224
1747352630899543,15473964,1,167,75,8424978,8364720,60258,1244.6480135417703
1747352630993707,15566524,1,168,75,8519142,8457280,61862,1212.3759335294687
1747352631087771,15659084,1,169,75,8613206,8549840,63366,1183.600037875201
1747352631181549,15751644,1,170,75,8706984,8642400,64584,1161.2783351913786
1747352631276079,15844204,1,171,75,8801514,8734960,66554,1126.9044685518527
1747352631365862,15936764,1,172,75,8891297,8827520,63777,1175.972529281716
1747352631459857,16029324,1,173,75,8985292,8920080,65212,1150.0950745261607
1747352631554595,16121892,1,174,75,9080030,9012648,67382,1113.056899468701
1747352631648356,16214444,1,175,75,9173791,9105200,68591,1093.4379145952091
1747352631738573,16307004,1,176,75,9264008,9197760,66248,1132.109648593165
1747352631833391,16399564,1,177,75,9358826,9290320,68506,1094.794616529939
1747352631927522,16492124,1,178,75,9452957,9382880,70077,1070.251295004067
1747352632021475,16584684,1,179,75,9546910,9475440,71470,1049.391353015251
1747352632111366,16677244,1,180,75,9636801,9568000,68801,1090.1004345867066
1747352632205032,16769804,1,181,75,9730467,9660560,69907,1072.853934512996
1747352632300202,16862364,1,182,75,9825637,9753120,72517,1034.2402471144696
1747352632393939,16954924,1,183,75,9919374,9845680,73694,1017.7219312291368
1747352632484540,17047484,1,184,75,10009975,9938240,71735,1045.514741757859
1747352632577820,17140044,1,185,75,10103255,10030800,72455,1035.1252501552688
1747352632672172,17232604,1,186,75,10197607,10123360,74247,1010.1418239120774
1747352632766419,17325164,1,187,75,10291854,10215920,75934,987.6998446018912
1747352632860745,17417724,1,188,75,10386180,10308480,77700,965.2509652509652
1747352632950737,17510284,1,189,75,10476172,10401040,75132,998.2430921578024
1747352633044991,17602844,1,190,75,10570426,10493600,76826,976.2320047900448
1747352633139185,17695404,1,191,75,10664620,10586160,78460,955.9010960999236
1747352633233323,17787964,1,192,75,10758758,10678720,80038,937.0548989230116
1747352633324216,17880524,1,193,75,10849651,10771280,78371,956.9866404664992
1747352633418342,17973084,1,194,75,10943777,10863840,79937,938.238863104695
1747352633512229,18065644,1,195,75,11037664,10956400,81264,922.917897223863
1747352633605729,18158204,1,196,75,11131164,11048960,82204,912.364361831541
1747352633696863,18250772,1,197,75,11222298,11141528,80770,928.562585118237
1747352633789629,18343324,1,198,75,11315064,11234080,80984,926.108861009582
1747352633884820,18435884,1,199,75,11410255,11326640,83615,896.9682473240448
1747352633979072,18528444,1,200,75,11504507,11419200,85307,879.1775586997551
1747352634069179,18621004,1,201,75,11594614,11511760,82854,905.2067492215224
1747352634163783,18713564,1,202,75,11689218,11604320,84898,883.4130368206554
1747352634257575,18806124,1,203,75,11783010,11696880,86130,870.7767328456983
1747352634352220,18898684,1,204,75,11877655,11789440,88215,850.1955449753443
1747352634445578,18991244,1,205,75,11971013,11882000,89013,842.5735566714975
1747352634535892,19083804,1,206,75,12061327,11974560,86767,864.3839247640232
1747352634630391,19176364,1,207,75,12155826,12067120,88706,845.4895948413862
1747352634724135,19268924,1,208,75,12249570,12159680,89890,834.3530982311714
1747352634818485,19361484,1,209,75,12343920,12252240,91680,818.062827225131
1747352634908603,19454044,1,210,75,12434038,12344800,89238,840.4491360182882
1747352635003435,19546604,1,211,75,12528870,12437360,91510,819.5825592831385
1747352635096968,19639164,1,212,75,12622403,12529920,92483,810.959852080923
1747352635191153,19731724,1,213,75,12716588,12622480,94108,796.9566880605262
1747352635281691,19824284,1,214,75,12807126,12715040,92086,814.4560519514367
1747352635376052,19916844,1,215,75,12901487,12807600,93887,798.8326392365291
1747352635469507,20009404,1,216,75,12994942,12900160,94782,791.2894853453187
1747352635564084,20101964,1,217,75,13089519,12992720,96799,774.8013925763696
1747352635654119,20194524,1,218,75,13179554,13085280,94274,795.5533869359526
1747352635748839,20287084,1,219,75,13274274,13177840,96434,777.7339942343987
1747352635842504,20379644,1,220,75,13367939,13270400,97539,768.9231999507889
1747352635937094,20472204,1,221,75,13462529,13362960,99569,753.246492382167
1747352636031339,20564764,1,222,75,13556774,13455520,101254,740.7114780650642
1747352636120982,20657324,1,223,75,13646417,13548080,98337,762.6834253638001
1747352636214934,20749884,1,224,75,13740369,13640640,99729,752.038023042445
1747352636309604,20842444,1,225,75,13835039,13733200,101839,736.4565637918676
1747352636403921,20935004,1,226,75,13929356,13825760,103596,723.9661763002433
1747352636494415,21027564,1,227,75,14019850,13918320,101530,738.6979217965134
1747352636587968,21120124,1,228,75,14113403,14010880,102523,731.5431659237439
1747352636682460,21212684,1,229,75,14207895,14103440,104455,718.0125412857211
1747352636776009,21305244,1,230,75,14301444,14196000,105444,711.2780243541596
1747352636866221,21397804,1,231,75,14391656,14288560,103096,727.4773027081555
1747352636960444,21490364,1,232,75,14485879,14381120,104759,715.9289416661098
1747352637055247,21582924,1,233,75,14580682,14473680,107002,700.9214781032131
1747352637149158,21675484,1,234,75,14674593,14566240,108353,692.1820346460181
1747352637243179,21768044,1,235,75,14768614,14658800,109814,682.9730271185823
1747352637332799,21860604,1,236,75,14858234,14751360,106874,701.7609521492599
1747352637427240,21953164,1,237,75,14952675,14843920,108755,689.623465587789
1747352637521469,22045732,1,238,75,15046904,14936488,110416,679.249384147225
1747352637615779,22138284,1,239,75,15141214,15029040,112174,668.6041328650133
1747352637706069,22230844,1,240,75,15231504,15121600,109904,682.4137429028971
1747352637800479,22323404,1,241,75,15325914,15214160,111754,671.1169175152567
1747352637894344,22415964,1,242,75,15419779,15306720,113059,663.3704525955474
1747352637988452,22508524,1,243,75,15513887,15399280,114607,654.4102890748384
1747352638078308,22601084,1,244,75,15603743,15491840,111903,670.2233184096941
1747352638173015,22693644,1,245,75,15698450,15584400,114050,657.6063130206051
1747352638267367,22786204,1,246,75,15792802,15676960,115842,647.4335733153779
1747352638361549,22878764,1,247,75,15886984,15769520,117464,638.4934958795886
1747352638451638,22971324,1,248,75,15977073,15862080,114993,652.2136130025306
1747352638545646,23063884,1,249,75,16071081,15954640,116441,644.1030221313798
1747352638640030,23156444,1,250,75,16165465,16047200,118265,634.1690271847124
1747352638733813,23249004,1,251,75,16259248,16139760,119488,627.6780931976433
1747352638828532,23341564,1,252,75,16353967,16232320,121647,616.5380157340502
1747352638918120,23434124,1,253,75,16443555,16324880,118675,631.9780914261639
1747352639012111,23526684,1,254,75,16537546,16417440,120106,624.4484039098796
1747352639106289,23619244,1,255,75,16631724,16510000,121724,616.1480069665802
1747352639200842,23711804,1,256,75,16726277,16602560,123717,606.2222653313611
1747352639290976,23804364,1,257,75,16816411,16695120,121291,618.3476102926021
1747352639385678,23896924,1,258,75,16911113,16787680,123433,607.6170878128215
1747352639479697,23989484,1,259,75,17005132,16880240,124892,600.5188482849181
1747352639574120,24082044,1,260,75,17099555,16972800,126755,591.692635398998
1747352639664133,24174612,1,261,75,17189568,17065368,124200,603.8647342995168
1747352639757898,24267164,1,262,75,17283333,17157920,125413,598.0241282801624
1747352639852407,24359724,1,263,75,17377842,17250480,127362,588.8726621755311
1747352639946804,24452284,1,264,75,17472239,17343040,129199,580.4998490700392
1747352640036997,24544844,1,265,75,17562432,17435600,126832,591.3334174340861
1747352640130266,24637404,1,266,75,17655701,17528160,127541,588.0461969092293
1747352640224621,24729964,1,267,75,17750056,17620720,129336,579.8849508257562
1747352640318722,24822524,1,268,75,17844157,17713280,130877,573.0571452585252
1747352640413790,24915084,1,269,75,17939225,17805840,133385,562.2821156801739
1747352640503914,25007644,1,270,75,18029349,17898400,130949,572.7420598859097
1747352640598017,25100204,1,271,75,18123452,17990960,132492,566.0719137759261
1747352640690971,25192764,1,272,75,18216406,18083520,132886,564.3935403277998
1747352640785591,25285324,1,273,75,18311026,18176080,134946,555.7778667022365
1747352640876690,25377884,1,274,75,18402125,18268640,133485,561.8608832453085
1747352640970411,25470444,1,275,75,18495846,18361200,134646,557.0161757497439
1747352641064634,25563004,1,276,75,18590069,18453760,136309,550.2204549956349
1747352641158493,25655564,1,277,75,18683928,18546320,137608,545.026451950468
1747352641248484,25748124,1,278,75,18773919,18638880,135039,555.395108079888
1747352641343245,25840684,1,279,75,18868680,18731440,137240,546.4879044010493
1747352641436993,25933244,1,280,75,18962428,18824000,138428,541.7979021585229
1747352641531890,26025804,1,281,75,19057325,18916560,140765,532.8028984477676
1747352641621693,26118364,1,282,75,19147128,19009120,138008,543.446756709756
1747352641715541,26210924,1,283,75,19240976,19101680,139296,538.42177808408
1747352641809608,26303484,1,284,75,19335043,19194240,140803,532.6591052747456
1747352641904640,26396044,1,285,75,19430075,19286800,143275,523.4688536032105
1747352641998066,26488604,1,286,75,19523501,19379360,144141,520.3238495639687
1747352642088677,26581164,1,287,75,19614112,19471920,142192,527.4558343648025
1747352642183166,26673724,1,288,75,19708601,19564480,144121,520.3960560917562
1747352642277333,26766284,1,289,75,19802768,19657040,145728,514.6574440052701
1747352642371857,26858844,1,290,75,19897292,19749600,147692,507.8135579449124
1747352642461849,26951404,1,291,75,19987284,19842160,145124,516.7994266971693
1747352642555785,27043964,1,292,75,20081220,19934720,146500,511.9453924914676
1747352642649782,27136524,1,293,75,20175217,20027280,147937,506.9725626449096
1747352642744152,27229084,1,294,75,20269587,20119840,149747,500.8447581587611
1747352642834542,27321644,1,295,75,20359977,20212400,147577,508.2092738028283
1747352642928183,27414204,1,296,75,20453618,20304960,148658,504.5137160462269
1747352643022667,27506764,1,297,75,20548102,20397520,150582,498.0674981073435
1747352643116532,27599324,1,298,75,20641967,20490080,151887,493.7881451342116
1747352643207202,27691884,1,299,75,20732637,20582640,149997,500.010000200004
1747352643300644,27784444,1,300,75,20826079,20675200,150879,497.08706977114105
1747352643394644,27877004,1,301,75,20920079,20767760,152319,492.38768636873925
1747352643488839,27969572,1,302,75,21014274,20860328,153946,487.1838177023112
1747352643583307,28062124,1,303,75,21108742,20952880,155862,481.1949031835855
1747352643674039,28154684,1,304,75,21199474,21045440,154034,486.9054883986652
1747352643767790,28247244,1,305,75,21293225,21138000,155225,483.16959252697694
1747352643861488,28339804,1,306,75,21386923,21230560,156363,479.65311486732793
1747352643956595,28432364,1,307,75,21482030,21323120,158910,471.96526335661696
1747352644046389,28524924,1,308,75,21571824,21415680,156144,480.32585305871504
1747352644140214,28617484,1,309,75,21665649,21508240,157409,476.4657675228227
1747352644234495,28710044,1,310,75,21759930,21600800,159130,471.3127631496261
1747352644328456,28802604,1,311,75,21853891,21693360,160531,467.1994817200416
1747352644419102,28895164,1,312,75,21944537,21785920,158617,472.83708555829446
1747352644513302,28987724,1,313,75,22038737,21878480,160257,467.99827776633776
1747352644607101,29080284,1,314,75,22132536,21971040,161496,464.4077871897756
1747352644701074,29172844,1,315,75,22226509,22063600,162909,460.3797211940408
1747352644792201,29265404,1,316,75,22317636,22156160,161476,464.4653075379623
1747352644886270,29357964,1,317,75,22411705,22248720,162985,460.1650458631163
1747352644980428,29450524,1,318,75,22505863,22341280,164583,455.6971254625325
1747352645074308,29543084,1,319,75,22599743,22433840,165903,452.0713911140848
1747352645168238,29635644,1,320,75,22693673,22526400,167273,448.3688341812486
1747352645259074,29728204,1,321,75,22784509,22618960,165549,453.03807331968176
1747352645352674,29820764,1,322,75,22878109,22711520,166589,450.2097977657589
1747352645447015,29913324,1,323,75,22972450,22804080,168370,445.44752628140407
1747352645541540,30005884,1,324,75,23066975,22896640,170335,440.3088032406728
1747352645631228,30098452,1,325,75,23156663,22989208,167455,447.881520408468
1747352645725295,30191004,1,326,75,23250730,23081760,168970,443.8657749896431
1747352645819255,30283564,1,327,75,23344690,23174320,170370,440.2183483007572
1747352645914353,30376124,1,328,75,23439788,23266880,172908,433.7566798528697
1747352646004468,30468684,1,329,75,23529903,23359440,170463,439.9781770824167
1747352646098432,30561244,1,330,75,23623867,23452000,171867,436.38394805285486
1747352646192231,30653804,1,331,75,23717666,23544560,173106,433.26054556167895
1747352646286909,30746364,1,332,75,23812344,23637120,175224,428.0235584166553
1747352646377147,30838924,1,333,75,23902582,23729680,172902,433.7717319637714
1747352646470737,30931484,1,334,75,23996172,23822240,173932,431.2029988731228
1747352646564725,31024044,1,335,75,24090160,23914800,175360,427.69160583941607
1747352646659834,31116604,1,336,75,24185269,24007360,177909,421.56383319562246
1747352646753201,31209164,1,337,75,24278636,24099920,178716,419.6602430672128
1747352646843847,31301724,1,338,75,24369282,24192480,176802,424.2033461159942
1747352646937421,31394284,1,339,75,24462856,24285040,177816,421.78431637198
1747352647031736,31486844,1,340,75,24557171,24377600,179571,417.6620946589371
1747352647126170,31579404,1,341,75,24651605,24470160,181445,413.3483975860454
1747352647216756,31671964,1,342,75,24742191,24562720,179471,417.89481308958
1747352647310618,31764524,1,343,75,24836053,24655280,180773,414.8849662283638
1747352647405132,31857084,1,344,75,24930567,24747840,182727,410.448373803543
1747352647498761,31949644,1,345,75,25024196,24840400,183796,408.06111123201816
1747352647589475,32042204,1,346,75,25114910,24932960,181950,412.2011541632317
1747352647682907,32134764,1,347,75,25208342,25025520,182822,410.2350920567546
1747352647777203,32227324,1,348,75,25302638,25118080,184558,406.3763153046739
1747352647871725,32319884,1,349,75,25397160,25210640,186520,402.101651297448
1747352647961239,32412444,1,350,75,25486674,25303200,183474,408.7772654436051
1747352648056295,32505004,1,351,75,25581730,25395760,185970,403.2908533634457
1747352648150179,32597564,1,352,75,25675614,25488320,187294,400.4399500250943
1747352648244660,32690124,1,353,75,25770095,25580880,189215,396.37449462251936
1747352648338160,32782684,1,354,75,25863595,25673440,190155,394.4150824327522
1747352648428526,32875244,1,355,75,25953961,25766000,187961,399.01894541952856
1747352648522458,32967804,1,356,75,26047893,25858560,189333,396.1274579708767
1747352648617388,33060364,1,357,75,26142823,25951120,191703,391.2301841911707
1747352648710869,33152924,1,358,75,26236304,26043680,192624,389.35958136057815
1747352648801533,33245484,1,359,75,26326968,26136240,190728,393.230149742041
1747352648895312,33338044,1,360,75,26420747,26228800,191947,390.7328585494954
1747352648990048,33430604,1,361,75,26515483,26321360,194123,386.35298238745537
1747352649084248,33523164,1,362,75,26609683,26413920,195763,383.1163192227336
1747352649174038,33615724,1,363,75,26699473,26506480,192993,388.6151311187453
1747352649268294,33708284,1,364,75,26793729,26599040,194689,385.2297767208214
1747352649362297,33800844,1,365,75,26887732,26691600,196132,382.3955295413293
1747352649456142,33893412,1,366,75,26981577,26784168,197409,379.9218880598149
1747352649546665,33985964,1,367,75,27072100,26876720,195380,383.86733544886886
1747352649641160,34078524,1,368,75,27166595,26969280,197315,380.10288117983936
1747352649735628,34171084,1,369,75,27261063,27061840,199223,376.46255703407735
1747352649829780,34263644,1,370,75,27355215,27154400,200815,373.47807683688967
1747352649923924,34356204,1,371,75,27449359,27246960,202399,370.5551904900716
1747352650013249,34448764,1,372,75,27538684,27339520,199164,376.5740796529493
1747352650108385,34541324,1,373,75,27633820,27432080,201740,371.7656389412115
1747352650201789,34633884,1,374,75,27727224,27524640,202584,370.2167989574695
1747352650296543,34726444,1,375,75,27821978,27617200,204778,366.250280791882
1747352650386274,34819004,1,376,75,27911709,27709760,201949,371.3808931958069
1747352650480397,34911564,1,377,75,28005832,27802320,203512,368.52863713196274
1747352650575014,35004124,1,378,75,28100449,27894880,205569,364.8410022912015
1747352650668713,35096684,1,379,75,28194148,27987440,206708,362.8306596745167
1747352650759357,35189244,1,380,75,28284792,28080000,204792,366.2252431735615
1747352650852867,35281804,1,381,75,28378302,28172560,205742,364.5342224728057
1747352650947882,35374364,1,382,75,28473317,28265120,208197,360.23573826712203
1747352651041663,35466924,1,383,75,28567098,28357680,209418,358.13540383348135
1747352651136212,35559484,1,384,75,28661647,28450240,211407,354.7659254423931
1747352651226358,35652044,1,385,75,28751793,28542800,208993,358.8636939993205
1747352651319861,35744604,1,386,75,28845296,28635360,209936,357.25173386174833
1747352651414303,35837164,1,387,75,28939738,28727920,211818,354.0775571481177
1747352651509008,35929724,1,388,75,29034443,28820480,213963,350.5278950098849
1747352651598472,36022292,1,389,75,29123907,28913048,210859,355.6879241578496
1747352651693477,36114844,1,390,75,29218912,29005600,213312,351.5976597659766
1747352651787114,36207404,1,391,75,29312549,29098160,214389,349.8313812742258
1747352651881675,36299964,1,392,75,29407110,29190720,216390,346.5964231249134
1747352651971924,36392524,1,393,75,29497359,29283280,214079,350.3379593514544
1747352652065900,36485084,1,394,75,29591335,29375840,215495,348.0359173066661
1747352652159897,36577644,1,395,75,29685332,29468400,216932,345.73045931443954
1747352652254024,36670204,1,396,75,29779459,29560960,218499,343.2509988604067
1747352652344578,36762764,1,397,75,29870013,29653520,216493,346.431524344898
1747352652438158,36855324,1,398,75,29963593,29746080,217513,344.806977054245
1747352652533692,36947884,1,399,75,30059127,29838640,220487,340.1561089769465
1747352652626277,37040444,1,400,75,30151712,29931200,220512,340.11754462342185
1747352652721005,37133004,1,401,75,30246440,30023760,222680,336.8061792707024
1747352652811113,37225564,1,402,75,30336548,30116320,220228,340.55615089816007
1747352652905785,37318124,1,403,75,30431220,30208880,222340,337.3212197535306
1747352652999727,37410684,1,404,75,30525162,30301440,223722,335.2374822324134
1747352653093723,37503244,1,405,75,30619158,30394000,225158,333.09942351593105
1747352653183399,37595804,1,406,75,30708834,30486560,222274,337.42138081826937
1747352653277665,37688364,1,407,75,30803100,30579120,223980,334.851326011251
1747352653372606,37780924,1,408,75,30898041,30671680,226361,331.32916005849063
1747352653466479,37873484,1,409,75,30991914,30764240,227674,329.41837891019617
1747352653556234,37966044,1,410,75,31081669,30856800,224869,333.52752046747213
1747352653650802,38058604,1,411,75,31176237,30949360,226877,330.5755982316409
1747352653745315,38151164,1,412,75,31270750,31041920,228830,327.7542280295416
1747352653839401,38243724,1,413,75,31364836,31134480,230356,325.5830106443939
1747352653929314,38336284,1,414,75,31454749,31227040,227709,329.3677456754015
1747352654023539,38428844,1,415,75,31548974,31319600,229374,326.97690235161787
1747352654117932,38521404,1,416,75,31643367,31412160,231207,324.3846423334934
1747352654211664,38613964,1,417,75,31737099,31504720,232379,322.7486132567917
1747352654306222,38706524,1,418,75,31831657,31597280,234377,319.99726935663483
1747352654395714,38799084,1,419,75,31921149,31689840,231309,324.2415989001725
1747352654490783,38891644,1,420,75,32016218,31782400,233818,320.76230230350103
1747352654584151,38984204,1,421,75,32109586,31874960,234626,319.65766794813874
1747352654678252,39076764,1,422,75,32203687,31967520,236167,317.57188768964335
1747352654769264,39169324,1,423,75,32294699,32060080,234619,319.66720512831444
1747352654862994,39261884,1,424,75,32388429,32152640,235789,318.0809961448583
1747352654957521,39354444,1,425,75,32482956,32245200,237756,315.44945237975065
1747352655052032,39447004,1,426,75,32577467,32337760,239707,312.8819767466115
1747352655141134,39539564,1,427,75,32666569,32430320,236249,317.4616612133808
1747352655235335,39632124,1,428,75,32760770,32522880,237890,315.2717642607928
1747352655330351,39724684,1,429,75,32855786,32615440,240346,312.05012773251894
1747352655423416,39817252,1,430,75,32948851,32708008,240843,311.4061857724742
1747352655514693,39909804,1,431,75,33040128,32800560,239568,313.0635143257864
1747352655608469,40002364,1,432,75,33133904,32893120,240784,311.4824905309323
1747352655702742,40094924,1,433,75,33228177,32985680,242497,309.2821766867219
1747352655797073,40187484,1,434,75,33322508,33078240,244268,307.03980873466844
1747352655891255,40280044,1,435,75,33416690,33170800,245890,305.0144373500346
1747352655981602,40372604,1,436,75,33507037,33263360,243677,307.78448519967003
1747352656075485,40465164,1,437,75,33600920,33355920,245000,306.12244897959187
1747352656170004,40557724,1,438,75,33695439,33448480,246959,303.69413546378144
1747352656263542,40650284,1,439,75,33788977,33541040,247937,302.4961986311039
1747352656353423,40742844,1,440,75,33878858,33633600,245258,305.80042241231683
1747352656452412,40835404,1,441,75,33977847,33726160,251687,297.9891690870009
1747352656542590,40927964,1,442,75,34068025,33818720,249305,300.836324983454
1747352656636116,41020524,1,443,75,34161551,33911280,250271,299.6751521350856
1747352656726446,41113084,1,444,75,34251881,34003840,248041,302.36936635475587
1747352656820517,41205644,1,445,75,34345952,34096400,249552,300.53856510867473
1747352656915268,41298204,1,446,75,34440703,34188960,251743,297.9228816690037
1747352657009415,41390764,1,447,75,34534850,34281520,253330,296.0565270595666
1747352657099219,41483324,1,448,75,34624654,34374080,250574,299.3127778620288
1747352657193762,41575884,1,449,75,34719197,34466640,252557,296.9626658536489
1747352657288071,41668444,1,450,75,34813506,34559200,254306,294.9202928755122
1747352657382090,41761004,1,451,75,34907525,34651760,255765,293.2379332590464
1747352657476190,41853564,1,452,75,35001625,34744320,257305,291.4828705233089
1747352657566190,41946132,1,453,75,35091625,34836888,254737,294.4213051107613
1747352657660808,42038684,1,454,75,35186243,34929440,256803,292.05266293618064
1747352657754325,42131244,1,455,75,35279760,35022000,257760,290.9683426443204
1747352657848953,42223804,1,456,75,35374388,35114560,259828,288.6524931878012
1747352657939068,42316364,1,457,75,35464503,35207120,257383,291.3945365467028
1747352658032942,42408924,1,458,75,35558377,35299680,258697,289.91445590787674
1747352658127648,42501484,1,459,75,35653083,35392240,260843,287.52928006502
1747352658221529,42594044,1,460,75,35746964,35484800,262164,286.08046871423994
1747352658311753,42686604,1,461,75,35837188,35577360,259828,288.6524931878012
1747352658405479,42779164,1,462,75,35930914,35669920,260994,287.3629278833996
1747352658499826,42871724,1,463,75,36025261,35762480,262781,285.40876242955164
1747352658594304,42964284,1,464,75,36119739,35855040,264699,283.3407001915383
1747352658684556,43056844,1,465,75,36209991,35947600,262391,285.83297445415434
1747352658778349,43149404,1,466,75,36303784,36040160,263624,284.49610050678234
1747352658872268,43241964,1,467,75,36397703,36132720,264983,283.03702501669915
1747352658966643,43334524,1,468,75,36492078,36225280,266798,281.11155256036403
1747352659061179,43427084,1,469,75,36586614,36317840,268774,279.0448480879847
1747352659151392,43519644,1,470,75,36676827,36410400,266427,281.50300082198873
1747352659245658,43612204,1,471,75,36771093,36502960,268133,279.7119340029016
1747352659340085,43704764,1,472,75,36865520,36595520,270000,277.77777777777777
1747352659434091,43797324,1,473,75,36959526,36688080,271446,276.29804823058726
1747352659523371,43889884,1,474,75,37048806,36780640,268166,279.67751318213345
1747352659617706,43982444,1,475,75,37143141,36873200,269941,277.83849063313835
1747352659712688,44075004,1,476,75,37238123,36965760,272363,275.36779959098703
1747352659806526,44167564,1,477,75,37331961,37058320,273641,274.08173482774873
1747352659896836,44260124,1,478,75,37422271,37150880,271391,276.35404269117254
1747352659991127,44352684,1,479,75,37516562,37243440,273122,274.6025585635724
1747352660084761,44445244,1,480,75,37610196,37336000,274196,273.5269661118324
1747352660178930,44537804,1,481,75,37704365,37428560,275805,271.93125577853914
1747352660268729,44630364,1,482,75,37794164,37521120,273044,274.6810037942603
1747352660363794,44722924,1,483,75,37889229,37613680,275549,272.18389469749485
1747352660460454,44815484,1,484,75,37985889,37706240,279649,268.1933423684691
1747352660552239,44908044,1,485,75,38077674,37798800,278874,268.9386604703199
1747352660646309,45000604,1,486,75,38171744,37891360,280384,267.4902990184889
1747352660735819,45093164,1,487,75,38261254,37983920,277334,270.4320422306677
1747352660830386,45185724,1,488,75,38355821,38076480,279341,268.4890510164996
1747352660924584,45278284,1,489,75,38450019,38169040,280979,266.92386263742134
1747352661019246,45370844,1,490,75,38544681,38261600,283081,264.9418364355078
1747352661109372,45463404,1,491,75,38634807,38354160,280647,267.2396284300207
1747352661203567,45555964,1,492,75,38729002,38446720,282282,265.6917550534572
1747352661296894,45648524,1,493,75,38822329,38539280,283049,264.97178933682864
1747352661391950,45741092,1,494,75,38917385,38631848,285537,262.66298238056714
1747352661481441,45833644,1,495,75,39006876,38724400,282476,265.50928220450584
1747352661575388,45926204,1,496,75,39100823,38816960,283863,264.2119614039167
1747352661670335,46018764,1,497,75,39195770,38909520,286250,262.0087336244541
1747352661763693,46111324,1,498,75,39289128,39002080,287048,261.2803433572085
1747352661854236,46203884,1,499,75,39379671,39094640,285031,263.12927365795304
1747352661948569,46296444,1,500,75,39474004,39187200,286804,261.5026289730966
1747352662042693,46389004,1,501,75,39568128,39279760,288368,260.0843366809077
1747352662136953,46481564,1,502,75,39662388,39372320,290068,258.5600617786174
1747352662231028,46574124,1,503,75,39756463,39464880,291583,257.2166415737543
1747352662321831,46666684,1,504,75,39847266,39557440,289826,258.77595522830944
1747352662415760,46759244,1,505,75,39941195,39650000,291195,257.5593674341936
1747352662509266,46851804,1,506,75,40034701,39742560,292141,256.72534837629775
1747352662603448,46944364,1,507,75,40128883,39835120,293763,255.30785020577807
1747352662693749,47036924,1,508,75,40219184,39927680,291504,257.28634941544544
1747352662787894,47129484,1,509,75,40313329,40020240,293089,255.8949670577879
1747352662882044,47222044,1,510,75,40407479,40112800,294679,254.51423413273423
1747352662977005,47314604,1,511,75,40502440,40205360,297080,252.45725057223643
1747352663066228,47407164,1,512,75,40591663,40297920,293743,255.32523328215484
1747352663161175,47499724,1,513,75,40686610,40390480,296130,253.2671461857968
1747352663254734,47592284,1,514,75,40780169,40483040,297129,252.41561745908345
1747352663349424,47684844,1,515,75,40874859,40575600,299259,250.61902900163403
1747352663443919,47777404,1,516,75,40969354,40668160,301194,249.0089444012829
1747352663533434,47869972,1,517,75,41058869,40760728,298141,251.55882619297583
1747352663627431,47962524,1,518,75,41152866,40853280,299586,250.34547675792592
1747352663722015,48055084,1,519,75,41247450,40945840,301610,248.6654951758894
1747352663816053,48147644,1,520,75,41341488,41038400,303088,247.45288497070155
1747352663906325,48240204,1,521,75,41431760,41130960,300800,249.33510638297872
1747352664000929,48332764,1,522,75,41526364,41223520,302844,247.6522566073622
1747352664095110,48425324,1,523,75,41620545,41316080,304465,246.333732941389
1747352664189034,48517884,1,524,75,41714469,41408640,305829,245.23508234994063
1747352664279248,48610444,1,525,75,41804683,41501200,303483,247.1308112810273
1747352664373885,48703004,1,526,75,41899320,41593760,305560,245.4509752585417
1747352664467096,48795564,1,527,75,41992531,41686320,306211,244.92915016116336
1747352664561907,48888124,1,528,75,42087342,41778880,308462,243.14178083524064
1747352664652115,48980684,1,529,75,42177550,41871440,306110,245.00996373852536
1747352664751033,49073244,1,530,75,42276468,41964000,312468,240.0245785168401
1747352664840392,49165804,1,531,75,42365827,42056560,309267,242.5089000766328
1747352664934393,49258364,1,532,75,42459828,42149120,310708,241.3841935193172
1747352665028323,49350924,1,533,75,42553758,42241680,312078,240.3245342510526
1747352665119027,49443484,1,534,75,42644462,42334240,310222,241.76235083262955
1747352665212984,49536044,1,535,75,42738419,42426800,311619,240.67852088608203
1747352665306936,49628604,1,536,75,42832371,42519360,313011,239.60819268332423
1747352665400993,49721164,1,537,75,42926428,42611920,314508,238.46770193445
1747352665491468,49813724,1,538,75,43016903,42704480,312423,240.0591505747016
1747352665585296,49906284,1,539,75,43110731,42797040,313691,239.08878482328151
1747352665679727,49998844,1,540,75,43205162,42889600,315562,237.67120248952665
1747352665774196,50091404,1,541,75,43299631,42982160,317471,236.2420504550022
1747352665863714,50183964,1,542,75,43389149,43074720,314429,238.5276167274647
1747352665958764,50276524,1,543,75,43484199,43167280,316919,236.65352976628097
1747352666052532,50369084,1,544,75,43577967,43259840,318127,235.754902916131
1747352666146643,50461644,1,545,75,43672078,43352400,319678,234.61107739663035
1747352666236688,50554204,1,546,75,43762123,43444960,317163,236.47146735274924
1747352666330672,50646764,1,547,75,43856107,43537520,318587,235.41450216110516
1747352666425691,50739324,1,548,75,43951126,43630080,321046,233.61138279249704
1747352666519403,50831884,1,549,75,44044838,43722640,322198,232.77611903239625
1747352666613026,50924444,1,550,75,44138461,43815200,323261,232.01066630369888
1747352666704114,51017004,1,551,75,44229549,43907760,321789,233.07198195090567
1747352666798158,51109564,1,552,75,44323593,44000320,323273,232.002053991518
1747352666892490,51202124,1,553,75,44417925,44092880,325045,230.73728253011123
1747352666986257,51294684,1,554,75,44511692,44185440,326252,229.88364822284612
1747352667076481,51387244,1,555,75,44601916,44278000,323916,231.54151076204943
1747352667170358,51479804,1,556,75,44695793,44370560,325233,230.6039055077437
1747352667264949,51572364,1,557,75,44790384,44463120,327264,229.17277794074508
1747352667359409,51664932,1,558,75,44884844,44555688,329156,227.8554849372334
1747352667449352,51757484,1,559,75,44974787,44648240,326547,229.6759731370982
1747352667543759,51850044,1,560,75,45069194,44740800,328394,228.3841970316145
1747352667636955,51942604,1,561,75,45162390,44833360,329030,227.9427407835152
1747352667731946,52035164,1,562,75,45257381,44925920,331461,226.27096400481503
1747352667821468,52127724,1,563,75,45346903,45018480,328423,228.36403053379328
1747352667915793,52220284,1,564,75,45441228,45111040,330188,227.1433244091245
1747352668010370,52312844,1,565,75,45535805,45203600,332205,225.7642118571364
1747352668104153,52405404,1,566,75,45629588,45296160,333428,224.93611814244755
1747352668198173,52497964,1,567,75,45723608,45388720,334888,223.9554716800841
1747352668289143,52590524,1,568,75,45814578,45481280,333298,225.023852528368
1747352668382924,52683084,1,569,75,45908359,45573840,334519,224.20251166600403
1747352668476821,52775644,1,570,75,46002256,45666400,335856,223.30998999571244
1747352668571245,52868204,1,571,75,46096680,45758960,337720,222.07746061826364
1747352668661886,52960764,1,572,75,46187321,45851520,335801,223.3465653765176
1747352668756042,53053324,1,573,75,46281477,45944080,337397,222.29006185591453
1747352668849425,53145884,1,574,75,46374860,46036640,338220,221.74915735320204
1747352668944260,53238444,1,575,75,46469695,46129200,340495,220.26755165274088
1747352669033588,53331004,1,576,75,46559023,46221760,337263,222.3783812632871
1747352669128409,53423564,1,577,75,46653844,46314320,339524,220.8974917826133
1747352669222160,53516124,1,578,75,46747595,46406880,340715,220.12532468485392
1747352669316464,53608684,1,579,75,46841899,46499440,342459,219.00431876516603
1747352669406948,53701244,1,580,75,46932383,46592000,340383,220.34002873233976
1747352669501229,53793812,1,581,75,47026664,46684568,342096,219.2367054861793
1747352669595194,53886364,1,582,75,47120629,46777120,343509,218.33489078888763
1747352669689218,53978924,1,583,75,47214653,46869680,344973,217.40831891191488
1747352669783033,54071484,1,584,75,47308468,46962240,346228,216.62026179280707
1747352669873255,54164044,1,585,75,47398690,47054800,343890,218.0929948530053
1747352669967904,54256604,1,586,75,47493339,47147360,345979,216.7761627150781
1747352670061615,54349164,1,587,75,47587050,47239920,347130,216.0573848414139
1747352670156118,54441724,1,588,75,47681553,47332480,349073,214.8547724974432
1747352670246338,54534284,1,589,75,47771773,47425040,346733,216.30476476135811
1747352670340257,54626844,1,590,75,47865692,47517600,348092,215.46028061546943
1747352670435264,54719404,1,591,75,47960699,47610160,350539,213.95622170428967
1747352670529397,54811964,1,592,75,48054832,47702720,352112,213.0004089607852
1747352670619744,54904524,1,593,75,48145179,47795280,349899,214.34756886987387
1747352670713641,54997084,1,594,75,48239076,47887840,351236,213.5316425423362
1747352670807627,55089644,1,595,75,48333062,47980400,352662,212.6682205624649
1747352670901178,55182204,1,596,75,48426613,48072960,353653,212.0722855454358
1747352670992363,55274764,1,597,75,48517798,48165520,352278,212.9000391736072
1747352671085698,55367324,1,598,75,48611133,48258080,353053,212.4326942413745
1747352671180033,55459884,1,599,75,48705468,48350640,354828,211.3700158950252
1747352671273979,55552444,1,600,75,48799414,48443200,356214,210.54759217773588
1747352671368264,55645004,1,601,75,48893699,48535760,357939,209.53290923872504
1747352671458778,55737564,1,602,75,48984213,48628320,355893,210.7374969443063
1747352671552648,55830124,1,603,75,49078083,48720880,357203,209.9646419542949
1747352671647271,55922684,1,604,75,49172706,48813440,359266,208.75896967706385
1747352671741510,56015244,1,605,75,49266945,48906000,360945,207.7878901217637
1747352671831255,56107804,1,606,75,49356690,48998560,358130,209.4211599139977
1747352671925495,56200364,1,607,75,49450930,49091120,359810,208.44334509880213
1747352672020480,56292924,1,608,75,49545915,49183680,362235,207.0479108865792
1747352672113736,56385484,1,609,75,49639171,49276240,362931,206.65085098820435
1747352672204391,56478044,1,610,75,49729826,49368800,361026,207.74127071180467
1747352672298915,56570604,1,611,75,49824350,49461360,362990,206.61726218353124
1747352672393151,56663164,1,612,75,49918586,49553920,364666,205.6676520432396
1747352672486482,56755724,1,613,75,50011917,49646480,365437,205.23373385836683
1747352672577451,56848284,1,614,75,50102886,49739040,363846,206.1311653831566
1747352672671605,56940844,1,615,75,50197040,49831600,365440,205.2320490367776
1747352672765526,57033404,1,616,75,50290961,49924160,366801,204.4705439734352
1747352672859733,57125964,1,617,75,50385168,50016720,368448,203.5565398645128
1747352672953429,57218524,1,618,75,50478864,50109280,369584,202.9308628079137
1747352673044219,57311084,1,619,75,50569654,50201840,367814,203.9074097233928
1747352673138583,57403644,1,620,75,50664018,50294400,369618,202.91219583461844
1747352673232226,57496204,1,621,75,50757661,50386960,370701,202.3193894810103
1747352673326578,57588772,1,622,75,50852013,50479528,372485,201.3503899485885
1747352673416950,57681324,1,623,75,50942385,50572080,370305,202.53574755944425
1747352673510398,57773884,1,624,75,51035833,50664640,371193,202.0512240263152
1747352673605341,57866444,1,625,75,51130776,50757200,373576,200.76236160781207
1747352673698816,57959004,1,626,75,51224251,50849760,374491,200.2718356382396
1747352673789078,58051564,1,627,75,51314513,50942320,372193,201.50835722326855
1747352673883798,58144124,1,628,75,51409233,51034880,374353,200.34566305065005
1747352673978012,58236684,1,629,75,51503447,51127440,376007,199.4643716739316
1747352674071833,58329244,1,630,75,51597268,51220000,377268,198.79767168166927
1747352674166204,58421804,1,631,75,51691639,51312560,379079,197.84794198570748
1747352674256530,58514364,1,632,75,51781965,51405120,376845,199.0208175775186
1747352674350471,58606924,1,633,75,51875906,51497680,378226,198.29414159788064
1747352674444622,58699484,1,634,75,51970057,51590240,379817,197.4635153244852
1747352674538784,58792044,1,635,75,52064219,51682800,381419,196.63414774827683
1747352674628374,58884604,1,636,75,52153809,51775360,378449,198.17729733728984
1747352674723504,58977164,1,637,75,52248939,51867920,381019,196.840577504009
1747352674817714,59069724,1,638,75,52343149,51960480,382669,195.99183628671256
1747352674910980,59162284,1,639,75,52436415,52053040,383375,195.63090968373
1747352675001748,59254844,1,640,75,52527183,52145600,381583,196.5496366452384
1747352675095745,59347404,1,641,75,52621180,52238160,383020,195.8122291264164
1747352675189818,59439964,1,642,75,52715253,52330720,384533,195.04177794883665
1747352675284345,59532524,1,643,75,52809780,52423280,386500,194.0491591203105
1747352675374597,59625084,1,644,75,52900032,52515840,384192,195.2148925537232
1747352675468298,59717652,1,645,75,52993733,52608408,385325,194.6408875624473
1747352675562919,59810204,1,646,75,53088354,52700960,387394,193.60134643283064
1747352675656964,59902764,1,647,75,53182399,52793520,388879,192.8620470634825
1747352675751218,59995324,1,648,75,53276653,52886080,390573,192.0255624428724
1747352675841588,60087884,1,649,75,53367023,52978640,388383,193.10834923258744
1747352675935247,60180444,1,650,75,53460682,53071200,389482,192.56345607755944
1747352676029546,60273004,1,651,75,53554981,53163760,391221,191.70750036424425
1747352676123490,60365564,1,652,75,53648925,53256320,392605,191.03169852650885
1747352676213582,60458124,1,653,75,53739017,53348880,390137,192.24016178932013
1747352676308547,60550684,1,654,75,53833982,53441440,392542,191.06235765854356
1747352676402151,60643244,1,655,75,53927586,53534000,393586,190.5555583786009
1747352676498835,60735804,1,656,75,54024270,53626560,397710,188.57961831485247
1747352676586267,60828364,1,657,75,54111702,53719120,392582,191.04289040251464
1747352676680474,60920924,1,658,75,54205909,53811680,394229,190.24475622036937
1747352676774808,61013484,1,659,75,54300243,53904240,396003,189.39250460223784
1747352676869181,61106044,1,660,75,54394616,53996800,397816,188.52937036217747
1747352676959435,61198604,1,661,75,54484870,54089360,395510,189.6285808197012
1747352677053263,61291164,1,662,75,54578698,54181920,396778,189.02257685657972
1747352677147368,61383724,1,663,75,54672803,54274480,398323,188.2894033234335
1747352677241675,61476284,1,664,75,54767110,54367040,400070,187.4671932411828
1747352677335723,61568844,1,665,75,54861158,54459600,401558,186.77252103058584
1747352677425960,61661404,1,666,75,54951395,54552160,399235,187.8592808746728
1747352677520468,61753964,1,667,75,55045903,54644720,401183,186.94710394009715
1747352677614479,61846524,1,668,75,55139914,54737280,402634,186.27338972863691
1747352677708460,61939084,1,669,75,55233895,54829840,404055,185.61829453910977
1747352677798913,62031644,1,670,75,55324348,54922400,401948,186.5913003672117
1747352677892933,62124204,1,671,75,55418368,55014960,403408,185.91599571649547
1747352677986761,62216764,1,672,75,55512196,55107520,404676,185.3334519467426
1747352678081166,62309324,1,673,75,55606601,55200080,406521,184.49231405019663
1747352678171380,62401884,1,674,75,55696815,55292640,404175,185.563184264242
1747352678266229,62494444,1,675,75,55791664,55385200,406464,184.51818611242325
1747352678360068,62587004,1,676,75,55885503,55477760,407743,183.9393931962045
1747352678453993,62679564,1,677,75,55979428,55570320,409108,183.32567439404752
1747352678544804,62772124,1,678,75,56070239,55662880,407359,184.1127850372767
1747352678638397,62864684,1,679,75,56163832,55755440,408392,183.6470841740289
1747352678732528,62957244,1,680,75,56257963,55848000,409963,182.9433387891102
1747352678826732,63049804,1,681,75,56352167,55940560,411607,182.21264458573347
1747352678920820,63142364,1,682,75,56446255,56033120,413135,181.5387222094473
1747352679011509,63234924,1,683,75,56536944,56125680,411264,182.3646125116713
1747352679105314,63327484,1,684,75,56630749,56218240,412509,181.81421496258264
1747352679199442,63420044,1,685,75,56724877,56310800,414077,181.12573265358856
1747352679293712,63512612,1,686,75,56819147,56403368,415779,180.3842906928921
1747352679383548,63605164,1,687,75,56908983,56495920,413063,181.5703657795542
1747352679477957,63697724,1,688,75,57003392,56588480,414912,180.76122165664043
1747352679572465,63790284,1,689,75,57097900,56681040,416860,179.91651873530682
1747352679666581,63882844,1,690,75,57192016,56773600,418416,179.24744751634736
1747352679757131,63975404,1,691,75,57282566,56866160,416406,180.11267849166438
1747352679850887,64067964,1,692,75,57376322,56958720,417602,179.59684101129784
1747352679944865,64160524,1,693,75,57470300,57051280,419020,178.98906973414157
1747352680038790,64253084,1,694,75,57564225,57143840,420385,178.40788800742178
1747352680129776,64345644,1,695,75,57655211,57236400,418811,179.0783909687186
1747352680223776,64438204,1,696,75,57749211,57328960,420251,178.46477462278497
1747352680317339,64530764,1,697,75,57842774,57421520,421254,178.0398524405703
1747352680411931,64623324,1,698,75,57937366,57514080,423286,177.1851655854434
1747352680506421,64715884,1,699,75,58031856,57606640,425216,176.38094521372668
1747352680596589,64808444,1,700,75,58122024,57699200,422824,177.37876752502223
1747352680690931,64901004,1,701,75,58216366,57791760,424606,176.63433865748482
1747352680784888,64993564,1,702,75,58310323,57884320,426003,176.05509820353376
1747352680878657,65086124,1,703,75,58404092,57976880,427212,175.55686638015786
1747352680968925,65178684,1,704,75,58494360,58069440,424920,176.50381248234962
1747352681062881,65271244,1,705,75,58588316,58162000,426316,175.92583904896838
1747352681157070,65363804,1,706,75,58682505,58254560,427945,175.25616609611046
1747352681251867,65456364,1,707,75,58777302,58347120,430182,174.3448121957683
1747352681341963,65548924,1,708,75,58867398,58439680,427718,175.34917866444715
1747352681436199,65641492,1,709,75,58961634,58532248,429386,174.668014327435
1747352681529643,65734044,1,710,75,59055078,58624800,430278,174.30591385104515
1747352681624623,65826604,1,711,75,59150058,58717360,432698,173.3310530670352
1747352681714374,65919164,1,712,75,59239809,58809920,429889,174.46364061420505
1747352681808130,66011724,1,713,75,59333565,58902480,431085,173.97960958975608
1747352681902726,66104284,1,714,75,59428161,58995040,433121,173.16177234537233
1747352681996938,66196844,1,715,75,59522373,59087600,434773,172.5038123342526
1747352682091095,66289404,1,716,75,59616530,59180160,436370,171.87249352613608
1747352682181019,66381964,1,717,75,59706454,59272720,433734,172.9170413202562
1747352682275348,66474524,1,718,75,59800783,59365280,435503,172.21465753393204
1747352682369756,66567084,1,719,75,59895191,59457840,437351,171.48697499262607
1747352682463826,66659644,1,720,75,59989261,59550400,438861,170.89693547615303
1747352682554563,66752204,1,721,75,60079998,59642960,437038,171.6097913682563
1747352682648525,66844764,1,722,75,60173960,59735520,438440,171.06103457713712
1747352682742915,66937324,1,723,75,60268350,59828080,440270,170.35001249233426
1747352682836516,67029884,1,724,75,60361951,59920640,441311,169.94817713585203
1747352682926524,67122444,1,725,75,60451959,60013200,438759,170.93666454705203
1747352683021041,67215004,1,726,75,60546476,60105760,440716,170.17762005463837
1747352683306981,67498924,1,729,75,60832416,60389680,442736,169.40117812872683
1747352683401494,67591484,1,730,75,60926929,60482240,444689,168.65719637769317
1747352683495503,67684044,1,731,75,61020938,60574800,446138,168.1094190586769
1747352683586734,67776604,1,732,75,61112169,60667360,444809,168.6116962561459
1747352683679818,67869164,1,733,75,61205253,60759920,445333,168.41329971055367
1747352683775067,67961724,1,734,75,61300502,60852480,448022,167.40249362754508
1747352683868501,68054284,1,735,75,61393936,60945040,448896,167.0765611633875
1747352683958667,68146844,1,736,75,61484102,61037600,446502,167.97237190426918
1747352684053640,68239404,1,737,75,61579075,61130160,448915,167.06948976977824
1747352684147405,68331964,1,738,75,61672840,61222720,450120,166.6222340709144
1747352684241406,68424524,1,739,75,61766841,61315280,451561,166.0905171172887
1747352684331309,68517084,1,740,75,61856744,61407840,448904,167.07358366154008
1747352684426009,68609644,1,741,75,61951444,61500400,451044,166.2808949902892
1747352684519901,68702204,1,742,75,62045336,61592960,452376,165.79128866252853
1747352684614586,68794764,1,743,75,62140021,61685520,454501,165.01613857835298
1747352684704315,68887324,1,744,75,62229750,61778080,451670,166.05043505213982
1747352684802219,68979884,1,745,75,62327654,61870640,457014,164.10875815620528
1747352684892921,69072444,1,746,75,62418356,61963200,455156,164.77866929140777
1747352684987258,69165004,1,747,75,62512693,62055760,456933,164.1378495315506
1747352685081235,69257564,1,748,75,62606670,62148320,458350,163.6304134395113
1747352685171439,69350124,1,749,75,62696874,62240880,455994,164.47584836642588
1747352685269998,69442684,1,750,75,62795433,62333440,461993,162.34012203648106
1747352685359441,69535244,1,751,75,62884876,62426000,458876,163.44284730515434
1747352685453938,69627804,1,752,75,62979373,62518560,460813,162.75582503097786
1747352685543916,69720364,1,753,75,63069351,62611120,458231,163.67290733276448
1747352685637830,69812924,1,754,75,63163265,62703680,459585,163.1907046574627
1747352685732501,69905484,1,755,75,63257936,62796240,461696,162.44455225949542
1747352685826830,69998044,1,756,75,63352265,62888800,463465,161.82451749323033
1747352685916935,70090604,1,757,75,63442370,62981360,461010,162.6862757857747
1747352686010550,70183164,1,758,75,63535985,63073920,462065,162.3148258361919
1747352686104464,70275724,1,759,75,63629899,63166480,463419,161.84058055453056
1747352686199115,70368292,1,760,75,63724550,63259048,465502,161.11638618094014
1747352686293455,70460844,1,761,75,63818890,63351600,467290,160.4999037000578
1747352686383470,70553404,1,762,75,63908905,63444160,464745,161.3788206435787
1747352686477956,70645964,1,763,75,64003391,63536720,466671,160.7127933812043
1747352686571855,70738524,1,764,75,64097290,63629280,468010,160.25298604730668
1747352686665721,70831084,1,765,75,64191156,63721840,469316,159.80703832812006
1747352686755892,70923644,1,766,75,64281327,63814400,466927,160.62468008917884
1747352686850167,71016204,1,767,75,64375602,63906960,468642,160.03687249542295
1747352686944691,71108764,1,768,75,64470126,63999520,470606,159.36898382086076
1747352687039121,71201324,1,769,75,64564556,64092080,472476,158.7382216239555
1747352687129381,71293884,1,770,75,64654816,64184640,470176,159.51473490777923
1747352687223663,71386444,1,771,75,64749098,64277200,471898,158.9326506999394
1747352687317761,71479004,1,772,75,64843196,64369760,473436,158.41634349732593
1747352687411495,71571564,1,773,75,64936930,64462320,474610,158.02448325993976
1747352687501324,71664124,1,774,75,65026759,64554880,471879,158.93905005308565
1747352687596310,71756684,1,775,75,65121745,64647440,474305,158.12610029411456
1747352687690510,71849244,1,776,75,65215945,64740000,475945,157.58123312567628
1747352687784152,71941804,1,777,75,65309587,64832560,477027,157.22380494185865
1747352687878610,72034364,1,778,75,65404045,64925120,478925,156.60072036331368
1747352687968863,72126924,1,779,75,65494298,65017680,476618,157.358723338187
1747352688062414,72219484,1,780,75,65587849,65110240,477609,157.03221672958423
1747352688157139,72312044,1,781,75,65682574,65202800,479774,156.32360236277916
1747352688251165,72404604,1,782,75,65776600,65295360,481240,155.84739423156844
1747352688341196,72497172,1,783,75,65866631,65387928,478703,156.67334443276937
1747352688435216,72589724,1,784,75,65960651,65480480,480171,156.19435576076023
1747352688530093,72682284,1,785,75,66055528,65573040,482488,155.44428047951453
1747352688623759,72774844,1,786,75,66149194,65665600,483594,155.08877281355848
1747352688713633,72867404,1,787,75,66239068,65758160,480908,155.9549851530854
1747352688807968,72959964,1,788,75,66333403,65850720,482683,155.3814822564706
1747352688902853,73052524,1,789,75,66428288,65943280,485008,154.63662455052287
1747352688996893,73145084,1,790,75,66522328,66035840,486488,154.16618703852922
1747352689086462,73237644,1,791,75,66611897,66128400,483497,155.11988698999167
1747352689181154,73330204,1,792,75,66706589,66220960,485629,154.43888235669615
1747352689275566,73422764,1,793,75,66801001,66313520,487481,153.85215013508218
1747352689368901,73515324,1,794,75,66894336,66406080,488256,153.60794337396774
1747352689463420,73607884,1,795,75,66988855,66498640,490215,152.99409442795508
1747352689553651,73700444,1,796,75,67079086,66591200,487886,153.72443562635533
1747352689647239,73793004,1,797,75,67172674,66683760,488914,153.4012116650372
1747352689742240,73885564,1,798,75,67267675,66776320,491355,152.6391305675123
1747352689836326,73978124,1,799,75,67361761,66868880,492881,152.166547300464
1747352689926354,74070684,1,800,75,67451789,66961440,490349,152.95228500516978
1747352690019795,74163244,1,801,75,67545230,67054000,491230,152.67797162225435
1747352690114984,74255804,1,802,75,67640419,67146560,493859,151.86520849068256
1747352690208700,74348364,1,803,75,67734135,67239120,495015,151.51056028605194
1747352690299516,74440924,1,804,75,67824951,67331680,493271,152.04623827470093
1747352690393665,74533484,1,805,75,67919100,67424240,494860,151.55801640868123
1747352690487785,74626044,1,806,75,68013220,67516800,496420,151.08174529632169
1747352690581143,74718604,1,807,75,68106578,67609360,497218,150.83926969659183
1747352690672156,74811164,1,808,75,68197591,67701920,495671,151.3100423466372
1747352690765882,74903724,1,809,75,68291317,67794480,496837,150.95494095649076
1747352690860464,74996284,1,810,75,68385899,67887040,498859,150.3430829152125
1747352690954588,75088844,1,811,75,68480023,67979600,500423,149.87320726665243
1747352691048500,75181404,1,812,75,68573935,68072160,501775,149.46938368790794
1747352691138445,75273964,1,813,75,68663880,68164720,499160,150.2524240724417
1747352691233295,75366524,1,814,75,68758730,68257280,501450,149.56625785222857
1747352691326967,75459084,1,815,75,68852402,68349840,502562,149.23531822939262
1747352691421625,75551644,1,816,75,68947060,68442400,504660,148.61490904767567
1747352691511446,75644204,1,817,75,69036881,68534960,501921,149.4259056704143
1747352691605988,75736764,1,818,75,69131423,68627520,503903,148.83816925082803
1747352691699375,75829324,1,819,75,69224810,68720080,504730,148.59429794147366
1747352691793986,75921884,1,820,75,69319421,68812640,506781,147.9929200187063
1747352691884105,76014444,1,821,75,69409540,68905200,504340,148.7092041083396
1747352691978776,76107004,1,822,75,69504211,68997760,506451,148.08935119093456
1747352692072307,76199564,1,823,75,69597742,69090320,507422,147.8059682079216
1747352692166746,76292132,1,824,75,69692181,69182888,509293,147.26297043155904
1747352692256675,76384684,1,825,75,69782110,69275440,506670,148.0253419385399
1747352692350377,76477244,1,826,75,69875812,69368000,507812,147.6924531125692
1747352692445589,76569804,1,827,75,69971024,69460560,510464,146.92515045135406
1747352692539585,76662364,1,828,75,70065020,69553120,511900,146.51299081851923
1747352692633914,76754924,1,829,75,70159349,69645680,513669,146.00842176576745
1747352692723734,76847484,1,830,75,70249169,69738240,510929,146.79143286053446
1747352692818313,76940044,1,831,75,70343748,69830800,512948,146.21365128629023
1747352692912235,77032604,1,832,75,70437670,69923360,514310,145.82644708444323
1747352693006543,77125164,1,833,75,70531978,70015920,516058,145.33250138550318
1747352693096831,77217724,1,834,75,70622266,70108480,513786,145.97517254265395
1747352693190418,77310284,1,835,75,70715853,70201040,514813,145.6839667995952
1747352693284947,77402844,1,836,75,70810382,70293600,516782,145.12889380822088
1747352693378916,77495404,1,837,75,70904351,70386160,518191,144.73427751543352
1747352693468838,77587964,1,838,75,70994273,70478720,515553,145.4748590348616
1747352693563327,77680524,1,839,75,71088762,70571280,517482,144.9325773650098
1747352693657972,77773084,1,840,75,71183407,70663840,519567,144.35096917240702
1747352693751898,77865644,1,841,75,71277333,70756400,520933,143.97244943207667
1747352693841937,77958204,1,842,75,71367372,70848960,518412,144.67257702368002
1747352693935752,78050764,1,843,75,71461187,70941520,519667,144.32319158230175
1747352694030172,78143324,1,844,75,71555607,71034080,521527,143.80847012714588
1747352694124464,78235884,1,845,75,71649899,71126640,523259,143.33246059790656
1747352694218945,78328444,1,846,75,71744380,71219200,525180,142.8081800525534
1747352694309146,78421012,1,847,75,71834581,71311768,522813,143.45473429314114
1747352694403043,78513564,1,848,75,71928478,71404320,524158,143.08662655153597
1747352694497226,78606124,1,849,75,72022661,71496880,525781,142.64494152508362
1747352694591019,78698684,1,850,75,72116454,71589440,527014,142.3112099488818
1747352694689790,78791244,1,851,75,72215225,71682000,533225,140.65357025645835
1747352694779877,78886932,1,852,75,72305312,71777688,527624,142.14668021166588
1747352694874242,78979484,1,853,75,72399677,71870240,529437,141.65991421075594
1747352694964065,79072044,1,854,75,72489500,71962800,526700,142.39605088285552
1747352695058609,79164604,1,855,75,72584044,72055360,528684,141.86167918832422
1747352695152105,79257164,1,856,75,72677540,72147920,529620,141.6109663532344
1747352695246534,79349724,1,857,75,72771969,72240480,531489,141.11298634590744
1747352695336688,79442284,1,858,75,72862123,72333040,529083,141.75469633308953
1747352695431284,79534844,1,859,75,72956719,72425600,531119,141.2112916314423
1747352695524775,79627404,1,860,75,73050210,72518160,532050,140.964195094446
1747352695619230,79719964,1,861,75,73144665,72610720,533945,140.46390545842738
1747352695713589,79812524,1,862,75,73239024,72703280,535744,139.99223509735992
1747352695803502,79905084,1,863,75,73328937,72795840,533097,140.6873420784585
1747352695897649,79997644,1,864,75,73423084,72888400,534684,140.26976681553964
1747352695992179,80090204,1,865,75,73517614,72980960,536654,139.75485135674012
1747352696086693,80182764,1,866,75,73612128,73073520,538608,139.2478388735407
1747352696176665,80275324,1,867,75,73702100,73166080,536020,139.9201522331256
1747352696270816,80367884,1,868,75,73796251,73258640,537611,139.50607409446607
1747352696364507,80460444,1,869,75,73889942,73351200,538742,139.2132040939819
1747352696458803,80553004,1,870,75,73984238,73443760,540478,138.76605523259042
1747352696549193,80645564,1,871,75,74074628,73536320,538308,139.32544194030183
1747352696643223,80738124,1,872,75,74168658,73628880,539778,138.94601113791225
1747352696737335,80830684,1,873,75,74262770,73721440,541330,138.54765115548742
1747352696831525,80923244,1,874,75,74356960,73814000,542960,138.13172241049065
1747352696925836,81015804,1,875,75,74451271,73906560,544711,137.68769127115112
1747352697015649,81108364,1,876,75,74541084,73999120,541964,138.38557542567403
1747352697110504,81200924,1,877,75,74635939,74091680,544259,137.8020391027066
1747352697204774,81293484,1,878,75,74730209,74184240,545969,137.3704367830408
1747352697300339,81386044,1,879,75,74825774,74276800,548974,136.61849195043845
1747352697388405,81478604,1,880,75,74913840,74369360,544480,137.74610637672643
1747352697483320,81571164,1,881,75,75008755,74461920,546835,137.15288889701648
1747352697576806,81663724,1,882,75,75102241,74554480,547761,136.92102942706762
1747352697671512,81756284,1,883,75,75196947,74647040,549907,136.38669811440843
1747352697760930,81848844,1,884,75,75286365,74739600,546765,137.1704479986832
1747352697855305,81941404,1,885,75,75380740,74832160,548580,136.71661380290934
1747352697949872,82033964,1,886,75,75475307,74924720,550587,136.21825433582703
1747352698044408,82126524,1,887,75,75569843,75017280,552563,135.73112930109326
1747352698134229,82219084,1,888,75,75659664,75109840,549824,136.4072866953789
1747352698227954,82311644,1,889,75,75753389,75202400,550989,136.11886988669465
1747352698322176,82404204,1,890,75,75847611,75294960,552651,135.70951649413465
1747352698416677,82496764,1,891,75,75942112,75387520,554592,135.23455080491604
1747352698510323,82589324,1,892,75,76035758,75480080,555678,134.9702525563366
1747352698601009,82681892,1,893,75,76126444,75572648,553796,135.4289305087072
1747352698695561,82774444,1,894,75,76220996,75665200,555796,134.94159727669864
1747352698789473,82867004,1,895,75,76314908,75757760,557148,134.6141420233044
1747352698883502,82959564,1,896,75,76408937,75850320,558617,134.2601460392362
1747352698973716,83052124,1,897,75,76499151,75942880,556271,134.8263705999414
1747352699068312,83144684,1,898,75,76593747,76035440,558307,134.33469399452272
1747352699162392,83237244,1,899,75,76687827,76128000,559827,133.9699585764888
1747352699256478,83329804,1,900,75,76781913,76220560,561353,133.60577034415064
1747352699346293,83422364,1,901,75,76871728,76313120,558608,134.26230916850457
1747352699440764,83514924,1,902,75,76966199,76405680,560519,133.80456327082578
1747352699534960,83607484,1,903,75,77060395,76498240,562155,133.41516129893003
1747352699629128,83700044,1,904,75,77154563,76590800,563763,133.034626252521
1747352699719480,83792604,1,905,75,77244915,76683360,561555,133.55771028661485
1747352699813490,83885164,1,906,75,77338925,76775920,563005,133.2137370005595
1747352699907301,83977724,1,907,75,77432736,76868480,564256,132.9183916520161
1747352700001461,84070284,1,908,75,77526896,76961040,565856,132.54255499632416
1747352700095644,84162844,1,909,75,77621079,77053600,567479,132.1634809393828
1747352700190272,84255404,1,910,75,77715707,77146160,569547,131.68360117777812
1747352700279975,84347964,1,911,75,77805410,77238720,566690,132.34749157387637
1747352700374839,84440524,1,912,75,77900274,77331280,568994,131.8115832504385
1747352700468886,84533084,1,913,75,77994321,77423840,570481,131.4680068223131
1747352700558524,84625644,1,914,75,78083959,77516400,567559,132.14485190085963
1747352700652950,84718204,1,915,75,78178385,77608960,569425,131.71181454976514
1747352700746944,84810772,1,916,75,78272379,77701528,570851,131.3827951602082
1747352700840947,84903324,1,917,75,78366382,77794080,572302,131.0496905479974
1747352700931863,84995884,1,918,75,78457298,77886640,570658,131.4272296191414
1747352701025728,85088444,1,919,75,78551163,77979200,571963,131.12736313362927
1747352701119546,85181004,1,920,75,78644981,78071760,573221,130.8395889194569
1747352701213639,85273564,1,921,75,78739074,78164320,574754,130.4906098957119
1747352701304391,85366124,1,922,75,78829826,78256880,572946,130.90238870678914
1747352701398281,85458684,1,923,75,78923716,78349440,574276,130.59922406647675
1747352701493095,85551244,1,924,75,79018530,78442000,576530,130.0886337224429
1747352701587102,85643804,1,925,75,79112537,78534560,577977,129.76294904468517
1747352701681108,85736364,1,926,75,79206543,78627120,579423,129.4391144293547
1747352701770906,85828924,1,927,75,79296341,78719680,576661,130.0590815054252
1747352701865282,85921484,1,928,75,79390717,78812240,578477,129.65078991904605
1747352701959275,86014044,1,929,75,79484710,78904800,579910,129.33041334000103
1747352702245793,86297964,1,932,75,79771228,79188720,582508,128.75359651712938
1747352702336300,86390524,1,933,75,79861735,79281280,580455,129.20898260847093
1747352702430846,86483084,1,934,75,79956281,79373840,582441,128.7684074438441
1747352702525179,86575644,1,935,75,80050614,79466400,584214,128.3776150520186
1747352702618651,86668204,1,936,75,80144086,79558960,585126,128.17752073912283
1747352702709669,86760764,1,937,75,80235104,79651520,583584,128.51620332291495
1747352702803654,86853324,1,938,75,80329089,79744080,585009,128.20315584888436
1747352702897897,86945884,1,939,75,80423332,79836640,586692,127.83538892638728
1747352702992134,87038444,1,940,75,80517569,79929200,588369,127.4710258358275
1747352703085045,87131004,1,941,75,80610480,80021760,588720,127.3950264981655
1747352703176530,87223564,1,942,75,80701965,80114320,587645,127.62807477303474
1747352703274759,87316124,1,943,75,80800194,80206880,593314,126.40861331436642
1747352703364597,87408684,1,944,75,80890032,80299440,590592,126.99122236671
1747352703458191,87501244,1,945,75,80983626,80392000,591626,126.76927653619008
1747352703548879,87593804,1,946,75,81074314,80484560,589754,127.17166818707462
1747352703642696,87686364,1,947,75,81168131,80577120,591011,126.9011913483844
1747352703737019,87778924,1,948,75,81262454,80669680,592774,126.52376791154808
1747352703831002,87871484,1,949,75,81356437,80762240,594197,126.22076516710788
1747352703921359,87964044,1,950,75,81446794,80854800,591994,126.69047321425556
1747352704015415,88056604,1,951,75,81540850,80947360,593490,126.37112672496588
1747352704109336,88149164,1,952,75,81634771,81039920,594851,126.08199364210532
1747352704203404,88241724,1,953,75,81728839,81132480,596359,125.7631728539353
1747352704294161,88334284,1,954,75,81819596,81225040,594556,126.14455156452884
1747352704388516,88426844,1,955,75,81913951,81317600,596351,125.76485995663629
1747352704482823,88519404,1,956,75,82008258,81410160,598098,125.39751010703932
1747352704576511,88611964,1,957,75,82101946,81502720,599226,125.16145828118272
1747352704671267,88704524,1,958,75,82196702,81595280,601422,124.70445045242776
1747352704760526,88797084,1,959,75,82285961,81687840,598121,125.39268810157142
1747352704855582,88889644,1,960,75,82381017,81780400,600617,124.87159038122464
1747352704948893,88982204,1,961,75,82474328,81872960,601368,124.71564832182624
1747352705043523,89074764,1,962,75,82568958,81965520,603438,124.28783072991756
1747352705134028,89167324,1,963,75,82659463,82058080,601383,124.71253760083007
1747352705228159,89259884,1,964,75,82753594,82150640,602954,124.38759839059033
1747352705321684,89352444,1,965,75,82847119,82243200,603919,124.18883989409176
1747352705416680,89445004,1,966,75,82942115,82335760,606355,123.68991762251488
1747352705506587,89537572,1,967,75,83032022,82428328,603694,124.23512574251194
1747352705600568,89630124,1,968,75,83126003,82520880,605123,123.9417440751715
1747352705695105,89722684,1,969,75,83220540,82613440,607100,123.5381321034426
1747352705789341,89815244,1,970,75,83314776,82706000,608776,123.1980235751738
1747352705879545,89907804,1,971,75,83404980,82798560,606420,123.67665974077372
1747352705972889,90000364,1,972,75,83498324,82891120,607204,123.51697287896656
1747352706069506,90092924,1,973,75,83594941,82983680,611261,122.69717845568422
1747352706161841,90185484,1,974,75,83687276,83076240,611036,122.74235887901858
1747352706256278,90278044,1,975,75,83781713,83168800,612913,122.366469629458
1747352706345656,90370604,1,976,75,83871091,83261360,609731,123.00506288838848
1747352706440114,90463164,1,977,75,83965549,83353920,611629,122.62335500769258
1747352706534815,90555724,1,978,75,84060250,83446480,613770,122.19561073366243
1747352706628126,90648284,1,979,75,84153561,83539040,614521,122.04627669355482
1747352706720706,90740844,1,980,75,84246141,83631600,614541,122.04230474451664
1747352706812878,90833404,1,981,75,84338313,83724160,614153,122.11940672763954
1747352706907024,90925964,1,982,75,84432459,83816720,615739,121.80485562876478
1747352707000371,91018524,1,983,75,84525806,83909280,616526,121.64937082945409
1747352707091347,91111084,1,984,75,84616782,84001840,614942,121.9627216875738
1747352707185701,91203644,1,985,75,84711136,84094400,616736,121.60794894411872
1747352707279416,91296204,1,986,75,84804851,84186960,617891,121.3806318590172
1747352707374425,91388764,1,987,75,84899860,84279520,620340,120.90144114517844
1747352707468289,91481324,1,988,75,84993724,84372080,621644,120.6478305911422
1747352707557826,91573884,1,989,75,85083261,84464640,618621,121.23739737254311
1747352707652641,91666452,1,990,75,85178076,84557208,620868,120.79862386207697
1747352707746638,91759004,1,991,75,85272073,84649760,622313,120.51813155116476
1747352707840421,91851564,1,992,75,85365856,84742320,623536,120.28174796643658
1747352707931380,91944124,1,993,75,85456815,84834880,621935,120.59138012814844
1747352708025316,92036684,1,994,75,85550751,84927440,623311,120.3251667305727
1747352708119379,92129244,1,995,75,85644814,85020000,624814,120.035722631055
1747352708213637,92221804,1,996,75,85739072,85112560,626512,119.71039660852466
1747352708303479,92314364,1,997,75,85828914,85205120,623794,120.2319996665566
1747352708397418,92406924,1,998,75,85922853,85297680,625173,119.96679319164456
1747352708492276,92499484,1,999,75,86017711,85390240,627471,119.52743632773466
1747352708586248,92592044,1,1000,75,86111683,85482800,628883,119.2590672668843
1747352708680418,92685644,1,1001,75,86205853,85576400,629453,119.151072439086
1747352708775039,92779244,1,1002,75,86300474,85670000,630474,118.95811722608704
1747352708869114,92872844,1,1003,75,86394549,85763600,630949,118.8685614843672
1747352708962714,92966444,1,1004,75,86488149,85857200,630949,118.8685614843672
1747352709057567,93060044,1,1005,75,86583002,85950800,632202,118.63296857649928
1747352709151141,93153644,1,1006,75,86676576,86044400,632176,118.63784768798564
1747352709245299,93247244,1,1007,75,86770734,86138000,632734,118.53322249159994
1747352709340005,93340844,1,1008,75,86865440,86231600,633840,118.32639151836426
1747352709434611,93434444,1,1009,75,86960046,86325200,634846,118.13888722619345
1747352709528682,93528044,1,1010,75,87054117,86418800,635317,118.0513035224935
1747352709623033,93621644,1,1011,75,87148468,86512400,636068,117.91192136689789
1747352709716866,93715244,1,1012,75,87242301,86606000,636301,117.868744509281
1747352709811343,93808844,1,1013,75,87336778,86699600,637178,117.70651215202032
1747352709904498,93902444,1,1014,75,87429933,86793200,636733,117.788774886805
1747352709999719,93996052,1,1015,75,87525154,86886808,638346,117.49114116795594
1747352710093752,94089644,1,1016,75,87619187,86980400,638787,117.410028695011
1747352710187466,94183244,1,1017,75,87712901,87074000,638901,117.38907905919696
1747352710282438,94276844,1,1018,75,87807873,87167600,640273,117.13753352085752
1747352710375858,94370444,1,1019,75,87901293,87261200,640093,117.17047366554549
1747352710470135,94464044,1,1020,75,87995570,87354800,640770,117.04667821527228
1747352710564349,94557644,1,1021,75,88089784,87448400,641384,116.93462886507928
1747352710658279,94651244,1,1022,75,88183714,87542000,641714,116.87449549176112
1747352710753128,94744844,1,1023,75,88278563,87635600,642963,116.64745871846436
1747352710847416,94838444,1,1024,75,88372851,87729200,643651,116.52277398776668
1747352710941057,94932044,1,1025,75,88466492,87822800,643692,116.51535206278778
1747352711035553,95025644,1,1026,75,88560988,87916400,644588,116.3533916237969
1747352711133618,95119244,1,1027,75,88659053,88010000,649053,115.55296716909098
1747352711227524,95212844,1,1028,75,88752959,88103600,649359,115.4985146891011
1747352711322573,95306444,1,1029,75,88848008,88197200,650808,115.24136150754138
1747352711416124,95400044,1,1030,75,88941559,88290800,650759,115.2500388008464
1747352711510961,95493644,1,1031,75,89036396,88384400,651996,115.03138056061694
1747352711604951,95587244,1,1032,75,89130386,88478000,652386,114.96261415787586
1747352711698682,95680844,1,1033,75,89224117,88571600,652517,114.93953414240548
1747352711793244,95774444,1,1034,75,89318679,88665200,653479,114.77032926842332
1747352711887626,95868044,1,1035,75,89413061,88758800,654261,114.63315099020116
1747352711981751,95961644,1,1036,75,89507186,88852400,654786,114.5412394278436
1747352712075829,96055244,1,1037,75,89601264,88946000,655264,114.45768423108856
1747352712170348,96148844,1,1038,75,89695783,89039600,656183,114.29738350429685
1747352712264190,96242444,1,1039,75,89789625,89133200,656425,114.2552462200556
1747352712358324,96336044,1,1040,75,89883759,89226800,656959,114.16237542982137
1747352712452846,96429644,1,1041,75,89978281,89320400,657881,114.00238036970212
1747352712547157,96523244,1,1042,75,90072592,89414000,658592,113.87930615616348
1747352712640976,96616844,1,1043,75,90166411,89507600,658811,113.84145073473272
1747352712735440,96710444,1,1044,75,90260875,89601200,659675,113.6923485049456
1747352712829702,96804044,1,1045,75,90355137,89694800,660337,113.57836983237348
1747352712923811,96897644,1,1046,75,90449246,89788400,660846,113.49088895143495
1747352713017792,96991252,1,1047,75,90543227,89882008,661219,113.42686764899376
1747352713112034,97084844,1,1048,75,90637469,89975600,661869,113.31547481450256
1747352713205864,97178444,1,1049,75,90731299,90069200,662099,113.27611127641032
1747352713300501,97272044,1,1050,75,90825936,90162800,663136,113.09897215654104
1747352713394481,97365644,1,1051,75,90919916,90256400,663516,113.03419962743928
1747352713489028,97459244,1,1052,75,91014463,90350000,664463,112.8731020387892
1747352713583501,97552844,1,1053,75,91108936,90443600,665336,112.7249990982
1747352713676950,97646444,1,1054,75,91202385,90537200,665185,112.750588182235
1747352713771188,97740044,1,1055,75,91296623,90630800,665823,112.6425491459442
1747352713865589,97833644,1,1056,75,91391024,90724400,666624,112.5072004608295
1747352713960130,97927244,1,1057,75,91485565,90818000,667565,112.34861024769124
1747352714054542,98020844,1,1058,75,91579977,90911600,668377,112.21211980663608
1747352714147890,98114444,1,1059,75,91673325,91005200,668125,112.25444340505146
1747352714242230,98208044,1,1060,75,91767665,91098800,668865,112.1302504989796
1747352714336369,98301644,1,1061,75,91861804,91192400,669404,112.03996390819296
1747352714430970,98395244,1,1062,75,91956405,91286000,670405,111.87267398065347
1747352714524804,98488844,1,1063,75,92050239,91379600,670639,111.83363926046653
1747352714619370,98582444,1,1064,75,92144805,91473200,671605,111.67278385360444
1747352714713748,98676044,1,1065,75,92239183,91566800,672383,111.54356966193376
1747352714807877,98769644,1,1066,75,92333312,91660400,672912,111.45588130394464
1747352714902163,98863244,1,1067,75,92427598,91754000,673598,111.34237334433892
1747352714996443,98956844,1,1068,75,92521878,91847600,674278,111.23008610691733
1747352715090826,99050444,1,1069,75,92616261,91941200,675061,111.10107086618838
1747352715184562,99144044,1,1070,75,92709997,92034800,675197,111.07869258897772
1747352715278752,99237644,1,1071,75,92804187,92128400,675787,110.98171465269382
1747352715372734,99331244,1,1072,75,92898169,92222000,676169,110.91901580817812
1747352715467097,99424844,1,1073,75,92992532,92315600,676932,110.79399407916895
1747352715565228,99518444,1,1074,75,93090663,92409200,681463,110.05733253309424
1747352715659474,99612044,1,1075,75,93184909,92502800,682109,109.95310133717632
1747352715754173,99705644,1,1076,75,93279608,92596400,683208,109.7762321284294
1747352715847604,99799244,1,1077,75,93373039,92690000,683039,109.80339336406853
1747352715942016,99892844,1,1078,75,93467451,92783600,683851,109.67301356582064
1747352716036120,99986452,1,1079,75,93561555,92877208,684347,109.5935249222982
1747352716130790,100080044,1,1080,75,93656225,92970800,685425,109.421162052741
1747352716225364,100174684,1,1081,75,93750799,93065440,685359,109.4316992991994
1747352716319044,100269324,1,1082,75,93844479,93160080,684399,109.58519810812116
1747352716417294,100363964,1,1083,75,93942729,93254720,688009,109.01020190142862
1747352716511266,100458604,1,1084,75,94036701,93349360,687341,109.11614467927856
1747352716605467,100553244,1,1085,75,94130902,93444000,686902,109.1858809553619
1747352716703774,100647884,1,1086,75,94229209,93538640,690569,108.60609149845996
1747352716797897,100742524,1,1087,75,94323332,93633280,690052,108.6874612348055
1747352716892406,100837164,1,1088,75,94417841,93727920,689921,108.70809846344726
1747352716986439,100931804,1,1089,75,94511874,93822560,689314,108.80382525235234
1747352717085335,101026444,1,1090,75,94610770,93917200,693570,108.13616505904234
1747352717178741,101121084,1,1091,75,94704176,94011840,692336,108.32890388481894
1747352717273662,101215724,1,1092,75,94799097,94106480,692617,108.28495402220852
1747352717367737,101310364,1,1093,75,94893172,94201120,692052,108.3733592273413
1747352717465600,101405004,1,1094,75,94991035,94295760,695275,107.87098630038474
1747352717559847,101499644,1,1095,75,95085282,94390400,694882,107.93199420908874
1747352717654023,101594284,1,1096,75,95179458,94485040,694418,108.0041127966153
1747352717752133,101688924,1,1097,75,95277568,94579680,697888,107.46710073822734
1747352717846485,101783572,1,1098,75,95371920,94674328,697592,107.51270083372516
1747352717940640,101878204,1,1099,75,95466075,94768960,697115,107.58626625449172
1747352718035128,101972844,1,1100,75,95560563,94863600,696963,107.60972964131524
1747352718133023,102067484,1,1101,75,95658458,94958240,700218,107.10950018422834
1747352718228001,102162124,1,1102,75,95753436,95052880,700556,107.0578226437287
1747352718321707,102256764,1,1103,75,95847142,95147520,699622,107.2007455454517
1747352718420208,102351404,1,1104,75,95945643,95242160,703483,106.61238437886917
1747352718514434,102446044,1,1105,75,96039869,95336800,703069,106.67516275073996
1747352718608321,102540684,1,1106,75,96133756,95431440,702316,106.78953633407184
1747352718702625,102635324,1,1107,75,96228060,95526080,701980,106.84065073079005
1747352718800614,102729964,1,1108,75,96326049,95620720,705329,106.33335649037542
1747352718895296,102824604,1,1109,75,96420731,95715360,705371,106.32702506907712
1747352718989400,102919244,1,1110,75,96514835,95810000,704835,106.40788269595012
1747352719083941,103013884,1,1111,75,96609376,95904640,704736,106.42283067701948
1747352719181544,103108524,1,1112,75,96706979,95999280,707699,105.97725869331454
1747352719276430,103203164,1,1113,75,96801865,96093920,707945,105.94043322574493
1747352719370906,103297804,1,1114,75,96896341,96188560,707781,105.96498069318052
1747352719468289,103392444,1,1115,75,96993724,96283200,710524,105.55589958959864
1747352719562763,103487084,1,1116,75,97088198,96377840,710358,105.58056641862272
1747352719657407,103581732,1,1117,75,97182842,96472488,710354,105.58116094229074
1747352719751623,103676364,1,1118,75,97277058,96567120,709938,105.64302798272526
1747352719849472,103771004,1,1119,75,97374907,96661760,713147,105.1676582808313
1747352719943529,103865644,1,1120,75,97468964,96756400,712564,105.25370352698144
1747352720038206,103960284,1,1121,75,97563641,96851040,712601,105.24823849531504
1747352720136708,104054924,1,1122,75,97662143,96945680,716463,104.68091164512336
1747352720229943,104149564,1,1123,75,97755378,97040320,715058,104.8865966117434
1747352720324461,104244204,1,1124,75,97849896,97134960,714936,104.90449494779952
1747352720419193,104338844,1,1125,75,97944628,97229600,715028,104.89099727563116
1747352720516830,104433484,1,1126,75,98042265,97324240,718025,104.45318756310714
1747352720611031,104528124,1,1127,75,98136466,97418880,717586,104.51708924087148
1747352720705777,104622764,1,1128,75,98231212,97513520,717692,104.50165251946518
1747352720800161,104717404,1,1129,75,98325596,97608160,717436,104.53894145261738
1747352720897857,104812044,1,1130,75,98423292,97702800,720492,104.09553471794274
1747352720991810,104906684,1,1131,75,98517245,97797440,719805,104.19488611498949
1747352721086904,105001324,1,1132,75,98612339,97892080,720259,104.12920907617956
1747352721184857,105095964,1,1133,75,98710292,97986720,723572,103.65243541762256
1747352721278463,105190604,1,1134,75,98803898,98081360,722538,103.80076895609642
1747352721373048,105285244,1,1135,75,98898483,98176000,722483,103.8086709306655
1747352721467198,105379884,1,1136,75,98992633,98270640,721993,103.87912348180662
1747352721566031,105474524,1,1137,75,99091466,98365280,726186,103.27932513157786
1747352721659496,105569164,1,1138,75,99184931,98459920,725011,103.44670632583508
1747352721753505,105663804,1,1139,75,99278940,98554560,724380,103.5368176923714
1747352721848150,105758444,1,1140,75,99373585,98649200,724385,103.53610303912976
1747352721946196,105853084,1,1141,75,99471631,98743840,727791,103.05156288000263
1747352722040491,105947724,1,1142,75,99565926,98838480,727446,103.1004363210465
1747352722134865,106042364,1,1143,75,99660300,98933120,727180,103.13815011413956
1747352722233047,106137004,1,1144,75,99758482,99027760,730722,102.6382126171102
1747352722327816,106231644,1,1145,75,99853251,99122400,730851,102.62009629869836
1747352722421809,106326284,1,1146,75,99947244,99217040,730204,102.71102322090812
1747352722515244,106420924,1,1147,75,100040679,99311680,728999,102.88079956213932
1747352722613633,106515564,1,1148,75,100139068,99406320,732748,102.35442471354408
1747352722708629,106610204,1,1149,75,100234064,99500960,733104,102.30472074903425
1747352722802092,106704844,1,1150,75,100327527,99595600,731927,102.46923531991578
1747352722900877,106799484,1,1151,75,100426312,99690240,736072,101.89220619721983
1747352722995094,106894124,1,1152,75,100520529,99784880,735649,101.95079446855767
1747352723088938,106988764,1,1153,75,100614373,99879520,734853,102.06122857224508
1747352723183378,107083404,1,1154,75,100708813,99974160,734653,102.0890134526096
1747352723281856,107178044,1,1155,75,100807291,100068800,738491,101.55844824107538
1747352723376159,107272684,1,1156,75,100901594,100163440,738154,101.60481417156852
1747352723470258,107367324,1,1157,75,100995693,100258080,737613,101.6793359119213
1747352723564276,107461964,1,1158,75,101089711,100352720,736991,101.76515045638278
1747352723662586,107556604,1,1159,75,101188021,100447360,740661,101.26090073596424
1747352723756824,107651244,1,1160,75,101282259,100542000,740259,101.315890789575
1747352723850977,107745884,1,1161,75,101376412,100636640,739772,101.38258814878098
1747352723949422,107840532,1,1162,75,101474857,100731288,743569,100.86488274793597
1747352724043499,107935164,1,1163,75,101568934,100825920,743014,100.94022454489418
1747352724138310,108029804,1,1164,75,101663745,100920560,743185,100.91699913211382
1747352724231848,108124444,1,1165,75,101757283,101015200,742083,101.06686179308782
1747352724329906,108219084,1,1166,75,101855341,101109840,745501,100.60348678271392
1747352724423988,108313724,1,1167,75,101949423,101204480,744943,100.6788438846999
1747352724518625,108408364,1,1168,75,102044060,101299120,744940,100.67924933551694
1747352724616629,108503004,1,1169,75,102142064,101393760,748304,100.22664585516048
1747352724711267,108597644,1,1170,75,102236702,101488400,748302,100.2269137326908
1747352724805006,108692284,1,1171,75,102330441,101583040,747401,100.3477383626728
1747352724899602,108786924,1,1172,75,102425037,101677680,747357,100.35364624938282
1747352724997695,108881564,1,1173,75,102523130,101772320,750810,99.8921165141647
1747352725091843,108976204,1,1174,75,102617278,101866960,750318,99.95761796998072
1747352725186458,109070844,1,1175,75,102711893,101961600,750293,99.96094858941774
1747352725280830,109165484,1,1176,75,102806265,102056240,750025,99.99666677777408
1747352725378579,109260124,1,1177,75,102904014,102150880,753134,99.58387219273064
1747352725472833,109354764,1,1178,75,102998268,102245520,752748,99.6349375886751
1747352725567421,109449404,1,1179,75,103092856,102340160,752696,99.64182086792012
1747352725665742,109544044,1,1180,75,103191177,102434800,756377,99.15690191531472
1747352725759572,109638692,1,1181,75,103285007,102529448,755559,99.26425335413911
1747352725853903,109733324,1,1182,75,103379338,102624080,755258,99.30381406089045
1747352725948354,109827964,1,1183,75,103473789,102718720,755069,99.32867062480383
1747352726046033,109922604,1,1184,75,103571468,102813360,758108,98.930495391158
1747352726140867,110017244,1,1185,75,103666302,102908000,758302,98.90518553294068
1747352726234408,110111884,1,1186,75,103759843,103002640,757203,99.04873594003192
1747352726333325,110206524,1,1187,75,103858760,103097280,761480,98.49240951830645
1747352726427136,110301164,1,1188,75,103952571,103191920,760651,98.59975205449015
1747352726521857,110395804,1,1189,75,104047292,103286560,760732,98.5892535084629
1747352726615482,110490444,1,1190,75,104140917,103381200,759717,98.7209710984485
1747352726714130,110585084,1,1191,75,104239565,103475840,763725,98.20288716488264
1747352726808093,110679724,1,1192,75,104333528,103570480,763048,98.29001583124524
1747352726902678,110774364,1,1193,75,104428113,103665120,762993,98.29710102189664
1747352726996986,110869004,1,1194,75,104522421,103759760,762661,98.33989151143167
1747352727094649,110963644,1,1195,75,104620084,103854400,765684,97.95163540050464
1747352727188960,111058284,1,1196,75,104714395,103949040,765355,97.99374146637837
1747352727283185,111152924,1,1197,75,104808620,104043680,764940,98.04690563965802
1747352727381542,111247564,1,1198,75,104906977,104138320,768657,97.57277953625608
1747352727476161,111342204,1,1199,75,105001596,104232960,768636,97.57544533433251
1747352727570340,111436844,1,1200,75,105095775,104327600,768175,97.63400266866272
1747352727663422,111531484,1,1201,75,105188857,104422240,766617,97.83242479621508
1747352727762827,111626124,1,1202,75,105288262,104516880,771382,97.22809191814171
1747352727856855,111720764,1,1203,75,105382290,104611520,770770,97.30529211048692
1747352727950849,111815404,1,1204,75,105476284,104706160,770124,97.3869143150973
1747352728045313,111910044,1,1205,75,105570748,104800800,769948,97.40917568459167
1747352728143650,112004684,1,1206,75,105669085,104895440,773645,96.94368864272371
1747352728237651,112099324,1,1207,75,105763086,104990080,773006,97.02382646447764
1747352728331798,112193964,1,1208,75,105857233,105084720,772513,97.085744835362
1747352728430083,112288604,1,1209,75,105955518,105179360,776158,96.62980990983796
1747352728523925,112383244,1,1210,75,106049360,105274000,775360,96.72926124638876
1747352728618445,112477884,1,1211,75,106143880,105368640,775240,96.744234043651
1747352728712135,112572524,1,1212,75,106237570,105463280,774290,96.86293249299358
1747352728810294,112667164,1,1213,75,106335729,105557920,777809,96.42470066558757
1747352728904909,112761804,1,1214,75,106430344,105652560,777784,96.42780000617138
1747352728999069,112856444,1,1215,75,106524504,105747200,777304,96.48734600619578
1747352729097336,112951084,1,1216,75,106622771,105841840,780931,96.03921473215944
1747352729191367,113045724,1,1217,75,106716802,105936480,780322,96.1141682536184
1747352729285869,113140364,1,1218,75,106811304,106031120,780184,96.13116905755564
1747352729380095,113235004,1,1219,75,106905530,106125760,779770,96.18220757402824
1747352729478186,113329644,1,1220,75,107003621,106220400,783221,95.7584130149728
1747352729572650,113424284,1,1221,75,107098085,106315040,783045,95.77993601900276
1747352729666911,113518924,1,1222,75,107192346,106409680,782666,95.82631671747592
1747352729760818,113613564,1,1223,75,107286253,106504320,781933,95.9161462682864
1747352729859255,113708204,1,1224,75,107384690,106598960,785730,95.4526364018174
1747352729953341,113802844,1,1225,75,107478776,106693600,785176,95.51998532813026
1747352730048059,113897492,1,1226,75,107573494,106788248,785246,95.5114702908388
1747352730146094,113992124,1,1227,75,107671529,106882880,788649,95.09934077136975
1747352730240466,114086764,1,1228,75,107765901,106977520,788381,95.13166857141408
1747352730334334,114181404,1,1229,75,107859769,107072160,787609,95.22491490066771
1747352730428556,114276044,1,1230,75,107953991,107166800,787191,95.27547952148844
1747352730526466,114370684,1,1231,75,108051901,107261440,790461,94.88134139445212
1747352730621665,114465324,1,1232,75,108147100,107356080,791020,94.8142904098506
1747352730715979,114559964,1,1233,75,108241414,107450720,790694,94.8533819657162
1747352730814187,114654604,1,1234,75,108339622,107545360,794262,94.42727966338563
1747352730907222,114749244,1,1235,75,108432657,107640000,792657,94.6184793674944
1747352731001963,114843884,1,1236,75,108527398,107734640,792758,94.60642465922766
1747352731096282,114938524,1,1237,75,108621717,107829280,792437,94.64474778436646
1747352731194880,115033164,1,1238,75,108720315,107923920,796395,94.1743732695459
1747352731288463,115127804,1,1239,75,108813898,108018560,795338,94.29953051407075
1747352731382806,115222444,1,1240,75,108908241,108113200,795041,94.33475757853998
1747352731476812,115317084,1,1241,75,109002247,108207840,794407,94.41004422166472
1747352731575202,115411724,1,1242,75,109100637,108302480,798157,93.96647526739729
1747352731669991,115506364,1,1243,75,109195426,108397120,798306,93.94893687383032
1747352731763817,115601004,1,1244,75,109289252,108491760,797492,94.04483054375468
1747352731862511,115695652,1,1245,75,109387946,108586408,801538,93.57011146071676
1747352731956170,115790284,1,1246,75,109481605,108681040,800565,93.68383579097262
1747352732050441,115884924,1,1247,75,109575876,108775680,800196,93.72703687596538
1747352732144931,115979564,1,1248,75,109670366,108870320,800046,93.74460968494311
1747352732243203,116074204,1,1249,75,109768638,108964960,803678,93.32095690064926
1747352732337291,116168844,1,1250,75,109862726,109059600,803126,93.38509773061762
1747352732431845,116263484,1,1251,75,109957280,109154240,803040,93.39509862522416
1747352732526105,116358124,1,1252,75,110051540,109248880,802660,93.43931428001892
1747352732624179,116452764,1,1253,75,110149614,109343520,806094,93.04125821554312
1747352732718225,116547404,1,1254,75,110243660,109438160,805500,93.1098696461825
1747352732813015,116642044,1,1255,75,110338450,109532800,805650,93.09253397877492
1747352732911155,116736684,1,1256,75,110436590,109627440,809150,92.6898597293456
1747352733005125,116831324,1,1257,75,110530560,109722080,808480,92.76667326340788
1747352733099047,116925964,1,1258,75,110624482,109816720,807762,92.84913130352751
1747352733193379,117020604,1,1259,75,110718814,109911360,807454,92.88454822194204
1747352733291967,117115244,1,1260,75,110817402,110006000,811402,92.43260430711288
1747352733385949,117209884,1,1261,75,110911384,110100640,810744,92.50762262810456
1747352733480253,117304524,1,1262,75,111005688,110195280,810408,92.54597684129476
1747352733578728,117399164,1,1263,75,111104163,110289920,814243,92.11009489796044
1747352733672613,117493804,1,1264,75,111198048,110384560,813488,92.19558247939736
1747352733766977,117588444,1,1265,75,111292412,110479200,813212,92.22687318927905
1747352733861755,117683084,1,1266,75,111387190,110573840,813350,92.21122517981188
1747352733959626,117777724,1,1267,75,111485061,110668480,816581,91.84636919056408
1747352734053551,117872364,1,1268,75,111578986,110763120,815866,91.92686053837272
1747352734147328,117967004,1,1269,75,111672763,110857760,815003,92.02420113790993
1747352734241628,118061644,1,1270,75,111767063,110952400,814663,92.06260748309424
1747352734342625,118156284,1,1271,75,111868060,111047040,821020,91.3497844145088
1747352734434640,118250924,1,1272,75,111960075,111141680,818395,91.6427886289628
1747352734528051,118345564,1,1273,75,112053486,111236320,817166,91.78061740209456
1747352734627243,118440204,1,1274,75,112152678,111330960,821718,91.2721882689682
1747352734720673,118534844,1,1275,75,112246108,111425600,820508,91.40678701487371
1747352734814926,118629484,1,1276,75,112340361,111520240,820121,91.44992019470298
1747352734909016,118724124,1,1277,75,112434451,111614880,819571,91.511290663042
1747352735007790,118818764,1,1278,75,112533225,111709520,823705,91.05201498109152
1747352735101852,118913404,1,1279,75,112627287,111804160,823127,91.1159517304134
1747352735196236,119008044,1,1280,75,112721671,111898800,822871,91.14429843802978
1747352735294656,119102684,1,1281,75,112820091,111993440,826651,90.72752588456314
1747352735388736,119197324,1,1282,75,112914171,112088080,826091,90.78902929580396
1747352735482398,119291964,1,1283,75,113007833,112182720,825113,90.89664082374172
1747352735576688,119386604,1,1284,75,113102123,112277360,824763,90.93521411605516
1747352735675533,119481244,1,1285,75,113200968,112372000,828968,90.47393868038333
1747352735769820,119575884,1,1286,75,113295255,112466640,828615,90.51248167122246
1747352735864018,119670524,1,1287,75,113389453,112561280,828173,90.5607886274969
1747352735957413,119765164,1,1288,75,113482848,112655920,826928,90.69713445426927
1747352736055986,119859804,1,1289,75,113581421,112750560,830861,90.26780652840849
1747352736150390,119954452,1,1290,75,113675825,112845208,830617,90.29432337647796
1747352736244706,120049084,1,1291,75,113770141,112939840,830301,90.32868803000358
1747352736342657,120143724,1,1292,75,113868092,113034480,833612,89.96991406073809
1747352736437132,120238364,1,1293,75,113962567,113129120,833447,89.98772567421803
1747352736530973,120333004,1,1294,75,114056408,113223760,832648,90.07407692085972
1747352736625466,120427644,1,1295,75,114150901,113318400,832501,90.08998187389564
1747352736723986,120522284,1,1296,75,114249421,113413040,836381,89.67205137371604
1747352736818096,120616924,1,1297,75,114343531,113507680,835851,89.72891101404437
1747352736912217,120711564,1,1298,75,114437652,113602320,835332,89.78466047032796
1747352737010584,120806204,1,1299,75,114536019,113696960,839059,89.38584771750259
1747352737104495,120900844,1,1300,75,114629930,113791600,838330,89.46357639593
1747352737198560,120995484,1,1301,75,114723995,113886240,837755,89.5249804537126
1747352737293140,121090124,1,1302,75,114818575,113980880,837695,89.5313926906571
1747352737390997,121184764,1,1303,75,114916432,114075520,840912,89.18888064387237
1747352737485847,121279404,1,1304,75,115011282,114170160,841122,89.16661316669877
1747352737579874,121374044,1,1305,75,115105309,114264800,840509,89.23164415848017
1747352737674385,121468684,1,1306,75,115199820,114359440,840380,89.24534139317927
1747352737772570,121563324,1,1307,75,115298005,114454080,843925,88.87045649791155
1747352737866569,121657964,1,1308,75,115392004,114548720,843284,88.93800902187164
1747352737960673,121752612,1,1309,75,115486108,114643368,842740,88.99541970239932
1747352738059454,121847244,1,1310,75,115584889,114738000,846889,88.55942160070565
1747352738152732,121941884,1,1311,75,115678167,114832640,845527,88.70207574684191
1747352738247455,122036524,1,1312,75,115772890,114927280,845610,88.69336928371236
1747352738341250,122131164,1,1313,75,115866685,115021920,844765,88.78208732606109
1747352738440125,122225804,1,1314,75,115965560,115116560,849000,88.33922261484099
1747352738534348,122320444,1,1315,75,116059783,115211200,848583,88.3826331661134
1747352738627988,122415084,1,1316,75,116153423,115305840,847583,88.48690924664605
1747352738722190,122509724,1,1317,75,116247625,115400480,847145,88.53265969816265
1747352738820624,122604364,1,1318,75,116346059,115495120,850939,88.1379276305352
1747352738915502,122699004,1,1319,75,116440937,115589760,851177,88.11328313617497
1747352739009470,122793644,1,1320,75,116534905,115684400,850505,88.18290309874722
1747352739107761,122888284,1,1321,75,116633196,115779040,854156,87.80597455265783
1747352739202125,122982924,1,1322,75,116727560,115873680,853880,87.83435611561343
1747352739296328,123077564,1,1323,75,116821763,115968320,853443,87.87933113283489
1747352739390191,123172204,1,1324,75,116915626,116062960,852666,87.9594120089226
1747352739488728,123266844,1,1325,75,117014163,116157600,856563,87.55923382168037
1747352739582250,123361484,1,1326,75,117107685,116252240,855445,87.67366692189445
1747352739677216,123456124,1,1327,75,117202651,116346880,855771,87.64026824933306
1747352739775526,123550764,1,1328,75,117300961,116441520,859441,87.26602524198869
1747352739868898,123645404,1,1329,75,117394333,116536160,858173,87.3949658169157
1747352739963619,123740044,1,1330,75,117489054,116630800,858254,87.38671768497439
1747352740057308,123834684,1,1331,75,117582743,116725440,857303,87.48365513709855
1747352740156423,123929324,1,1332,75,117681858,116820080,861778,87.02937415436458
1747352740250340,124023964,1,1333,75,117775775,116914720,861055,87.10244990157423
1747352740344866,124118604,1,1334,75,117870301,117009360,860941,87.11398342046668
1747352740438647,124213244,1,1335,75,117964082,117104000,860082,87.20098781278995
1747352740536747,124307884,1,1336,75,118062182,117198640,863542,86.85159494268953
1747352740631035,124402524,1,1337,75,118156470,117293280,863190,86.88701212942689
1747352740725062,124497164,1,1338,75,118250497,117387920,862577,86.94875935713564
1747352740824064,124591804,1,1339,75,118349499,117482560,866939,86.51127703333222
1747352740917500,124686444,1,1340,75,118442935,117577200,865735,86.63159049824715
1747352741012429,124781084,1,1341,75,118537864,117671840,866024,86.60268075711528
1747352741105797,124875724,1,1342,75,118631232,117766480,864752,86.73006827390975
1747352741204884,124970364,1,1343,75,118730319,117861120,869199,86.286339491877
1747352741299150,125065004,1,1344,75,118824585,117955760,868825,86.32348286478866
1747352741393147,125159644,1,1345,75,118918582,118050400,868182,86.38741646336828
1747352741490522,125254284,1,1346,75,119015957,118145040,870917,86.11612817294873
1747352741585202,125348924,1,1347,75,119110637,118239680,870957,86.11217316124677
1747352741679459,125443564,1,1348,75,119204894,118334320,870574,86.1500573185048
1747352741773477,125538204,1,1349,75,119298912,118428960,869952,86.21165305672038
1747352741871973,125632844,1,1350,75,119397408,118523600,873808,85.83121234870818
1747352741966488,125727484,1,1351,75,119491923,118618240,873683,85.84349243375458
1747352742060190,125822124,1,1352,75,119585625,118712880,872745,85.93575442998814
1747352742157259,125916764,1,1353,75,119682694,118807520,875174,85.69724420515234
1747352742252611,126011412,1,1354,75,119778046,118902168,875878,85.62836376755666
1747352742346892,126106044,1,1355,75,119872327,118996800,875527,85.66269229846709
1747352742441429,126200684,1,1356,75,119966864,119091440,875424,85.6727711371861
1747352742539882,126295324,1,1357,75,120065317,119186080,879237,85.30123277341603
1747352742633890,126389964,1,1358,75,120159325,119280720,878605,85.36259183592172
1747352742728407,126484604,1,1359,75,120253842,119375360,878482,85.37454381535422
1747352742821901,126579244,1,1360,75,120347336,119470000,877336,85.48606235239407
1747352742920314,126673884,1,1361,75,120445749,119564640,881109,85.12000217907206
1747352743014558,126768524,1,1362,75,120539993,119659280,880713,85.15827517023139
1747352743109270,126863164,1,1363,75,120634705,119753920,880785,85.15131388477324
1747352743207691,126957804,1,1364,75,120733126,119848560,884566,84.78734204118179
1747352743301512,127052444,1,1365,75,120826947,119943200,883747,84.8659175080651
1747352743395724,127147084,1,1366,75,120921159,120037840,883319,84.90703811420336
1747352743489561,127241724,1,1367,75,121014996,120132480,882516,84.98429490230205
1747352743588077,127336364,1,1368,75,121113512,120227120,886392,84.61267700972031
1747352743682226,127431004,1,1369,75,121207661,120321760,885901,84.65957257075
1747352743776223,127525644,1,1370,75,121301658,120416400,885258,84.72106436767587
1747352743871030,127620284,1,1371,75,121396465,120511040,885425,84.70508512861055
1747352743968867,127714924,1,1372,75,121494302,120605680,888622,84.40034120244603
1747352744062976,127809572,1,1373,75,121588411,120700328,888083,84.45156590093494
1747352744157970,127904204,1,1374,75,121683405,120794960,888445,84.4171558171862
1747352744255934,127998844,1,1375,75,121781369,120889600,891769,84.10249739562599
1747352744349949,128093484,1,1376,75,121875384,120984240,891144,84.16148231935578
1747352744443874,128188124,1,1377,75,121969309,121078880,890429,84.22906262037736
1747352744538329,128282764,1,1378,75,122063764,121173520,890244,84.24656610996536
1747352744636369,128377404,1,1379,75,122161804,121268160,893644,83.92603766152965
1747352744730654,128472044,1,1380,75,122256089,121362800,893289,83.95939052199232
1747352744824633,128566684,1,1381,75,122350068,121457440,892628,84.02156329400377
1747352744919129,128661324,1,1382,75,122444564,121552080,892484,84.03511995733257
1747352745017655,128755964,1,1383,75,122543090,121646720,896370,83.67080558251615
1747352745111544,128850604,1,1384,75,122636979,121741360,895619,83.74096574547882
1747352745205894,128945244,1,1385,75,122731329,121836000,895329,83.7680897189748
1747352745304416,129039884,1,1386,75,122829851,121930640,899211,83.40645299045497
1747352745398357,129134524,1,1387,75,122923792,122025280,898512,83.47133928094449
1747352745493026,129229164,1,1388,75,123018461,122119920,898541,83.46864528162877
1747352745587139,129323804,1,1389,75,123112574,122214560,898014,83.51762890110845
1747352745685323,129418444,1,1390,75,123210758,122309200,901558,83.18932337131943
1747352745778963,129513084,1,1391,75,123304398,122403840,900558,83.28169868015165
1747352745873634,129607724,1,1392,75,123399069,122498480,900589,83.27883196441441
1747352745972348,129702364,1,1393,75,123497783,122593120,904663,82.90379953640195
1747352746065670,129797004,1,1394,75,123591105,122687760,903345,83.02475798283048
1747352746160012,129891644,1,1395,75,123685447,122782400,903047,83.05215564638385
1747352746254534,129986284,1,1396,75,123779969,122877040,902929,83.06300938390505
1747352746353086,130080924,1,1397,75,123878521,122971680,906841,82.70468582695312
1747352746446846,130175564,1,1398,75,123972281,123066320,905961,82.7850205472421
1747352746541025,130270204,1,1399,75,124066460,123160960,905500,82.82716731087797
1747352746634959,130364844,1,1400,75,124160394,123255600,904794,82.89179636469738
1747352746733491,130459484,1,1401,75,124258926,123350240,908686,82.53676187373857
1747352746827837,130554124,1,1402,75,124353272,123444880,908392,82.5634747994258
1747352746921918,130648764,1,1403,75,124447353,123539520,907833,82.61431342548684
1747352747019940,130743404,1,1404,75,124545375,123634160,911215,82.30768808678522
1747352747114476,130838044,1,1405,75,124639911,123728800,911111,82.3170832094004
1747352747208714,130932684,1,1406,75,124734149,123823440,910709,82.35341914925624
1747352747302946,131027324,1,1407,75,124828381,123918080,910301,82.39033023142895
1747352747401201,131121964,1,1408,75,124926636,124012720,913916,82.0644348058246
1747352747495364,131216604,1,1409,75,125020799,124107360,913439,82.10728904721607
1747352747589539,131311244,1,1410,75,125114974,124202000,912974,82.14910829881245
1747352747687651,131405884,1,1411,75,125213086,124296640,916446,81.83788242842459
1747352747781437,131500524,1,1412,75,125306872,124391280,915592,81.91421506522556
1747352747875866,131595164,1,1413,75,125401301,124485920,915381,81.93309671055003
1747352747970322,131689804,1,1414,75,125495757,124580560,915197,81.94956932769665
1747352748069223,131784444,1,1415,75,125594658,124675200,919458,81.56979437886233
1747352748163427,131879084,1,1416,75,125688862,124769840,919022,81.60849250616415
1747352748256980,131973724,1,1417,75,125782415,124864480,917935,81.70513162696706
1747352748351465,132068372,1,1418,75,125876900,124959128,917772,81.71964278709744
1747352748449277,132163004,1,1419,75,125974712,125053760,920952,81.43746905376176
1747352748544464,132257644,1,1420,75,126069899,125148400,921499,81.38912793177204
1747352748637966,132352284,1,1421,75,126163401,125243040,920361,81.48976325593979
1747352748736556,132446924,1,1422,75,126261991,125337680,924311,81.14152054881961
1747352748830822,132541564,1,1423,75,126356257,125432320,923937,81.17436578468012
1747352748924570,132636204,1,1424,75,126450005,125526960,923045,81.25280999301226
1747352749019482,132730844,1,1425,75,126544917,125621600,923317,81.22887372375901
1747352749117265,132825484,1,1426,75,126642700,125716240,926460,80.95330613302248
1747352749211828,132920124,1,1427,75,126737263,125810880,926383,80.9600348883777
1747352749306241,133014764,1,1428,75,126831676,125905520,926156,80.97987811988477
1747352749404318,133109404,1,1429,75,126929753,126000160,929593,80.68046984002676
1747352749498252,133204044,1,1430,75,127023687,126094800,928887,80.74179098211084
1747352749592788,133298684,1,1431,75,127118223,126189440,928783,80.75083200273906
1747352749687131,133393324,1,1432,75,127212566,126284080,928486,80.77666222215521
1747352749785001,133487964,1,1433,75,127310436,126378720,931716,80.49663202091625
1747352749878885,133582604,1,1434,75,127404320,126473360,930960,80.56200051559681
1747352749973397,133677244,1,1435,75,127498832,126568000,930832,80.57307870808052
1747352750067230,133771884,1,1436,75,127592665,126662640,930025,80.64299346791753
1747352750166033,133866532,1,1437,75,127691468,126757288,934180,80.28431351559657
1747352750260035,133961164,1,1438,75,127785470,126851920,933550,80.33849284987414
1747352750354041,134055804,1,1439,75,127879476,126946560,932916,80.39309005312376
1747352750452598,134150444,1,1440,75,127978033,127041200,936833,80.05695785694995
1747352750546835,134245084,1,1441,75,128072270,127135840,936430,80.09141099708468
1747352750641104,134339724,1,1442,75,128166539,127230480,936059,80.12315463021028
1747352750735429,134434364,1,1443,75,128260864,127325120,935744,80.15012653033308
1747352750833207,134529004,1,1444,75,128358642,127419760,938882,79.88224292296583
1747352750927434,134623644,1,1445,75,128452869,127514400,938469,79.91739737807002
1747352751022233,134718284,1,1446,75,128547668,127609040,938628,79.90385967603778
1747352751115931,134812924,1,1447,75,128641366,127703680,937686,79.98413114838016
1747352751214815,134907564,1,1448,75,128740250,127798320,941930,79.62375123416814
1747352751308749,135002204,1,1449,75,128834184,127892960,941224,79.68347598446279
1747352751402682,135096844,1,1450,75,128928117,127987600,940517,79.74337518620078
1747352751500705,135191484,1,1451,75,129026140,128082240,943900,79.45756965780274
1747352751594833,135286124,1,1452,75,129120268,128176880,943388,79.5006932460451
1747352751689816,135380764,1,1453,75,129215251,128271520,943731,79.47179863753549
1747352751783577,135475404,1,1454,75,129309012,128366160,942852,79.54588843211872
1747352751881803,135570044,1,1455,75,129407238,128460800,946438,79.24449356429052
1747352751976550,135664684,1,1456,75,129501985,128555440,946545,79.2355355529848
1747352752070176,135759324,1,1457,75,129595611,128650080,945531,79.3205087934716
1747352752168610,135853964,1,1458,75,129694045,128744720,949325,79.00350248861034
1747352752263275,135948604,1,1459,75,129788710,128839360,949350,79.00142202559645
1747352752357532,136043244,1,1460,75,129882967,128934000,948967,79.03330674301635
1747352752451076,136137884,1,1461,75,129976511,129028640,947871,79.12469101808158
1747352752549328,136232524,1,1462,75,130074763,129123280,951483,78.82431950964967
1747352752643610,136327164,1,1463,75,130169045,129217920,951125,78.85398869759496
1747352752738494,136421804,1,1464,75,130263929,129312560,951369,78.8337648168061
1747352752831925,136516444,1,1465,75,130357360,129407200,950160,78.93407426117706
1747352752930179,136611084,1,1466,75,130455614,129501840,953774,78.63498061385611
1747352753025020,136705724,1,1467,75,130550455,129596480,953975,78.61841243219162
1747352753119248,136800364,1,1468,75,130644683,129691120,953563,78.65238059782101
1747352753216996,136895004,1,1469,75,130742431,129785760,956671,78.39685743583739
1747352753311801,136989644,1,1470,75,130837236,129880400,956836,78.38333841954108
1747352753405581,137084284,1,1471,75,130931016,129975040,955976,78.45385239796815
1747352753500046,137178924,1,1472,75,131025481,130069680,955801,78.46821671038218
1747352753598541,137273564,1,1473,75,131123976,130164320,959656,78.15300482672959
1747352753692081,137368204,1,1474,75,131217516,130258960,958556,78.24269004627794
1747352753786076,137462844,1,1475,75,131311511,130353600,957911,78.29537399612282
1747352753885011,137557484,1,1476,75,131410446,130448240,962206,77.94588684751498
1747352753979527,137652124,1,1477,75,131504962,130542880,962082,77.9559330701541
1747352754072985,137746764,1,1478,75,131598420,130637520,960900,78.05182641273807
1747352754167302,137841404,1,1479,75,131692737,130732160,960577,78.07807182557983
1747352754265817,137936044,1,1480,75,131791252,130826800,964452,77.76436774458449
1747352754360022,138030684,1,1481,75,131885457,130921440,964017,77.7994578933774
1747352754454407,138125332,1,1482,75,131979842,131016088,963754,77.82068868196656
1747352754548381,138219964,1,1483,75,132073816,131110720,963096,77.873856811782
1747352754646564,138314604,1,1484,75,132171999,131205360,966639,77.58842753085692
1747352754740798,138409244,1,1485,75,132266233,131300000,966233,77.62102929624635
1747352754834701,138503884,1,1486,75,132360136,131394640,965496,77.68028039474011
1747352754933750,138598524,1,1487,75,132459185,131489280,969905,77.32716090751155
1747352755027947,138693164,1,1488,75,132553382,131583920,969462,77.36249589978772
1747352755122048,138787804,1,1489,75,132647483,131678560,968923,77.40553170891805
1747352755216261,138882444,1,1490,75,132741696,131773200,968496,77.43965901769342
1747352755313956,138977084,1,1491,75,132839391,131867840,971551,77.19615336714182
1747352755408772,139071724,1,1492,75,132934207,131962480,971727,77.1821715358326
1747352755502295,139166364,1,1493,75,133027730,132057120,970610,77.2709945292136
1747352755597479,139261004,1,1494,75,133122914,132151760,971154,77.22771053818447
1747352755695537,139355644,1,1495,75,133220972,132246400,974572,76.95685901092993
1747352755788962,139450284,1,1496,75,133314397,132341040,973357,77.05292097349688
1747352755883186,139544924,1,1497,75,133408621,132435680,972941,77.08586646055619
1747352755981626,139639564,1,1498,75,133507061,132530320,976741,76.78596475421837
1747352756076206,139734204,1,1499,75,133601641,132624960,976681,76.79068191149413
1747352756169818,139828844,1,1500,75,133695253,132719600,975653,76.87159266665505
