Tempo total receptor,Tempo total emissor,Id do pacote,Id da mensagem,Distancia (m),Tempo zerado receptor,Tempo zerado emissor,Delta tempo,Velocidade (m/s)
1747352400409688,109580,1,1,50,0,0,0,0
1747352400589891,288924,1,3,50,180203,179344,859,58207.217694994186
1747352400671489,377324,1,4,50,261801,267744,-5943,0
1747352400761928,465724,1,5,50,352240,356144,-3904,0
1747352400851490,554124,1,6,50,441802,444544,-2742,0
1747352400941624,642524,1,7,50,531936,532944,-1008,0
1747352401031542,730924,1,8,50,621854,621344,510,98039.2156862745
1747352401118375,819324,1,9,50,708687,709744,-1057,0
1747352401228589,907724,1,10,50,818901,798144,20757,2408.8259382377028
1747352401679229,1370524,1,15,50,1269541,1260944,8597,5815.982319413749
1747352401769466,1461004,1,16,50,1359778,1351424,8354,5985.156811108451
1747352401858946,1551484,1,17,50,1449258,1441904,7354,6799.020940984498
1747352401949840,1641964,1,18,50,1540152,1532384,7768,6436.663233779609
1747352402039263,1732444,1,19,50,1629575,1622864,6711,7450.454477723141
1747352402133515,1822924,1,20,50,1723827,1713344,10483,4769.627015167414
1747352402223528,1913404,1,21,50,1813840,1803824,10016,4992.012779552715
1747352402314275,2003884,1,22,50,1904587,1894304,10283,4862.3942429252165
1747352402408072,2094364,1,23,50,1998384,1984784,13600,3676.470588235294
1747352402498343,2184844,1,24,50,2088655,2075264,13391,3733.8510940183705
1747352402588859,2275324,1,25,50,2179171,2165744,13427,3723.840023832576
1747352402682801,2365804,1,26,50,2273113,2256224,16889,2960.5068387707975
1747352402773017,2456284,1,27,50,2363329,2346704,16625,3007.518796992481
1747352402863271,2546764,1,28,50,2453583,2437184,16399,3048.9664003902676
1747352402952976,2637244,1,29,50,2543288,2527664,15624,3200.2048131080387
1747352403047217,2727724,1,30,50,2637529,2618144,19385,2579.3139025019345
1747352403133159,2818204,1,31,50,2723471,2708624,14847,3367.6837071462246
1747352403227071,2908684,1,32,50,2817383,2799104,18279,2735.379397122381
1747352403317969,2999164,1,33,50,2908281,2889584,18697,2674.225811627534
1747352403416206,3089644,1,34,50,3006518,2980064,26454,1890.073334845392
1747352403497172,3180124,1,35,50,3087484,3070544,16940,2951.59386068477
1747352403592018,3270604,1,36,50,3182330,3161024,21306,2346.7567821271005
1747352403689833,3361084,1,37,50,3280145,3251504,28641,1745.7491009392131
1747352403776575,3451564,1,38,50,3366887,3341984,24903,2007.7902260771793
1747352403866253,3542052,1,39,50,3456565,3432472,24093,2075.291578466775
1747352403960169,3632524,1,40,50,3550481,3522944,27537,1815.7388241275376
1747352404046427,3723004,1,41,50,3636739,3613424,23315,2144.542140253056
1747352404140062,3813484,1,42,50,3730374,3703904,26470,1888.930865130336
1747352404230718,3903964,1,43,50,3821030,3794384,26646,1876.4542520453351
1747352404320899,3994444,1,44,50,3911211,3884864,26347,1897.7492693665313
1747352404419107,4084924,1,45,50,4009419,3975344,34075,1467.3514306676448
1747352404505256,4175404,1,46,50,4095568,4065824,29744,1681.0112963959118
1747352404591437,4265884,1,47,50,4181749,4156304,25445,1965.0225977598743
1747352404685190,4356364,1,48,50,4275502,4246784,28718,1741.068319520858
1747352404783807,4446844,1,49,50,4374119,4337264,36855,1356.6680233346901
1747352404869843,4537324,1,50,50,4460155,4427744,32411,1542.686125080991
1747352404955100,4627804,1,51,50,4545412,4518224,27188,1839.0466382227453
1747352405057607,4718284,1,52,50,4647919,4608704,39215,1275.0223128904756
1747352405156019,4808764,1,53,50,4746331,4699184,47147,1060.5128640210405
1747352405238803,4899244,1,54,50,4829115,4789664,39451,1267.3949963245545
1747352405328587,4989724,1,55,50,4918899,4880144,38755,1290.1561088891756
1747352405426573,5080204,1,56,50,5016885,4970624,46261,1080.8240202330257
1747352405521068,5170684,1,57,50,5111380,5061104,50276,994.5103031267404
1747352405615067,5261164,1,58,50,5205379,5151584,53795,929.4544102611767
1747352405693060,5351644,1,59,50,5283372,5242064,41308,1210.4192892417934
1747352405782871,5442124,1,60,50,5373183,5332544,40639,1230.3452348729054
1747352405869050,5532604,1,61,50,5459362,5423024,36338,1375.9700588915184
1747352405959083,5623084,1,62,50,5549395,5513504,35891,1393.106907024045
1747352406052819,5713564,1,63,50,5643131,5603984,39147,1277.2370807469283
1747352406143843,5804052,1,64,50,5734155,5694472,39683,1259.9853841695435
1747352406237643,5894524,1,65,50,5827955,5784944,43011,1162.493315663435
1747352406331685,5985004,1,66,50,5921997,5875424,46573,1073.583406694866
1747352406418179,6075484,1,67,50,6008491,5965904,42587,1174.0672036067344
1747352406516221,6165964,1,68,50,6106533,6056384,50149,997.0288540150352
1747352406601720,6256444,1,69,50,6192032,6146864,45168,1106.9783917817924
1747352406704854,6346924,1,70,50,6295166,6237344,57822,864.7227698799765
1747352406786050,6437404,1,71,50,6376362,6327824,48538,1030.1207301495735
1747352406880828,6527884,1,72,50,6471140,6418304,52836,946.3244757362404
1747352407159473,6805564,1,75,50,6749785,6695984,53801,929.3507555621643
1747352407253131,6896044,1,76,50,6843443,6786464,56979,877.5162779269555
1747352407360163,6986524,1,77,50,6950475,6876944,73531,679.9853123172539
1747352407445534,7077004,1,78,50,7035846,6967424,68422,730.7591125661337
1747352407531941,7167484,1,79,50,7122253,7057904,64349,777.0128517925687
1747352407609456,7257964,1,80,50,7199768,7148384,51384,973.065545695158
1747352407699899,7348444,1,81,50,7290211,7238864,51347,973.7667244434924
1747352407793598,7438924,1,82,50,7383910,7329344,54566,916.3215188945496
1747352407884199,7529404,1,83,50,7474511,7419824,54687,914.2940735458153
1747352407973757,7619884,1,84,50,7564069,7510304,53765,929.9730307821073
1747352408064193,7710364,1,85,50,7654505,7600784,53721,930.7347219895386
1747352408157870,7800852,1,86,50,7748182,7691272,56910,878.5802143735723
1747352408265419,7891324,1,87,50,7855731,7781744,73987,675.7943963128658
1747352408338791,7981804,1,88,50,7929103,7872224,56879,879.0590551873275
1747352408429237,8072284,1,89,50,8019549,7962704,56845,879.5848359574281
1747352408522886,8162764,1,90,50,8113198,8053184,60014,833.1389342486754
1747352408613389,8253244,1,91,50,8203701,8143664,60037,832.8197611472925
1747352408703360,8343724,1,92,50,8293672,8234144,59528,839.9408681628813
1747352408813208,8434204,1,93,50,8403520,8324624,78896,633.7456905293044
1747352408891286,8524684,1,94,50,8481598,8415104,66494,751.9475441393208
1747352408977187,8615164,1,95,50,8567499,8505584,61915,807.5587498990552
1747352409067623,8705644,1,96,50,8657935,8596064,61871,808.1330510255208
1747352409161854,8796124,1,97,50,8752166,8686544,65622,761.9395934290329
1747352409248005,8886604,1,98,50,8838317,8777024,61293,815.7538381218084
1747352409354317,8977084,1,99,50,8944629,8867504,77125,648.2982171799027
1747352409432384,9067564,1,100,50,9022696,8957984,64712,772.6542217826677
1747352409530371,9159084,1,101,50,9120683,9049504,71179,702.4543755883054
1747352409620815,9250604,1,102,50,9211127,9141024,70103,713.2362381067858
1747352409714547,9342124,1,103,50,9304859,9232544,72315,691.4194842010647
1747352409813564,9433644,1,104,50,9403876,9324064,79812,626.472209692778
1747352409895066,9525164,1,105,50,9485378,9415584,69794,716.3939593661347
1747352409992911,9616684,1,106,50,9583223,9507104,76119,656.8662226251001
1747352410091860,9708204,1,107,50,9682172,9598624,83548,598.4583712356969
1747352410178057,9799724,1,108,50,9768369,9690144,78225,639.1818472355385
1747352410271861,9891244,1,109,50,9862173,9781664,80509,621.048578419804
1747352410362158,9982764,1,110,50,9952470,9873184,79286,630.6283580960069
1747352410464475,10074284,1,111,50,10054787,9964704,90083,555.0436819377685
1747352410558257,10166844,1,112,50,10148569,10057264,91305,547.6151360823613
1747352410636500,10259404,1,113,50,10226812,10149824,76988,649.451862627942
1747352410746731,10351964,1,114,50,10337043,10242384,94659,528.2117918000401
1747352410836968,10444524,1,115,50,10427280,10334944,92336,541.5006064806793
1747352410914495,10537084,1,116,50,10504807,10427504,77303,646.8054279911518
1747352411021801,10629644,1,117,50,10612113,10520064,92049,543.1889537094373
1747352411123289,10722204,1,118,50,10713601,10612624,100977,495.1622646741337
1747352411201800,10814764,1,119,50,10792112,10705184,86928,575.188661881097
1747352411287549,10907324,1,120,50,10877861,10797744,80117,624.0872723641675
1747352411385850,10999884,1,121,50,10976162,10890304,85858,582.3569149060075
1747352411479655,11092444,1,122,50,11069967,10982864,87103,574.0330413418596
1747352411570146,11185004,1,123,50,11160458,11075424,85034,588.0000940800151
1747352411660264,11277564,1,124,50,11250576,11167984,82592,605.3855094924448
1747352411766446,11370124,1,125,50,11356758,11260544,96214,519.6748913879477
1747352411857264,11462692,1,126,50,11447576,11353112,94464,529.3021680216801
1747352411942572,11555244,1,127,50,11532884,11445664,87220,573.2630130703967
1747352412040513,11647804,1,128,50,11630825,11538224,92601,539.9509724517013
1747352412127161,11740364,1,129,50,11717473,11630784,86689,576.7744465849185
1747352412221844,11832924,1,130,50,11812156,11723344,88812,562.9869837409359
1747352412339957,11925484,1,131,50,11930269,11815904,114365,437.1966947929874
1747352412409634,12018044,1,132,50,11999946,11908464,91482,546.5556065674122
1747352412500066,12110604,1,133,50,12090378,12001024,89354,559.57203930434
1747352412594223,12203164,1,134,50,12184535,12093584,90951,549.7465668326901
1747352412700121,12295724,1,135,50,12290433,12186144,104289,479.43694924680455
1747352412782829,12388284,1,136,50,12373141,12278704,94437,529.453498099262
1747352412892891,12480844,1,137,50,12483203,12371264,111939,446.6718480601042
1747352412970931,12573404,1,138,50,12561243,12463824,97419,513.2469025549431
1747352413057270,12665964,1,139,50,12647582,12556384,91198,548.2576372288866
1747352413159259,12758524,1,140,50,12749571,12648944,100627,496.8845339719956
1747352413269995,12851084,1,141,50,12860307,12741504,118803,420.8647929766083
1747352413343402,12943644,1,142,50,12933714,12834064,99650,501.75614651279477
1747352413528067,13131884,1,144,50,13118379,13022304,96075,520.4267499349467
1747352413630709,13224444,1,145,50,13221021,13114864,106157,471.0004992605292
1747352413729066,13317004,1,146,50,13319378,13207424,111954,446.6120013577005
1747352413811030,13409564,1,147,50,13401342,13299984,101358,493.3009727895183
1747352413909257,13502124,1,148,50,13499569,13392544,107025,467.18056528848405
1747352414007468,13594684,1,149,50,13597780,13485104,112676,443.7502218751109
1747352414100939,13687244,1,150,50,13691251,13577664,113587,440.1912190655621
1747352414183688,13779804,1,151,50,13774000,13670224,103776,481.8069688559976
1747352414281951,13872364,1,152,50,13872263,13762784,109479,456.70859251545954
1747352414372175,13964924,1,153,50,13962487,13855344,107143,466.66604444527405
1747352414465624,14057492,1,154,50,14055936,13947912,108024,462.8601051618159
1747352414568536,14150044,1,155,50,14158848,14040464,118384,422.35437221246116
1747352414761119,14338284,1,157,50,14351431,14228704,122727,407.4083127592135
1747352414850330,14430844,1,158,50,14440642,14321264,119378,418.8376417765418
1747352415047826,14619084,1,160,50,14638138,14509504,128634,388.6997216909993
1747352415232001,14807324,1,162,50,14822313,14697744,124569,401.3839719352327
1747352415318219,14899884,1,163,50,14908531,14790304,118227,422.91523932773396
1747352415600474,15183804,1,166,50,15190786,15074224,116562,428.9562636193614
1747352415887834,15467724,1,169,50,15478146,15358144,120002,416.65972233796106
1747352416173604,15751644,1,172,50,15763916,15642064,121852,410.33384761842234
1747352416288248,15844204,1,173,50,15878560,15734624,143936,347.3766118274789
1747352416550920,16128124,1,176,50,16141232,16018544,122688,407.5378195096505
1747352416849558,16412044,1,179,50,16439870,16302464,137406,363.88512874255855
1747352426753414,26263964,1,282,50,26343726,26154384,189342,264.07241922024696
1747352426847250,26356524,1,283,50,26437562,26246944,190618,262.3047141403225
1747352426941602,26449084,1,284,50,26531914,26339504,192410,259.8617535471129
1747352427035687,26541644,1,285,50,26625999,26432064,193935,257.81834119679274
1747352427125423,26634204,1,286,50,26715735,26524624,191111,261.62805908608084
1747352427219906,26726764,1,287,50,26810218,26617184,193034,259.0217267424391
1747352427314478,26819324,1,288,50,26904790,26709744,195046,256.3497841534817
1747352427408053,26911884,1,289,50,26998365,26802304,196061,255.0226715154977
1747352427498234,27004444,1,290,50,27088546,26894864,193682,258.155120248655
1747352427592314,27097004,1,291,50,27182626,26987424,195202,256.1449165479862
1747352427686738,27189564,1,292,50,27277050,27079984,197066,253.72210325474714
1747352427780742,27282124,1,293,50,27371054,27172544,198510,251.87647977431868
1747352427874627,27374684,1,294,50,27464939,27265104,199835,250.2064202967448
1747352427964888,27467244,1,295,50,27555200,27357664,197536,253.11841892110806
1747352428059486,27559804,1,296,50,27649798,27450224,199574,250.5336366460561
1747352428153165,27652364,1,297,50,27743477,27542784,200693,249.1367411917705
1747352428247274,27744924,1,298,50,27837586,27635344,202242,247.22856775546128
1747352428338179,27837484,1,299,50,27928491,27727904,200587,249.26839725405935
1747352428432564,27930044,1,300,50,28022876,27820464,202412,247.02092761298735
1747352428526293,28022604,1,301,50,28116605,27913024,203581,245.602487461993
1747352428620914,28115164,1,302,50,28211226,28005584,205642,243.1409925987882
1747352428710252,28207724,1,303,50,28300564,28098144,202420,247.0111649046537
1747352428804365,28300284,1,304,50,28394677,28190704,203973,245.13048295607754
1747352428899119,28392844,1,305,50,28489431,28283264,206167,242.52183909161022
1747352428993147,28485404,1,306,50,28583459,28375824,207635,240.8071856864209
1747352429083014,28577964,1,307,50,28673326,28468384,204942,243.97146509744218
1747352429177546,28670524,1,308,50,28767858,28560944,206914,241.64628782972636
1747352429271661,28763084,1,309,50,28861973,28653504,208469,239.84381370851304
1747352435243575,34692132,1,371,50,34833887,34582552,251335,198.93767282710328
1747352435337091,34784684,1,372,50,34927403,34675104,252299,198.17755916591028
1747352435431371,34877244,1,373,50,35021683,34767664,254019,196.83566977273355
1747352435526086,34969804,1,374,50,35116398,34860224,256174,195.17983870338128
1747352435906871,35349404,1,378,50,35497183,35239824,257359,194.28114035258142
1747352436001287,35441964,1,379,50,35591599,35332384,259215,192.89007194799686
1747352436090990,35534524,1,380,50,35681302,35424944,256358,195.03974910086677
1747352436185089,35627084,1,381,50,35775401,35517504,257897,193.87584966091114
1747352436280014,35719644,1,382,50,35870326,35610064,260262,192.11410040651344
1747352436372984,35812204,1,383,50,35963296,35702624,260672,191.81193223668058
1747352436463858,35904764,1,384,50,36054170,35795184,258986,193.06062875985575
1747352436557675,35997324,1,385,50,36147987,35887744,260243,192.12812640493692
1747352436652116,36089892,1,386,50,36242428,35980312,262116,190.75523813883927
1747352436746424,36182444,1,387,50,36336736,36072864,263872,189.48581130244966
1747352436840995,36275004,1,388,50,36431307,36165424,265883,188.0526396949034
1747352436931000,36367564,1,389,50,36521312,36257984,263328,189.87726333697898
1747352437024551,36460124,1,390,50,36614863,36350544,264319,189.16536457840712
1747352437119853,36552684,1,391,50,36710165,36443104,267061,187.22314377614103
1747352437212776,36645244,1,392,50,36803088,36535664,267424,186.96900801723106
1747352437303214,36737804,1,393,50,36893526,36628224,265302,188.4644669094089
1747352437397603,36830364,1,394,50,36987915,36720784,267131,187.1740831277538
1747352437492312,36922924,1,395,50,37082624,36813344,269280,185.68033273915626
1747352437586546,37015484,1,396,50,37176858,36905904,270954,184.53316799161482
1747352437676445,37108044,1,397,50,37266757,36998464,268293,186.36341611596276
1747352437770421,37200604,1,398,50,37360733,37091024,269709,185.38498900667017
1747352437863971,37293164,1,399,50,37454283,37183584,270699,184.70699928703095
1747352437958579,37385724,1,400,50,37548891,37276144,272747,183.3200731813732
1747352438048662,37478284,1,401,50,37638974,37368704,270270,185.00018500018498
1747352438142929,37570844,1,402,50,37733241,37461264,271977,183.83907462763395
1747352438236989,37663404,1,403,50,37827301,37553824,273477,182.8307316520219
1747352438332218,37755964,1,404,50,37922530,37646384,276146,181.06364024827445
1747352438425500,37848524,1,405,50,38015812,37738944,276868,180.59147319300172
1747352438515676,37941084,1,406,50,38105988,37831504,274484,182.15998018099415
1747352438610328,38033644,1,407,50,38200640,37924064,276576,180.7821358324656
1747352438704086,38126204,1,408,50,38294398,38016624,277774,180.00244803329323
1747352438799036,38218772,1,409,50,38389348,38109192,280156,178.4719941746741
1747352438888162,38311324,1,410,50,38478474,38201744,276730,180.68153073392838
1747352438982768,38403884,1,411,50,38573080,38294304,278776,179.35546818951414
1747352439076891,38496444,1,412,50,38667203,38386864,280339,178.35549103050235
1747352439171264,38589004,1,413,50,38761576,38479424,282152,177.20944739005924
1747352439260845,38681564,1,414,50,38851157,38571984,279173,179.100414438359
1747352439355131,38774124,1,415,50,38945443,38664544,280899,177.99992168003445
1747352439449692,38866684,1,416,50,39040004,38757104,282900,176.74089784376105
1747352439543431,38959244,1,417,50,39133743,38849664,284079,176.00737822929537
1747352439638152,39051804,1,418,50,39228464,38942224,286240,174.678591391839
1747352439728145,39144364,1,419,50,39318457,39034784,283673,176.2592844578088
1747352439822159,39236924,1,420,50,39412471,39127344,285127,175.36045341198832
1747352439917021,39329484,1,421,50,39507333,39219904,287429,173.95600304770917
1747352440010883,39422044,1,422,50,39601195,39312464,288731,173.1715679992796
1747352440100813,39514604,1,423,50,39691125,39405024,286101,174.76345766005713
1747352440195049,39607164,1,424,50,39785361,39497584,287777,173.74564332799355
1747352440288863,39699724,1,425,50,39879175,39590144,289031,172.99182440637856
1747352440383803,39792284,1,426,50,39974115,39682704,291411,171.57897265374336
1747352440473554,39884844,1,427,50,40063866,39775264,288602,173.24897263359227
1747352440567925,39977404,1,428,50,40158237,39867824,290413,172.1686012678496
1747352440661639,40069964,1,429,50,40251951,39960384,291567,171.48717104473414
1747352440756127,40162524,1,430,50,40346439,40052944,293495,170.36065350346684
1747352440846524,40255084,1,431,50,40436836,40145504,291332,171.62549943020335
1747352440939951,40347644,1,432,50,40530263,40238064,292199,171.1162598092396
1747352441035221,40440204,1,433,50,40625533,40330624,294909,169.54382538342338
1747352441129172,40532764,1,434,50,40719484,40423184,296300,168.74789065136684
1747352441223465,40625324,1,435,50,40813777,40515744,298033,167.76665671251172
1747352441312790,40717884,1,436,50,40903102,40608304,294798,169.60766355266995
1747352441407670,40810444,1,437,50,40997982,40700864,297118,168.28330831521484
1747352441501416,40903004,1,438,50,41091728,40793424,298304,167.61424586998498
1747352441595841,40995564,1,439,50,41186153,40885984,300169,166.57283063874016
1747352441685504,41088124,1,440,50,41275816,40978544,297272,168.19613014343767
1747352441779930,41180684,1,441,50,41370242,41071104,299138,167.14693552808401
1747352441874352,41273244,1,442,50,41464664,41163664,301000,166.11295681063123
1747352441968423,41365804,1,443,50,41558735,41256224,302511,165.28324589849626
1747352442059063,41458364,1,444,50,41649375,41348784,300591,166.33897887827646
1747352442152490,41550924,1,445,50,41742802,41441344,301458,165.86058422732188
1747352442246637,41643484,1,446,50,41836949,41533904,303045,164.99199788810242
1747352442341102,41736044,1,447,50,41931414,41626464,304950,163.96130513198884
1747352442431106,41828604,1,448,50,42021418,41719024,302394,165.34719604224952
1747352442525917,41921164,1,449,50,42116229,41811584,304645,164.12545749971278
1747352442620026,42013732,1,450,50,42210338,41904152,306186,163.29943237117308
1747352442713393,42106284,1,451,50,42303705,41996704,307001,162.86591900352116
1747352442808169,42198844,1,452,50,42398481,42089264,309217,161.69874230718233
1747352442898643,42291404,1,453,50,42488955,42181824,307131,162.79698239513434
1747352442992790,42383964,1,454,50,42583102,42274384,308718,161.96010598669335
1747352443086517,42476524,1,455,50,42676829,42366944,309885,161.350178291947
1747352443180816,42569084,1,456,50,42771128,42459504,311624,160.4497728031217
1747352443271336,42661644,1,457,50,42861648,42552064,309584,161.50705462814614
1747352443365494,42754204,1,458,50,42955806,42644624,311182,160.677674158531
1747352443458908,42846764,1,459,50,43049220,42737184,312036,160.237921265495
1747352443552961,42939324,1,460,50,43143273,42829744,313529,159.47488111147612
1747352443643175,43031884,1,461,50,43233487,42922304,311183,160.67715781389086
1747352443738301,43124444,1,462,50,43328613,43014864,313749,159.3630577308613
1747352443831832,43217004,1,463,50,43422144,43107424,314720,158.8713777325877
1747352443925913,43309564,1,464,50,43516225,43199984,316241,158.10726629374432
1747352444016101,43402124,1,465,50,43606413,43292544,313869,159.30212923225932
1747352444110705,43494684,1,466,50,43701017,43385104,315913,158.27142282843695
1747352444204702,43587244,1,467,50,43795014,43477664,317350,157.5547502757208
1747352444299234,43679804,1,468,50,43889546,43570224,319322,156.5817575989127
1747352444393125,43772364,1,469,50,43983437,43662784,320653,155.9318016672228
1747352444483717,43864924,1,470,50,44074029,43755344,318685,156.89473931939062
1747352444577782,43957484,1,471,50,44168094,43847904,320190,156.15728161404166
1747352444671976,44050044,1,472,50,44262288,43940464,321824,155.36442279009646
1747352444765510,44142612,1,473,50,44355822,44033032,322790,154.89947024381175
1747352444856336,44235164,1,474,50,44446648,44125584,321064,155.73219046669823
1747352444949635,44327724,1,475,50,44539947,44218144,321803,155.3745614553003
1747352445043987,44420284,1,476,50,44634299,44310704,323595,154.5141303172175
1747352445138483,44512844,1,477,50,44728795,44403264,325531,153.59520291462258
1747352445228344,44605404,1,478,50,44818656,44495824,322832,154.87931803538683
1747352445322905,44697964,1,479,50,44913217,44588384,324833,153.92524774268625
1747352445417520,44790524,1,480,50,45007832,44680944,326888,152.95758792002152
1747352445511509,44883084,1,481,50,45101821,44773504,328317,152.29183989863455
1747352445601217,44975644,1,482,50,45191529,44866064,325465,153.62634999155054
1747352445695258,45068204,1,483,50,45285570,44958624,326946,152.9304533470359
1747352445789423,45160764,1,484,50,45379735,45051184,328551,152.18337487939468
1747352445883969,45253324,1,485,50,45474281,45143744,330537,151.26899560412298
1747352445978154,45345884,1,486,50,45568466,45236304,332162,150.52895876108644
1747352446067714,45438444,1,487,50,45658026,45328864,329162,151.90088770878776
1747352446162942,45531004,1,488,50,45753254,45421424,331830,150.67956483741673
1747352446257035,45623564,1,489,50,45847347,45513984,333363,149.98665118804425
1747352446350513,45716124,1,490,50,45940825,45606544,334281,149.57475896027594
1747352446441364,45808684,1,491,50,46031676,45699104,332572,150.34338428971773
1747352446535346,45901244,1,492,50,46125658,45791664,333994,149.70328808301946
1747352446629348,45993804,1,493,50,46219660,45884224,335436,149.05973121549266
1747352446723438,46086364,1,494,50,46313750,45976784,336966,148.38292290616857
1747352446813922,46178924,1,495,50,46404234,46069344,334890,149.30275612887812
1747352446907390,46271484,1,496,50,46497702,46161904,335798,148.89904049458306
1747352447002052,46364044,1,497,50,46592364,46254464,337900,147.9727730097662
1747352447096617,46456604,1,498,50,46686929,46347024,339905,147.09992497903826
1747352447186415,46549164,1,499,50,46776727,46439584,337143,148.3050219046517
1747352447280971,46641724,1,500,50,46871283,46532144,339139,147.43217382843022
1747352447375151,46734284,1,501,50,46965463,46624704,340759,146.7312675527279
1747352447469427,46826844,1,502,50,47059739,46717264,342475,145.99605810643115
1747352447563654,46919404,1,503,50,47153966,46809824,344142,145.28886331804895
1747352447653751,47011964,1,504,50,47244063,46902384,341679,146.33618103541627
1747352447747518,47104524,1,505,50,47337830,46994944,342886,145.8210600607782
1747352447841676,47197084,1,506,50,47431988,47087504,344484,145.1446221014619
1747352447935473,47289644,1,507,50,47525785,47180064,345721,144.62529033527034
1747352448026210,47382204,1,508,50,47616522,47272624,343898,145.39194761237346
1747352448120154,47474764,1,509,50,47710466,47365184,345282,144.80917047514785
1747352448214516,47567324,1,510,50,47804828,47457744,347084,144.05734634843438
1747352448308224,47659884,1,511,50,47898536,47550304,348232,143.58243929334466
1747352448399034,47752444,1,512,50,47989346,47642864,346482,144.30764080096512
1747352448492747,47845004,1,513,50,48083059,47735424,347635,143.8290160657011
1747352448587349,47937572,1,514,50,48177661,47827992,349669,142.99237278683555
1747352448681750,48030124,1,515,50,48272062,47920544,351518,142.24022667402522
1747352448771494,48122684,1,516,50,48361806,48013104,348702,143.38891087518854
1747352448865530,48215244,1,517,50,48455842,48105664,350178,142.7845267264077
1747352448959845,48307804,1,518,50,48550157,48198224,351933,142.07249675364346
1747352449054383,48400364,1,519,50,48644695,48290784,353911,141.2784570132039
1747352449148655,48492924,1,520,50,48738967,48383344,355623,140.5983302542299
1747352449238647,48585484,1,521,50,48828959,48475904,353055,141.62099389613516
1747352449332177,48678044,1,522,50,48922489,48568464,354025,141.2329637737448
1747352449426534,48770604,1,523,50,49016846,48661024,355822,140.51969805127283
1747352449520788,48863164,1,524,50,49111100,48753584,357516,139.85388066548072
1747352449610899,48955724,1,525,50,49201211,48846144,355067,140.81849341110268
1747352449705179,49048284,1,526,50,49295491,48938704,356787,140.13963513244596
1747352449799901,49140844,1,527,50,49390213,49031264,358949,139.29555452167298
1747352449893229,49233404,1,528,50,49483541,49123824,359717,138.9981568844397
1747352449983425,49325964,1,529,50,49573737,49216384,357353,139.91767244153542
1747352450078366,49418524,1,530,50,49668678,49308944,359734,138.99158822908038
1747352450172022,49511084,1,531,50,49762334,49401504,360830,138.56940941717707
1747352450266698,49603644,1,532,50,49857010,49494064,362946,137.76154028422962
1747352450360719,49696204,1,533,50,49951031,49586624,364407,137.20921936186738
1747352450450941,49788764,1,534,50,50041253,49679184,362069,138.09522494331193
1747352450545127,49881324,1,535,50,50135439,49771744,363695,137.47783169963844
1747352450639126,49973884,1,536,50,50229438,49864304,365134,136.93602896470884
1747352450733530,50066452,1,537,50,50323842,49956872,366970,136.2509196937079
1747352450823339,50159004,1,538,50,50413651,50049424,364227,137.27702778761596
1747352450917665,50251564,1,539,50,50507977,50141984,365993,136.61463470612824
1747352451011924,50344124,1,540,50,50602236,50234544,367692,135.9833773919476
1747352451105877,50436684,1,541,50,50696189,50327104,369085,135.4701491526342
1747352451195920,50529244,1,542,50,50786232,50419664,366568,136.40034045524976
1747352451289946,50621804,1,543,50,50880258,50512224,368034,135.85701321073597
1747352451384227,50714364,1,544,50,50974539,50604784,369755,135.22467579883977
1747352451478778,50806924,1,545,50,51069090,50697344,371746,134.50043847142942
1747352451569175,50899484,1,546,50,51159487,50789904,369583,135.28760792568923
1747352451663249,50992044,1,547,50,51253561,50882464,371097,134.73566210451713
1747352451757558,51084604,1,548,50,51347870,50975024,372846,134.10362455276442
1747352451851324,51177164,1,549,50,51441636,51067584,374052,133.671254264113
1747352451945787,51269724,1,550,50,51536099,51160144,375955,132.99464031599527
1747352452035846,51362284,1,551,50,51626158,51252704,373454,133.88529778767935
1747352452129532,51454844,1,552,50,51719844,51345264,374580,133.48283410753376
1747352452224094,51547404,1,553,50,51814406,51437824,376582,132.77320742892653
1747352452317824,51639964,1,554,50,51908136,51530384,377752,132.3619729346238
1747352452408501,51732524,1,555,50,51998813,51622944,375869,133.02506990467424
1747352452502912,51825084,1,556,50,52093224,51715504,377720,132.37318648734512
1747352452596862,51917644,1,557,50,52187174,51808064,379110,131.8878425786711
1747352452691074,52010204,1,558,50,52281386,51900624,380762,131.31562498358556
1747352452781104,52102764,1,559,50,52371416,51993184,378232,132.193997334969
1747352452874943,52195324,1,560,50,52465255,52085744,379511,131.7484868686283
1747352452969083,52287884,1,561,50,52559395,52178304,381091,131.20225877808713
1747352453064102,52380444,1,562,50,52654414,52270864,383550,130.3611002476861
1747352453153939,52473004,1,563,50,52744251,52363424,380827,131.29321187835944
1747352453248465,52565564,1,564,50,52838777,52455984,382793,130.61889846470547
1747352453341904,52658124,1,565,50,52932216,52548544,383672,130.3196480326946
1747352453435980,52750684,1,566,50,53026292,52641104,385188,129.80674371994974
1747352453530049,52843244,1,567,50,53120361,52733664,386697,129.30020144971385
1747352453621058,52935804,1,568,50,53211370,52826224,385146,129.82089908761873
1747352453714979,53028364,1,569,50,53305291,52918784,386507,129.36376314012423
1747352453808791,53120924,1,570,50,53399103,53011344,387759,128.9460721736955
1747352453903316,53213484,1,571,50,53493628,53103904,389724,128.29592224240744
1747352453993495,53306044,1,572,50,53583807,53196464,387343,129.08455813064907
1747352454088129,53398604,1,573,50,53678441,53289024,389417,128.3970653566742
1747352454181929,53491164,1,574,50,53772241,53381584,390657,127.9895150989231
1747352454275948,53583724,1,575,50,53866260,53474144,392116,127.51328688449335
1747352454366598,53676284,1,576,50,53956910,53566704,390206,128.13744534937956
1747352454459969,53768844,1,577,50,54050281,53659264,391017,127.87167821347921
1747352454554512,53861412,1,578,50,54144824,53751832,392992,127.22905300871264
1747352454648284,53953964,1,579,50,54238596,53844384,394212,126.83530689070855
1747352454739263,54046524,1,580,50,54329575,53936944,392631,127.34603227967226
1747352454833697,54139084,1,581,50,54424009,54029504,394505,126.74110594289046
1747352454927374,54231644,1,582,50,54517686,54122064,395622,126.3832648336038
1747352455021120,54324204,1,583,50,54611432,54214624,396808,126.00552408217577
1747352455115357,54416764,1,584,50,54705669,54307184,398485,125.4752374618869
1747352455205801,54509324,1,585,50,54796113,54399744,396369,126.14508198168878
1747352455299732,54601884,1,586,50,54890044,54492304,397740,125.71026298587017
1747352455393998,54694444,1,587,50,54984310,54584864,399446,125.17336511067828
1747352455488314,54787004,1,588,50,55078626,54677424,401202,124.62550037138399
1747352455578169,54879564,1,589,50,55168481,54769984,398497,125.47145900721964
1747352455673066,54972124,1,590,50,55263378,54862544,400834,124.73991727248686
1747352455766754,55064684,1,591,50,55357066,54955104,401962,124.38986769893673
1747352455860859,55157244,1,592,50,55451171,55047664,403507,123.91358762053694
1747352455951530,55249804,1,593,50,55541842,55140224,401618,124.49641201340579
1747352456045583,55342364,1,594,50,55635895,55232784,403111,124.03531533498217
1747352456139777,55434924,1,595,50,55730089,55325344,404745,123.53457114973625
1747352456233759,55527484,1,596,50,55824071,55417904,406167,123.10207377753486
1747352456323663,55620044,1,597,50,55913975,55510464,403511,123.91235926653796
1747352456418134,55712604,1,598,50,56008446,55603024,405422,123.32828509553009
1747352456512619,55805164,1,599,50,56102931,55695584,407347,122.7454725332456
1747352456606650,55897724,1,600,50,56196962,55788144,408818,122.30381245444183
1747352456700974,55990292,1,601,50,56291286,55880712,410574,121.78072649510199
1747352456790491,56082844,1,602,50,56380803,55973264,407539,122.6876446180611
1747352456885317,56175404,1,603,50,56475629,56065824,409805,122.00924830102123
1747352456979338,56267964,1,604,50,56569650,56158384,411266,121.5758171110668
1747352457073482,56360524,1,605,50,56663794,56250944,412850,121.10936175366356
1747352457163571,56453084,1,606,50,56753883,56343504,410379,121.83859310539769
1747352457257861,56545644,1,607,50,56848173,56436064,412109,121.32712461994278
1747352457352079,56638204,1,608,50,56942391,56528624,413767,120.8409563836652
1747352457446086,56730764,1,609,50,57036398,56621184,415214,120.41983170124321
1747352457535970,56823324,1,610,50,57126282,56713744,412538,121.20095603314118
1747352457629881,56915884,1,611,50,57220193,56806304,413889,120.80533669655391
1747352457724717,57008444,1,612,50,57315029,56898864,416165,120.14465416361298
1747352457818698,57101004,1,613,50,57409010,56991424,417586,119.73581489800902
1747352457909419,57193564,1,614,50,57499731,57083984,415747,120.26544990102154
1747352458002628,57286124,1,615,50,57592940,57176544,416396,120.07800267053479
1747352458097037,57378684,1,616,50,57687349,57269104,418245,119.54715537543785
1747352458191709,57471244,1,617,50,57782021,57361664,420357,118.94651451028531
1747352458285642,57563804,1,618,50,57875954,57454224,421730,118.5592677779622
1747352458375781,57656364,1,619,50,57966093,57546784,419309,119.24380349575135
1747352458470424,57748924,1,620,50,58060736,57639344,421392,118.6543645821468
1747352458564203,57841484,1,621,50,58154515,57731904,422611,118.3121120841625
1747352458658525,57934044,1,622,50,58248837,57824464,424373,117.82087927365784
1747352458748888,58026604,1,623,50,58339200,57917024,422176,118.43401803986963
1747352458843099,58119164,1,624,50,58433411,58009584,423827,117.97266337444287
1747352458936786,58211724,1,625,50,58527098,58102144,424954,117.65979376591349
1747352459031356,58304284,1,626,50,58621668,58194704,426964,117.10589183162983
1747352459121322,58396844,1,627,50,58711634,58287264,424370,117.82171218512147
1747352459215500,58489404,1,628,50,58805812,58379824,425988,117.37419833422538
1747352459309790,58581964,1,629,50,58900102,58472384,427718,116.89945244296476
1747352459403636,58674524,1,630,50,58993948,58564944,429004,116.54902984587557
1747352459493659,58767084,1,631,50,59083971,58657504,426467,117.24236576335332
1747352459588047,58859644,1,632,50,59178359,58750064,428295,116.74196523424276
1747352459682628,58952204,1,633,50,59272940,58842624,430316,116.1936809228567
1747352459776845,59044764,1,634,50,59367157,58935184,431973,115.74797498917756
1747352459870732,59137324,1,635,50,59461044,59027744,433300,115.39349180706208
1747352459960829,59229884,1,636,50,59551141,59120304,430837,116.05317092078906
1747352460054755,59322444,1,637,50,59645067,59212864,432203,115.68637885438093
1747352460148774,59415004,1,638,50,59739086,59305424,433662,115.2971669180145
1747352460243655,59507564,1,639,50,59833967,59397984,435983,114.68337068188438
1747352460333779,59600124,1,640,50,59924091,59490544,433547,115.32774993253327
1747352460427681,59692684,1,641,50,60017993,59583104,434889,114.97186638429575
1747352460522061,59785252,1,642,50,60112373,59675672,436701,114.49481452984995
1747352460616216,59877804,1,643,50,60206528,59768224,438304,114.07607505293129
1747352460706089,59970364,1,644,50,60296401,59860784,435617,114.779726227397
1747352460800986,60062924,1,645,50,60391298,59953344,437954,114.16724130844791
1747352460894468,60155484,1,646,50,60484780,60045904,438876,113.9273963488548
1747352460988631,60248044,1,647,50,60578943,60138464,440479,113.51278948599139
1747352461083303,60340604,1,648,50,60673615,60231024,442591,112.97111780402221
1747352461172859,60433164,1,649,50,60763171,60323584,439587,113.7431270715467
1747352461267654,60525724,1,650,50,60857966,60416144,441822,113.16774628696625
1747352461361665,60618284,1,651,50,60951977,60508704,443273,112.79730549796628
1747352461455538,60710844,1,652,50,61045850,60601264,444586,112.46418015861948
1747352461546528,60803404,1,653,50,61136840,60693824,443016,112.86274084908896
1747352461640140,60895964,1,654,50,61230452,60786384,444068,112.59536827693056
1747352461734129,60988524,1,655,50,61324441,60878944,445497,112.23420135264661
1747352461828808,61081084,1,656,50,61419120,60971504,447616,111.70288818987703
1747352461918962,61173644,1,657,50,61509274,61064064,445210,112.30655196424159
1747352462012938,61266204,1,658,50,61603250,61156624,446626,111.95049101485358
1747352462106912,61358764,1,659,50,61697224,61249184,448040,111.59717882331935
1747352462201124,61451324,1,660,50,61791436,61341744,449692,111.18721258105548
1747352462291825,61543884,1,661,50,61882137,61434304,447833,111.648761926879
1747352462386005,61636444,1,662,50,61976317,61526864,449453,111.24633721434722
1747352462480332,61729004,1,663,50,62070644,61619424,451220,110.81069101546917
1747352462574211,61821564,1,664,50,62164523,61711984,452539,110.4877148709835
1747352462668654,61914132,1,665,50,62258966,61804552,454414,110.03182120269182
1747352462758848,62006684,1,666,50,62349160,61897104,452056,110.60576565735218
1747352462852602,62099244,1,667,50,62442914,61989664,453250,110.31439602868174
1747352462947241,62191804,1,668,50,62537553,62082224,455329,109.81070830103069
1747352463041083,62284364,1,669,50,62631395,62174784,456611,109.50239919756642
1747352463131581,62376924,1,670,50,62721893,62267344,454549,109.99914200669235
1747352463225062,62469484,1,671,50,62815374,62359904,455470,109.77671416339166
1747352463319108,62562044,1,672,50,62909420,62452464,456956,109.41972531272158
1747352463413328,62654604,1,673,50,63003640,62545024,458616,109.02367121949517
1747352463504045,62747164,1,674,50,63094357,62637584,456773,109.46356286382952
1747352463598376,62839724,1,675,50,63188688,62730144,458544,109.04078997871524
1747352463692652,62932284,1,676,50,63282964,62822704,460260,108.63425020640507
1747352463786560,63024844,1,677,50,63376872,62915264,461608,108.31701356995545
1747352463876069,63117404,1,678,50,63466381,63007824,458557,109.03769869394645
1747352463970354,63209964,1,679,50,63560666,63100384,460282,108.62905783845555
1747352464063890,63302524,1,680,50,63654202,63192944,461258,108.39920391624644
1747352464159305,63395084,1,681,50,63749617,63285504,464113,107.73238413920748
1747352464252818,63487644,1,682,50,63843130,63378064,465066,107.5116220063389
1747352464342832,63580204,1,683,50,63933144,63470624,462520,108.10343336504367
1747352464437396,63672764,1,684,50,64027708,63563184,464524,107.63706503862018
1747352464531615,63765324,1,685,50,64121927,63655744,466183,107.25401827179455
1747352464625610,63857884,1,686,50,64215922,63748304,467618,106.92488313110275
1747352464716083,63950444,1,687,50,64306395,63840864,465531,107.40423301563162
1747352464810734,64043004,1,688,50,64401046,63933424,467622,106.92396850447584
1747352464904728,64135564,1,689,50,64495040,64025984,469056,106.59708009278211
1747352464998902,64228124,1,690,50,64589214,64118544,470670,106.23154226953068
1747352465089069,64320684,1,691,50,64679381,64211104,468277,106.7744091638069
1747352465182385,64413244,1,692,50,64772697,64303664,469033,106.60230730033922
1747352465277415,64505804,1,693,50,64867727,64396224,471503,106.0438639838983
1747352465371399,64598364,1,694,50,64961711,64488784,472927,105.7245621417259
1747352465461104,64690924,1,695,50,65051416,64581344,470072,106.36668425262513
1747352465555812,64783484,1,696,50,65146124,64673904,472220,105.88285121341748
1747352465649994,64876044,1,697,50,65240306,64766464,473842,105.52040553602257
1747352465743667,64968604,1,698,50,65333979,64859024,474955,105.27313113873946
1747352465838211,65061164,1,699,50,65428523,64951584,476939,104.8352095341333
1747352465928213,65153724,1,700,50,65518525,65044144,474381,105.40051140328133
1747352466022754,65246284,1,701,50,65613066,65136704,476362,104.96219261821892
1747352466116574,65338844,1,702,50,65706886,65229264,477622,104.68529506597268
1747352466210252,65431404,1,703,50,65800564,65321824,478740,104.44082382921836
1747352466300747,65523964,1,704,50,65891059,65414384,476675,104.89327109665915
1747352466395118,65616524,1,705,50,65985430,65506944,478486,104.49626530347805
1747352466489128,65709092,1,706,50,66079440,65599512,479928,104.18229401076827
1747352466583245,65801644,1,707,50,66173557,65692064,481493,103.84366958605837
1747352466673978,65894204,1,708,50,66264290,65784624,479666,104.23919977651116
1747352466768202,65986764,1,709,50,66358514,65877184,481330,103.87883572600919
1747352466861883,66079324,1,710,50,66452195,65969744,482451,103.6374678464756
1747352466956254,66171884,1,711,50,66546566,66062304,484262,103.24989365260953
1747352467046833,66264444,1,712,50,66637145,66154864,482281,103.67399918304888
1747352467140829,66357004,1,713,50,66731141,66247424,483717,103.3662244659584
1747352467235345,66449564,1,714,50,66825657,66339984,485673,102.94992721440146
1747352467328803,66542124,1,715,50,66919115,66432544,486571,102.75992609506116
1747352467423534,66634684,1,716,50,67013846,66525104,488742,102.30346481374632
1747352467513281,66727244,1,717,50,67103593,66617664,485929,102.89569052268953
1747352467607803,66819804,1,718,50,67198115,66710224,487891,102.48190681935104
1747352467701808,66912364,1,719,50,67292120,66802784,489336,102.17927967694999
1747352467795703,67004924,1,720,50,67386015,66895344,490671,101.90127396972717
1747352467885614,67097484,1,721,50,67475926,66987904,488022,102.45439754765154
1747352467980270,67190044,1,722,50,67570582,67080464,490118,102.01624914816432
1747352468074889,67282604,1,723,50,67665201,67173024,492177,101.58946882930329
1747352468168270,67375164,1,724,50,67758582,67265584,492998,101.42028973748373
1747352468258967,67467724,1,725,50,67849279,67358144,491135,101.80500269783258
1747352468353418,67560284,1,726,50,67943730,67450704,493026,101.41452986252246
1747352468447226,67652844,1,727,50,68037538,67543264,494274,101.158466761351
1747352468541686,67745404,1,728,50,68131998,67635824,496174,100.77110046072546
1747352468631707,67837972,1,729,50,68222019,67728392,493627,101.291055797191
1747352468726194,67930524,1,730,50,68316506,67820944,495562,100.89554889196508
1747352468819805,68023084,1,731,50,68410117,67913504,496613,100.68202000350372
1747352468914422,68115644,1,732,50,68504734,68006064,498670,100.26670944712936
1747352469008006,68208204,1,733,50,68598318,68098624,499694,100.06123747733612
1747352469098029,68300764,1,734,50,68688341,68191184,497157,100.57185154790136
1747352469192481,68393324,1,735,50,68782793,68283744,499049,100.19056244977948
1747352469286511,68485884,1,736,50,68876823,68376304,500519,99.89630763267728
1747352469380907,68578444,1,737,50,68971219,68468864,502355,99.53120801027163
1747352469471526,68671004,1,738,50,69061838,68561424,500414,99.91726850168061
1747352469565162,68763564,1,739,50,69155474,68653984,501490,99.70288540150352
1747352469659463,68856124,1,740,50,69249775,68746544,503231,99.35794893398857
1747352470257381,69430204,1,746,50,69847693,69320624,527069,94.86423978644162
1747352470335067,69525884,1,747,50,69925379,69416304,509075,98.21735500662966
1747352470425321,69618444,1,748,50,70015633,69508864,506769,98.66428293759088
1747352470519646,69711004,1,749,50,70109958,69601424,508534,98.32184278730625
1747352470613896,69803564,1,750,50,70204208,69693984,510224,97.99617422935809
1747352470707968,69896124,1,751,50,70298280,69786544,511736,97.706629981084
1747352470798242,69988684,1,752,50,70388554,69879104,509450,98.14505839630975
1747352470892795,70081244,1,753,50,70483107,69971664,511443,97.76260502147845
1747352470987015,70173804,1,754,50,70577327,70064224,513103,97.44632169369503
1747352471080796,70266364,1,755,50,70671108,70156784,514324,97.21498510666429
1747352471174804,70358924,1,756,50,70765116,70249344,515772,96.94205966977657
1747352471264792,70451484,1,757,50,70855104,70341904,513200,97.42790335151987
1747352471358692,70544044,1,758,50,70949004,70434464,514540,97.17417499125432
1747352471555674,70732284,1,760,50,71145986,70622704,523282,95.55077377016599
1747352471646283,70827964,1,761,50,71236595,70718384,518211,96.485794396491
1747352471740596,70923644,1,762,50,71330908,70814064,516844,96.74098954423386
1747352471834381,71016204,1,763,50,71424693,70906624,518069,96.51224064748132
1747352471928408,71108764,1,764,50,71518720,70999184,519536,96.23972159773336
1747352472023125,71201324,1,765,50,71613437,71091744,521693,95.84180734646623
1747352472113309,71293884,1,766,50,71703621,71184304,519317,96.28030663352057
1747352472207016,71386444,1,767,50,71797328,71276864,520464,96.06812382796888
1747352472301480,71479004,1,768,50,71891792,71369424,522368,95.717961283999
1747352472395268,71571564,1,769,50,71985580,71461984,523596,95.49347206624957
1747352472489267,71664124,1,770,50,72079579,71554544,525035,95.23174645499823
1747352472579631,71756684,1,771,50,72169943,71647104,522839,95.63173366944699
1747352472673429,71849244,1,772,50,72263741,71739664,524077,95.40582776958347
1747352472767647,71941804,1,773,50,72357959,71832224,525735,95.1049483104606
1747352472862743,72034364,1,774,50,72453055,71924784,528271,94.64839069341303
1747352472952652,72126924,1,775,50,72542964,72017344,525620,95.12575624976219
1747352473047100,72219484,1,776,50,72637412,72109904,527508,94.78529235575574
1747352473140902,72312044,1,777,50,72731214,72202464,528750,94.5626477541371
1747352473234842,72404604,1,778,50,72825154,72295024,530130,94.31648840850357
1747352473325026,72497172,1,779,50,72915338,72387592,527746,94.74254660385867
1747352473419026,72589724,1,780,50,73009338,72480144,529194,94.48330857870647
1747352473513204,72682284,1,781,50,73103516,72572704,530812,94.1953083200832
1747352473607222,72774844,1,782,50,73197534,72665264,532270,93.9372874668871
1747352473698179,72867404,1,783,50,73288491,72757824,530667,94.22104634356386
1747352473792079,72959964,1,784,50,73382391,72850384,532007,93.98372577804427
1747352473886547,73052524,1,785,50,73476859,72942944,533915,93.64786529691055
1747352473980271,73145084,1,786,50,73570583,73035504,535079,93.44414563083208
1747352474074670,73237644,1,787,50,73664982,73128064,536918,93.12408971202306
1747352474165100,73330204,1,788,50,73755412,73220624,534788,93.49499240820661
1747352474259037,73422764,1,789,50,73849349,73313184,536165,93.25487489858533
1747352474353300,73515324,1,790,50,73943612,73405744,537868,92.95961090825259
1747352474447221,73607884,1,791,50,74037533,73498304,539229,92.72498326314053
1747352474537752,73700444,1,792,50,74128064,73590864,537200,93.07520476545048
1747352474631863,73793004,1,793,50,74222175,73683424,538751,92.80725232992607
1747352474725489,73885564,1,794,50,74315801,73775984,539817,92.62398183087973
1747352474819651,73978124,1,795,50,74409963,73868544,541419,92.34991753152364
1747352474909683,74070684,1,796,50,74499995,73961104,538891,92.78314167429035
1747352475004362,74163244,1,797,50,74594674,74053664,541010,92.4197334614887
1747352475098798,74255804,1,798,50,74689110,74146224,542886,92.10036729626478
1747352475192423,74348364,1,799,50,74782735,74238784,543951,91.92004426869333
1747352475287042,74440924,1,800,50,74877354,74331344,546010,91.57341440632956
1747352475377068,74533484,1,801,50,74967380,74423904,543476,92.00038272159213
1747352475471126,74626044,1,802,50,75061438,74516464,544974,91.74749621082842
1747352475565438,74718604,1,803,50,75155750,74609024,546726,91.45348858477554
1747352475660146,74811164,1,804,50,75250458,74701584,548874,91.09558842284386
1747352475750179,74903724,1,805,50,75340491,74794144,546347,91.51692971682832
1747352475844363,74996284,1,806,50,75434675,74886704,547971,91.24570460845555
1747352475937988,75088844,1,807,50,75528300,74979264,549036,91.06870951995862
1747352476032705,75181404,1,808,50,75623017,75071824,551193,90.71232762389943
1747352476122711,75273964,1,809,50,75713023,75164384,548639,91.13460763817373
1747352476216889,75366524,1,810,50,75807201,75256944,550257,90.86663141041367
1747352476311100,75459084,1,811,50,75901412,75349504,551908,90.5948092798075
1747352476404847,75551644,1,812,50,75995159,75442064,553095,90.40038329762518
1747352476495625,75644204,1,813,50,76085937,75534624,551313,90.6925829791788
1747352476589365,75736764,1,814,50,76179677,75627184,552493,90.49888414875845
1747352476683713,75829324,1,815,50,76274025,75719744,554281,90.20695279109333
1747352476777549,75921884,1,816,50,76367861,75812304,555557,89.9997660006084
1747352476872258,76014444,1,817,50,76462570,75904864,557706,89.65297127877412
1747352476961597,76107004,1,818,50,76551909,75997424,554485,90.17376484485604
1747352477056602,76199564,1,819,50,76646914,76089984,556930,89.7778895013736
1747352477150953,76292132,1,820,50,76741265,76182552,558713,89.49138466439835
1747352477244302,76384684,1,821,50,76834614,76275104,559510,89.36390770495613
1747352477334467,76477244,1,822,50,76924779,76367664,557115,89.7480771474471
1747352477428540,76569804,1,823,50,77018852,76460224,558628,89.50500153948603
1747352477523058,76662364,1,824,50,77113370,76552784,560586,89.19238083005997
1747352477617733,76754924,1,825,50,77208045,76645344,562701,88.85713727183709
1747352477707656,76847484,1,826,50,77297968,76737904,560064,89.27551137012912
1747352477801396,76940044,1,827,50,77391708,76830464,561244,89.08781207460571
1747352477896719,77032604,1,828,50,77487031,76923024,564007,88.65138198639379
1747352477989957,77125164,1,829,50,77580269,77015584,564685,88.54494098479684
1747352478080094,77217724,1,830,50,77670406,77108144,562262,88.92651468532463
1747352478174854,77310284,1,831,50,77765166,77200704,564462,88.57992212053247
1747352478269042,77402844,1,832,50,77859354,77293264,566090,88.32517797523363
1747352478363012,77495404,1,833,50,77953324,77385824,567500,88.10572687224669
1747352478457202,77587964,1,834,50,78047514,77478384,569130,87.85339026233022
1747352478547113,77680524,1,835,50,78137425,77570944,566481,88.26421362764152
1747352478641716,77773084,1,836,50,78232028,77663504,568524,87.94703477777543
1747352478735097,77865644,1,837,50,78325409,77756064,569345,87.82021445696371
1747352478829417,77958204,1,838,50,78419729,77848624,571105,87.54957494681364
1747352478919856,78050764,1,839,50,78510168,77941184,568984,87.87593324241102
1747352479013911,78143324,1,840,50,78604223,78033744,570479,87.6456451508294
1747352479108564,78235884,1,841,50,78698876,78126304,572572,87.32526215043698
1747352479202601,78328444,1,842,50,78792913,78218864,574049,87.10057852204254
1747352479293001,78421012,1,843,50,78883313,78311432,571881,87.43077668256159
1747352479386721,78513564,1,844,50,78977033,78403984,573049,87.25257351465581
1747352479480663,78606124,1,845,50,79070975,78496544,574431,87.04265612406016
1747352479575159,78698684,1,846,50,79165471,78589104,576367,86.75028237216912
1747352479664853,78791244,1,847,50,79255165,78681664,573501,87.18380613111398
1747352479759844,78883804,1,848,50,79350156,78774224,575932,86.81580464360376
1747352479853948,78976364,1,849,50,79444260,78866784,577476,86.58368486309388
1747352479947532,79068924,1,850,50,79537844,78959344,578500,86.4304235090752
1747352480042032,79161484,1,851,50,79632344,79051904,580440,86.14154779133072
1747352480132587,79254044,1,852,50,79722899,79144464,578435,86.4401358838936
1747352480226266,79346604,1,853,50,79816578,79237024,579554,86.27323769657357
1747352480320943,79439164,1,854,50,79911255,79329584,581671,85.95924500275929
1747352480415058,79531724,1,855,50,80005370,79422144,583226,85.73006004533406
1747352480505121,79624284,1,856,50,80095433,79514704,580729,86.09867941845508
1747352480598755,79716844,1,857,50,80189067,79607264,581803,85.93974249015561
1747352480693240,79809404,1,858,50,80283552,79699824,583728,85.65633308664309
1747352480788141,79901964,1,859,50,80378453,79792384,586069,85.31418655482547
1747352480877823,79994524,1,860,50,80468135,79884944,583191,85.73520510433117
1747352480971438,80087084,1,861,50,80561750,79977504,584246,85.58038908268092
1747352481065774,80179644,1,862,50,80656086,80070064,586022,85.32102890335175
1747352481159871,80272204,1,863,50,80750183,80162624,587559,85.09783698317955
1747352481250735,80364764,1,864,50,80841047,80255184,585863,85.34418456191976
1747352481344695,80457324,1,865,50,80935007,80347744,587263,85.14072911114782
1747352481438419,80549884,1,866,50,81028731,80440304,588427,84.97230752497761
1747352481532887,80642444,1,867,50,81123199,80532864,590335,84.69767166100603
1747352481627072,80735004,1,868,50,81217384,80625424,591960,84.46516656530846
1747352481717293,80827564,1,869,50,81307605,80717984,589621,84.80023608385727
1747352481811225,80920124,1,870,50,81401537,80810544,590993,84.6033709367116
1747352481905329,81012684,1,871,50,81495641,80903104,592537,84.38291617232342
1747352481999318,81105244,1,872,50,81589630,80995664,593966,84.1799025533448
1747352482089310,81197804,1,873,50,81679622,81088224,591398,84.54543302479887
1747352482184178,81290364,1,874,50,81774490,81180784,593706,84.21676722148673
1747352482278851,81382924,1,875,50,81869163,81273344,595819,83.91810264526643
1747352482372540,81475484,1,876,50,81962852,81365904,596948,83.75938942755482
1747352482462786,81568044,1,877,50,82053098,81458464,594634,84.08533652633385
1747352482557099,81660604,1,878,50,82147411,81551024,596387,83.83817890061319
1747352482651187,81753164,1,879,50,82241499,81643584,597915,83.62392647784384
1747352482745215,81845724,1,880,50,82335527,81736144,599383,83.41911599094402
1747352482835179,81938284,1,881,50,82425491,81828704,596787,83.78198586765463
1747352482929347,82030844,1,882,50,82519659,81921264,598395,83.55684790146977
1747352483023631,82123404,1,883,50,82613943,82013824,600119,83.31680883291482
1747352483117629,82215972,1,884,50,82707941,82106392,601549,83.11874843113362
1747352483212089,82308524,1,885,50,82802401,82198944,603457,82.85594499690947
1747352483302369,82401084,1,886,50,82892681,82291504,601177,83.17018116128861
1747352483396568,82493644,1,887,50,82986880,82384064,602816,82.94404926212974
1747352483490610,82586204,1,888,50,83080922,82476624,604298,82.74063458757104
1747352483585240,82678764,1,889,50,83175552,82569184,606368,82.45817721251781
1747352483675328,82771324,1,890,50,83265640,82661744,603896,82.79571316915495
1747352483768978,82863884,1,891,50,83359290,82754304,604986,82.64654058110435
1747352483863165,82956444,1,892,50,83453477,82846864,606613,82.42487384873058
1747352483957828,83049004,1,893,50,83548140,82939424,608716,82.14011131627885
1747352484047587,83141564,1,894,50,83637899,83031984,605915,82.51982538804948
1747352484142236,83234124,1,895,50,83732548,83124544,608004,82.2363010769666
1747352484236240,83326684,1,896,50,83826552,83217104,609448,82.04145390582954
1747352484330726,83419244,1,897,50,83921038,83309664,611374,81.78300025843429
1747352484424751,83511804,1,898,50,84015063,83402224,612839,81.58749687927825
1747352484515006,83604364,1,899,50,84105318,83494784,610534,81.8955209701671
1747352484609291,83696924,1,900,50,84199603,83587344,612259,81.6647856544371
1747352484703361,83789484,1,901,50,84293673,83679904,613769,81.46387321614483
1747352484797543,83882044,1,902,50,84387855,83772464,615391,81.24915703999571
1747352484886940,83974604,1,903,50,84477252,83865024,612228,81.66892072887879
1747352484981594,84067164,1,904,50,84571906,83957584,614322,81.39054111687355
1747352485075963,84159724,1,905,50,84666275,84050144,616131,81.1515732855513
1747352485170089,84252284,1,906,50,84760401,84142704,617697,80.94583590336362
1747352485260473,84344852,1,907,50,84850785,84235272,615513,81.23305275436913
1747352485354585,84437404,1,908,50,84944897,84327824,617073,81.0276904029183
1747352485448645,84529964,1,909,50,85038957,84420384,618573,80.83120343112292
1747352485542775,84622524,1,910,50,85133087,84512944,620143,80.62656516319623
1747352485632682,84715084,1,911,50,85222994,84605504,617490,80.97297122220603
1747352485726576,84807644,1,912,50,85316888,84698064,618824,80.79841764378885
1747352485821497,84900204,1,913,50,85411809,84790624,621185,80.49131901124464
1747352485915740,84992764,1,914,50,85506052,84883184,622868,80.27383008920029
1747352486009410,85085324,1,915,50,85599722,84975744,623978,80.13103026068227
1747352486099998,85177884,1,916,50,85690310,85068304,622006,80.38507667128614
1747352486194225,85270444,1,917,50,85784537,85160864,623673,80.17021740559555
1747352486288388,85363004,1,918,50,85878700,85253424,625276,79.9646875939585
1747352486381982,85455564,1,919,50,85972294,85345984,626310,79.83267072216634
1747352486472334,85548124,1,920,50,86062646,85438544,624102,80.11510938917036
1747352486566808,85640684,1,921,50,86157120,85531104,626016,79.8701630629249
1747352486660479,85733244,1,922,50,86250791,85623664,627127,79.72866739910737
1747352486754444,85825804,1,923,50,86344756,85716224,628532,79.55044452788403
1747352486845654,85918364,1,924,50,86435966,85808784,627182,79.72167568584557
1747352486939639,86010924,1,925,50,86529951,85901344,628607,79.54095325060014
1747352487033249,86103484,1,926,50,86623561,85993904,629657,79.40831277981503
1747352487127438,86196044,1,927,50,86717750,86086464,631286,79.20340384548366
1747352487217559,86288604,1,928,50,86807871,86179024,628847,79.51059637717918
1747352487311553,86381164,1,929,50,86901865,86271584,630281,79.32969580234848
1747352487406201,86473724,1,930,50,86996513,86364144,632369,79.06775948852648
1747352487500160,86566284,1,931,50,87090472,86456704,633768,78.89322275659232
1747352487594827,86658844,1,932,50,87185139,86549264,635875,78.63180656575585
1747352487684545,86751404,1,933,50,87274857,86641824,633033,78.98482385594433
1747352487778518,86843964,1,934,50,87368830,86734384,634446,78.8089136033642
1747352487872721,86936524,1,935,50,87463033,86826944,636089,78.60535239565532
1747352487966860,87029084,1,936,50,87557172,86919504,637668,78.41070902099526
1747352488057298,87121644,1,937,50,87647610,87012064,635546,78.67251150978842
1747352488151336,87214204,1,938,50,87741648,87104624,637024,78.48997839955794
1747352488246122,87306764,1,939,50,87836434,87197184,639250,78.21666014861165
1747352488340384,87399324,1,940,50,87930696,87289744,640952,78.0089616695166
1747352488429957,87491884,1,941,50,88020269,87382304,637965,78.37420548149193
1747352488524696,87584444,1,942,50,88115008,87474864,640144,78.10742582918843
1747352488618289,87677004,1,943,50,88208601,87567424,641177,77.98158698768047
1747352488712646,87769564,1,944,50,88302958,87659984,642974,77.76364207572934
1747352488802503,87862124,1,945,50,88392815,87752544,640271,78.0919329471427
1747352488896579,87954684,1,946,50,88486891,87845104,641787,77.90746774241298
1747352488991396,88047244,1,947,50,88581708,87937664,644044,77.63444733589631
1747352489085473,88139812,1,948,50,88675785,88030232,645553,77.4529744265769
1747352489179433,88232364,1,949,50,88769745,88122784,646961,77.28441127054026
1747352489270130,88324924,1,950,50,88860442,88215344,645098,77.50760349590296
1747352489364275,88417484,1,951,50,88954587,88307904,646683,77.31763476077151
1747352489457828,88510044,1,952,50,89048140,88400464,647676,77.19909337384742
1747352489552003,88602604,1,953,50,89142315,88493024,649291,77.00707386980568
1747352489642607,88695164,1,954,50,89232919,88585584,647335,77.23975993882611
1747352489736889,88787724,1,955,50,89327201,88678144,649057,77.0348366938497
1747352489831132,88880284,1,956,50,89421444,88770704,650740,76.83560254479515
1747352489924815,88972844,1,957,50,89515127,88863264,651863,76.70323365492443
1747352490014952,89065404,1,958,50,89605264,88955824,649440,76.98940625769895
1747352490108950,89157964,1,959,50,89699262,89048384,650878,76.81931176042208
1747352490203768,89250524,1,960,50,89794080,89140944,653136,76.5537345973886
1747352490297337,89343084,1,961,50,89887649,89233504,654145,76.43565264582011
1747352490388021,89435644,1,962,50,89978333,89326064,652269,76.65549029618148
1747352490772970,89815244,1,966,50,90363282,89705664,657618,76.03198209294757
1747352490866638,89907804,1,967,50,90456950,89798224,658726,75.90409365957925
1747352490956940,90000364,1,968,50,90547252,89890784,656468,76.16517484477536
1747352491051286,90092924,1,969,50,90641598,89983344,658254,75.95852057108654
1747352491145489,90185484,1,970,50,90735801,90075904,659897,75.76940037611931
1747352491239858,90278044,1,971,50,90830170,90168464,661706,75.56225876748888
1747352491330247,90370604,1,972,50,90920559,90261024,659535,75.81098804460719
1747352491424445,90463164,1,973,50,91014757,90353584,661173,75.6231727550883
1747352491518100,90555724,1,974,50,91108412,90446144,662268,75.4981367059861
1747352491612472,90648284,1,975,50,91202784,90538704,664080,75.29213347789423
1747352491702769,90740844,1,976,50,91293081,90631264,661817,75.54958545942459
1747352491797028,90833404,1,977,50,91387340,90723824,663516,75.35613308495952
1747352491894754,90925964,1,978,50,91485066,90816384,668682,74.77395832398659
1747352491985616,91018524,1,979,50,91575928,90908944,666984,74.96431698511508
1747352492083622,91114204,1,980,50,91673934,91004624,669310,74.70379943523928
1747352492177722,91206764,1,981,50,91768034,91097184,670850,74.53230975627935
1747352492267853,91299324,1,982,50,91858165,91189744,668421,74.80315549631145
1747352492362199,91391884,1,983,50,91952511,91282304,670207,74.60381643283344
1747352492460647,91487564,1,984,50,92050959,91377984,672975,74.29696496898102
1747352493418067,92444364,1,994,50,93008379,92334784,673595,74.22857948767434
1747352493513120,92536924,1,995,50,93103432,92427344,676088,73.95486978026528
1747352493607331,92629484,1,996,50,93197643,92519904,677739,73.77471268438146
1747352493700799,92722044,1,997,50,93291111,92612464,678647,73.67600534593095
1747352493794973,92814604,1,998,50,93385285,92705024,680261,73.50120027460048
1747352493886127,92907164,1,999,50,93476439,92797584,678855,73.6534311450899
1747352493979684,92999724,1,1000,50,93569996,92890144,679852,73.54541870877779
1747352494074530,93093324,1,1001,50,93664842,92983744,681098,73.41087479334838
1747352494168408,93186924,1,1002,50,93758720,93077344,681376,73.38092330812944
1747352494262120,93280524,1,1003,50,93852432,93170944,681488,73.36886342826286
1747352494356438,93374124,1,1004,50,93946750,93264544,682206,73.29164504563138
1747352494451227,93467724,1,1005,50,94041539,93358144,683395,73.16412909078937
1747352494545183,93561324,1,1006,50,94135495,93451744,683751,73.12603564747985
1747352494638873,93654924,1,1007,50,94229185,93545344,683841,73.11641156350672
1747352494737006,93748524,1,1008,50,94327318,93638944,688374,72.63493391673711
1747352494831503,93842124,1,1009,50,94421815,93732544,689271,72.54040863462993
1747352494924921,93935724,1,1010,50,94515233,93826144,689089,72.55956777716668
1747352495019765,94029324,1,1011,50,94610077,93919744,690333,72.42881334080799
1747352495113969,94122924,1,1012,50,94704281,94013344,690937,72.36549786738877
1747352495208693,94216524,1,1013,50,94799005,94106944,692061,72.24796658098057
1747352495302686,94310124,1,1014,50,94892998,94200544,692454,72.20696248415057
1747352495397323,94403724,1,1015,50,94987635,94294144,693491,72.09898902797585
1747352495491501,94497324,1,1016,50,95081813,94387744,694069,72.0389471363798
1747352495585551,94590924,1,1017,50,95175863,94481344,694519,71.99227090979512
1747352495679885,94684524,1,1018,50,95270197,94574944,695253,71.91626645264385
1747352495774036,94778124,1,1019,50,95364348,94668544,695804,71.85931670412933
1747352495867399,94871724,1,1020,50,95457711,94762144,695567,71.88380127291835
1747352495962148,94965324,1,1021,50,95552460,94855744,696716,71.76525298686983
1747352496056634,95058924,1,1022,50,95646946,94949344,697602,71.67410643891502
1747352496150665,95152524,1,1023,50,95740977,95042944,698033,71.62985131075465
1747352496244333,95246124,1,1024,50,95834645,95136544,698101,71.62287405404089
1747352496338449,95339724,1,1025,50,95928761,95230144,698617,71.56997324714399
1747352496432716,95433324,1,1026,50,96023028,95323744,699284,71.50170746077416
1747352496527800,95526932,1,1027,50,96118112,95417352,700760,71.35110451509789
1747352496621225,95620524,1,1028,50,96211537,95510944,700593,71.36811244188851
1747352496715288,95714124,1,1029,50,96305600,95604544,701056,71.32097863794047
1747352496809790,95807724,1,1030,50,96400102,95698144,701958,71.22933280908545
1747352496904445,95901324,1,1031,50,96494757,95791744,703013,71.12244012557377
1747352496997945,95994924,1,1032,50,96588257,95885344,702913,71.13255836782076
1747352497092960,96088524,1,1033,50,96683272,95978944,704328,70.98965254824458
1747352497187093,96182124,1,1034,50,96777405,96072544,704861,70.93597177315812
1747352497281127,96275724,1,1035,50,96871439,96166144,705295,70.8923216526418
1747352497375040,96369324,1,1036,50,96965352,96259744,705608,70.86087459325857
1747352497468963,96462924,1,1037,50,97059275,96353344,705931,70.82845207251134
1747352497563337,96556524,1,1038,50,97153649,96446944,706705,70.75087907967256
1747352497657228,96650124,1,1039,50,97247540,96540544,706996,70.721757973171
1747352497751898,96743724,1,1040,50,97342210,96634144,708066,70.61488618292645
1747352505099140,104037244,1,1115,50,104689452,103927664,761788,65.63505857272627
1747352505197651,104131884,1,1116,50,104787963,104022304,765659,65.30322245281516
1747352505783287,104715324,1,1122,50,105373599,104605744,767855,65.11646079012314
1747352508936995,107840532,1,1154,50,108527307,107730952,796355,62.78606902700429
1747352509036171,107935164,1,1155,50,108626483,107825584,800899,62.4298444622855
1747352509122125,108029804,1,1156,50,108712437,107920224,792213,63.11433919918002
1747352509219480,108124444,1,1157,50,108809792,108014864,794928,62.898778254131194
1747352509314604,108219084,1,1158,50,108904916,108109504,795412,62.86050499615293
1747352509412086,108313724,1,1159,50,109002398,108204144,798254,62.636704607806536
1747352509507097,108408364,1,1160,50,109097409,108298784,798625,62.607606824229144
1747352509600668,108503004,1,1161,50,109190980,108393424,797556,62.691522601547724
1747352509694705,108597644,1,1162,50,109285017,108488064,796953,62.738957002483204
1747352509793337,108692284,1,1163,50,109383649,108582704,800945,62.42625898157801
1747352509883575,108786924,1,1164,50,109473887,108677344,796543,62.77125026520853
1747352509981476,108881564,1,1165,50,109571788,108771984,799804,62.51531625248186
1747352510080711,108976204,1,1166,50,109671023,108866624,804399,62.158207556200345
1747352510174058,109070844,1,1167,50,109764370,108961264,803106,62.25828221928363
1747352510268102,109165484,1,1168,50,109858414,109055904,802510,62.3045195698496
1747352510367389,109260124,1,1169,50,109957701,109150544,807157,61.945817232583
1747352510460924,109354764,1,1170,50,110051236,109245184,806052,62.03073747103165
1747352510554693,109449404,1,1171,50,110145005,109339824,805181,62.09783887101161
1747352510649093,109544044,1,1172,50,110239405,109434464,804941,62.11635386941403
1747352510743576,109638692,1,1173,50,110333888,109529112,804776,62.12908933666014
1747352510837907,109733324,1,1174,50,110428219,109623744,804475,62.15233537400167
1747352510935624,109827964,1,1175,50,110525936,109718384,807552,61.91551751466159
1747352511034759,109922604,1,1176,50,110625071,109813024,812047,61.572790737481945
1747352511124347,110017244,1,1177,50,110714659,109907664,806995,61.95825252944566
1747352511222740,110111884,1,1178,50,110813052,110002304,810748,61.67144414787332
1747352511317313,110206524,1,1179,50,110907625,110096944,810681,61.67654108089372
1747352511419102,110301164,1,1180,50,111009414,110191584,817830,61.13740019319419
1747352511722771,110591324,1,1183,50,111313083,110481744,831339,60.143936468757026
1747352511808544,110685964,1,1184,50,111398856,110576384,822472,60.79234308280404
1747352511923107,110780604,1,1185,50,111513419,110671024,842395,59.354578315398356
1747352512008952,110875244,1,1186,50,111599264,110765664,833600,59.980806142034545
1747352512107753,110969892,1,1187,50,111698065,110860312,837753,59.68346278676412
1747352512193099,111064524,1,1188,50,111783411,110954944,828467,60.352434074018646
1747352512377857,111256924,1,1190,50,111968169,111147344,820825,60.91432400328937
1747352512574756,111449324,1,1192,50,112165068,111339744,825324,60.58226829705667
1747352512672450,111543964,1,1193,50,112262762,111434384,828378,60.35891827161031
1747352512766952,111638604,1,1194,50,112357264,111529024,828240,60.36897517627741
1747352512865209,111733244,1,1195,50,112455521,111623664,831857,60.10648464820276
1747352512971521,111827884,1,1196,50,112561833,111718304,843529,59.274784862168346
1747352513045276,111922524,1,1197,50,112635588,111812944,822644,60.77963250203004
1747352513344077,112212684,1,1200,50,112934389,112103104,831285,60.14784339907492
1747352513438248,112307324,1,1201,50,113028560,112197744,830816,60.1817971728999
1747352513548714,112401964,1,1202,50,113139026,112292384,846642,59.05683866380359
1747352513622646,112496604,1,1203,50,113212958,112387024,825934,60.53752479011641
1747352513721440,112591244,1,1204,50,113311752,112481664,830088,60.23457753876697
1747352513810902,112685884,1,1205,50,113401214,112576304,824910,60.61267289764944
1747352513925464,112780524,1,1206,50,113515776,112670944,844832,59.18336426650505
1747352514004043,112875164,1,1207,50,113594355,112765584,828771,60.33029630621728
1747352514101939,112969804,1,1208,50,113692251,112860224,832027,60.09420367367886
1747352514208612,113064444,1,1209,50,113798924,112954864,844060,59.237494964812925
1747352514296247,113159084,1,1210,50,113886559,113049504,837055,59.73323138861843
1747352514389068,113253724,1,1211,50,113979380,113144144,835236,59.86332006762161
1747352514482981,113348364,1,1212,50,114073293,113238784,834509,59.91547125315605
1747352514581633,113443004,1,1213,50,114171945,113333424,838521,59.62879880169966
1747352514675623,113537644,1,1214,50,114265935,113428064,837871,59.67505737756767
1747352514769802,113632292,1,1215,50,114360114,113522712,837402,59.708479320565274
1747352514863360,113726924,1,1216,50,114453672,113617344,836328,59.78515606317139
1747352514957897,113821564,1,1217,50,114548209,113711984,836225,59.792519955753534
1747352515052445,113916204,1,1218,50,114642757,113806624,836133,59.799098947177065
1747352515150889,114010844,1,1219,50,114741201,113901264,839937,59.52827414437035
1747352515249161,114105484,1,1220,50,114839473,113995904,843569,59.271974195353316
1747352515343208,114200124,1,1221,50,114933520,114090544,842976,59.31366966556581
1747352515437543,114294764,1,1222,50,115027855,114185184,842671,59.335137912661054
1747352515531691,114389404,1,1223,50,115122003,114279824,842179,59.36980143176213
1747352515629707,114484044,1,1224,50,115220019,114374464,845555,59.13275895713467
1747352515719701,114578684,1,1225,50,115310013,114469104,840909,59.45946588750982
1747352515817813,114673324,1,1226,50,115408125,114563744,844381,59.214975230375856
1747352515912309,114767964,1,1227,50,115502621,114658384,844237,59.22507542313355
1747352516010922,114862604,1,1228,50,115601234,114753024,848210,58.94766626189269
1747352516109251,114957244,1,1229,50,115699563,114847664,851899,58.69240367696171
1747352516198916,115051884,1,1230,50,115789228,114942304,846924,59.03717452805682
1747352516309100,115146524,1,1231,50,115899412,115036944,862468,57.97316538120835
1747352516387513,115241164,1,1232,50,115977825,115131584,846241,59.08482335410362
1747352516498169,115335804,1,1233,50,116088481,115226224,862257,57.987351798825635
1747352516583892,115430444,1,1234,50,116174204,115320864,853340,58.59329223990438
1747352516678622,115525084,1,1235,50,116268934,115415504,853430,58.587113178585234
1747352516768191,115619724,1,1236,50,116358503,115510144,848359,58.93731309504585
1747352516866455,115714364,1,1237,50,116456767,115604784,851983,58.68661698648916
1747352516973618,115809004,1,1238,50,116563930,115699424,864506,57.836498532109665
1747352517062858,115903644,1,1239,50,116653170,115794064,859106,58.20003585122208
1747352517152933,115998284,1,1240,50,116743245,115888704,854541,58.510943301725725
1747352517243058,116092924,1,1241,50,116833370,115983344,850026,58.8217301588422
1747352517349560,116187564,1,1242,50,116939872,116077984,861888,58.01217791638821
1747352517562344,116379964,1,1244,50,117152656,116270384,882272,56.67186536578289
1747352517632226,116474604,1,1245,50,117222538,116365024,857514,58.308085932124726
1747352517735000,116569244,1,1246,50,117325312,116459664,865648,57.760198140583704
1747352517923650,116761644,1,1248,50,117513962,116652064,861898,58.01150484164019
1747352518017712,116856284,1,1249,50,117608024,116746704,861320,58.05043421724795
1747352518127828,116950924,1,1250,50,117718140,116841344,876796,57.02580759948722
1747352518218449,117045564,1,1251,50,117808761,116935984,872777,57.28840242123704
1747352518300457,117140204,1,1252,50,117890769,117030624,860145,58.12973394020775
1747352518402731,117234844,1,1253,50,117993043,117125264,867779,57.618356747512905
1747352518590889,117427244,1,1255,50,118181201,117317664,863537,57.901398550380584
1747352518705560,117521884,1,1256,50,118295872,117412304,883568,56.588740198830195
1747352518787265,117616524,1,1257,50,118377577,117506944,870633,57.42947947068397
1747352518872979,117711164,1,1258,50,118463291,117601584,861707,58.02436326964966
1747352518971362,117805804,1,1259,50,118561674,117696224,865450,57.77341267548674
1747352519073884,117900444,1,1260,50,118664196,117790864,873332,57.251995804573745
1747352519160172,117995084,1,1261,50,118750484,117885504,864980,57.80480473536961
1747352519258432,118089724,1,1262,50,118848744,117980144,868600,57.563895924476164
1747352519352155,118184364,1,1263,50,118942467,118074784,867683,57.62473161281252
1747352519451043,118279004,1,1264,50,119041355,118169424,871931,57.34398708154659
1747352519540590,118373644,1,1265,50,119130902,118264064,866838,57.68090462116336
1747352519639600,118468284,1,1266,50,119229912,118358704,871208,57.391575834932645
1747352519733779,118562924,1,1267,50,119324091,118453344,870747,57.42196068433196
1747352519831668,118657564,1,1268,50,119421980,118547984,873996,57.20849981006778
1747352519929927,118752204,1,1269,50,119520239,118642624,877615,56.97259048671684
1747352520023880,118846844,1,1270,50,119614192,118737264,876928,57.01722376295431
1747352520118250,118941484,1,1271,50,119708562,118831904,876658,57.03478437429419
1747352520212241,119036124,1,1272,50,119802553,118926544,876009,57.07703916283965
1747352520315029,119130764,1,1273,50,119905341,119021184,884157,56.55104240536466
1747352520405616,119225404,1,1274,50,119995928,119115824,880104,56.81146773563125
1747352520495748,119320044,1,1275,50,120086060,119210464,875596,57.10396118757966
1747352520593558,119414684,1,1276,50,120183870,119305104,878766,56.89796828734839
1747352520687575,119509324,1,1277,50,120277887,119399744,878143,56.938334644812976
1747352520786476,119603964,1,1278,50,120376788,119494384,882404,56.66338774529581
1747352520884237,119698604,1,1279,50,120474549,119589024,885525,56.46367973800852
1747352520974501,119793244,1,1280,50,120564813,119683664,881149,56.74409208885217
1747352521072634,119887892,1,1281,50,120662946,119778312,884634,56.520549741475
1747352521162675,119982524,1,1282,50,120752987,119872944,880043,56.81540561086219
1747352521273600,120077164,1,1283,50,120863912,119967584,896328,55.78315081086388
1747352521355620,120171804,1,1284,50,120945932,120062224,883708,56.579775219869006
1747352521453539,120266444,1,1285,50,121043851,120156864,886987,56.370611970637675
1747352521547689,120361084,1,1286,50,121138001,120251504,886497,56.40177011315323
1747352521642282,120455724,1,1287,50,121232594,120346144,886450,56.40476056179142
1747352521740072,120550364,1,1288,50,121330384,120440784,889600,56.205035971223026
1747352521834501,120645004,1,1289,50,121424813,120535424,889389,56.218370139500266
1747352521925107,120739644,1,1290,50,121515419,120630064,885355,56.474521519616424
1747352522023300,120834284,1,1291,50,121613612,120724704,888908,56.248790651001
1747352522121109,120928924,1,1292,50,121711421,120819344,892077,56.04897335095513
1747352522211811,121023564,1,1293,50,121802123,120913984,888139,56.29749397335327
1747352522318836,121118204,1,1294,50,121909148,121008624,900524,55.523228697958075
1747352522403586,121212844,1,1295,50,121993898,121103264,890634,56.13978356990638
1747352522498358,121307484,1,1296,50,122088670,121197904,890766,56.13146438009534
1747352522596691,121402124,1,1297,50,122187003,121292544,894459,55.89971144568952
1747352522690769,121496764,1,1298,50,122281081,121387184,893897,55.934856029274066
1747352522793248,121591404,1,1299,50,122383560,121481824,901736,55.44860136447918
1747352522887390,121686052,1,1300,50,122477702,121576472,901230,55.47973325344252
1747352522977884,121780684,1,1301,50,122568196,121671104,897092,55.73564361291818
1747352523071490,121875324,1,1302,50,122661802,121765744,896058,55.79995937762957
1747352523166578,121969964,1,1303,50,122756890,121860384,896506,55.77207514506316
1747352523268629,122064604,1,1304,50,122858941,121955024,903917,55.31481319634435
1747352523354960,122159244,1,1305,50,122945272,122049664,895608,55.82799617689882
1747352523452695,122253884,1,1306,50,123043007,122144304,898703,55.63573282830924
1747352523550755,122348524,1,1307,50,123141067,122238944,902123,55.424814576282834
1747352523645107,122443164,1,1308,50,123235419,122333584,901835,55.44251442891438
1747352523739036,122537804,1,1309,50,123329348,122428224,901124,55.48625938272646
1747352523845794,122632444,1,1310,50,123436106,122522864,913242,54.75000054750001
1747352523931851,122727084,1,1311,50,123522163,122617504,904659,55.269444066769914
1747352524025628,122821724,1,1312,50,123615940,122712144,903796,55.322218730775525
1747352524120303,122916364,1,1313,50,123710615,122806784,903831,55.32007643021759
1747352524214247,123011004,1,1314,50,123804559,122901424,903135,55.362708786615514
1747352524317152,123105644,1,1315,50,123907464,122996064,911400,54.86065393899495
1747352524406531,123200284,1,1316,50,123996843,123090704,906139,55.17917229034398
1747352524501392,123294924,1,1317,50,124091704,123185344,906360,55.165717816320225
1747352524598834,123389564,1,1318,50,124189146,123279984,909162,54.9956993363119
1747352524688913,123484204,1,1319,50,124279225,123374624,904601,55.27298775924413
1747352524787645,123578844,1,1320,50,124377957,123469264,908693,55.024084041585006
1747352524886043,123673484,1,1321,50,124476355,123563904,912451,54.79746309664848
1747352524980232,123768124,1,1322,50,124570544,123658544,912000,54.82456140350877
1747352525078867,123862764,1,1323,50,124669179,123753184,915995,54.585450793945384
1747352525192708,123957404,1,1324,50,124783020,123847824,935196,53.46472824947925
1747352525271210,124052044,1,1325,50,124861522,123942464,919058,54.403530571519966
1747352525357060,124146684,1,1326,50,124947372,124037104,910268,54.92887808865082
1747352525455319,124241324,1,1327,50,125045631,124131744,913887,54.71135928183681
1747352525549874,124335964,1,1328,50,125140186,124226384,913802,54.716448420992734
1747352525664449,124430604,1,1329,50,125254761,124321024,933737,53.54826894510981
1747352525746479,124525244,1,1330,50,125336791,124415664,921127,54.28133145592302
1747352525844518,124619884,1,1331,50,125434830,124510304,924526,54.08176730562472
1747352525938213,124714524,1,1332,50,125528525,124604944,923581,54.13710329684132
1747352526024869,124809164,1,1333,50,125615181,124699584,915597,54.60917849228427
1747352526127368,124903804,1,1334,50,125717680,124794224,923456,54.14443135352415
1747352526225165,124998444,1,1335,50,125815477,124888864,926613,53.95995955161432
1747352526315073,125093084,1,1336,50,125905385,124983504,921881,54.2369351358798
1747352526421349,125187724,1,1337,50,126011661,125078144,933517,53.56088855371675
1747352526503505,125282364,1,1338,50,126093817,125172784,921033,54.28687137160124
1747352526597842,125377004,1,1339,50,126188154,125267424,920730,54.30473645911396
1747352526692121,125471644,1,1340,50,126282433,125362064,920369,54.32603662226781
1747352526786014,125566284,1,1341,50,126376326,125456704,919622,54.37016513306554
1747352526896880,125660924,1,1342,50,126487192,125551344,935848,53.42747967618673
1747352526983148,125755564,1,1343,50,126573460,125645984,927476,53.90975076444027
1747352527094060,125850204,1,1344,50,126684372,125740624,943748,52.98024472634644
1747352527188061,125944852,1,1345,50,126778373,125835272,943101,53.016591011991295
1747352527269908,126039484,1,1346,50,126860220,125929904,930316,53.74517905743855
1747352527363588,126134124,1,1347,50,126953900,126024544,929356,53.80069639621416
1747352527462381,126228764,1,1348,50,127052693,126119184,933509,53.56134756065555
1747352527573075,126323404,1,1349,50,127163387,126213824,949563,52.65580061565162
1747352527670615,126418044,1,1350,50,127260927,126308464,952463,52.49547751461212
1747352527753274,126512684,1,1351,50,127343586,126403104,940482,53.16422855514512
1747352527838487,126607324,1,1352,50,127428799,126497744,931055,53.70252025927577
1747352527953685,126701964,1,1353,50,127543997,126592384,951613,52.54236753806432
1747352528035289,126796604,1,1354,50,127625601,126687024,938577,53.27213430544324
1747352528130123,126891244,1,1355,50,127720435,126781664,938771,53.26112545018966
1747352528220350,126985884,1,1356,50,127810662,126876304,934358,53.51267929423197
1747352528322452,127080524,1,1357,50,127912764,126970944,941820,53.08870060096409
1747352528429092,127175164,1,1358,50,128019404,127065584,953820,52.42079218301147
1747352528527328,127269804,1,1359,50,128117640,127160224,957416,52.22390267135707
1747352528605104,127364444,1,1360,50,128195416,127254864,940552,53.16027184036608
1747352528703142,127459084,1,1361,50,128293454,127349504,943950,52.968907251443405
1747352528801041,127553724,1,1362,50,128391353,127444144,947209,52.78666059971981
1747352529091741,127843884,1,1365,50,128682053,127734304,947749,52.75658428550175
1747352529178102,127938524,1,1366,50,128768414,127828944,939470,53.22149722715999
1747352529281062,128033164,1,1367,50,128871374,127923584,947790,52.75430211333734
1747352529370722,128127804,1,1368,50,128961034,128018224,942810,53.03295467803693
1747352529567310,128320204,1,1370,50,129157622,128210624,946998,52.798421960764436
1747352529665739,128414844,1,1371,50,129256051,128305264,950787,52.588013929513124
1747352529762971,128509484,1,1372,50,129353283,128399904,953379,52.44504022010135
1747352529948498,128701884,1,1374,50,129538810,128592304,946506,52.825866925302115
1747352530042921,128796524,1,1375,50,129633233,128686944,946289,52.83798078599666
1747352530153287,128891164,1,1376,50,129743599,128781584,962015,51.97424156587995
1747352530247728,128985804,1,1377,50,129838040,128876224,961816,51.98499505102847
1747352530350062,129080444,1,1378,50,129940374,128970864,969510,51.57244381182247
1747352530530145,129272852,1,1380,50,130120457,129163272,957185,52.23650600458637
1747352530619609,129367484,1,1381,50,130209921,129257904,952017,52.520070544958756
1747352530717937,129462124,1,1382,50,130308249,129352544,955705,52.317399197451095
1747352530808443,129556764,1,1383,50,130398755,129447184,951571,52.54468662874342
