Tempo total receptor,Tempo total emissor,Id do pacote,Id da mensagem,Distancia (m),Tempo zerado receptor,Tempo zerado emissor,Delta tempo,Velocidade (m/s)
1747352847177226,841164,1,9,100,0,0,0,0
1747352847266470,929564,1,10,100,89244,88400,844,118483.41232227487
1747352847385795,1019004,1,11,100,208569,177840,30729,3254.254938331869
1747352847459806,1109484,1,12,100,282580,268320,14260,7012.622720897616
1747352847544904,1199964,1,13,100,367678,358800,8878,11263.798152737103
1747352847722017,1384044,1,15,100,544791,542880,1911,52328.623757195186
1747352848118960,1755324,1,19,100,941734,914160,27574,3626.6047726118804
1747352848196218,1848924,1,20,100,1018992,1007760,11232,8903.133903133903
1747352848479339,2126604,1,23,100,1302113,1285440,16673,5997.720866070893
1747352848565450,2217084,1,24,100,1388224,1375920,12304,8127.43823146944
1747352848655430,2307564,1,25,100,1478204,1466400,11804,8471.704506946797
1747352849044662,2678844,1,29,100,1867436,1837680,29756,3360.666756284447
1747352849142032,2772444,1,30,100,1964806,1931280,33526,2982.759649227465
1747352849219909,2866044,1,31,100,2042683,2024880,17803,5617.030837499298
1747352849310689,2956524,1,32,100,2133463,2115360,18103,5523.946307241893
1747352849420646,3047004,1,33,100,2243420,2205840,37580,2660.9898882384246
1747352850362874,3979884,1,43,100,3185648,3138720,46928,2130.923968632799
1747352850432925,4070364,1,44,100,3255699,3229200,26499,3773.7273104645456
1747352850522997,4160844,1,45,100,3345771,3319680,26091,3832.7392587482273
1747352853181386,6778524,1,73,100,6004160,5937360,66800,1497.005988023952
1747352853357002,6965724,1,75,100,6179776,6124560,55216,1811.0692552883222
1747352853443685,7059324,1,76,100,6266459,6218160,48299,2070.4362409159608
1747352853533775,7149804,1,77,100,6356549,6308640,47909,2087.290488217245
1747352853840824,7427484,1,80,100,6663598,6586320,77278,1294.029348585626
1747352854020551,7614684,1,82,100,6843325,6773520,69805,1432.562137382709
1747352854397629,7989084,1,86,100,7220403,7147920,72483,1379.6338451774898
1747352854573635,8173164,1,88,100,7396409,7332000,64409,1552.5780558617587
1747352854654857,8263644,1,89,100,7477631,7422480,55151,1813.2037497053545
1747352854746037,8354124,1,90,100,7568811,7512960,55851,1790.4782367370326
1747352854835788,8444604,1,91,100,7658562,7603440,55122,1814.1576865861182
1747352854929717,8535084,1,92,100,7752491,7693920,58571,1707.3295658260915
1747352855020246,8625564,1,93,100,7843020,7784400,58620,1705.90242238144
1747352855114006,8716044,1,94,100,7936780,7874880,61900,1615.5088852988692
1747352855208181,8806524,1,95,100,8030955,7965360,65595,1524.5064410397133
1747352855294565,8897004,1,96,100,8117339,8055840,61499,1626.0426998812989
1747352855384052,8987484,1,97,100,8206826,8146320,60506,1652.7286550094207
1747352855474259,9077964,1,98,100,8297033,8236800,60233,1660.21948101539
1747352855564490,9168444,1,99,100,8387264,8327280,59984,1667.111229661243
1747352855658723,9258924,1,100,100,8481497,8417760,63737,1568.9473931939062
1747352856044114,9634364,1,104,100,8866888,8793200,73688,1357.0730648138094
1747352856137856,9725884,1,105,100,8960630,8884720,75910,1317.3494928204452
1747352856609629,10201164,1,110,100,9432403,9360000,72403,1381.1582392994767
1747352856728268,10293724,1,111,100,9551042,9452560,98482,1015.4139842813915
1747352856814169,10389404,1,112,100,9636943,9548240,88703,1127.3575865528787
1747352856908224,10485084,1,113,100,9730998,9643920,87078,1148.3956912193664
1747352857002526,10580764,1,114,100,9825300,9739600,85700,1166.8611435239206
1747352857108578,10673324,1,115,100,9931352,9832160,99192,1008.145818211146
1747352858349662,11914044,1,128,100,11172436,11072880,99556,1004.4598015187431
1747352858456130,12009724,1,129,100,11278904,11168560,110344,906.2567969259769
1747352858746674,12296764,1,132,100,11569448,11455600,113848,878.3641346356545
1747352858816424,12392444,1,133,100,11639198,11551280,87918,1137.4235082690689
1747352858906341,12485004,1,134,100,11729115,11643840,85275,1172.6766344180592
1747352859000835,12577564,1,135,100,11823609,11736400,87209,1146.6706417915582
1747352859095435,12670124,1,136,100,11918209,11828960,89249,1120.4607334535963
1747352859189442,12762684,1,137,100,12012216,11921520,90696,1102.5844579694806
1747352859283602,12855244,1,138,100,12106376,12014080,92296,1083.470572939239
1747352859374088,12947804,1,139,100,12196862,12106640,90222,1108.3771142293454
1747352859475705,13040364,1,140,100,12298479,12199200,99279,1007.262361627333
1747352863428513,16963244,1,181,100,16251287,16122080,129207,773.9518756723708
1747352863518845,17058924,1,182,100,16341619,16217760,123859,807.3696703509636
1747352866229524,19734844,1,210,100,19052298,18893680,158618,630.4454727710599
1747352866315875,19830524,1,211,100,19138649,18989360,149289,669.8417164024141
1747352866402157,19923084,1,212,100,19224931,19081920,143011,699.2469110767703
1747352866492295,20015644,1,213,100,19315069,19174480,140589,711.293202170867
1747352866590464,20108204,1,214,100,19413238,19267040,146198,684.0038851420676
1747352866680082,20200764,1,215,100,19502856,19359600,143256,698.0510414921539
1747352866774547,20293324,1,216,100,19597321,19452160,145161,688.8902666694222
1747352866873456,20385884,1,217,100,19696230,19544720,151510,660.0224407629859
1747352866958593,20478444,1,218,100,19781367,19637280,144087,694.0251375904836
1747352867057127,20571004,1,219,100,19879901,19729840,150061,666.3956657625898
1747352867147131,20663564,1,220,100,19969905,19822400,147505,677.9431205721841
1747352867241536,20756124,1,221,100,20064310,19914960,149350,669.5681285570806
1747352867331322,20848684,1,222,100,20154096,20007520,146576,682.239930138631
1747352867426275,20941244,1,223,100,20249049,20100080,148969,671.280602004444
1747352867524087,21033804,1,224,100,20346861,20192640,154221,648.4201243669798
1747352867618313,21126364,1,225,100,20441087,20285200,155887,641.490310288863
1747352867707574,21218924,1,226,100,20530348,20377760,152588,655.3595302382887
1747352867798560,21311484,1,227,100,20621334,20470320,151014,662.1902605056484
1747352867896773,21404044,1,228,100,20719547,20562880,156667,638.2965142627356
1747352867986545,21496604,1,229,100,20809319,20655440,153879,649.8612546221382
1747352868085320,21589164,1,230,100,20908094,20748000,160094,624.6330280959936
1747352868179233,21681724,1,231,100,21002007,20840560,161447,619.3983164753757
1747352868265231,21774284,1,232,100,21088005,20933120,154885,645.6403137811925
1747352868359840,21866844,1,233,100,21182614,21025680,156934,637.2105471089758
1747352868454054,21959404,1,234,100,21276828,21118240,158588,630.5647337755694
1747352868552691,22055084,1,235,100,21375465,21213920,161545,619.022563372435
1747352868670937,22147644,1,236,100,21493711,21306480,187231,534.0995882092175
1747352868748315,22243324,1,237,100,21571089,21402160,168929,591.964671548402
1747352868859032,22339004,1,238,100,21681806,21497840,183966,543.5787047606623
1747352868949237,22434684,1,239,100,21772011,21593520,178491,560.2523376528789
1747352869146473,22622924,1,241,100,21969247,21781760,187487,533.3703136750815
1747352869343011,22814284,1,243,100,22165785,21973120,192665,519.0356317961227
1747352869608536,23101324,1,246,100,22431310,22260160,171150,584.28279287175
1747352869793297,23289564,1,248,100,22616071,22448400,167671,596.406057099916
1747352870473028,23956204,1,255,100,23295802,23115040,180762,553.2136179064183
1747352870575634,24051884,1,256,100,23398408,23210720,187688,532.7991134222752
1747352870862315,24335804,1,259,100,23685089,23494640,190449,525.0749544497477
1747352870960663,24431484,1,260,100,23783437,23590320,193117,517.820802932937
1747352871046862,24527164,1,261,100,23869636,23686000,183636,544.5555337733342
1747352871156587,24622844,1,262,100,23979361,23781680,197681,505.86551059535316
1747352871234432,24718524,1,263,100,24057206,23877360,179846,556.0312711986923
1747352871349171,24811084,1,264,100,24171945,23969920,202025,494.9882440292043
1747352871439343,24903644,1,265,100,24262117,24062480,199637,500.909150107445
1747352871812206,25286364,1,269,100,24634980,24445200,189780,526.9259142164611
1747352872771007,26243164,1,279,100,25593781,25402000,191781,521.4280872453476
1747352872967909,26431404,1,281,100,25790683,25590240,200443,498.8949476908647
1747352873065435,26527084,1,282,100,25888209,25685920,202289,494.3422529153834
1747352873147150,26619644,1,283,100,25969924,25778480,191444,522.345960176344
1747352873241357,26712204,1,284,100,26064131,25871040,193091,517.8905283001279
1747352873332319,26804764,1,285,100,26155093,25963600,191493,522.2123001885186
1747352873425863,26897324,1,286,100,26248637,26056160,192477,519.5425946996264
1747352873519926,26989884,1,287,100,26342700,26148720,193980,515.5170636148056
1747352873610314,27082444,1,288,100,26433088,26241280,191808,521.3546880213547
1747352873704752,27175004,1,289,100,26527526,26333840,193686,516.2995776669454
1747352873798863,27267564,1,290,100,26621637,26426400,195237,512.1979952570466
1747352873893189,27360124,1,291,100,26715963,26518960,197003,507.60648315000276
1747352873986620,27452684,1,292,100,26809394,26611520,197874,505.37210548126586
1747352874077684,27545244,1,293,100,26900458,26704080,196378,509.2220106121867
1747352874171138,27637804,1,294,100,26993912,26796640,197272,506.91431120483395
1747352874265297,27730364,1,295,100,27088071,26889200,198871,502.83852346495974
1747352874359773,27822924,1,296,100,27182547,26981760,200787,498.04021176669806
1747352874450286,27915484,1,297,100,27273060,27074320,198740,503.1699708161417
1747352874544396,28008044,1,298,100,27367170,27166880,200290,499.2760497278946
1747352874638185,28100604,1,299,100,27460959,27259440,201519,496.23112460859767
1747352874732852,28193164,1,300,100,27555626,27352000,203626,491.0964218714702
1747352874831239,28285724,1,301,100,27654013,27444560,209453,477.4340782896402
1747352874917176,28378284,1,302,100,27739950,27537120,202830,493.02371444066455
1747352875010798,28470844,1,303,100,27833572,27629680,203892,490.45573146567796
1747352875105248,28563404,1,304,100,27928022,27722240,205782,485.95115219018186
1747352875199209,28655964,1,305,100,28021983,27814800,207183,482.6650835251927
1747352875289379,28748524,1,306,100,28112153,27907360,204793,488.2979398709917
1747352875383610,28841084,1,307,100,28206384,27999920,206464,484.3459392436454
1747352875486609,28933644,1,308,100,28309383,28092480,216903,461.03557811556317
1747352875571890,29026204,1,309,100,28394664,28185040,209624,477.0446132122276
1747352875666699,29118764,1,310,100,28489473,28277600,211873,471.9808564564621
1747352875760709,29211324,1,311,100,28583483,28370160,213323,468.77270617795546
1747352875850730,29303884,1,312,100,28673504,28462720,210784,474.41931076362533
1747352875944656,29396444,1,313,100,28767430,28555280,212150,471.36460051850105
1747352876035544,29489004,1,314,100,28858318,28647840,210478,475.1090375241118
1747352876129694,29581564,1,315,100,28952468,28740400,212068,471.5468623271781
1747352876223627,29674124,1,316,100,29046401,28832960,213441,468.51354706921353
1747352876317255,29766692,1,317,100,29140029,28925528,214501,466.1982927818518
1747352876411464,29859244,1,318,100,29234238,29018080,216158,462.62456166322784
1747352876501510,29951804,1,319,100,29324284,29110640,213644,468.06837542828254
1747352876595658,30044364,1,320,100,29418432,29203200,215232,464.6149271483794
1747352876689950,30136924,1,321,100,29512724,29295760,216964,460.905956748585
1747352876780245,30229484,1,322,100,29603019,29388320,214699,465.76835476644044
1747352876874915,30322044,1,323,100,29697689,29480880,216809,461.2354653173992
1747352876969175,30414604,1,324,100,29791949,29573440,218509,457.64705343944644
1747352877062491,30507164,1,325,100,29885265,29666000,219265,456.0691400816364
1747352877157521,30599724,1,326,100,29980295,29758560,221735,450.98879292849574
1747352877247773,30692284,1,327,100,30070547,29851120,219427,455.7324303754779
1747352877341531,30784844,1,328,100,30164305,29943680,220625,453.25779036827197
1747352877435262,30877404,1,329,100,30258036,30036240,221796,450.86475860700824
1747352877530304,30969964,1,330,100,30353078,30128800,224278,445.87520844665994
1747352877620381,31062524,1,331,100,30443155,30221360,221795,450.86679140647897
1747352877714482,31155084,1,332,100,30537256,30313920,223336,447.75584769137083
1747352877808203,31247644,1,333,100,30630977,30406480,224497,445.4402508719493
1747352877902923,31340204,1,334,100,30725697,30499040,226657,441.1952862695615
1747352877997129,31432764,1,335,100,30819903,30591600,228303,438.014393152959
1747352878086869,31525324,1,336,100,30909643,30684160,225483,443.49241406225747
1747352878181420,31617884,1,337,100,31004194,30776720,227474,439.61068078110026
1747352878274755,31710444,1,338,100,31097529,30869280,228249,438.1180202322902
1747352878365090,31803004,1,339,100,31187864,30961840,226024,442.43089229462356
1747352878459775,31895572,1,340,100,31282549,31054408,228141,438.32542155947414
1747352878553970,31988124,1,341,100,31376744,31146960,229784,435.19131009992
1747352878647744,32080684,1,342,100,31470518,31239520,230998,432.90418098858
1747352878741651,32173244,1,343,100,31564425,31332080,232345,430.3944565194
1747352878832251,32265804,1,344,100,31655025,31424640,230385,434.0560366343295
1747352878925817,32358364,1,345,100,31748591,31517200,231391,432.16892618986907
1747352879020517,32450924,1,346,100,31843291,31609760,233531,428.2086746513311
1747352879115213,32543484,1,347,100,31937987,31702320,235667,424.3275469200185
1747352879204389,32636044,1,348,100,32027163,31794880,232283,430.5093355949424
1747352879298787,32728604,1,349,100,32121561,31887440,234121,427.12956120980175
1747352879393568,32821164,1,350,100,32216342,31980000,236342,423.1156544329827
1747352879487232,32913724,1,351,100,32310006,32072560,237446,421.14838742282456
1747352879578185,33006284,1,352,100,32400959,32165120,235839,424.0180801309368
1747352879671760,33098844,1,353,100,32494534,32257680,236854,422.2010183488562
1747352879766627,33191404,1,354,100,32589401,32350240,239161,418.12837377331584
1747352879859895,33283964,1,355,100,32682669,32442800,239869,416.89422142919676
1747352879954847,33376524,1,356,100,32777621,32535360,242261,412.7779543550138
1747352880048352,33469084,1,357,100,32871126,32627920,243206,411.17406642928216
1747352880138799,33561644,1,358,100,32961573,32720480,241093,414.777699891743
1747352880232745,33654204,1,359,100,33055519,32813040,242479,412.4068476032976
1747352880331658,33746764,1,360,100,33154432,32905600,248832,401.87757201646093
1747352880417569,33839324,1,361,100,33240343,32998160,242183,412.9108979573298
1747352880511295,33931884,1,362,100,33334069,33090720,243349,410.93244681506803
1747352880605637,34024444,1,363,100,33428411,33183280,245131,407.945139537635
1747352880703965,34117004,1,364,100,33526739,33275840,250899,398.5667539527858
1747352880790147,34209564,1,365,100,33612921,33368400,244521,408.96282936843875
1747352880888307,34302124,1,366,100,33711081,33460960,250121,399.80649365707
1747352880978344,34394684,1,367,100,33801118,33553520,247598,403.88048368726726
1747352881072709,34487244,1,368,100,33895483,33646080,249403,400.95748647770876
1747352881162268,34579804,1,369,100,33985042,33738640,246402,405.8408616813175
1747352881257366,34672364,1,370,100,34080140,33831200,248940,401.7032216598377
1747352881351167,34764924,1,371,100,34173941,33923760,250181,399.71060951870845
1747352881445651,34857484,1,372,100,34268425,34016320,252105,396.66012177465734
1747352881539288,34950044,1,373,100,34362062,34108880,253182,394.97278637501876
1747352881629806,35042604,1,374,100,34452580,34201440,251140,398.1842796846381
1747352881727444,35135164,1,375,100,34550218,34294000,256218,390.2926414225386
1747352881818112,35227724,1,376,100,34640886,34386560,254326,393.1961340956096
1747352881912055,35320284,1,377,100,34734829,34479120,255709,391.06953607420934
1747352882002262,35412844,1,378,100,34825036,34571680,253356,394.7015267055053
1747352882096262,35505404,1,379,100,34919036,34664240,254796,392.4708394166313
1747352882190907,35597964,1,380,100,35013681,34756800,256881,389.2853110973563
1747352882284775,35690532,1,381,100,35107549,34849368,258181,387.32517110089435
1747352882375776,35783084,1,382,100,35198550,34941920,256630,389.6660561898453
1747352882469901,35875644,1,383,100,35292675,35034480,258195,387.30416932938283
1747352882564300,35968204,1,384,100,35387074,35127040,260034,384.56509533368717
1747352882658380,36060764,1,385,100,35481154,35219600,261554,382.3302262630279
1747352882747786,36153324,1,386,100,35570560,35312160,258400,386.9969040247678
1747352882842098,36245884,1,387,100,35664872,35404720,260152,384.39066391955475
1747352882936904,36338444,1,388,100,35759678,35497280,262398,381.1004657047691
1747352883030411,36431004,1,389,100,35853185,35589840,263345,379.7300119614954
1747352883124283,36523564,1,390,100,35947057,35682400,264657,377.8475536260141
1747352883215296,36616124,1,391,100,36038070,35774960,263110,380.06917258941127
1747352883308956,36708684,1,392,100,36131730,35867520,264210,378.4868097346807
1747352883402650,36801244,1,393,100,36225424,35960080,265344,376.86927158707186
1747352883497548,36893804,1,394,100,36320322,36052640,267682,373.5776032755285
1747352883587684,36986364,1,395,100,36410458,36145200,265258,376.99145737357594
1747352883681406,37078924,1,396,100,36504180,36237760,266420,375.34719615644474
1747352883775344,37171484,1,397,100,36598118,36330320,267798,373.41578353833864
1747352883869630,37264044,1,398,100,36692404,36422880,269524,371.0244727742242
1747352883959793,37356604,1,399,100,36782567,36515440,267127,374.3537718014278
1747352884054480,37449164,1,400,100,36877254,36608000,269254,371.3965252141101
1747352884148794,37541724,1,401,100,36971568,36700560,271008,368.99279726059746
1747352884242718,37634284,1,402,100,37065492,36793120,272372,367.1449341341988
1747352884333262,37726844,1,403,100,37156036,36885680,270356,369.8826732160559
1747352884427463,37819412,1,404,100,37250237,36978248,271989,367.66192750442116
1747352884521333,37911964,1,405,100,37344107,37070800,273307,365.8889088095072
1747352884623299,38004524,1,406,100,37446073,37163360,282713,353.7156055788025
1747352884709397,38097084,1,407,100,37532171,37255920,276251,361.98963985650727
1747352884803543,38189644,1,408,100,37626317,37348480,277837,359.92326436003844
1747352884898575,38282204,1,409,100,37721349,37441040,280309,356.7491589638578
1747352884988751,38374764,1,410,100,37811525,37533600,277925,359.8093010704327
1747352885082211,38467324,1,411,100,37904985,37626160,278825,358.6478974267014
1747352885181151,38559884,1,412,100,38003925,37718720,285205,350.6249890429691
1747352885267093,38652444,1,413,100,38089867,37811280,278587,358.9542943497005
1747352885373559,38745004,1,414,100,38196333,37903840,292493,341.88852382792066
1747352885454882,38837564,1,415,100,38277656,37996400,281256,355.5479705321842
1747352885549298,38930124,1,416,100,38372072,38088960,283112,353.2171013591794
1747352885643347,39022684,1,417,100,38466121,38181520,284601,351.36910973608667
1747352885733514,39115244,1,418,100,38556288,38274080,282208,354.3485655970064
1747352885828169,39207804,1,419,100,38650943,38366640,284303,351.73740692148874
1747352885918319,39300364,1,420,100,38741093,38459200,281893,354.7445307261975
1747352886012713,39392924,1,421,100,38835487,38551760,283727,352.45147624300824
1747352886106727,39485484,1,422,100,38929501,38644320,285181,350.65449661793735
1747352886200894,39578044,1,423,100,39023668,38736880,286788,348.6896243915366
1747352886294855,39670604,1,424,100,39117629,38829440,288189,346.994507076953
1747352886384763,39763164,1,425,100,39207537,38922000,285537,350.21730984075623
1747352886487205,39855724,1,426,100,39309979,39014560,295419,338.5022628876274
1747352886573728,39948284,1,427,100,39396502,39107120,289382,345.56399499623336
1747352886667212,40040844,1,428,100,39489986,39199680,290306,344.4641171729141
1747352886757694,40133404,1,429,100,39580468,39292240,288228,346.9475554075246
1747352886851585,40225964,1,430,100,39674359,39384800,289559,345.3527605772917
1747352886945799,40318524,1,431,100,39768573,39477360,291213,343.39126343947555
1747352887039769,40411084,1,432,100,39862543,39569920,292623,341.7366372431422
1747352887130446,40503644,1,433,100,39953220,39662480,290740,343.9499208915182
1747352887224056,40596204,1,434,100,40046830,39755040,291790,342.71222454504954
1747352887318289,40688764,1,435,100,40141063,39847600,293463,340.75846018067017
1747352887422192,40781324,1,436,100,40244966,39940160,304806,328.0775312821926
1747352887621612,40969564,1,438,100,40444386,40128400,315986,316.4697170127791
1747352887699502,41062124,1,439,100,40522276,40220960,301316,331.8774973781678
1747352887793768,41154684,1,440,100,40616542,40313520,303022,330.0090422477576
1747352887880228,41247244,1,441,100,40703002,40406080,296922,336.78878628057197
1747352887978238,41339804,1,442,100,40801012,40498640,302372,330.7184527667906
1747352888068314,41432364,1,443,100,40891088,40591200,299888,333.4578242543883
1747352888161984,41524924,1,444,100,40984758,40683760,300998,332.22812111708384
1747352888256205,41617484,1,445,100,41078979,40776320,302659,330.4048450566479
1747352888346563,41710044,1,446,100,41169337,40868880,300457,332.8263278938417
1747352888440801,41802604,1,447,100,41263575,40961440,302135,330.97787412911447
1747352888551358,41895164,1,448,100,41374132,41054000,320132,312.37114690190293
1747352888633387,41990844,1,449,100,41456161,41149680,306481,326.2845005073724
1747352888743939,42086524,1,450,100,41566713,41245360,321353,311.18427399152955
1747352888846128,42179084,1,451,100,41668902,41337920,330982,302.1312337226798
1747352888919868,42274764,1,452,100,41742642,41433600,309042,323.58061363827574
1747352889018094,42367324,1,453,100,41840868,41526160,314708,317.75487118217524
1747352889104673,42459884,1,454,100,41927447,41618720,308727,323.910769061339
1747352889198646,42552444,1,455,100,42021420,41711280,310140,322.43502934158766
1747352889289126,42645004,1,456,100,42111900,41803840,308060,324.6120885541778
1747352889383031,42737564,1,457,100,42205805,41896400,309405,323.2009825309869
1747352889477331,42830124,1,458,100,42300105,41988960,311145,321.3935624869434
1747352889566764,42922684,1,459,100,42389538,42081520,308018,324.65635125219956
1747352889661783,43015244,1,460,100,42484557,42174080,310477,322.08504977824447
1747352889756008,43107804,1,461,100,42578782,42266640,312142,320.36701244946215
1747352889849775,43200364,1,462,100,42672549,42359200,313349,319.13297952123673
1747352889940154,43292924,1,463,100,42762928,42451760,311168,321.3698066639243
1747352890033906,43385484,1,464,100,42856680,42544320,312360,320.1434242540658
1747352890128151,43478052,1,465,100,42950925,42636888,314037,318.4338151236956
1747352890221966,43570604,1,466,100,43044740,42729440,315300,317.15826197272435
1747352890316627,43663164,1,467,100,43139401,42822000,317401,315.0588687496259
1747352890407262,43755724,1,468,100,43230036,42914560,315476,316.9813234604217
1747352890501359,43848284,1,469,100,43324133,43007120,317013,315.4444770403737
1747352890595463,43940844,1,470,100,43418237,43099680,318557,313.91556299186647
1747352890689027,44033404,1,471,100,43511801,43192240,319561,312.9292998832774
1747352890779781,44125964,1,472,100,43602555,43284800,317755,314.7078724174285
1747352890873609,44218524,1,473,100,43696383,43377360,319023,313.4570234747965
1747352890968067,44311084,1,474,100,43790841,43469920,320921,311.60316713459076
1747352891062044,44403644,1,475,100,43884818,43562480,322338,310.2333575315352
1747352891151947,44496204,1,476,100,43974721,43655040,319681,312.81183429731516
1747352891246279,44588764,1,477,100,44069053,43747600,321453,311.0874684635079
1747352891340672,44681324,1,478,100,44163446,43840160,323286,309.3236329442042
1747352891435004,44773884,1,479,100,44257778,43932720,325058,307.63740624750045
1747352891525452,44866444,1,480,100,44348226,44025280,322946,309.6492912127724
1747352891619502,44959004,1,481,100,44442276,44117840,324436,308.2272004339839
1747352891713750,45051564,1,482,100,44536524,44210400,326124,306.63183329040487
1747352891807380,45144124,1,483,100,44630154,44302960,327194,305.62907632780554
1747352891901489,45236684,1,484,100,44724263,44395520,328743,304.18898653355353
1747352891991479,45329244,1,485,100,44814253,44488080,326173,306.58576890177915
1747352892086514,45421804,1,486,100,44909288,44580640,328648,304.2769163360191
1747352892180589,45514364,1,487,100,45003363,44673200,330163,302.88069832173807
1747352892274619,45606932,1,488,100,45097393,44765768,331625,301.5454202789295
1747352892365028,45699484,1,489,100,45187802,44858320,329482,303.50671660363844
1747352892459058,45792044,1,490,100,45281832,44950880,330952,302.15862118977975
1747352892552552,45884604,1,491,100,45375326,45043440,331886,301.3082805541662
1747352892647099,45977164,1,492,100,45469873,45136000,333873,299.5150850772599
1747352892737248,46069724,1,493,100,45560022,45228560,331462,301.69370847940337
1747352893028235,46353644,1,496,100,45851009,45512480,338529,295.3956677271371
1747352893122518,46446204,1,497,100,45945292,45605040,340252,293.8998154309159
1747352893212513,46538772,1,498,100,46035287,45697608,337679,296.13923282170344
1747352893307039,46631324,1,499,100,46129813,45790160,339653,294.41812673522685
1747352893396742,46723884,1,500,100,46219516,45882720,336796,296.91564032826994
1747352893491032,46816444,1,501,100,46313806,45975280,338526,295.3982855083509
1747352893589283,46909004,1,502,100,46412057,46067840,344217,290.5144138726443
1747352893896447,47192924,1,505,100,46719221,46351760,367461,272.1377234590882
1747352893965652,47285484,1,506,100,46788426,46444320,344106,290.6081265656513
1747352894059896,47378044,1,507,100,46882670,46536880,345790,289.19286272014807
1747352894149850,47470612,1,508,100,46972624,46629448,343176,291.3956686947805
1747352894244145,47563164,1,509,100,47066919,46722000,344919,289.92314137522146
1747352894334360,47655724,1,510,100,47157134,46814560,342574,291.9077338034994
1747352894428515,47748284,1,511,100,47251289,46907120,344169,290.55493086245417
1747352894523405,47840844,1,512,100,47346179,46999680,346499,288.60112150395815
1747352894617426,47933404,1,513,100,47440200,47092240,347960,287.3893550982872
1747352894711671,48025964,1,514,100,47534445,47184800,349645,286.0043758669508
1747352894801444,48118524,1,515,100,47624218,47277360,346858,288.30241770407486
1747352894896143,48211084,1,516,100,47718917,47369920,348997,286.5354143445359
1747352894990152,48303644,1,517,100,47812926,47462480,350446,285.35066743521116
1747352895091925,48396204,1,518,100,47914699,47555040,359659,278.0411445285673
1747352895178617,48488764,1,519,100,48001391,47647600,353791,282.6527526138313
1747352895272259,48581324,1,520,100,48095033,47740160,354873,281.79095056541354
1747352895363041,48673884,1,521,100,48185815,47832720,353095,283.2099010181396
1747352895457178,48766444,1,522,100,48279952,47925280,354672,281.95064735868635
1747352895550695,48859004,1,523,100,48373469,48017840,355629,281.19191629479036
1747352895640777,48951564,1,524,100,48463551,48110400,353151,283.1649917457405
1747352895743792,49044124,1,525,100,48566566,48202960,363606,275.0229644175289
1747352895845328,49136684,1,526,100,48668102,48295520,372582,268.3972924081142
1747352895948676,49232364,1,527,100,48771450,48391200,380250,262.98487836949374
1747352896042124,49324924,1,528,100,48864898,48483760,381138,262.37215916544665
1747352896222895,49516284,1,530,100,49045669,48675120,370549,269.8698417753117
1747352897463278,50757004,1,543,100,50286052,49915840,370212,270.1155013883937
1747352897570430,50849564,1,544,100,50393204,50008400,384804,259.8725584973129
1747352897647948,50942124,1,545,100,50470722,50100960,369762,270.4442316949822
1747352897750828,51034684,1,546,100,50573602,50193520,380082,263.1011202845702
1747352897938878,51222924,1,548,100,50761652,50381760,379892,263.2327082433955
1747352898024708,51315484,1,549,100,50847482,50474320,373162,267.9801265938118
1747352898131450,51408044,1,550,100,50954224,50566880,387344,258.1684497500929
1747352898208940,51500604,1,551,100,51031714,50659440,372274,268.61935026351557
1747352898311045,51593164,1,552,100,51133819,50752000,381819,261.9042006814747
1747352898397048,51685724,1,553,100,51219822,50844560,375262,266.48048563403705
1747352898487533,51778284,1,554,100,51310307,50937120,373187,267.9621744594533
1747352898598057,51870844,1,555,100,51420831,51029680,391151,255.65574420108857
1747352898684142,51963404,1,556,100,51506916,51122240,384676,259.9590304568
1747352898770698,52055964,1,557,100,51593472,51214800,378672,264.08078759454094
1747352898862118,52148524,1,558,100,51684892,51307360,377532,264.878208999502
1747352898958632,52241084,1,559,100,51781406,51399920,381486,262.1328174559486
1747352899057154,52333644,1,560,100,51879928,51492480,387448,258.0991513699903
1747352899261350,52521884,1,562,100,52084124,51680720,403404,247.8904522513411
1747352899548906,52808924,1,565,100,52371680,51967760,403920,247.57377698554168
1747352899622442,52904604,1,566,100,52445216,52063440,381776,261.9336993420225
1747352900318695,53571244,1,573,100,53141469,52730080,411389,243.07893502256988
1747352900416316,53666924,1,574,100,53239090,52825760,413330,241.93743497931436
1747352900506579,53759484,1,575,100,53329353,52918320,411033,243.28946824220927
1747352900609488,53855164,1,576,100,53432262,53014000,418262,239.08459291066364
1747352900772039,54046524,1,578,100,53594813,53205360,389453,256.7703933465656
1747352900891436,54142204,1,579,100,53714210,53301040,413170,242.03112520270108
1747352900965232,54234764,1,580,100,53788006,53393600,394406,253.54583855215185
1747352901059854,54327332,1,581,100,53882628,53486168,396460,252.23225546082836
1747352901154128,54419884,1,582,100,53976902,53578720,398182,251.1414378349599
1747352901243856,54512444,1,583,100,54066630,53671280,395350,252.94043252813964
1747352901338546,54605004,1,584,100,54161320,53763840,397480,251.58498540807085
1747352901428794,54697564,1,585,100,54251568,53856400,395168,253.05692768645233
1747352901526767,54790124,1,586,100,54349541,53948960,400581,249.6374016740684
1747352901616773,54882684,1,587,100,54439547,54041520,398027,251.2392375391619
1747352901711378,54975244,1,588,100,54534152,54134080,400072,249.95500809854227
1747352901805547,55067804,1,589,100,54628321,54226640,401681,248.95377177411925
1747352901895628,55160364,1,590,100,54718402,54319200,399202,250.49974699525552
1747352901989354,55252924,1,591,100,54812128,54411760,400368,249.77021140550693
1747352902084056,55345484,1,592,100,54906830,54504320,402510,248.44103252093117
1747352902178150,55438044,1,593,100,55000924,54596880,404044,247.4977972696043
1747352902268149,55530604,1,594,100,55090923,54689440,401483,249.07654869571067
1747352902362365,55623164,1,595,100,55185139,54782000,403139,248.0534009361535
1747352902456577,55715724,1,596,100,55279351,54874560,404791,247.04106563634073
1747352902550933,55808284,1,597,100,55373707,54967120,406587,245.94982131745482
1747352902641015,55900844,1,598,100,55463789,55059680,404109,247.45798782011784
1747352902734694,55993404,1,599,100,55557468,55152240,405228,246.77465525580664
1747352902829594,56085964,1,600,100,55652368,55244800,407568,245.35782985906647
1747352902927822,56178524,1,601,100,55750596,55337360,413236,241.99246919435868
1747352903013019,56271084,1,602,100,55835793,55429920,405873,246.38248910373443
1747352903111539,56363644,1,603,100,55934313,55522480,411833,242.81686994485628
1747352903201583,56456212,1,604,100,56024357,55615048,409309,244.31419783097857
1747352903296486,56548764,1,605,100,56119260,55707600,411660,242.91891366661807
1747352903385783,56641324,1,606,100,56208557,55800160,408397,244.85978104638377
1747352903480676,56733884,1,607,100,56303450,55892720,410730,243.46894553599688
1747352903578439,56826444,1,608,100,56401213,55985280,415933,240.42333741251596
1747352903672405,56919004,1,609,100,56495179,56077840,417339,239.6133598824936
1747352903762392,57011564,1,610,100,56585166,56170400,414766,241.09980085156448
1747352903856619,57104124,1,611,100,56679393,56262960,416433,240.13466752154608
1747352903951213,57196684,1,612,100,56773987,56355520,418467,238.96746935839624
1747352904041576,57289244,1,613,100,56864350,56448080,416270,240.22869772022966
1747352904139581,57381804,1,614,100,56962355,56540640,421715,237.12696963589153
1747352904226025,57474364,1,615,100,57048799,56633200,415599,240.6165558627427
1747352904324447,57566924,1,616,100,57147221,56725760,421461,237.26987787719386
1747352904414359,57659484,1,617,100,57237133,56818320,418813,238.77004773013255
1747352904511991,57752044,1,618,100,57334765,56910880,423885,235.913042452552
1747352904598910,57844604,1,619,100,57421684,57003440,418244,239.09488241313682
1747352904693143,57937164,1,620,100,57515917,57096000,419917,238.1422995496729
1747352904786515,58029724,1,621,100,57609289,57188560,420729,237.68268885672248
1747352904880738,58122284,1,622,100,57703512,57281120,422392,236.7469080853804
1747352904979469,58214844,1,623,100,57802243,57373680,428563,233.33792231247213
1747352905069033,58307404,1,624,100,57891807,57466240,425567,234.9806258473989
1747352905159918,58399964,1,625,100,57982692,57558800,423892,235.90914666943468
1747352905257414,58492524,1,626,100,58080188,57651360,428828,233.19372802149115
1747352905351643,58585084,1,627,100,58174417,57743920,430497,232.28965590933268
1747352905442562,58677644,1,628,100,58265336,57836480,428856,233.17850280746916
1747352905532688,58770204,1,629,100,58355462,57929040,426422,234.50947652794648
1747352905626958,58862764,1,630,100,58449732,58021600,428132,233.57282333485932
1747352905732959,58955324,1,631,100,58555733,58114160,441573,226.46312161296095
1747352905815056,59047884,1,632,100,58637830,58206720,431110,231.95936072000185
1747352905917609,59140444,1,633,100,58740383,58299280,441103,226.7044205094955
1747352906011479,59233004,1,634,100,58834253,58391840,442413,226.03314097913037
1747352906114142,59325564,1,635,100,58936916,58484400,452516,220.98666124512727
1747352906191726,59421244,1,636,100,59014500,58580080,434420,230.19198011141293
1747352906282148,59513804,1,637,100,59104922,58672640,432282,231.3304740886736
1747352906474376,59702044,1,639,100,59297150,58860880,436270,229.21585256836363
1747352906564431,59794604,1,640,100,59387205,58953440,433765,230.5395778820329
1747352906658947,59887164,1,641,100,59481721,59046000,435721,229.50466009212315
1747352906753305,59979724,1,642,100,59576079,59138560,437519,228.56150247189265
1747352906843158,60072284,1,643,100,59665932,59231120,434812,229.98445305097377
1747352906937153,60164844,1,644,100,59759927,59323680,436247,229.22793738409663
1747352907031305,60257404,1,645,100,59854079,59416240,437839,228.3944554961984
1747352907125166,60349964,1,646,100,59947940,59508800,439140,227.71781208726148
1747352907215584,60442524,1,647,100,60038358,59601360,436998,228.8339992402711
1747352907309307,60535084,1,648,100,60132081,59693920,438161,228.2266107663621
1747352907404444,60627644,1,649,100,60227218,59786480,440738,226.89216722860291
1747352907498356,60720204,1,650,100,60321130,59879040,442090,226.19828541699655
1747352907592259,60812764,1,651,100,60415033,59971600,443433,225.51321169150694
1747352907682451,60905324,1,652,100,60505225,60064160,441065,226.72395225193566
1747352907789307,60997884,1,653,100,60612081,60156720,455361,219.60598294539935
1747352907878900,61090444,1,654,100,60701674,60249280,452394,221.04625613955974
1747352907965159,61183012,1,655,100,60787933,60341848,446085,224.17252317383458
1747352908055467,61275564,1,656,100,60878241,60434400,443841,225.30590909807793
1747352908251854,61463804,1,658,100,61074628,60622640,451988,221.24481180916308
1747352908358435,61556364,1,659,100,61181209,60715200,466009,214.58813027216212
1747352908432428,61648932,1,660,100,61255202,60807768,447434,223.49664978521972
1747352908526386,61741484,1,661,100,61349160,60900320,448840,222.79654219766508
1747352908620530,61834044,1,662,100,61443304,60992880,450424,222.01303660550948
1747352908735317,61926604,1,663,100,61558091,61085440,472651,211.5725979634022
1747352908820928,62019164,1,664,100,61643702,61178000,465702,214.72959102602093
1747352908911523,62111724,1,665,100,61734297,61270560,463737,215.63946806056018
1747352908996707,62204284,1,666,100,61819481,61363120,456361,219.12477183633132
1747352909099115,62296844,1,667,100,61921889,61455680,466209,214.49607364937185
1747352909177212,62389404,1,668,100,61999986,61548240,451746,221.36333249215267
1747352909279240,62481964,1,669,100,62102014,61640800,461214,216.81909048727923
1747352909365667,62574524,1,670,100,62188441,61733360,455081,219.74110103476085
1747352909459841,62667084,1,671,100,62282615,61825920,456695,218.96451680005254
1747352909554472,62759644,1,672,100,62377246,61918480,458766,217.97604879175876
1747352909644352,62852204,1,673,100,62467126,62011040,456086,219.2568945330486
1747352909738060,62944764,1,674,100,62560834,62103600,457234,218.70639541241465
1747352909833015,63037324,1,675,100,62655789,62196160,459629,217.5667766829334
1747352909927055,63129884,1,676,100,62749829,62288720,461109,216.86846277127535
1747352910017166,63222444,1,677,100,62839940,62381280,458660,218.02642480268608
1747352910111016,63315004,1,678,100,62933790,62473840,459950,217.4149364061311
1747352910205327,63407564,1,679,100,63028101,62566400,461701,216.59039075072397
1747352910295773,63500124,1,680,100,63118547,62658960,459587,217.58665932674336
1747352910393391,63592684,1,681,100,63216165,62751520,464645,215.21806970913278
1747352910484214,63685244,1,682,100,63306988,62844080,462908,216.02564656476017
1747352910577780,63777812,1,683,100,63400554,62936648,463906,215.56091104663446
1747352912212247,65401244,1,700,100,65035021,64560080,474941,210.55246862241836
1747352912306988,65493804,1,701,100,65129762,64652640,477122,209.59000004191802
1747352912405468,65586364,1,702,100,65228242,64745200,483042,207.02133561884887
1747352912495568,65678924,1,703,100,65318342,64837760,480582,208.08103507830089
1747352912585479,65771484,1,704,100,65408253,64930320,477933,209.23434874762782
1747352912679382,65864044,1,705,100,65502156,65022880,479276,208.6480441332343
1747352912777556,65956604,1,706,100,65600330,65115440,484890,206.2323413557714
1747352912867824,66049164,1,707,100,65690598,65208000,482598,207.21179946870893
1747352912962086,66141724,1,708,100,65784860,65300560,484300,206.48358455502787
1747352913056164,66234284,1,709,100,65878938,65393120,485818,205.8384003886229
1747352913150645,66326844,1,710,100,65973419,65485680,487739,205.02768898939803
1747352913244551,66419404,1,711,100,66067325,65578240,489085,204.4634368259096
1747352913334436,66511964,1,712,100,66157210,65670800,486410,205.58787853868137
1747352913429275,66604524,1,713,100,66252049,65763360,488689,204.62911995154383
1747352913519105,66697084,1,714,100,66341879,65855920,485959,205.77867680195243
1747352913609092,66789644,1,715,100,66431866,65948480,483386,206.8740095906791
1747352913719584,66882204,1,716,100,66542358,66041040,501318,199.47418604558382
1747352913801680,66974764,1,717,100,66624454,66133600,490854,203.7265663517054
1747352913891659,67067324,1,718,100,66714433,66226160,488273,204.8034603592662
1747352913986029,67159884,1,719,100,66808803,66318720,490083,204.04706957801025
1747352914075702,67252444,1,720,100,66898476,66411280,487196,205.25620078982584
1747352914170041,67345004,1,721,100,66992815,66503840,488975,204.50943299759703
1747352914264236,67437564,1,722,100,67087010,66596400,490610,203.82788773159945
1747352914362244,67530124,1,723,100,67185018,66688960,496058,201.58933027992694
1747352914452330,67622684,1,724,100,67275104,66781520,493584,202.599760121884
1747352914547227,67715244,1,725,100,67370001,66874080,495921,201.64502007376174
1747352914637309,67807804,1,726,100,67460083,66966640,493443,202.65765245428548
1747352914734908,67900364,1,727,100,67557682,67059200,498482,200.60904907298558
1747352914825748,67992924,1,728,100,67648522,67151760,496762,201.30364238810537
1747352914914996,68085484,1,729,100,67737770,67244320,493450,202.6547775863816
1747352915009438,68178044,1,730,100,67832212,67336880,495332,201.8847964597482
1747352915120646,68270604,1,731,100,67943420,67429440,513980,194.56009961477102
1747352915215026,68363164,1,732,100,68037800,67522000,515800,193.87359441644045
1747352916835975,69989724,1,749,100,69658749,69148560,510189,196.0057939312686
1747352916946943,70082284,1,750,100,69769717,69241120,528597,189.18003696577924
1747352917033162,70177964,1,751,100,69855936,69336800,519136,192.62775072428033
1747352917229630,70366204,1,753,100,70052404,69525040,527364,189.62234813146137
1747352917307765,70458764,1,754,100,70130539,69617600,512939,194.95495565749533
1747352917401859,70551324,1,755,100,70224633,69710160,514473,194.37366003658113
1747352917492237,70643884,1,756,100,70315011,69802720,512291,195.20155536599313
1747352917590256,70736444,1,757,100,70413030,69895280,517750,193.1434089811685
1747352917680595,70829004,1,758,100,70503369,69987840,515529,193.97550865227757
1747352917774176,70921564,1,759,100,70596950,70080400,516550,193.59210144226117
1747352917868953,71014124,1,760,100,70691727,70172960,518767,192.76476722690535
1747352917970950,71106684,1,761,100,70793724,70265520,528204,189.32079272402328
1747352918053174,71199244,1,762,100,70875948,70358080,517868,193.09939984706529
1747352918146810,71291804,1,763,100,70969584,70450640,518944,192.69901954738856
1747352918240957,71384364,1,764,100,71063731,70543200,520531,192.11151689332624
1747352918335826,71476924,1,765,100,71158600,70635760,522840,191.2631015224543
1747352918425704,71569484,1,766,100,71248478,70728320,520158,192.2492781039607
1747352918519978,71662044,1,767,100,71342752,70820880,521872,191.61786798295367
1747352918613630,71754604,1,768,100,71436404,70913440,522964,191.21775112627256
1747352918704229,71847164,1,769,100,71527003,71006000,521003,191.9374744483237
1747352918798226,71939724,1,770,100,71621000,71098560,522440,191.40953985146618
1747352918892252,72032292,1,771,100,71715026,71191128,523898,190.87685007386935
1747352918986767,72124844,1,772,100,71809541,71283680,525861,190.16432098976725
1747352919080817,72217404,1,773,100,71903591,71376240,527351,189.6270226092299
1747352919175404,72309964,1,774,100,71998178,71468800,529378,188.90093657084353
1747352919265377,72402524,1,775,100,72088151,71561360,526791,189.82860375367082
1747352919359447,72495084,1,776,100,72182221,71653920,528301,189.28603201583945
1747352919453468,72587644,1,777,100,72276242,71746480,529762,188.76401100871715
1747352919543919,72680204,1,778,100,72366693,71839040,527653,189.51849037151308
1747352919638259,72772764,1,779,100,72461033,71931600,529433,188.88131264957036
1747352919732502,72865324,1,780,100,72555276,72024160,531116,188.2827856814707
1747352919826600,72957884,1,781,100,72649374,72116720,532654,187.7391327203025
1747352919916439,73050444,1,782,100,72739213,72209280,529933,188.70310020323325
1747352920010730,73143004,1,783,100,72833504,72301840,531664,188.08871768635828
1747352920104836,73235564,1,784,100,72927610,72394400,533210,187.54336940417474
1747352920199422,73328124,1,785,100,73022196,72486960,535236,186.8334715901023
1747352920289202,73420684,1,786,100,73111976,72579520,532456,187.80894571570232
1747352920387585,73513244,1,787,100,73210359,72672080,538279,185.77726420685187
1747352920477389,73605804,1,788,100,73300163,72764640,535523,186.73334291897828
1747352920571179,73698364,1,789,100,73393953,72857200,536753,186.3054328527274
1747352920661749,73790924,1,790,100,73484523,72949760,534763,186.9987265386723
1747352920756002,73883484,1,791,100,73578776,73042320,536456,186.40857777711497
1747352920850081,73976044,1,792,100,73672855,73134880,537975,185.88224359868025
1747352920944032,74068604,1,793,100,73766806,73227440,539366,185.40286187857595
1747352921034559,74161172,1,794,100,73857333,73320008,537325,186.10710463871956
1747352921129024,74253724,1,795,100,73951798,73412560,539238,185.44687132583385
1747352921226885,74346284,1,796,100,74049659,73505120,544539,183.64157571817628
1747352921317583,74438844,1,797,100,74140357,73597680,542677,184.27167541650007
1747352921423457,74531404,1,798,100,74246231,73690240,555991,179.8590264950332
1747352921505685,74623964,1,799,100,74328459,73782800,545659,183.26463963757584
1747352921604252,74716524,1,800,100,74427026,73875360,551666,181.26910123154227
1747352921690073,74809084,1,801,100,74512847,73967920,544927,183.51081888032707
1747352921784216,74901644,1,802,100,74606990,74060480,546510,182.9792684488847
1747352921874059,74994204,1,803,100,74696833,74153040,543793,183.89350359419853
1747352921984775,75086764,1,804,100,74807549,74245600,561949,177.95209173786233
1747352922070777,75179324,1,805,100,74893551,74338160,555391,180.05333179687824
1747352922169332,75271884,1,806,100,74992106,74430720,561386,178.13055544669797
1747352922279245,75364444,1,807,100,75102019,74523280,578739,172.78946122518096
1747352922755085,75839724,1,812,100,75577859,74998560,579299,172.62242814159873
1747352922832443,75935404,1,813,100,75655217,75094240,560977,178.26042778937463
1747352922918098,76027964,1,814,100,75740872,75186800,554072,180.48195902337602
1747352923008813,76120524,1,815,100,75831587,75279360,552227,181.08495238371177
1747352923102327,76213084,1,816,100,75925101,75371920,553181,180.77265849694766
1747352923196859,76305644,1,817,100,76019633,75464480,555153,180.13052257665905
1747352923291048,76398204,1,818,100,76113822,75557040,556782,179.6035072972905
1747352923381291,76490772,1,819,100,76204065,75649608,554457,180.35663721442782
1747352923475139,76583324,1,820,100,76297913,75742160,555753,179.9360507275714
1747352923570155,76675884,1,821,100,76392929,75834720,558209,179.1443706568687
1747352923664140,76768444,1,822,100,76486914,75927280,559634,178.68821408277554
1747352923758149,76861004,1,823,100,76580923,76019840,561083,178.22675076592947
1747352923852669,76953564,1,824,100,76675443,76112400,563043,177.606328468696
1747352923941767,77046124,1,825,100,76764541,76204960,559581,178.70513830884178
1747352924036579,77138684,1,826,100,76859353,76297520,561833,177.98883298061878
1747352924130673,77231244,1,827,100,76953447,76390080,563367,177.5041846611534
1747352924220664,77323804,1,828,100,77043438,76482640,560798,178.31732638133516
1747352924315523,77416364,1,829,100,77138297,76575200,563097,177.58929633793113
1747352924413630,77508924,1,830,100,77236404,76667760,568644,175.85695092184213
1747352924503584,77601484,1,831,100,77326358,76760320,566038,176.6665842222607
1747352924593291,77694044,1,832,100,77416065,76852880,563185,177.5615472713229
1747352924691490,77786604,1,833,100,77514264,76945440,568824,175.8013023360477
1747352924782173,77879164,1,834,100,77604947,77038000,566947,176.38333036421395
1747352924876566,77971724,1,835,100,77699340,77130560,568780,175.81490207109957
1747352924970846,78064284,1,836,100,77793620,77223120,570500,175.28483786152498
1747352925060958,78156844,1,837,100,77883732,77315680,568052,176.0402216698471
1747352925155116,78249404,1,838,100,77977890,77408240,569650,175.54638813306417
1747352925249203,78341964,1,839,100,78071977,77500800,571177,175.0770776834501
1747352925342721,78434524,1,840,100,78165495,77593360,572135,174.783923374728
1747352925433702,78527084,1,841,100,78256476,77685920,570556,175.26763367662423
1747352925527424,78619644,1,842,100,78350198,77778480,571718,174.91140737216602
1747352925621872,78712204,1,843,100,78444646,77871040,573606,174.33569383862792
1747352925716210,78804764,1,844,100,78538984,77963600,575384,173.7969773229704
1747352925805921,78897324,1,845,100,78628695,78056160,572535,174.66181106831897
1747352925900216,78989884,1,846,100,78722990,78148720,574270,174.13411809775891
1747352925994691,79082444,1,847,100,78817465,78241280,576185,173.5553685014362
1747352926088019,79175004,1,848,100,78910793,78333840,576953,173.32434357737978
1747352926178399,79267564,1,849,100,79001173,78426400,574773,173.98172843887934
1747352926272882,79360124,1,850,100,79095656,78518960,576696,173.40158419687322
1747352926366939,79452684,1,851,100,79189713,78611520,578193,172.95263000416818
1747352926461104,79545244,1,852,100,79283878,78704080,579798,172.4738615862766
1747352926551062,79637804,1,853,100,79373836,78796640,577196,173.25137388339488
1747352926650112,79730364,1,854,100,79472886,78889200,583686,171.32499323266276
1747352926747606,79822924,1,855,100,79570380,78981760,588620,169.8888926641976
1747352926834044,79915484,1,856,100,79656818,79074320,582498,171.6744091825208
1747352926928024,80008044,1,857,100,79750798,79166880,583918,171.25692306111472
1747352927018341,80100604,1,858,100,79841115,79259440,581675,171.91730777496022
1747352927112199,80193164,1,859,100,79934973,79352000,582973,171.5345307587144
1747352927207074,80285732,1,860,100,80029848,79444568,585280,170.85839256424276
1747352927300510,80378284,1,861,100,80123284,79537120,586164,170.60071925263236
1747352927390121,80470844,1,862,100,80212895,79629680,583215,171.46335399466747
1747352927489089,80563404,1,863,100,80311863,79722240,589623,169.5998968832627
1747352927579405,80655964,1,864,100,80402179,79814800,587379,170.24782976579007
1747352927673176,80748524,1,865,100,80495950,79907360,588590,169.89755177627893
1747352927764140,80841084,1,866,100,80586914,79999920,586994,170.35949260128723
1747352927862203,80933644,1,867,100,80684977,80092480,592497,168.77722587624916
1747352927952383,81026204,1,868,100,80775157,80185040,590117,169.4579210563329
1747352928045979,81118764,1,869,100,80868753,80277600,591153,169.16094479770888
1747352928140499,81211324,1,870,100,80963273,80370160,593113,168.60193588742786
1747352928230487,81303884,1,871,100,81053261,80462720,590541,169.33625269032973
1747352928325240,81396444,1,872,100,81148014,80555280,592734,168.70974163790166
1747352928427273,81489004,1,873,100,81250047,80647840,602207,166.05585786947012
1747352928513384,81581564,1,874,100,81336158,80740400,595758,167.85339013492055
1747352928607382,81674124,1,875,100,81430156,80832960,597196,167.4492126538021
1747352928697901,81766684,1,876,100,81520675,80925520,595155,168.023456074468
1747352928791911,81859244,1,877,100,81614685,81018080,596605,167.61508871028568
1747352928886139,81951804,1,878,100,81708913,81110640,598273,167.1477736752285
1747352928976341,82044364,1,879,100,81799115,81203200,595915,167.80916741481587
1747352929069753,82136924,1,880,100,81892527,81295760,596767,167.56958746043261
1747352929164152,82229484,1,881,100,81986926,81388320,598606,167.0547906302309
1747352929258305,82322044,1,882,100,82081079,81480880,600199,166.6114072166065
1747352929352703,82414612,1,883,100,82175477,81573448,602029,166.10495507691488
1747352929450855,82507164,1,884,100,82273629,81666000,607629,164.5741068974654
1747352929537010,82599724,1,885,100,82359784,81758560,601224,166.3273588546033
1747352929631169,82692284,1,886,100,82453943,81851120,602823,165.88617222634173
1747352929721259,82784844,1,887,100,82544033,81943680,600353,166.56866876654234
1747352929816043,82877404,1,888,100,82638817,82036240,602577,165.9538946889775
1747352929909897,82969964,1,889,100,82732671,82128800,603871,165.59828175222853
1747352930004192,83062524,1,890,100,82826966,82221360,605606,165.12385940694116
1747352930098514,83155084,1,891,100,82921288,82313920,607368,164.6448281766573
1747352930188662,83247644,1,892,100,83011436,82406480,604956,165.30127810948233
1747352930283023,83340204,1,893,100,83105797,82499040,606757,164.81062435208824
1747352930381045,83432764,1,894,100,83203819,82591600,612219,163.3402426255964
1747352930475105,83525324,1,895,100,83297879,82684160,613719,162.94102023890412
1747352930564831,83617884,1,896,100,83387605,82776720,610885,163.696931501019
1747352930684491,83710444,1,897,100,83507265,82869280,637985,156.74349710416388
1747352933952231,86960444,1,931,100,86775005,86119280,655725,152.50295474474817
1747352934046335,87053004,1,932,100,86869109,86211840,657269,152.14470787455366
1747352934214604,87241244,1,934,100,87037378,86400080,637298,156.91246481237977
1747352934312432,87333804,1,935,100,87135206,86492640,642566,155.62603685847057
1747352934402945,87426364,1,936,100,87225719,86585200,640519,156.12339368543323
1747352934492942,87518924,1,937,100,87315716,86677760,637956,156.75062229997053
1747352934612253,87611484,1,938,100,87435027,86770320,664707,150.44222492015277
1747352934689944,87704044,1,939,100,87512718,86862880,649838,153.88450660010648
1747352934775979,87796604,1,940,100,87598753,86955440,643313,155.44532754662194
1747352934869384,87889164,1,941,100,87692158,87048000,644158,155.24141592590638
1747352934959453,87981724,1,942,100,87782227,87140560,641667,155.84407488619487
1747352935053845,88074284,1,943,100,87876619,87233120,643499,155.40039689261366
1747352935152689,88166844,1,944,100,87975463,87325680,649783,153.8975319452802
1747352935922633,88929164,1,952,100,88745407,88088000,657407,152.11277032340698
1747352936114512,89117404,1,954,100,88937286,88276240,661046,151.27540292203568
1747352936504305,89497004,1,958,100,89327079,88655840,671239,148.978232790407
1747352936585401,89589564,1,959,100,89408175,88748400,659775,151.56682202265924
1747352936680151,89682124,1,960,100,89502925,88840960,661965,151.06538865347866
1747352936765846,89774684,1,961,100,89588620,88933520,655100,152.64845061822624
1747352936860741,89867244,1,962,100,89683515,89026080,657435,152.1062918767635
1747352936950763,89959804,1,963,100,89773537,89118640,654897,152.69576742602274
1747352937045042,90052364,1,964,100,89867816,89211200,656616,152.29601471788686
1747352937138852,90144924,1,965,100,89961626,89303760,657866,152.00663965001993
1747352937228879,90237484,1,966,100,90051653,89396320,655333,152.59417731138214
1747352937323068,90330044,1,967,100,90145842,89488880,656962,152.21580548037784
1747352937416831,90422604,1,968,100,90239605,89581440,658165,151.93758404047617
1747352937511750,90515164,1,969,100,90334524,89674000,660524,151.39495309784354
1747352938014732,90990444,1,974,100,90837506,90149280,688226,145.30110748504126
1747352938084528,91086124,1,975,100,90907302,90244960,662342,150.97940338978958
1747352938178728,91178684,1,976,100,91001502,90337520,663982,150.606492344672
1747352938273562,91271244,1,977,100,91096336,90430080,666256,150.09245695348335
1747352938420561,91363804,1,978,100,91243335,90522640,720695,138.754951817343
1747352938462015,91456364,1,979,100,91284789,90615200,669589,149.34534468158827
1747352938551588,91548924,1,980,100,91374362,90707760,666602,150.0145514114869
1747352938645722,91641484,1,981,100,91468496,90800320,668176,149.66116711764565
1747352938740358,91734052,1,982,100,91563132,90892888,670244,149.19939604084485
1747352938829810,91826604,1,983,100,91652584,90985440,667144,149.89267684338014
1747352938923473,91919164,1,984,100,91746247,91078000,668247,149.6452658971907
1747352939018526,92011724,1,985,100,91841300,91170560,670740,149.08906580791364
1747352939112849,92104284,1,986,100,91935623,91263120,672503,148.6982214205736
1747352939202802,92196844,1,987,100,92025576,91355680,669896,149.2769026834016
1747352939301477,92289404,1,988,100,92124251,91448240,676011,147.92658699340691
1747352939390731,92381964,1,989,100,92213505,91540800,672705,148.65357028712438
1747352939489962,92474524,1,990,100,92312736,91633360,679376,147.19389557476273
1747352939575503,92567084,1,991,100,92398277,91725920,672357,148.73051072570078
1747352939670158,92659644,1,992,100,92492932,91818480,674452,148.26852022086078
1747352939764135,92752204,1,993,100,92586909,91911040,675869,147.9576663525032
1747352939857708,92844764,1,994,100,92680482,92003600,676882,147.7362376307835
1747352939948077,92937324,1,995,100,92770851,92096160,674691,148.21599813840706
1747352940046218,93029884,1,996,100,92868992,92188720,680272,147.00002352000377
1747352940136944,93122444,1,997,100,92959718,92281280,678438,147.3974040369201
1747352940230765,93215004,1,998,100,93053539,92373840,679699,147.12394751206048
1747352940325342,93307564,1,999,100,93148116,92466400,681716,146.68865040574082
1747352940419431,93400124,1,1000,100,93242205,92558960,683245,146.36038317148314
1747352940513645,93493724,1,1001,100,93336419,92652560,683859,146.2289741013864
1747352940611483,93587324,1,1002,100,93434257,92746160,688097,145.32834760215493
1747352940702117,93680924,1,1003,100,93524891,92839760,685131,145.95748842192222
1747352940796234,93774524,1,1004,100,93619008,92933360,685648,145.84743191841878
1747352940890696,93868124,1,1005,100,93713470,93026960,686510,145.66430204949674
1747352940984464,93961724,1,1006,100,93807238,93120560,686678,145.6286643812675
1747352941078386,94055324,1,1007,100,93901160,93214160,687000,145.56040756914118
1747352941173276,94148924,1,1008,100,93996050,93307760,688290,145.28759679786137
1747352941267381,94242524,1,1009,100,94090155,93401360,688795,145.18107709841098
1747352941361834,94336124,1,1010,100,94184608,93494960,689648,145.00150801568336
1747352941456043,94429724,1,1011,100,94278817,93588560,690257,144.87357607383916
1747352941549385,94523324,1,1012,100,94372159,93682160,689999,144.92774627209604
1747352941644002,94616924,1,1013,100,94466776,93775760,691016,144.71444944834852
1747352941738080,94710524,1,1014,100,94560854,93869360,691494,144.6144145863883
1747352941832198,94804124,1,1015,100,94654972,93962960,692012,144.50616463298326
1747352941926225,94897724,1,1016,100,94748999,94056560,692439,144.41705334332698
1747352942020740,94991324,1,1017,100,94843514,94150160,693354,144.2264701725237
1747352942114550,95084924,1,1018,100,94937324,94243760,693564,144.18280072206747
1747352942209136,95178524,1,1019,100,95031910,94337360,694550,143.97811532647037
1747352942303632,95272124,1,1020,100,95126406,94430960,695446,143.79261653672606
1747352942398299,95365724,1,1021,100,95221073,94524560,696513,143.57233820474275
1747352942491863,95459324,1,1022,100,95314637,94618160,696477,143.5797592741756
1747352942585800,95552924,1,1023,100,95408574,94711760,696814,143.51031982709875
1747352942680080,95646524,1,1024,100,95502854,94805360,697494,143.37040892108033
1747352942774987,95740124,1,1025,100,95597761,94898960,698801,143.102256579484
1747352942869309,95833724,1,1026,100,95692083,94992560,699523,142.95455617613717
1747352942963765,95927332,1,1027,100,95786539,95086168,700371,142.78146867874312
1747352943057195,96020924,1,1028,100,95879969,95179760,700209,142.81450252710263
1747352943151426,96114524,1,1029,100,95974200,95273360,700840,142.68591975343872
1747352943245645,96208124,1,1030,100,96068419,95366960,701459,142.56000707097633
1747352943340067,96301724,1,1031,100,96162841,95460560,702281,142.3931446244452
1747352943434004,96395324,1,1032,100,96256778,95554160,702618,142.3248479259
1747352943528286,96488924,1,1033,100,96351060,95647760,703300,142.18683349921795
1747352943622559,96582524,1,1034,100,96445333,95741360,703973,142.05090252040918
1747352943717036,96676124,1,1035,100,96539810,95834960,704850,141.87415762218913
1747352943810875,96769724,1,1036,100,96633649,95928560,705089,141.82606734752636
1747352943909195,96863324,1,1037,100,96731969,96022160,709809,140.88296992571242
1747352943999409,96956924,1,1038,100,96822183,96115760,706423,141.55824484763377
1747352944093632,97050524,1,1039,100,96916406,96209360,707046,141.43351351962957
1747352944191147,97144124,1,1040,100,97013921,96302960,710961,140.65469132624716
1747352944286011,97237724,1,1041,100,97108785,96396560,712225,140.4050686229773
1747352944375641,97331324,1,1042,100,97198415,96490160,708255,141.1920847717277
1747352944474124,97424924,1,1043,100,97296898,96583760,713138,140.22531403459078
1747352944564195,97518524,1,1044,100,97386969,96677360,709609,140.9226771362821
1747352944662509,97612124,1,1045,100,97485283,96770960,714323,139.9926923814577
1747352944756809,97705724,1,1046,100,97579583,96864560,715023,139.8556410073522
1747352944850480,97799324,1,1047,100,97673254,96958160,715094,139.84175506996283
1747352944945340,97892924,1,1048,100,97768114,97051760,716354,139.59578644078206
1747352945039613,97986524,1,1049,100,97862387,97145360,717027,139.46476213587493
1747352945133716,98080124,1,1050,100,97956490,97238960,717530,139.36699510821848
1747352945227592,98173724,1,1051,100,98050366,97332560,717806,139.31340780099356
1747352945321951,98267324,1,1052,100,98144725,97426160,718565,139.16625496649573
1747352945416546,98360924,1,1053,100,98239320,97519760,719560,138.9738173328145
1747352945510691,98454524,1,1054,100,98333465,97613360,720105,138.86863721262873
1747352945604425,98548124,1,1055,100,98427199,97706960,720239,138.8428007925147
1747352945698718,98641724,1,1056,100,98521492,97800560,720932,138.70933735775358
1747352945792713,98735324,1,1057,100,98615487,97894160,721327,138.63337986793783
1747352945887197,98828924,1,1058,100,98709971,97987760,722211,138.46368997425958
1747352945981743,98922532,1,1059,100,98804517,98081368,723149,138.28408806483864
1747352946075920,99016124,1,1060,100,98898694,98174960,723734,138.17231192675763
1747352946169361,99109724,1,1061,100,98992135,98268560,723575,138.2026742217462
1747352946264389,99203324,1,1062,100,99087163,98362160,725003,137.93046373601214
1747352946370845,99296924,1,1063,100,99193619,98455760,737859,135.52724843093327
1747352946551024,99487244,1,1065,100,99373798,98646080,727718,137.4158671353464
1747352946645041,99580844,1,1066,100,99467815,98739680,728135,137.33716961827133
1747352946738897,99674444,1,1067,100,99561671,98833280,728391,137.28890115336407
1747352946833621,99768044,1,1068,100,99656395,98926880,729515,137.07737332337237
1747352946927649,99861644,1,1069,100,99750423,99020480,729943,136.99699839576516
1747352947021375,99955244,1,1070,100,99844149,99114080,730069,136.97335457333486
1747352947115591,100048844,1,1071,100,99938365,99207680,730685,136.85787993458192
1747352947210204,100143484,1,1072,100,100032978,99302320,730658,136.86293724286875
1747352947324745,100238124,1,1073,100,100147519,99396960,750559,133.23402956996054
1747352948020632,100922444,1,1080,100,100843406,100081280,762126,131.21189934472778
1747352948209519,101114844,1,1082,100,101032293,100273680,758613,131.81951798875053
1747352948987794,101896924,1,1090,100,101810568,101055760,754808,132.4840224268953
1747352949196838,102092444,1,1092,100,102019612,101251280,768332,130.15206967821203
1747352949298552,102190204,1,1093,100,102121326,101349040,772286,129.48570866233493
1747352949389168,102284844,1,1094,100,102211942,101443680,768262,130.1639284514918
1747352949467045,102379484,1,1095,100,102289819,101538320,751499,133.06737600449236
1747352949564718,102474124,1,1096,100,102387492,101632960,754532,132.53248371175775
1747352949655385,102568764,1,1097,100,102478159,101727600,750559,133.23402956996054
1747352949749346,102663404,1,1098,100,102572120,101822240,749880,133.3546700805462
1747352949950058,102855804,1,1100,100,102772832,102014640,758192,131.8927131913816
1747352951523127,104416844,1,1116,100,104345901,103575680,770221,129.8328661514033
1747352951641847,104511484,1,1117,100,104464621,103670320,794301,125.89685774032765
1747352952808775,105684604,1,1129,100,105631549,104843440,788109,126.8860018093944
1747352952911069,105782364,1,1130,100,105733843,104941200,792643,126.16020074611143
1747352952993342,105877004,1,1131,100,105816116,105035840,780276,128.15977936012385
1747352953091139,105974764,1,1132,100,105913913,105133600,780313,128.1537024245399
1747352953186275,106069404,1,1133,100,106009049,105228240,780809,128.0722942486575
1747352953284442,106164044,1,1134,100,106107216,105322880,784336,127.49637910283347
1747352953382750,106258684,1,1135,100,106205524,105417520,788004,126.90290912228872
1747352953480453,106353324,1,1136,100,106303227,105512160,791067,126.41154289080445
1747352953582683,106447964,1,1137,100,106405457,105606800,798657,125.21019661757175
1747352953758722,106643492,1,1139,100,106581496,105802328,779168,128.3420263665859
1747352953852797,106738124,1,1140,100,106675571,105896960,778611,128.43383923422607
1747352953951886,106832764,1,1141,100,106774660,105991600,783060,127.70413505989325
1747352954045572,106927404,1,1142,100,106868346,106086240,782106,127.85990645769245
1747352954139940,107022044,1,1143,100,106962714,106180880,781834,127.9043889112011
1747352954234605,107116684,1,1144,100,107057379,106275520,781859,127.90029915879974
1747352954332091,107211324,1,1145,100,107154865,106370160,784705,127.4364251534016
1747352954426327,107305964,1,1146,100,107249101,106464800,784301,127.502068721065
1747352954521019,107400604,1,1147,100,107343793,106559440,784353,127.49361575719097
1747352954619009,107495244,1,1148,100,107441783,106654080,787703,126.95140173390224
1747352954713334,107589884,1,1149,100,107536108,106748720,787388,127.00218951774728
1747352954811957,107684524,1,1150,100,107634731,106843360,791371,126.36298272238936
1747352954901754,107779164,1,1151,100,107724528,106938000,786528,127.14105537247244
1747352955007770,107873804,1,1152,100,107830544,107032640,797904,125.32836030399648
1747352955098575,107968444,1,1153,100,107921349,107127280,794069,125.93364052746045
1747352955188779,108063084,1,1154,100,108011553,107221920,789633,126.64111049056966
1747352955282248,108157724,1,1155,100,108105022,107316560,788462,126.82919405120349
1747352955380810,108252364,1,1156,100,108203584,107411200,792384,126.20143768677814
1747352955479422,108347004,1,1157,100,108302196,107505840,796356,125.57198037058804
1747352955569902,108441644,1,1158,100,108392676,107600480,792196,126.23138718196002
1747352955667166,108536284,1,1159,100,108489940,107695120,794820,125.81464985782945
1747352955761886,108630924,1,1160,100,108584660,107789760,794900,125.8019876714052
1747352955856060,108725564,1,1161,100,108678834,107884400,794434,125.87578074453008
1747352955958781,108820204,1,1162,100,108781555,107979040,802515,124.60826277390454
1747352956049161,108914844,1,1163,100,108871935,108073680,798255,125.2732522815391
1747352956143102,109009484,1,1164,100,108965876,108168320,797556,125.38304520309545
1747352956245501,109104124,1,1165,100,109068275,108262960,805315,124.17501226228246
1747352957035822,109886204,1,1173,100,109858596,109045040,813556,122.91716857843836
1747352957133484,109983964,1,1174,100,109956258,109142800,813458,122.93197681994644
1747352957219496,110078604,1,1175,100,110042270,109237440,804830,124.24984158145197
1747352957318173,110173244,1,1176,100,110140947,109332080,808867,123.62971910091522
1747352957411901,110267884,1,1177,100,110234675,109426720,807955,123.76926932811853
1747352957506152,110362524,1,1178,100,110328926,109521360,807566,123.82888828900671
1747352957617805,110457164,1,1179,100,110440579,109616000,824579,121.27400770575046
1747352957703206,110551804,1,1180,100,110525980,109710640,815340,122.64822037432238
1747352957793503,110646444,1,1181,100,110616277,109805280,810997,123.3050183909435
1747352957887646,110741084,1,1182,100,110710420,109899920,810500,123.38062924120914
1747352957982161,110835732,1,1183,100,110804935,109994568,810367,123.40087886105925
1747352958076335,110930364,1,1184,100,110899109,110089200,809909,123.47066151876322
1747352958173777,111025004,1,1185,100,110996551,110183840,812711,123.04496924490995
1747352958268162,111119644,1,1186,100,111090936,110278480,812456,123.08358852664021
1747352958362906,111214284,1,1187,100,111185680,110373120,812560,123.06783499064686
1747352958460798,111308924,1,1188,100,111283572,110467760,815812,122.57726044725992
1747352958555395,111403564,1,1189,100,111378169,110562400,815769,122.58372161727156
1747352958649502,111498204,1,1190,100,111472276,110657040,815236,122.66386665947039
1747352958743960,111592844,1,1191,100,111566734,110751680,815054,122.69125726638973
1747352958850048,111687484,1,1192,100,111672822,110846320,826502,120.99184272996315
1747352958935820,111782124,1,1193,100,111758594,110940960,817634,122.30411161962444
1747352959030016,111876764,1,1194,100,111852790,111035600,817190,122.37056253747599
1747352959124014,111971404,1,1195,100,111946788,111130240,816548,122.46677476400652
1747352959222526,112066044,1,1196,100,112045300,111224880,820420,121.8887886692182
1747352959316196,112160684,1,1197,100,112138970,111319520,819450,122.03307096223077
1747352959411289,112255324,1,1198,100,112234063,111414160,819903,121.96564715582208
1747352959509681,112349964,1,1199,100,112332455,111508800,823655,121.41005639497119
1747352959603129,112444604,1,1200,100,112425903,111603440,822463,121.58601663539879
1747352959697734,112539244,1,1201,100,112520508,111698080,822428,121.59119096139722
1747352959792095,112633892,1,1202,100,112614869,111792728,822141,121.63363705252505
1747352959890437,112728524,1,1203,100,112713211,111887360,825851,121.08721791218997
1747352959984149,112823164,1,1204,100,112806923,111982000,824923,121.22343539942517
1747352960079230,112917804,1,1205,100,112902004,112076640,825364,121.15866454073597
1747352960173375,113012444,1,1206,100,112996149,112171280,824869,121.23137128441002
1747352960271273,113107084,1,1207,100,113094047,112265920,828127,120.75442534780294
1747352960369172,113201724,1,1208,100,113191946,112360560,831386,120.28107281094462
1747352960463474,113296364,1,1209,100,113286248,112455200,831048,120.3299929727284
1747352960557987,113391004,1,1210,100,113380761,112549840,830921,120.34838450346062
1747352960652469,113485644,1,1211,100,113475243,112644480,830763,120.37127315491902
1747352960746745,113580284,1,1212,100,113569519,112739120,830399,120.4240371195052
1747352960840767,113674924,1,1213,100,113663541,112833760,829781,120.51372591081261
1747352960938851,113769564,1,1214,100,113761625,112928400,833225,120.01560202826367
1747352961033002,113864204,1,1215,100,113855776,113023040,832736,120.08607770049571
1747352961127563,113958844,1,1216,100,113950337,113117680,832657,120.09747110755089
1747352961225765,114053484,1,1217,100,114048539,113212320,836219,119.58589795256984
1747352961320089,114148124,1,1218,100,114142863,113306960,835903,119.63110552300925
1747352961414539,114242764,1,1219,100,114237313,113401600,835713,119.65830374781773
1747352961512416,114337404,1,1220,100,114335190,113496240,838950,119.19661481613923
1747352961606759,114432044,1,1221,100,114429533,113590880,838653,119.2388270238108
1747352961700713,114526684,1,1222,100,114523487,113685520,837967,119.33644164985017
1747352961799038,114621324,1,1223,100,114621812,113780160,841652,118.8139516094538
1747352961889108,114715964,1,1224,100,114711882,113874800,837082,119.46260939788456
1747352961987615,114810604,1,1225,100,114810389,113969440,840949,118.91327535914783
1747352962085514,114905244,1,1226,100,114908288,114064080,844208,118.45421981312663
1747352962175755,114999884,1,1227,100,114998529,114158720,839809,119.07469436502824
1747352962282456,115094524,1,1228,100,115105230,114253360,851870,117.38880345592636
1747352962368581,115189164,1,1229,100,115191355,114348000,843355,118.57402873048717
1747352962462268,115283804,1,1230,100,115285042,114442640,842402,118.70817020852277
1747352962556454,115378444,1,1231,100,115379228,114537280,841948,118.7721807047466
1747352962655374,115473084,1,1232,100,115478148,114631920,846228,118.17146206459725
1747352962757684,115567724,1,1233,100,115580458,114726560,853898,117.11000611314232
1747352962850979,115662364,1,1234,100,115673753,114821200,852553,117.29476056034053
1747352962941997,115757004,1,1235,100,115764771,114915840,848931,117.79520361489921
1747352963039681,115851644,1,1236,100,115862455,115010480,851975,117.37433610141142
1747352963134418,115946284,1,1237,100,115957192,115105120,852072,117.36097418997456
1747352963224478,116040924,1,1238,100,116047252,115199760,847492,117.99521411411553
1747352963322702,116135564,1,1239,100,116145476,115294400,851076,117.49831977402722
1747352963420788,116230204,1,1240,100,116243562,115389040,854522,117.02448854447282
1747352963510695,116324844,1,1241,100,116333469,115483680,849789,117.6762702270799
1747352963609716,116419484,1,1242,100,116432490,115578320,854170,117.07271386258004
1747352963703669,116514124,1,1243,100,116526443,115672960,853483,117.16695001540745
1747352963809684,116608764,1,1244,100,116632458,115767600,864858,115.62591778072239
1747352963900327,116703404,1,1245,100,116723101,115862240,860861,116.16277192252872
1747352963990020,116798044,1,1246,100,116812794,115956880,855914,116.83416791873951
1747352964096792,116892692,1,1247,100,116919566,116051528,868038,115.20232985191893
1747352964178182,116987324,1,1248,100,117000956,116146160,854796,116.98697700971928
1747352964277268,117081964,1,1249,100,117100042,116240800,859242,116.3816480106885
1747352964370968,117176604,1,1250,100,117193742,116335440,858302,116.50910751693459
1747352964465409,117271244,1,1251,100,117288183,116430080,858103,116.53612678198306
1747352964563661,117365884,1,1252,100,117386435,116524720,861715,116.04764916474704
1747352964657953,117460524,1,1253,100,117480727,116619360,861367,116.09453345670312
1747352964752256,117555164,1,1254,100,117575030,116714000,861030,116.1399718941268
1747352964846037,117649804,1,1255,100,117668811,116808640,860171,116.25595375803184
1747352964940429,117744444,1,1256,100,117763203,116903280,859923,116.28948173266676
1747352965038466,117839084,1,1257,100,117861240,116997920,863320,115.83190473984155
1747352965132896,117933724,1,1258,100,117955670,117092560,863110,115.86008735850587
1747352965231341,118028364,1,1259,100,118054115,117187200,866915,115.35156272529602
1747352965325477,118123004,1,1260,100,118148251,117281840,866411,115.41866389046307
1747352965419951,118217644,1,1261,100,118242725,117376480,866245,115.4407817649741
1747352965513324,118312284,1,1262,100,118336098,117471120,864978,115.60987678299333
1747352965608261,118406924,1,1263,100,118431035,117565760,865275,115.57019444685216
1747352965706463,118501564,1,1264,100,118529237,117660400,868837,115.09638746968649
1747352965800865,118596204,1,1265,100,118623639,117755040,868599,115.12792439318949
1747352965898631,118690852,1,1266,100,118721405,117849688,871717,114.71612920248201
1747352965988342,118785484,1,1267,100,118811116,117944320,866796,115.36739901891563
1747352966086782,118880124,1,1268,100,118909556,118038960,870596,114.86384040358558
1747352966181693,118974764,1,1269,100,119004467,118133600,870867,114.828096597988
1747352966275671,119069404,1,1270,100,119098445,118228240,870205,114.91545095695842
1747352966369387,119164044,1,1271,100,119192161,118322880,869281,115.03760003957294
1747352966467830,119258684,1,1272,100,119290604,118417520,873084,114.5365165322008
1747352966561839,119353324,1,1273,100,119384613,118512160,872453,114.61935485349926
1747352966656536,119447964,1,1274,100,119479310,118606800,872510,114.61186691270014
1747352966754445,119542604,1,1275,100,119577219,118701440,875779,114.18405785021108
1747352966849303,119637244,1,1276,100,119672077,118796080,875997,114.15564208553225
1747352966947253,119731884,1,1277,100,119770027,118890720,879307,113.7259228005691
1747352967050032,119826524,1,1278,100,119872806,118985360,887446,112.68291253777696
1747352967135400,119921164,1,1279,100,119958174,119080000,878174,113.8726493838351
1747352967233772,120015804,1,1280,100,120056546,119174640,881906,113.39076953779654
1747352967528688,120305964,1,1283,100,120351462,119464800,886662,112.78254847957847
1747352967618497,120400604,1,1284,100,120441271,119559440,881831,113.40041345790746
1747352967713119,120495244,1,1285,100,120535893,119654080,881813,113.40272824283608
1747352967811425,120589884,1,1286,100,120634199,119748720,885479,112.93322597147984
1747352968004458,120782284,1,1288,100,120827232,119941120,886112,112.85255137048138
1747352968097973,120876924,1,1289,100,120920747,120035760,884987,112.99601011088299
1747352968192924,120971564,1,1290,100,121015698,120130400,885298,112.95631527463068
1747352968286755,121066204,1,1291,100,121109529,120225040,884489,113.05963104120006
1747352968384849,121160844,1,1292,100,121207623,120319680,887943,112.61984158893081
1747352968478743,121255484,1,1293,100,121301517,120414320,887197,112.71453803383014
1747352968576850,121350124,1,1294,100,121399624,120508960,890664,112.27578525684208
1747352968773375,121542524,1,1296,100,121596149,120701360,894789,111.7581910372166
1747352968864062,121637164,1,1297,100,121686836,120796000,890836,112.25410737778896
1747352968962225,121731804,1,1298,100,121784999,120890640,894359,111.81192339988752
1747352969056844,121826444,1,1299,100,121879618,120985280,894338,111.81454886183971
1747352969150689,121921084,1,1300,100,121973463,121079920,893543,111.91403211708894
1747352969261116,122015724,1,1301,100,122083890,121174560,909330,109.97107760658947
1747352969371481,122113484,1,1302,100,122194255,121272320,921935,108.46751669043914
1747352969446117,122208124,1,1303,100,122268891,121366960,901931,110.87322644415148
1747352969535964,122302764,1,1304,100,122358738,121461600,897138,111.46557162889098
1747352969629765,122397404,1,1305,100,122452539,121556240,896299,111.56991138001939
1747352969739923,122492044,1,1306,100,122562697,121650880,911817,109.6711291849132
1747352969831032,122586684,1,1307,100,122653806,121745520,908286,110.09748030906565
1747352969920806,122681324,1,1308,100,122743580,121840160,903420,110.69048725952491
1747352970027217,122775964,1,1309,100,122849991,121934800,915191,109.26680878636263
1747352970108914,122870604,1,1310,100,122931688,122029440,902248,110.83427173016732
1747352970198796,122965244,1,1311,100,123021570,122124080,897490,111.42185428249897
1747352970302025,123059884,1,1312,100,123124799,122218720,906079,110.36565244310927
1747352970395589,123154524,1,1313,100,123218363,122313360,905003,110.49687128108968
1747352970616481,123350052,1,1315,100,123439255,122508888,930367,107.48446580757916
1747352971378996,124132124,1,1323,100,124201770,123290960,910810,109.7923826044949
1747352971477118,124226764,1,1324,100,124299892,123385600,914292,109.37424805204465
1747352971571109,124321404,1,1325,100,124393883,123480240,913643,109.45194129435677
1747352971665408,124416044,1,1326,100,124488182,123574880,913302,109.49280741748075
1747352971759899,124510684,1,1327,100,124582673,123669520,913153,109.51067345778857
1747352971854498,124605324,1,1328,100,124677272,123764160,913112,109.51559063948343
1747352971951973,124699964,1,1329,100,124774747,123858800,915947,109.17662266484852
1747352972045973,124797724,1,1330,100,124868747,123956560,912187,109.62664453670136
1747352972140285,124892364,1,1331,100,124963059,124051200,911859,109.6660777598291
1747352972243379,124987004,1,1332,100,125066153,124145840,920313,108.65868459969597
1747352972333807,125081644,1,1333,100,125156581,124240480,916101,109.15826966677254
1747352972428028,125176284,1,1334,100,125250802,124335120,915682,109.20821857369698
1747352972525676,125270924,1,1335,100,125348450,124429760,918690,108.85064602858418
1747352972619571,125365564,1,1336,100,125442345,124524400,917945,108.93898871936771
1747352972922893,125655724,1,1339,100,125745667,124814560,931107,107.39904221534152
1747352973103763,125848124,1,1341,100,125926537,125006960,919577,108.74565153325932
1747352973218366,125942764,1,1342,100,126041140,125101600,939540,106.43506396747344
1747352973791081,126526204,1,1348,100,126613855,125685040,928815,107.66406657945878
1747352973885397,126620844,1,1349,100,126708171,125779680,928491,107.70163631096048
1747352973987848,126715484,1,1350,100,126810622,125874320,936302,106.80314684791873
1747352974077320,126810132,1,1351,100,126900094,125968968,931126,107.39685069475023
1747352974172128,126904764,1,1352,100,126994902,126063600,931302,107.37655454406841
1747352974282567,126999404,1,1353,100,127105341,126158240,947101,105.5853599563299
1747352974376917,127094044,1,1354,100,127199691,126252880,946811,105.61769983660942
1747352975544556,128267164,1,1366,100,128367330,127426000,941330,106.23267079557647
1747352975859561,128557324,1,1369,100,128682335,127716160,966175,103.50091857065232
1747352975949432,128655084,1,1370,100,128772206,127813920,958286,104.35298021676202
1747352976031833,128749724,1,1371,100,128854607,127908560,946047,105.70299361448215
1747352976126338,128844364,1,1372,100,128949112,128003200,945912,105.71807948308088
1747352976219844,128939004,1,1373,100,129042618,128097840,944778,105.84497098789345
1747352976314533,129033644,1,1374,100,129137307,128192480,944827,105.8394817252259
1747352976408025,129128284,1,1375,100,129230799,128287120,943679,105.96823708061746
1747352976502745,129222924,1,1376,100,129325519,128381760,943759,105.95925442830215
1747352976600822,129317564,1,1377,100,129423596,128476400,947196,105.57477016372535
1747352976699434,129412204,1,1378,100,129522208,128571040,951168,105.13389853317184
1747352976789571,129506844,1,1379,100,129612345,128665680,946665,105.6339887922338
1747352976887110,129601484,1,1380,100,129709884,128760320,949564,105.3114903260865
1747352976981608,129696124,1,1381,100,129804382,128854960,949422,105.327241205702
1747352977075584,129790764,1,1382,100,129898358,128949600,948758,105.40095577586698
1747352977169966,129885404,1,1383,100,129992740,129044240,948500,105.42962572482868
1747352977268796,129980044,1,1384,100,130091570,129138880,952690,104.96593855293956
1747352977362997,130074684,1,1385,100,130185771,129233520,952251,105.01432920522005
1747352977457211,130169324,1,1386,100,130279985,129328160,951825,105.06132955112547
1747352977555086,130263964,1,1387,100,130377860,129422800,955060,104.70546353108705
1747352977649383,130358604,1,1388,100,130472157,129517440,954717,104.7430809339312
1747352977743436,130453244,1,1389,100,130566210,129612080,954130,104.80752098770607
1747352977838443,130547884,1,1390,100,130661217,129706720,954497,104.7672229456981
1747352977936085,130642524,1,1391,100,130758859,129801360,957499,104.4387513720641
1747352978030640,130737172,1,1392,100,130853414,129896008,957406,104.44889628851293
1747352978124003,130831804,1,1393,100,130946777,129990640,956137,104.58752249939077
1747352978218579,130926444,1,1394,100,131041353,130085280,956073,104.59452363993127
1747352978316451,131021084,1,1395,100,131139225,130179920,959305,104.2421336279911
1747352978411219,131115724,1,1396,100,131233993,130274560,959433,104.22822646292133
1747352978505758,131210364,1,1397,100,131328532,130369200,959332,104.23919977651116
1747352978603752,131305004,1,1398,100,131426526,130463840,962686,103.8760301905294
1747352978697865,131399644,1,1399,100,131520639,130558480,962159,103.9329258469754
1747352978795861,131494284,1,1400,100,131618635,130653120,965515,103.57166900566018
1747352978886333,131588924,1,1401,100,131709107,130747760,961347,104.02071260429378
1747352978984732,131683564,1,1402,100,131807506,130842400,965106,103.61556139947322
1747352979079051,131778204,1,1403,100,131901825,130937040,964785,103.65003601838751
1747352979172771,131872844,1,1404,100,131995545,131031680,963865,103.74896899462063
1747352979271567,131967484,1,1405,100,132094341,131126320,968021,103.3035440346852
1747352979364947,132062124,1,1406,100,132187721,131220960,966761,103.43818172226642
1747352979459250,132156764,1,1407,100,132282024,131315600,966424,103.47425146726489
1747352979554290,132251404,1,1408,100,132377064,131410240,966824,103.43144150331395
1747352979651746,132346044,1,1409,100,132474520,131504880,969640,103.1310589497133
1747352979745884,132440684,1,1410,100,132568658,131599520,969138,103.18447940334606
1747352979840736,132535332,1,1411,100,132663510,131694168,969342,103.16276401930381
1747352979935161,132629964,1,1412,100,132757935,131788800,969135,103.18479881543851
1747352980033497,132724604,1,1413,100,132856271,131883440,972831,102.79277695714877
1747352980127549,132819244,1,1414,100,132950323,131978080,972243,102.85494470003898
1747352980221483,132913884,1,1415,100,133044257,132072720,971537,102.92968770103455
1747352980319507,133008524,1,1416,100,133142281,132167360,974921,102.57241355966278
1747352980414423,133103164,1,1417,100,133237197,132262000,975197,102.54338354199203
1747352980508614,133197804,1,1418,100,133331388,132356640,974748,102.59061829313833
1747352980602164,133292444,1,1419,100,133424938,132451280,973658,102.70546742285279
1747352980700989,133387084,1,1420,100,133523763,132545920,977843,102.26590567197393
1747352980794927,133481724,1,1421,100,133617701,132640560,977141,102.3393757912113
1747352980889597,133576364,1,1422,100,133712371,132735200,977171,102.33623388332236
1747352980983836,133671004,1,1423,100,133806610,132829840,976770,102.37824667014752
1747352981080788,133765644,1,1424,100,133903562,132924480,979082,102.13649112127483
1747352981175276,133860284,1,1425,100,133998050,133019120,978930,102.1523500148121
1747352981270198,133954924,1,1426,100,134092972,133113760,979212,102.12293150002247
1747352981368206,134049564,1,1427,100,134190980,133208400,982580,101.77288363288486
1747352981461976,134144204,1,1428,100,134284750,133303040,981710,101.86307565370629
1747352981556751,134238844,1,1429,100,134379525,133397680,981845,101.84906986336948
1747352981655383,134333484,1,1430,100,134478157,133492320,985837,101.43664723478628
1747352981749380,134428124,1,1431,100,134572154,133586960,985194,101.50285121509063
1747352981843236,134522764,1,1432,100,134666010,133681600,984410,101.5836897227781
1747352981937241,134617404,1,1433,100,134760015,133776240,983775,101.64925923102336
1747352982036238,134712044,1,1434,100,134859012,133870880,988132,101.20105411017961
1747352982130271,134806684,1,1435,100,134953045,133965520,987525,101.263259157996
1747352982228796,134901324,1,1436,100,135051570,134060160,991410,100.86644274316377
1747352982519507,135191484,1,1439,100,135342281,134350320,991961,100.8104149255868
1747352982612913,135286124,1,1440,100,135435687,134444960,990727,100.93597933638631
1747352982707260,135380764,1,1441,100,135530034,134539600,990434,100.96583921795899
1747352982801751,135475404,1,1442,100,135624525,134634240,990285,100.98103071338049
1747352982900441,135570044,1,1443,100,135723215,134728880,994335,100.56972750632332
1747352982994527,135664684,1,1444,100,135817301,134823520,993781,100.62579179919922
1747352983088218,135759324,1,1445,100,135910992,134918160,992832,100.72197511764327
1747352983182859,135853964,1,1446,100,136005633,135012800,992833,100.72187366858273
1747352983281395,135948604,1,1447,100,136104169,135107440,996729,100.32817345537252
1747352983375571,136043244,1,1448,100,136198345,135202080,996265,100.37490025244288
1747352983469687,136137884,1,1449,100,136292461,135296720,995741,100.42772166657795
1747352983567341,136232524,1,1450,100,136390115,135391360,998755,100.12465519571867
1747352983661661,136327164,1,1451,100,136484435,135486000,998435,100.15674530640453
1747352983755652,136421804,1,1452,100,136578426,135580640,997786,100.22189126726573
1747352983850000,136516444,1,1453,100,136672774,135675280,997494,100.25122958133082
1747352983948212,136611084,1,1454,100,136770986,135769920,1001066,99.89351351459344
1747352984042734,136705724,1,1455,100,136865508,135864560,1000948,99.90528978528356
1747352984137344,136800364,1,1456,100,136960118,135959200,1000918,99.90828419510889
1747352984235142,136895004,1,1457,100,137057916,136053840,1004076,99.59405463331461
1747352984329162,136989644,1,1458,100,137151936,136148480,1003456,99.65559027999235
1747352984436366,137084284,1,1459,100,137259140,136243120,1016020,98.42325938465778
1747352984522092,137178924,1,1460,100,137344866,136337760,1007106,99.2944138948631
1747352984616304,137273564,1,1461,100,137439078,136432400,1006678,99.33662998496044
1747352984709918,137368204,1,1462,100,137532692,136527040,1005652,99.43797655650265
1747352984807347,137462844,1,1463,100,137630121,136621680,1008441,99.16296540898279
1747352984996909,137655244,1,1465,100,137819683,136814080,1005603,99.44282186906761
1747352985095538,137749884,1,1466,100,137918312,136908720,1009592,99.049913232276
1747352985189187,137844524,1,1467,100,138011961,137003360,1008601,99.14723463490517
1747352985283604,137939164,1,1468,100,138106378,137098000,1008378,99.16916077106006
1747352985381683,138033804,1,1469,100,138204457,137192640,1011817,98.83210106175326
1747352985476585,138128444,1,1470,100,138299359,137287280,1012079,98.80651609212325
1747352985570027,138223084,1,1471,100,138392801,137381920,1010881,98.92361217591389
1747352985665189,138317724,1,1472,100,138487963,137476560,1011403,98.8725562411818
1747352985763007,138412364,1,1473,100,138585781,137571200,1014581,98.5628550110834
1747352985856553,138507004,1,1474,100,138679327,137665840,1013487,98.66924785419053
1747352985950964,138601644,1,1475,100,138773738,137760480,1013258,98.69154746372593
1747352986045867,138696284,1,1476,100,138868641,137855120,1013521,98.6659378542724
1747352986143734,138790932,1,1477,100,138966508,137949768,1016740,98.35356138245766
1747352986237921,138885564,1,1478,100,139060695,138044400,1016295,98.3966269636277
1747352986332369,138980204,1,1479,100,139155143,138139040,1016103,98.41521971689878
1747352986430596,139074844,1,1480,100,139253370,138233680,1019690,98.06902097696359
1747352986525075,139169484,1,1481,100,139347849,138328320,1019529,98.08450765010119
1747352986619230,139264124,1,1482,100,139442004,138422960,1019044,98.13118962478558
1747352986712884,139358764,1,1483,100,139535658,138517600,1018058,98.22623072555788
1747352986811587,139453404,1,1484,100,139634361,138612240,1022121,97.83577482509409
1747352986905445,139548044,1,1485,100,139728219,138706880,1021339,97.91068391591823
1747352987000177,139642684,1,1486,100,139822951,138801520,1021431,97.90186512843256
1747352987098220,139737324,1,1487,100,139920994,138896160,1024834,97.57677828799591
1747352987192700,139831964,1,1488,100,140015474,138990800,1024674,97.59201463099483
1747352987286835,139926604,1,1489,100,140109609,139085440,1024169,97.6401355635642
1747352987380830,140021244,1,1490,100,140203604,139180080,1023524,97.70166600880877
1747352987478712,140115884,1,1491,100,140301486,139274720,1026766,97.39317429677259
1747352987573683,140210524,1,1492,100,140396457,139369360,1027097,97.36178764031051
1747352987671793,140305164,1,1493,100,140494567,139464000,1030567,97.0339628573397
1747352987765118,140399804,1,1494,100,140587892,139558640,1029252,97.1579360545328
1747352987860345,140494444,1,1495,100,140683119,139653280,1029839,97.1025568074233
1747352987953719,140589092,1,1496,100,140776493,139747928,1028565,97.22282986490889
1747352988048406,140683724,1,1497,100,140871180,139842560,1028620,97.21763138962882
1747352988155068,140778364,1,1498,100,140977842,139937200,1040642,96.09452626359497
1747352988241129,140873004,1,1499,100,141063903,140031840,1032063,96.89330980763772
1747352988343002,140967644,1,1500,100,141165776,140126480,1039296,96.21897900117003
